Current Real Time,Real Time Elapsed (sec),Local Server Time,Hardware Clock Time,Software Clock Time,Error,Remote Est Time,
4886134327,0.00069,7263790790,807797,807797,-7262982993,,
4886150412,0.01677,7263806875,823881,823882,-7262982993,7263806781,
4886400889,0.26725,7264057353,1074360,1820313581,-5443743772,,
4886651420,0.51778,7264307883,1324890,3640151953,-3624155930,,
4886901573,0.76793,7264558034,1575041,5457244540,-1807313494,,
4887151743,1.01810,7264808205,1825212,7264808113,-92,,
4887402175,1.26854,7265058636,2075643,7265058544,-92,,
4887652581,1.51894,7265309041,2326048,7265308950,-91,,
4887902883,1.76924,7265559342,2576348,7265559250,-92,,
4888153009,2.01937,7265809466,2826473,7265809375,-91,,
4888169077,2.03544,7265825534,2842540,7265825441,-93,7265825524,
4888419325,2.28569,7266075781,3092788,7266075709,-72,,
4888669458,2.53582,7266325913,3342919,7266325862,-51,,
4888919995,2.78636,7266576450,3593456,7266576420,-30,,
4889170593,3.03695,7266827047,3844054,7266827039,-8,,
4889420738,3.28710,7267077190,4094196,7267077182,-8,,
4889670929,3.53729,7267327381,4344388,7267327373,-8,,
4889921396,3.78776,7267577847,4594854,7267577839,-8,,
4890171694,4.03805,7267828144,4845151,7267828137,-7,,
4890188242,4.05460,7267844691,4861698,7267844683,-8,7267844486,
4890438454,4.30481,7268094903,5111910,7268094846,-57,,
4890689100,4.55546,7268345549,5362556,7268345442,-107,,
4890939410,4.80577,7268595858,5612865,7268595702,-156,,
4891189553,5.05591,7268845999,5863006,7268845795,-204,,
4891439694,5.30605,7269096139,6113146,7269095935,-204,,
4891689838,5.55620,7269346282,6363289,7269346078,-204,,
4891939997,5.80636,7269596441,6613458,7269596248,-193,,
4892190349,6.05671,7269846793,6863800,7269846589,-204,,
4892206443,6.07280,7269862885,6879892,7269862681,-204,7269862929,
4892457001,6.32336,7270113443,7130450,7270113301,-142,,
4892707625,6.57399,7270364066,7381084,7270363997,-69,,
4892957751,6.82411,7270614192,7631198,7270614175,-17,,
4893207894,7.07425,7270864343,7881349,7270864388,45,,
4893458178,7.32454,7271114616,8131623,7271114661,45,,
4893708913,7.57527,7271365351,8382357,7271365396,45,,
4893959063,7.82542,7271615499,8632506,7271615545,46,,
4894209443,8.07580,7271865878,8882885,7271865924,46,,
4894225808,8.09217,7271882254,8899261,7271882299,45,7271882216,
4894475955,8.34232,7272132389,9149396,7272132416,27,,
4894726961,8.59332,7272383395,9400402,7272383405,10,,
4894977153,8.84351,7272633587,9650593,7272633579,-8,,
4895227799,9.09416,7272884232,9901238,7272884207,-25,,
4895478082,9.34444,7273134514,10151520,7273134489,-25,,
4895728242,9.59460,7273384672,10401679,7273384648,-24,,
4895978697,9.84506,7273635126,10652133,7273635102,-24,,
4896228854,10.09521,7273885282,10902289,7273885257,-25,,
4896245233,10.11159,7273901660,10918666,7273901635,-25,7273901566,
4896495379,10.36174,7274151807,11168814,7274151765,-42,,
4896745639,10.61200,7274402065,11419072,7274402006,-59,,
4896995758,10.86212,7274652183,11669190,7274652107,-76,,
4897246330,11.11269,7274902756,11919762,7274902663,-93,,
4897496487,11.36285,7275152912,12169919,7275152820,-92,,
4897746645,11.61301,7275403068,12420075,7275402975,-93,,
4897997366,11.86373,7275653789,12670795,7275653696,-93,,
4898247460,12.11382,7275903881,12920887,7275903788,-93,,
4898263971,12.13033,7275920391,12937397,7275920298,-93,7275920560,
4898514098,12.38046,7276170519,13187526,7276170492,-27,,
4898764731,12.63109,7276421149,13438156,7276421188,39,,
4899014880,12.88124,7276671298,13688305,7276671403,105,,
4899264992,13.13135,7276921409,13938416,7276921580,171,,
4899515188,13.38155,7277171605,14188611,7277171776,171,,
4899765574,13.63194,7277421990,14438997,7277422161,171,,
4900016137,13.88250,7277672552,14689559,7277672723,171,,
4900266255,14.13262,7277922669,14939675,7277922840,171,,
4900282181,14.14854,7277938594,14955601,7277938765,171,7277938602,
4900532807,14.39917,7278189221,15206228,7278189352,131,,
4900783262,14.64962,7278439674,15456692,7278439775,101,,
4901033398,14.89976,7278689809,15706817,7278689860,51,,
4901283509,15.14987,7278939920,15956926,7278939930,10,,
4901534349,15.40071,7279190758,16207765,7279190769,11,,
4901785003,15.65136,7279441412,16458419,7279441422,10,,
4902035404,15.90176,7279691813,16708819,7279691823,10,,
4902286345,16.15271,7279942753,16959760,7279942763,10,,
4902302345,16.16871,7279958752,16975758,7279958762,10,7279958767,
4902552528,16.41889,7280208934,17225941,7280208945,11,,
4902803162,16.66952,7280459568,17476574,7280459581,13,,
4903053297,16.91966,7280709701,17726707,7280709716,15,,
4903303460,17.16982,7280959863,17976870,7280959880,17,,
4903553591,17.41995,7281209993,18227000,7281210010,17,,
4903803714,17.67008,7281460116,18477123,7281460133,17,,
4904054340,17.92070,7281710741,18727748,7281710758,17,,
4904304835,18.17120,7281961235,18978242,7281961252,17,,
4904321045,18.18741,7281977443,18994450,7281977460,17,7281977343,
4904571676,18.43804,7282228074,19245080,7282228061,-13,,
4904822351,18.68871,7282478749,19495756,7282478707,-42,,
4905072559,18.93892,7282728956,19745963,7282728885,-71,,
4905322825,19.18919,7282979222,19996229,7282979123,-99,,
4905573027,19.43939,7283229422,20246428,7283229322,-100,,
4905823284,19.68964,7283479678,20496685,7283479580,-98,,
4906073420,19.93978,7283729813,20746820,7283729725,-88,,
4906324402,20.19076,7283980795,20997801,7283980696,-99,,
4906340677,20.20704,7283997069,21014075,7283996969,-100,7283997049,
4906590794,20.45716,7284247186,21264192,7284247106,-80,,
4906840931,20.70729,7284497322,21514339,7284497274,-48,,
4907091379,20.95774,7284747770,21764776,7284747732,-38,,
4907342344,21.20870,7284998733,22015740,7284998716,-17,,
4907592493,21.45885,7285248881,22265888,7285248863,-18,,
4907843098,21.70946,7285499485,22516492,7285499468,-17,,
4908093602,21.95996,7285749992,22766999,7285749974,-18,,
4908343754,22.21011,7286000140,23017146,7286000122,-18,,
4908359879,22.22624,7286016264,23033270,7286016246,-18,7286016172,
4908610035,22.47640,7286266420,23283427,7286266383,-37,,
4908860595,22.72696,7286516979,23533986,7286516935,-44,,
4909111033,22.97739,7286767415,23784422,7286767343,-72,,
4909361726,23.22809,7287018108,24035115,7287018018,-90,,
4909611889,23.47825,7287268270,24285277,7287268180,-90,,
4909862330,23.72869,7287518710,24535716,7287518620,-90,,
4910112478,23.97884,7287768857,24785864,7287768767,-90,,
4910362651,24.22901,7288019030,25036037,7288018940,-90,,
4910379422,24.24578,7288035800,25052806,7288035709,-91,7288035438,
4910629528,24.49589,7288285905,25302912,7288285747,-158,,
4910879697,24.74606,7288536073,25553080,7288535847,-226,,
4911129808,24.99617,7288786183,25803190,7288785891,-292,,
4911380434,25.24679,7289036808,26053814,7289036448,-360,,
4911631096,25.49746,7289287469,26304476,7289287110,-359,,
4911881486,25.74785,7289537859,26554866,7289537510,-349,,
4912131978,25.99834,7289788351,26805358,7289787991,-360,,
4912382868,26.24923,7290039240,27056246,7290038880,-360,,
4912399012,26.26537,7290055382,27072389,7290055022,-360,7290055414,
4912649259,26.51562,7290305629,27322636,7290305367,-262,,
4912899463,26.76582,7290555832,27572840,7290555669,-163,,
4913149633,27.01599,7290806002,27823008,7290805936,-66,,
4913399916,27.26628,7291056284,28073290,7291056317,33,,
4913650491,27.51685,7291306858,28323865,7291306891,33,,
4913900611,27.76697,7291556976,28573983,7291557009,33,,
4914151018,28.01738,7291807382,28824389,7291807416,34,,
4914401153,28.26751,7292057517,29074523,7292057550,33,,
4914417337,28.28370,7292073700,29090706,7292073733,33,7292073656,
4914667845,28.53421,7292324209,29341215,7292324223,14,,
4914918349,28.78471,7292574712,29591718,7292574707,-5,,
4915168999,29.03536,7292825360,29842367,7292825338,-22,,
4915419469,29.28583,7293075830,30092836,7293075787,-43,,
4915670257,29.53662,7293326616,30343623,7293326574,-42,,
4915920874,29.78723,7293577232,30594238,7293577190,-42,,
4916171585,30.03795,7293827943,30844950,7293827901,-42,,
4916421740,30.28810,7294078096,31095103,7294078055,-41,,
4916438343,30.30470,7294094698,31111705,7294094656,-42,7294094582,
4916688458,30.55482,7294344813,31361820,7294344752,-61,,
4916938583,30.80494,7294594938,31611944,7294594859,-79,,
4917188741,31.05510,7294845096,31862102,7294844999,-97,,
4917439046,31.30541,7295095400,32112406,7295095285,-115,,
4917689216,31.55558,7295345568,32362575,7295345453,-115,,
4917939379,31.80574,7295595730,32612737,7295595615,-115,,
4918189539,32.05590,7295845890,32862897,7295845775,-115,,
4918439681,32.30604,7296096030,33113037,7296095916,-114,,
4918455850,32.32221,7296112199,33129205,7296112084,-115,7296112172,
4918706307,32.57267,7296362668,33379674,7296362574,-94,,
4918956866,32.82323,7296613213,33630220,7296613143,-70,,
4919207037,33.07340,7296863384,33880391,7296863336,-48,,
4919457474,33.32384,7297113819,34130826,7297113794,-25,,
4919708201,33.57456,7297364546,34381553,7297364521,-25,,
4919958998,33.82536,7297615342,34632348,7297615317,-25,,
4920209656,34.07602,7297865999,34883006,7297865975,-24,,
4920460076,34.32644,7298116418,35133425,7298116393,-25,,
4920476164,34.34253,7298132506,35149512,7298132481,-25,7298132604,
4920726640,34.59300,7298382981,35399988,7298382987,6,,
4920976892,34.84325,7298633232,35650238,7298633269,37,,
4921227389,35.09375,7298883728,35900735,7298883797,69,,
4921479125,35.34549,7299135463,36152470,7299135563,100,,
4921730874,35.59723,7299387212,36404218,7299387312,100,,
4921981240,35.84760,7299637577,36654584,7299637677,100,,
4922231769,36.09813,7299888106,36905113,7299888206,100,,
4922481942,36.34830,7300138277,37155283,7300138377,100,,
4922498779,36.36514,7300155114,37172120,7300155213,99,7300154683,
4922749309,36.61567,7300405644,37422651,7300405611,-33,,
4922999776,36.86614,7300656109,37673116,7300655944,-165,,
4923250178,37.11654,7300906510,37923517,7300906213,-297,,
4923500500,37.36686,7301156832,38173838,7301156403,-429,,
4923751164,37.61753,7301407494,38424501,7301407065,-429,,
4924001231,37.86759,7301657560,38674567,7301657132,-428,,
4924251544,38.11791,7301907872,38924879,7301907443,-429,,
4924502318,38.36868,7302158646,39175653,7302158228,-418,,
4924518598,38.38496,7302174924,39191930,7302174495,-429,7302174895,
4924769037,38.63540,7302425365,39442371,7302425036,-329,,
4925019524,38.88589,7302675851,39692858,7302675623,-228,,
4925270351,39.13671,7302926676,39943683,7302926550,-126,,
4925520855,39.38722,7303177180,40194186,7303177152,-28,,
4925771601,39.63796,7303427924,40444931,7303427898,-26,,
4926022305,39.88867,7303678628,40695634,7303678601,-27,,
4926272442,40.13880,7303928763,40945770,7303928737,-26,,
4926522974,40.38934,7304179295,41196301,7304179268,-27,,
4926538982,40.40534,7304195302,41212308,7304195274,-28,7304195253,
4926789495,40.65586,7304445815,41462822,7304445782,-33,,
4927039643,40.90600,7304695963,41712970,7304695925,-38,,
4927289811,41.15617,7304946130,41963136,7304946087,-43,,
4927539927,41.40629,7305196244,42213251,7305196197,-47,,
4927790332,41.65669,7305446648,42463656,7305446613,-35,,
4928040485,41.90685,7305696801,42713808,7305696754,-47,,
4928290629,42.15699,7305946944,42963951,7305946897,-47,,
4928540957,42.40732,7306197270,43214277,7306197224,-46,,
4928557137,42.42350,7306213449,43230456,7306213402,-47,7306213454,
4928807604,42.67397,7306463917,43480924,7306463884,-33,,
4929057812,42.92417,7306714123,43731130,7306714104,-19,,
4929307964,43.17433,7306964275,43981282,7306964270,-5,,
4929558352,43.42471,7307214662,44231670,7307214670,8,,
4929808518,43.67488,7307464828,44481835,7307464835,7,,
4930059025,43.92539,7307715333,44732340,7307715340,7,,
4930309150,44.17551,7307965457,44982464,7307965465,8,,
4930559283,44.42564,7308215590,45232597,7308215597,7,,
4930575442,44.44180,7308231757,45248764,7308231764,7,7308231784,
4930825704,44.69206,7308482010,45499017,7308482024,14,,
4931075875,44.94224,7308732180,45749187,7308732203,23,,
4931326824,45.19318,7308983127,46000134,7308983158,31,,
4931576890,45.44325,7309233192,46250199,7309233232,40,,
4931827408,45.69377,7309483710,46500717,7309483750,40,,
4932077522,45.94388,7309733823,46750829,7309733862,39,,
4932327605,46.19397,7309983905,47000912,7309983945,40,,
4932577916,46.44428,7310234215,47251222,7310234254,39,,
4932594019,46.46038,7310250317,47267324,7310250356,39,7310250293,
4932844455,46.71082,7310500753,47517760,7310500776,23,,
4933094959,46.96132,7310751256,47768263,7310751264,8,,
4933345217,47.21158,7311001513,48018520,7311001506,-7,,
4933595660,47.46202,7311251955,48268962,7311251933,-22,,
4933846383,47.71274,7311502677,48519684,7311502656,-21,,
4934096666,47.96303,7311752959,48769966,7311752938,-21,,
4934346813,48.21317,7312003105,49020112,7312003084,-21,,
4934597798,48.46416,7312254090,49271097,7312254069,-21,,
4934613821,48.48018,7312270112,49287119,7312270090,-22,7312270123,
4934864031,48.73039,7312520323,49537330,7312520310,-13,,
4935114154,48.98051,7312770444,49787451,7312770441,-3,,
4935364567,49.23093,7313020857,50037864,7313020861,4,,
4935615078,49.48144,7313271366,50288373,7313271380,14,,
4935865227,49.73159,7313521515,50538522,7313521529,14,,
4936115436,49.98180,7313771722,50788729,7313771736,14,,
4936365570,50.23193,7314021856,51038862,7314021869,13,,
4936615904,50.48226,7314272188,51289195,7314272202,14,,
4936631990,50.49835,7314288273,51305280,7314288286,13,7314288300,
4936882621,50.74898,7314538905,51555912,7314538923,18,,
4937132764,50.99912,7314789047,51806053,7314789068,21,,
4937383277,51.24964,7315039560,52056566,7315039585,25,,
4937633978,51.50034,7315290259,52307266,7315290288,29,,
4937884556,51.75092,7315540836,52557843,7315540865,29,,
4938135133,52.00149,7315791413,52808419,7315791442,29,,
4938386155,52.25252,7316042434,53059440,7316042463,29,,
4938636299,52.50266,7316292576,53309583,7316292605,29,,
4938652553,52.51891,7316308830,53325836,7316308858,28,7316308801,
4938902764,52.76913,7316559041,53576047,7316559047,6,,
4939152896,53.01926,7316809171,53826178,7316809166,-5,,
4939403430,53.26979,7317059704,54076711,7317059688,-16,,
4939654343,53.52070,7317310618,54327625,7317310591,-27,,
4939904477,53.77084,7317560751,54577758,7317560724,-27,,
4940154665,54.02103,7317810937,54827944,7317810910,-27,,
4940404815,54.27118,7318061086,55078093,7318061059,-27,,
4940655454,54.52181,7318311725,55328731,7318311697,-28,,
4940671649,54.53801,7318327918,55344924,7318327890,-28,7318327995,
4940922230,54.78859,7318578499,55595506,7318578498,-1,,
4941172497,55.03886,7318828765,55845772,7318828791,26,,
4941422663,55.28902,7319078931,56095938,7319078984,53,,
4941673161,55.53952,7319329427,56346434,7319329506,79,,
4941923507,55.78987,7319579774,56596780,7319579853,79,,
4942173856,56.04022,7319830122,56847128,7319830200,78,,
4942424411,56.29077,7320080676,57097683,7320080755,79,,
4942675452,56.54181,7320331715,57348722,7320331795,80,,
4942691549,56.55791,7320347811,57364817,7320347901,90,7320347760,
4942941681,56.80804,7320597943,57614950,7320597991,48,,
4943192211,57.05857,7320848473,57865480,7320848488,15,,
4943442413,57.30877,7321098673,58115680,7321098667,-6,,
4943692591,57.55895,7321348850,58365857,7321348802,-48,,
4943942744,57.80911,7321599003,58616010,7321598954,-49,,
4944192886,58.05925,7321849144,58866150,7321849095,-49,,
4944443418,58.30978,7322099675,59116682,7322099626,-49,,
4944694190,58.56055,7322350447,59367453,7322350398,-49,,
4944710259,58.57662,7322366515,59383521,7322366465,-50,7322366477,
4944960455,58.82682,7322616710,59633717,7322616664,-46,,
4945210624,59.07699,7322866878,59883885,7322866835,-43,,
4945460842,59.32720,7323117095,60134102,7323117057,-38,,
4945711171,59.57753,7323367423,60384430,7323367387,-36,,
4945961509,59.82787,7323617761,60634768,7323617725,-36,,
4946211954,60.07832,7323868205,60885212,7323868169,-36,,
4946462762,60.32912,7324119018,61136025,7324118982,-36,,
4946712925,60.57929,7324369173,61386180,7324369137,-36,,
4946729048,60.59541,7324385296,61402302,7324385260,-36,7324385301,
4946979409,60.84577,7324635657,61652665,7324635642,-15,,
4947229625,61.09599,7324885873,61902879,7324885858,-15,,
4947480080,61.34644,7325136327,62153334,7325136323,-4,,
4947730233,61.59659,7325386478,62403485,7325386486,8,,
4947980384,61.84674,7325636629,62653635,7325636636,7,,
4948230940,62.09730,7325887183,62904190,7325887190,7,,
4948481191,62.34755,7326137433,63154440,7326137440,7,,
4948731925,62.59829,7326388166,63405173,7326388173,7,,
4948747942,62.61430,7326404182,63421189,7326404189,7,7326404104,
4948998802,62.86516,7326655042,63672049,7326655029,-13,,
4949249195,63.11556,7326905434,63922441,7326905399,-35,,
4949499950,63.36631,7327156189,64173195,7327156134,-55,,
4949750286,63.61665,7327406524,64423531,7327406448,-76,,
4950000723,63.86708,7327656960,64673967,7327656884,-76,,
4950250977,64.11734,7327907213,64924220,7327907137,-76,,
4950501641,64.36800,7328157876,65174883,7328157801,-75,,
4950752310,64.61867,7328408544,65425551,7328408468,-76,,
4950768469,64.63483,7328424703,65441709,7328424627,-76,7328424763,
4951018943,64.88530,7328675176,65692183,7328675134,-42,,
4951269148,65.13551,7328925380,65942387,7328925373,-7,,
4951520100,65.38646,7329176331,66193338,7329176360,29,,
4951770371,65.63673,7329426601,66443608,7329426664,63,,
4952021005,65.88737,7329677235,66694242,7329677297,62,,
4952271410,66.13777,7329927640,66944646,7329927702,62,,
4952521839,66.38820,7330178067,67195074,7330178129,62,,
4952772862,66.63922,7330429089,67446096,7330429151,62,,
4952788827,66.65519,7330445053,67462060,7330445115,62,7330445019,
4953039293,66.90565,7330695519,67712526,7330695557,38,,
4953289459,67.15582,7330945684,67962691,7330945698,14,,
4953540281,67.40664,7331196506,68213513,7331196497,-9,,
4953790880,67.65724,7331447103,68464109,7331447071,-32,,
4954041159,67.90752,7331697382,68714388,7331697350,-32,,
4954291664,68.15802,7331947885,68964892,7331947854,-31,,
4954541935,68.40830,7332198157,69215164,7332198125,-32,,
4954792028,68.65839,7332448248,69465255,7332448216,-32,,
4954808055,68.67442,7332464274,69481281,7332464242,-32,7332464233,
4955058542,68.92490,7332714761,69731768,7332714728,-33,,
4955308979,69.17534,7332965197,69982204,7332965161,-36,,
4955559408,69.42577,7333215626,70232632,7333215589,-37,,
4955809941,69.67630,7333466157,70483163,7333466118,-39,,
4956060457,69.92682,7333716673,70733679,7333716634,-39,,
4956310874,70.17723,7333967089,70984095,7333967050,-39,,
4956561093,70.42745,7334217306,71234313,7334217267,-39,,
4956811527,70.67789,7334467740,71484747,7334467701,-39,,
4956827687,70.69405,7334483898,71500905,7334483859,-39,7334483945,
4957078315,70.94468,7334734527,71751534,7334734510,-17,,
4957328984,71.19535,7334985196,72002202,7334985201,5,,
4957579310,71.44567,7335235520,72252526,7335235547,27,,
4957829569,71.69593,7335485779,72502785,7335485828,49,,
4958080041,71.94640,7335736250,72753256,7335736299,49,,
4958330879,72.19724,7335987087,73004093,7335987136,49,,
4958581333,72.44769,7336237539,73254546,7336237589,50,,
4958832100,72.69846,7336488305,73505312,7336488354,49,,
4958848341,72.71470,7336504545,73521551,7336504594,49,7336504560,
4959099120,72.96548,7336755324,73772330,7336755364,40,,
4959349482,73.21584,7337005685,74022692,7337005717,32,,
4959600033,73.46639,7337256236,74273243,7337256262,26,,
4959850833,73.71719,7337507036,74524042,7337507053,17,,
4960101506,73.96787,7337757707,74774714,7337757724,17,,
4960352123,74.21848,7338008323,75025330,7338008340,17,,
4960602761,74.46912,7338258960,75275967,7338258977,17,,
4960853298,74.71966,7338509497,75526504,7338509514,17,,
4960869604,74.73596,7338525802,75542808,7338525818,16,7338525798,
4961120145,74.98651,7338776343,75793350,7338776355,12,,
4961370962,75.23732,7339027158,76044165,7339027165,7,,
4961621106,75.48747,7339277302,76294309,7339277305,3,,
4961871687,75.73805,7339527882,76544888,7339527880,-2,,
4962122098,75.98846,7339778293,76795300,7339778291,-2,,
4962372353,76.23871,7340028547,77045554,7340028545,-2,,
4962622620,76.48898,7340278812,77295819,7340278810,-2,,
4962872709,76.73907,7340528900,77545907,7340528899,-1,,
4962888792,76.75515,7340544982,77561989,7340544980,-2,7340544978,
4963139623,77.00598,7340795813,77812820,7340795810,-3,,
4963390035,77.25640,7341046224,78063230,7341046221,-3,,
4963640174,77.50653,7341296362,78313369,7341296359,-3,,
4963890890,77.75725,7341547077,78564084,7341547074,-3,,
4964141765,78.00813,7341797951,78814957,7341797948,-3,,
4964392229,78.25859,7342048416,79065422,7342048413,-3,,
4964642595,78.50896,7342298781,79315787,7342298778,-3,,
4964893057,78.75942,7342549242,79566249,7342549239,-3,,
4964909363,78.77572,7342565546,79582553,7342565543,-3,7342565558,
4965159600,79.02596,7342815783,79832790,7342815784,1,,
4965409745,79.27611,7343065927,80082934,7343065933,6,,
4965660376,79.52674,7343316557,80333565,7343316568,11,,
4965910554,79.77692,7343566735,80583742,7343566749,14,,
4966161065,80.02743,7343817245,80834252,7343817259,14,,
4966411419,80.27778,7344067597,81084603,7344067611,14,,
4966662221,80.52858,7344318426,81335434,7344318441,15,,
4966912907,80.77927,7344569085,81586091,7344569099,14,,
4966928922,80.79528,7344585098,81602104,7344585112,14,7344585079,
4967179674,81.04604,7344835850,81852857,7344835856,6,,
4967430490,81.29685,7345086665,82103672,7345086663,-2,,
4967680630,81.54699,7345336804,82353810,7345336794,-10,,
4967931401,81.79776,7345587575,82604582,7345587558,-17,,
4968182131,82.04849,7345838303,82855310,7345838286,-17,,
4968432727,82.29909,7346088898,83105905,7346088882,-16,,
4968683314,82.54967,7346339485,83356491,7346339468,-17,,
4968933438,82.79980,7346589607,83606614,7346589590,-17,,
4968949532,82.81589,7346605701,83622707,7346605683,-18,7346605642,
4969200119,83.06648,7346856287,83873293,7346856259,-28,,
4969450225,83.31659,7347106393,84123400,7347106355,-38,,
4969700748,83.56711,7347356915,84373922,7347356867,-48,,
4969951562,83.81792,7347607728,84624735,7347607671,-57,,
4970201744,84.06811,7347857909,84874916,7347857852,-57,,
4970451979,84.31834,7348108143,85125150,7348108087,-56,,
4970702710,84.56907,7348358873,85375880,7348358816,-57,,
4970953328,84.81969,7348609490,85626496,7348609432,-58,,
4970969615,84.83598,7348625776,85642782,7348625719,-57,7348625735,
4971220073,85.08643,7348876234,85893240,7348876181,-53,,
4971471105,85.33747,7349127265,86144272,7349127217,-48,,
4971721309,85.58767,7349377468,86394475,7349377424,-44,,
4971972251,85.83861,7349628411,86645429,7349628383,-28,,
4972222660,86.08902,7349878818,86895825,7349878779,-39,,
4972472869,86.33923,7350129026,87146033,7350128987,-39,,
4972723244,86.58961,7350379400,87396408,7350379362,-38,,
4972973712,86.84007,7350629867,87646874,7350629829,-38,,
4972989738,86.85610,7350645892,87662898,7350645853,-39,7350645892,
4973239872,87.10623,7350896026,87913033,7350895997,-29,,
4973490015,87.35638,7351146168,88163175,7351146150,-18,,
4973740325,87.60669,7351396477,88413484,7351396468,-9,,
4973990460,87.85682,7351646612,88663629,7351646624,12,,
4974240907,88.10727,7351897058,88914075,7351897071,13,,
4974491068,88.35743,7352147218,89164225,7352147221,3,,
4974741720,88.60808,7352397869,89414876,7352397871,2,,
4974992234,88.85859,7352648383,89665390,7352648385,2,,
4975008391,88.87475,7352664538,89681545,7352664540,2,7352664494,
4975258563,89.12492,7352914710,89931717,7352914702,-8,,
4975508865,89.37523,7353165011,90182018,7353164991,-20,,
4975759020,89.62538,7353415166,90432173,7353415135,-31,,
4976009612,89.87597,7353665757,90682764,7353665715,-42,,
4976259913,90.12627,7353916057,90933064,7353916015,-42,,
4976510346,90.37671,7354166488,91183495,7354166447,-41,,
4976760979,90.62734,7354417121,91434127,7354417079,-42,,
4977011366,90.87773,7354667508,91684514,7354667466,-42,,
4977027514,90.89387,7354683654,91700661,7354683612,-42,7354683639,
4977278233,91.14459,7354934373,91951380,7354934338,-35,,
4977528582,91.39494,7355184722,92201729,7355184694,-28,,
4977778943,91.64530,7355435081,92452088,7355435061,-20,,
4978029531,91.89589,7355685669,92702675,7355685656,-13,,
4978279676,92.14604,7355935812,92952819,7355935799,-13,,
4978529789,92.39615,7356185924,93202931,7356185911,-13,,
4978779921,92.64628,7356436055,93453062,7356436042,-13,,
4979030283,92.89664,7356686416,93703423,7356686403,-13,,
4979046316,92.91268,7356702448,93719454,7356702435,-13,7356702381,
4979296920,93.16328,7356953053,93970059,7356953026,-27,,
4979547293,93.41365,7357203425,94220432,7357203387,-38,,
4979797454,93.66381,7357453585,94470592,7357453534,-51,,
4980047764,93.91412,7357703895,94720911,7357703840,-55,,
4980297921,94.16428,7357954051,94971058,7357953986,-65,,
4980548065,94.41443,7358204194,95221201,7358204129,-65,,
4980798505,94.66487,7358454633,95471640,7358454569,-64,,
4981048655,94.91502,7358704781,95721788,7358704716,-65,,
4981064702,94.93106,7358720828,95737834,7358720762,-66,7358720851,
4981314864,95.18122,7358970989,95987996,7358970946,-43,,
4981564991,95.43135,7359221115,96238122,7359221096,-19,,
4981815153,95.68151,7359471278,96488284,7359471280,2,,
4982065477,95.93184,7359721600,96738607,7359721625,25,,
4982315956,96.18232,7359972079,96989086,7359972104,25,,
4982566537,96.43290,7360222658,97239665,7360222683,25,,
4982817112,96.68347,7360473233,97490240,7360473268,35,,
4983067508,96.93387,7360723628,97740634,7360723653,25,,
4983083542,96.94990,7360739660,97756667,7360739685,25,7360739606,
4983334094,97.20046,7360990212,98007219,7360990216,4,,
4983584712,97.45107,7361240829,98257836,7361240814,-15,,
4983835240,97.70160,7361491357,98508364,7361491323,-34,,
4984085741,97.95210,7361741857,98758863,7361741804,-53,,
4984336308,98.20267,7361992424,99009431,7361992371,-53,,
4984586901,98.45326,7362243016,99260022,7362242963,-53,,
4984837739,98.70410,7362493852,99510859,7362493799,-53,,
4985088371,98.95473,7362744483,99761490,7362744430,-53,,
4985106256,98.97262,7362762368,99779374,7362762314,-54,7362762758,
4985356491,99.22285,7363012603,100029610,7363012671,68,,
4985606936,99.47330,7363263046,100280053,7363263215,169,,
4985857070,99.72343,7363513180,100530186,7363513460,280,,
4986107389,99.97375,7363763497,100780504,7363763890,393,,
4986357666,100.22403,7364013773,101030780,7364014166,393,,
4986625748,100.49211,7364281856,101298862,7364282248,392,,
4986876500,100.74286,7364532605,101549612,7364532998,393,,
4987126793,100.99315,7364782898,101799905,7364783291,393,,
4987144062,101.01042,7364800166,101817173,7364800558,392,7364799635,
4987394414,101.26077,7365050519,102067525,7365050680,161,,
4987645114,101.51148,7365301218,102318224,7365301148,-70,,
4987895223,101.76158,7365551325,102568332,7365551025,-300,,
4988145370,102.01173,7365801471,102818478,7365800943,-528,,
4988395976,102.26234,7366052077,103069084,7366051548,-529,,
4988646647,102.51301,7366302746,103319753,7366302217,-529,,
4988896801,102.76316,7366552899,103569906,7366552371,-528,,
4989147275,103.01364,7366803372,103820379,7366802844,-528,,
4989163330,103.02969,7366819427,103836433,7366818897,-530,7366819372,
4989413491,103.27985,7367069588,104086595,7367069178,-410,,
4989664100,103.53046,7367320196,104337203,7367319916,-280,,
4989914657,103.78102,7367570753,104587759,7367570581,-172,,
4990165012,104.03137,7367821106,104838113,7367821053,-53,,
4990415315,104.28168,7368071409,105088416,7368071356,-53,,
4990665869,104.53223,7368321961,105338968,7368321908,-53,,
4990916278,104.78264,7368572369,105589375,7368572316,-53,,
4991166371,105.03273,7368822461,105839468,7368822408,-53,,
4991183014,105.04937,7368839103,105856109,7368839050,-53,7368838749,
4991433920,105.30028,7369090009,106107016,7369089880,-129,,
4991684429,105.55079,7369340518,106357525,7369340314,-204,,
4991934861,105.80122,7369590949,106607955,7369590671,-278,,
4992185385,106.05175,7369841473,106858479,7369841121,-352,,
4992435614,106.30197,7370091701,107108708,7370091349,-352,,
4992686214,106.55258,7370342299,107359306,7370341947,-352,,
4992936372,106.80273,7370592457,107609464,7370592105,-352,,
4993186754,107.05312,7370842837,107859843,7370842485,-352,,
4993202846,107.06921,7370858928,107875935,7370858576,-352,7370858883,
4993453418,107.31978,7371109500,108126507,7371109225,-275,,
4993703852,107.57021,7371359933,108376940,7371359735,-198,,
4993954044,107.82040,7371610124,108627131,7371610004,-120,,
4994204121,108.07048,7371860200,108877207,7371860157,-43,,
4994454317,108.32068,7372110397,109127404,7372110365,-32,,
4994704483,108.57084,7372360562,109377568,7372360519,-43,,
4994954653,108.82101,7372610730,109627737,7372610688,-42,,
4995204863,109.07122,7372860940,109877947,7372860897,-43,,
4995220882,109.08724,7372876957,109893964,7372876914,-43,7372877010,
4995471018,109.33738,7373127094,110144101,7373127075,-19,,
4995721725,109.58809,7373377799,110394806,7373377804,5,,
4995971872,109.83823,7373627946,110644953,7373627976,30,,
4996222299,110.08866,7373878372,110895379,7373878427,55,,
4996472876,110.33924,7374128947,111145954,7374129003,56,,
4996723414,110.58978,7374379485,111396491,7374379540,55,,
4996974339,110.84070,7374630409,111647416,7374630465,56,,
4997224845,111.09121,7374880914,111897921,7374880969,55,,
4997240867,111.10723,7374896936,111913942,7374896991,55,7374896892,
4997491253,111.35761,7375147321,112164328,7375147351,30,,
4997741441,111.60780,7375397508,112414515,7375397515,7,,
4997992094,111.85846,7375648161,112665167,7375648143,-18,,
4998242246,112.10861,7375898312,112915319,7375898270,-42,,
4998492670,112.35903,7376148735,113165741,7376148693,-42,,
4998742908,112.60927,7376398971,113415977,7376398929,-42,,
4998993526,112.85989,7376649589,113666595,7376649547,-42,,
4999243669,113.11003,7376899730,113916737,7376899688,-42,,
4999259684,113.12605,7376915745,113932751,7376915703,-42,7376915706,
4999510696,113.37706,7377166758,114183764,7377166716,-42,,
4999761637,113.62800,7377417698,114434705,7377417658,-40,,
5000011978,113.87834,7377668037,114685044,7377667998,-39,,
5000262428,114.12879,7377918486,114935493,7377918449,-37,,
5000512545,114.37891,7378168614,115185621,7378168577,-37,,
5000763029,114.62939,7378419085,115436091,7378419048,-37,,
5001013127,114.87949,7378669182,115686189,7378669146,-36,,
5001263347,115.12971,7378919402,115936408,7378919365,-37,,
5001279432,115.14579,7378935486,115952492,7378935448,-38,7378935405,
5001529589,115.39595,7379185642,116202649,7379185595,-47,,
5001779725,115.64609,7379435777,116452794,7379435729,-48,,
5002030350,115.89671,7379686402,116703409,7379686333,-69,,
5002280895,116.14726,7379936947,116953953,7379936868,-79,,
5002531332,116.39769,7380187382,117204389,7380187303,-79,,
5002781770,116.64813,7380437819,117454826,7380437741,-78,,
5003032103,116.89846,7380688152,117705159,7380688073,-79,,
5003282840,117.14920,7380938888,117955894,7380938819,-69,,
5003299092,117.16545,7380955138,117972145,7380955059,-79,7380954954,
5003549640,117.41600,7381205687,118222694,7381205581,-106,,
5003799809,117.66617,7381455854,118472861,7381455722,-132,,
5004049961,117.91632,7381706005,118723012,7381705848,-157,,
5004300324,118.16669,7381956367,118973374,7381956184,-183,,
5004550450,118.41681,7382206494,119223500,7382206311,-183,,
5004801234,118.66760,7382457276,119474283,7382457094,-182,,
5005051813,118.91817,7382707854,119724861,7382707671,-183,,
5005302348,119.16871,7382958389,119975396,7382958206,-183,,
5005318622,119.18498,7382974661,119991667,7382974478,-183,7382974552,
5005569091,119.43545,7383225130,120242137,7383224966,-164,,
5005819395,119.68576,7383475433,120492440,7383475288,-145,,
5006069550,119.93591,7383725587,120742594,7383725462,-125,,
5006320431,120.18679,7383976468,120993475,7383976361,-107,,
5006570567,120.43693,7384226603,121243609,7384226496,-107,,
5006820793,120.68715,7384476828,121493835,7384476731,-97,,
5007070945,120.93731,7384726979,121743986,7384726872,-107,,
5007321100,121.18746,7384977134,121994141,7384977027,-107,,
5007337187,121.20355,7384993220,122010226,7384993112,-108,7384993243,
5007587838,121.45420,7385243870,122260877,7385243796,-74,,
5007838331,121.70469,7385494362,122511368,7385494321,-41,,
5008088959,121.95532,7385744989,122761996,7385744982,-7,,
5008339860,122.20622,7385995890,123012897,7385995915,25,,
5008590354,122.45672,7386246382,123263389,7386246418,36,,
5008841010,122.70737,7386497037,123514044,7386497062,25,,
5009091459,122.95782,7386747485,123764491,7386747510,25,,
5009341621,123.20798,7386997647,124014654,7386997672,25,,
5009357951,123.22431,7387013975,124030982,7387014000,25,7387013801,
5009608357,123.47472,7387264383,124281390,7387264359,-24,,
5009858505,123.72487,7387514530,124531537,7387514457,-73,,
5010108718,123.97508,7387764742,124781748,7387764619,-123,,
5010359339,124.22570,7388015361,125032368,7388015190,-171,,
5010609468,124.47583,7388265489,125282496,7388265318,-171,,
5010860140,124.72650,7388516160,125533166,7388515988,-172,,
5011110331,124.97669,7388766351,125783358,7388766179,-172,,
5011360489,125.22685,7389016508,126033515,7389016336,-172,,
5011376426,125.24279,7389032444,126049450,7389032271,-173,7389032371,
5011626563,125.49292,7389282580,126299587,7389282433,-147,,
5011876709,125.74307,7389532726,126549733,7389532604,-122,,
5012126883,125.99324,7389782899,126799907,7389782804,-95,,
5012377051,126.24341,7390033066,127050073,7390032996,-70,,
5012627514,126.49388,7390283528,127300535,7390283458,-70,,
5012878306,126.74467,7390534319,127551326,7390534249,-70,,
5013128729,126.99509,7390784741,127801748,7390784670,-71,,
5013379240,127.24560,7391035251,128052258,7391035180,-71,,
5013395367,127.26173,7391051378,128068384,7391051307,-71,7391051274,
5013645528,127.51189,7391301538,128318544,7391301459,-79,,
5013895711,127.76207,7391551721,128568728,7391551644,-77,,
5014145850,128.01221,7391801859,128818866,7391801766,-93,,
5014396488,128.26285,7392052496,129069503,7392052395,-101,,
5014647153,128.51351,7392303160,129320167,7392303058,-102,,
5014897263,128.76362,7392553269,129570276,7392553168,-101,,
5015147725,129.01409,7392803730,129820737,7392803629,-101,,
5015398306,129.26467,7393054311,130071317,7393054209,-102,,
5015414316,129.28068,7393070320,130087326,7393070217,-103,7393070272,
5015664985,129.53135,7393320988,130337995,7393320899,-89,,
5015915528,129.78189,7393571531,130588537,7393571457,-74,,
5016166152,130.03251,7393822153,130839159,7393822093,-60,,
5016416741,130.28310,7394072741,131089748,7394072696,-45,,
5016667522,130.53388,7394323522,131340528,7394323476,-46,,
5016918230,130.78459,7394574229,131591236,7394574183,-46,,
5017168387,131.03475,7394824386,131841393,7394824340,-46,,
5017418779,131.28514,7395074776,132091783,7395074730,-46,,
5017434848,131.30121,7395090845,132107851,7395090798,-47,7395090791,
5017685479,131.55184,7395341475,132358482,7395341427,-48,,
5017935650,131.80201,7395591646,132608652,7395591597,-49,,
5018185781,132.05214,7395841775,132858782,7395841725,-50,,
5018435943,132.30230,7396091937,133108944,7396091885,-52,,
5018686539,132.55290,7396342532,133359538,7396342480,-52,,
5018936809,132.80317,7396592801,133609808,7396592750,-51,,
5019187405,133.05377,7396843396,133860402,7396843344,-52,,
5019437683,133.30404,7397093674,134110681,7397093623,-51,,
5019453972,133.32033,7397109962,134126968,7397109910,-52,7397109894,
5019704545,133.57091,7397360535,134377541,7397360479,-56,,
5019954706,133.82107,7397610694,134627700,7397610635,-59,,
5020205411,134.07177,7397861399,134878406,7397861337,-62,,
5020455527,134.32189,7398111513,135128519,7398111447,-66,,
5020705676,134.57204,7398361662,135378668,7398361596,-66,,
5020955785,134.82215,7398611768,135628775,7398611702,-66,,
5021206088,135.07245,7398862071,135879077,7398862005,-66,,
5021456256,135.32262,7399112239,136129246,7399112173,-66,,
5021472649,135.33901,7399128630,136145636,7399128564,-66,7399128651,
5021723112,135.58947,7399379093,136396100,7399379049,-44,,
5021973458,135.83982,7399629439,136646446,7399629418,-21,,
5022223888,136.09025,7399879868,136896875,7399879869,1,,
5022474368,136.34073,7400130347,137147353,7400130370,23,,
5022724760,136.59112,7400380738,137397745,7400380761,23,,
5022975213,136.84157,7400631190,137648197,7400631214,24,,
5023225321,137.09168,7400881297,137898304,7400881321,24,,
5023475921,137.34228,7401131896,138148903,7401131920,24,,
5023492127,137.35849,7401148102,138165108,7401148125,23,7401148101,
5023742828,137.60919,7401398803,138415810,7401398819,16,,
5023993605,137.85997,7401649578,138666585,7401649589,11,,
5024244096,138.11046,7401900068,138917075,7401900074,6,,
5024494280,138.36064,7402150252,139167259,7402150254,2,,
5024744614,138.61097,7402400585,139417592,7402400586,1,,
5024994873,138.86123,7402650844,139667850,7402650845,1,,
5025245677,139.11204,7402901648,139918654,7402901649,1,,
5025496201,139.36256,7403152170,140169176,7403152171,1,,
5025512193,139.37855,7403168161,140185167,7403168162,1,7403168220,
5025762638,139.62900,7403418606,140435612,7403418622,16,,
5026012991,139.87935,7403668958,140685965,7403668989,31,,
5026263088,140.12945,7403919053,140936060,7403919099,46,,
5026513211,140.37957,7404169175,141186182,7404169236,61,,
5026763752,140.63011,7404419716,141436722,7404419777,61,,
5027014055,140.88042,7404670018,141687025,7404670080,62,,
5027264422,141.13078,7404920384,141937391,7404920445,61,,
5027514984,141.38135,7405170945,142187952,7405171007,62,,
5027531097,141.39746,7405187058,142204064,7405187118,60,7405187072,
5027781759,141.64812,7405437719,142454726,7405437766,47,,
5028032350,141.89871,7405688310,142705317,7405688348,38,,
5028283219,142.14958,7405939177,142956184,7405939204,27,,
5028533347,142.39971,7406189305,143206312,7406189322,17,,
5028783955,142.65032,7406439911,143456919,7406439929,18,,
5029034075,142.90044,7406690030,143707037,7406690047,17,,
5029284406,143.15077,7406940361,143957368,7406940379,18,,
5029534539,143.40090,7407190493,144207500,7407190510,17,,
5029550539,143.41690,7407206493,144223499,7407206509,16,7407206465,
5029800704,143.66707,7407456657,144473663,7407456662,5,,
5030050884,143.91725,7407706837,144723844,7407706833,-4,,
5030301261,144.16762,7407957212,144974219,7407957196,-16,,
5030551418,144.41778,7408207368,145224375,7408207342,-26,,
5030801874,144.66824,7408457823,145474830,7408457798,-25,,
5031052448,144.91881,7408708397,145725403,7408708371,-26,,
5031302858,145.16922,7408958805,145975812,7408958779,-26,,
5031553065,145.41943,7409209011,146226018,7409208986,-25,,
5031569186,145.43555,7409225131,146242138,7409225105,-26,7409225059,
5031819374,145.68573,7409475320,146492326,7409475281,-39,,
5032070026,145.93639,7409725971,146742978,7409725922,-49,,
5032320099,146.18646,7409976044,146993051,7409975984,-60,,
5032570629,146.43699,7410226572,147243579,7410226502,-70,,
5032820727,146.68709,7410476670,147493677,7410476599,-71,,
5033071190,146.93755,7410727131,147744138,7410727060,-71,,
5033321382,147.18774,7410977323,147994329,7410977252,-71,,
5033571815,147.43818,7411227754,148244760,7411227683,-71,,
5033588178,147.45454,7411244117,148261123,7411244046,-71,7411243904,
5033838293,147.70465,7411494231,148511238,7411494124,-107,,
5034089055,147.95542,7411744993,148762000,7411744851,-142,,
5034339539,148.20590,7411995476,149012483,7411995300,-176,,
5034590612,148.45697,7412246548,149263555,7412246337,-211,,
5034840895,148.70726,7412496831,149513838,7412496620,-211,,
5035091383,148.95774,7412747318,149764325,7412747107,-211,,
5035342028,149.20839,7412997962,150014968,7412997751,-211,,
5035592213,149.45857,7413248145,150265151,7413247934,-211,,
5035608290,149.47465,7413264221,150281228,7413264010,-211,7413264161,
5035858368,149.72473,7413514299,150531306,7413514126,-173,,
5036108510,149.97487,7413764441,150781448,7413764317,-124,,
5036359036,150.22540,7414014966,151031972,7414014869,-97,,
5036609141,150.47550,7414265070,151282076,7414265011,-59,,
5036859385,150.72575,7414515313,151532320,7414515254,-59,,
5037110325,150.97669,7414766252,151783258,7414766193,-59,,
5037361152,151.22751,7415017079,152034085,7415017020,-59,,
5037611614,151.47797,7415267540,152284546,7415267481,-59,,
5037627679,151.49404,7415283603,152300610,7415283544,-59,7415283612,
5037877804,151.74417,7415533728,152550735,7415533686,-42,,
5038128368,151.99473,7415784292,152801299,7415784267,-25,,
5038378633,152.24499,7416034555,153051562,7416034549,-6,,
5038629663,152.49602,7416285585,153302591,7416285595,10,,
5038879844,152.74621,7416535764,153552771,7416535775,11,,
5039130257,152.99662,7416786177,153803184,7416786187,10,,
5039380497,153.24686,7417036417,154053424,7417036428,11,,
5039631229,153.49759,7417287148,154304155,7417287158,10,,
5039647359,153.51372,7417303276,154320283,7417303286,10,7417303265,
5039897436,153.76380,7417553354,154570360,7417553359,5,,
5040147522,154.01388,7417803438,154820444,7417803438,0,,
5040398331,154.26469,7418054247,155071254,7418054243,-4,,
5040648421,154.51478,7418304335,155321342,7418304327,-8,,
5040899361,154.76572,7418555275,155572282,7418555267,-8,,
5041150295,155.01666,7418806207,155823214,7418806198,-9,,
5041400816,155.26718,7419056727,156073734,7419056718,-9,,
5041651251,155.51761,7419307161,156324167,7419307152,-9,,
5041667176,155.53354,7419323085,156340092,7419323076,-9,7419323034,
5041917305,155.78367,7419573215,156590222,7419573195,-20,,
5042168068,156.03443,7419823977,156840984,7419823947,-30,,
5042418397,156.28476,7420074305,157091312,7420074265,-40,,
5042668521,156.53488,7420324428,157341435,7420324379,-49,,
5042918921,156.78528,7420574828,157591834,7420574778,-50,,
5043169081,157.03544,7420824986,157841993,7420824937,-49,,
5043419421,157.28578,7421075325,158092332,7421075276,-49,,
5043670365,157.53673,7421326268,158343274,7421326218,-50,,
5043686292,157.55265,7421342194,158359200,7421342144,-50,7421342212,
5043936365,157.80273,7421592267,158609273,7421592235,-32,,
5044186909,158.05327,7421842810,158859817,7421842795,-15,,
5044437036,158.30340,7422092938,159109944,7422092941,3,,
5044688011,158.55437,7422343912,159360919,7422343933,21,,
5044938591,158.80495,7422594491,159611498,7422594512,21,,
5045189325,159.05569,7422845224,159862231,7422845244,20,,
5045439724,159.30608,7423095621,160112628,7423095642,21,,
5045690197,159.55656,7423346093,160363100,7423346113,20,,
5045706329,159.57269,7423362224,160379231,7423362244,20,7423362150,
5045956470,159.82283,7423612366,160629373,7423612363,-3,,
5046207068,160.07343,7423862962,160879969,7423862937,-25,,
5046457596,160.32396,7424113489,161130496,7424113440,-49,,
5046707911,160.57427,7424363804,161380810,7424363732,-72,,
5046958434,160.82479,7424614326,161631333,7424614254,-72,,
5047208945,161.07531,7424864837,161881844,7424864765,-72,,
5047459690,161.32605,7425115581,162132588,7425115510,-71,,
5047710345,161.57671,7425366235,162383242,7425366174,-61,,
5047726447,161.59281,7425382336,162399342,7425382275,-61,7425382256,
5047976571,161.84293,7425632459,162649466,7425632386,-73,,
5048227065,162.09343,7425882953,162899959,7425882878,-75,,
5048477249,162.34361,7426133135,163150142,7426133058,-77,,
5048727802,162.59416,7426383687,163400694,7426383609,-78,,
5048978216,162.84458,7426634100,163651107,7426634022,-78,,
5049228663,163.09502,7426884548,163901555,7426884471,-77,,
5049478836,163.34520,7427134720,164151727,7427134642,-78,,
5049729164,163.59553,7427385046,164402053,7427384969,-77,,
5049745290,163.61165,7427401172,164418178,7427401093,-79,7427401079,
5049995463,163.86182,7427651344,164668351,7427651253,-91,,
5050245689,164.11205,7427901570,164918577,7427901479,-91,,
5050495880,164.36224,7428151760,165168767,7428151669,-91,,
5050745990,164.61235,7428401869,165418875,7428401778,-91,,
5050996626,164.86299,7428652503,165669510,7428652412,-91,,
5051247049,165.11341,7428902926,165919933,7428902835,-91,,
5051497452,165.36381,7429153327,166170334,7429153237,-90,,
5051747859,165.61422,7429403734,166420741,7429403643,-91,,
5051763997,165.63036,7429419870,166436877,7429419779,-91,7429419867,
5052014308,165.88067,7429670182,166687189,7429670113,-69,,
5052264531,166.13089,7429920404,166937411,7429920357,-47,,
5052514596,166.38096,7430170468,167187475,7430170444,-24,,
5052765106,166.63147,7430420977,167437984,7430420976,-1,,
5053015438,166.88180,7430671308,167688315,7430671306,-2,,
5053265527,167.13189,7430921396,167938403,7430921394,-2,,
5053515628,167.38199,7431171496,168188503,7431171494,-2,,
5053766162,167.63252,7431422029,168439036,7431422027,-2,,
5053782092,167.64845,7431437959,168454966,7431437969,10,7431437958,
5054032625,167.89899,7431688491,168705498,7431688489,-2,,
5054283321,168.14968,7431939187,168956194,7431939186,-1,,
5054533812,168.40017,7432189677,169206684,7432189678,1,,
5054784767,168.65113,7432440632,169457639,7432440633,1,,
5055035422,168.90178,7432691285,169708292,7432691286,1,,
5055285878,169.15224,7432941740,169958747,7432941741,1,,
5055536015,169.40238,7433191877,170208884,7433191878,1,,
5055786367,169.65273,7433442227,170459233,7433442228,1,,
5055802426,169.66879,7433458285,170475292,7433458286,1,7433458308,
5056052709,169.91907,7433708569,170725575,7433708575,6,,
5056302928,170.16929,7433958786,170975793,7433958799,13,,
5056553134,170.41950,7434208992,171225999,7434209012,20,,
5056803752,170.67011,7434459609,171476616,7434459634,25,,
5057054299,170.92066,7434710155,171727161,7434710180,25,,
5057304349,171.17071,7434960205,171977211,7434960230,25,,
5057554854,171.42121,7435210708,172227714,7435210733,25,,
5057805293,171.67165,7435461146,172478153,7435461172,26,,
5057821608,171.68797,7435477460,172494467,7435477485,25,7435477424,
5058072066,171.93843,7435727919,172744925,7435727929,10,,
5058322233,172.18859,7435978084,172995091,7435978079,-5,,
5058572342,172.43870,7436228192,173245199,7436228174,-18,,
5058822823,172.68918,7436478672,173495679,7436478639,-33,,
5059073147,172.93951,7436728996,173746003,7436728962,-34,,
5059323409,173.18977,7436979258,173996265,7436979224,-34,,
5059573561,173.43992,7437229408,174246415,7437229374,-34,,
5059824104,173.69046,7437479951,174496958,7437479917,-34,,
5059840936,173.70730,7437496781,174513787,7437496747,-34,7437496400,
5060091428,173.95779,7437747274,174764280,7437747153,-121,,
5060342324,174.20869,7437998168,175015175,7437997961,-207,,
5060592404,174.45876,7438248247,175265254,7438247955,-292,,
5060842507,174.70887,7438498349,175515356,7438497970,-379,,
5061092651,174.95901,7438748492,175765499,7438748113,-379,,
5061342925,175.20929,7438998765,176015772,7438998387,-378,,
5061593112,175.45947,7439248951,176265958,7439248572,-379,,
5061843407,175.70977,7439499246,176516253,7439498867,-379,,
5061859551,175.72591,7439515390,176532396,7439515010,-380,7439515429,
5062109692,175.97605,7439765530,176782537,7439765255,-275,,
5062360461,176.22682,7440016298,177033305,7440016130,-168,,
5062610685,176.47705,7440266521,177283528,7440266458,-63,,
5062861318,176.72768,7440517154,177534161,7440517195,41,,
5063111459,176.97782,7440767294,177784301,7440767336,42,,
5063361927,177.22829,7441017761,178034767,7441017802,41,,
5063612387,177.47875,7441268220,178285226,7441268261,41,,
5063862859,177.72922,7441518691,178535698,7441518732,41,,
5063879032,177.74539,7441534862,178551880,7441534914,52,7441534862,
5064129526,177.99589,7441785357,178802363,7441785388,31,,
5064379664,178.24603,7442035495,179052502,7442035516,21,,
5064629779,178.49614,7442285608,179302615,7442285620,12,,
5064880140,178.74650,7442535968,179552975,7442535971,3,,
5065130278,178.99664,7442786106,179803113,7442786108,2,,
5065380401,179.24676,7443036227,180053234,7443036230,3,,
5065631180,179.49754,7443287006,180304012,7443287008,2,,
5065881334,179.74769,7443537158,180554165,7443537160,2,,
5065897391,179.76375,7443553214,180570221,7443553216,2,7443553194,
5066147848,180.01421,7443803671,180820678,7443803667,-4,,
5066398352,180.26471,7444054174,181071181,7444054165,-9,,
5066648486,180.51485,7444304307,181321314,7444304293,-14,,
5066898566,180.76493,7444554387,181571394,7444554368,-19,,
5067149320,181.01568,7444805141,181822148,7444805122,-19,,
5067399462,181.26582,7445055281,182072288,7445055262,-19,,
5067649789,181.51615,7445305607,182322614,7445305588,-19,,
5067900426,181.76679,7445556248,182573255,7445556229,-19,,
5067917534,181.78390,7445573351,182590357,7445573332,-19,7445573737,
5068167677,182.03404,7445823493,182840500,7445823575,82,,
5068417902,182.28426,7446073717,183090724,7446073901,184,,
5068668271,182.53463,7446324086,183341093,7446324372,286,,
5068918650,182.78501,7446574463,183591470,7446574852,389,,
5069169144,183.03551,7446824958,183841964,7446825346,388,,
5069419406,183.28577,7447075219,184092226,7447075607,388,,
5069670439,183.53680,7447326250,184343257,7447326638,388,,
5069920616,183.78698,7447576427,184593433,7447576815,388,,
5069936645,183.80301,7447592454,184609461,7447592842,388,7447592435,
5070187174,184.05354,7447842984,184859990,7447843270,286,,
5070437340,184.30370,7448093148,185110155,7448093333,185,,
5070687637,184.55400,7448343445,185360451,7448343528,83,,
5070938101,184.80446,7448593908,185610915,7448593891,-17,,
5071188611,185.05497,7448844417,185861424,7448844411,-6,,
5071438811,185.30517,7449094615,186111622,7449094598,-17,,
5071688984,185.55534,7449344788,186361794,7449344771,-17,,
5071939546,185.80591,7449595349,186612357,7449595333,-16,,
5071955699,185.82206,7449611501,186628507,7449611484,-17,7449611488,
5072206060,186.07242,7449861862,186878869,7449861846,-16,,
5072456378,186.32274,7450112180,187129187,7450112166,-14,,
5072706491,186.57285,7450362292,187379299,7450362281,-11,,
5072957039,186.82340,7450612838,187629845,7450612827,-11,,
5073207365,187.07373,7450863164,187880171,7450863153,-11,,
5073457969,187.32433,7451113766,188130773,7451113755,-11,,
5073708491,187.57485,7451364288,188381294,7451364277,-11,,
5073958788,187.82515,7451614584,188631591,7451614573,-11,,
5073974990,187.84135,7451630785,188647791,7451630773,-12,7451630790,
5074225698,188.09206,7451881494,188898500,7451881487,-7,,
5074476328,188.34269,7452132123,189149129,7452132121,-2,,
5074726726,188.59309,7452382520,189399527,7452382523,3,,
5074977412,188.84377,7452633205,189650211,7452633212,7,,
5075227629,189.09399,7452883421,189900428,7452883428,7,,
5075477805,189.34417,7453133595,190150602,7453133602,7,,
5075727930,189.59429,7453383719,190400726,7453383727,8,,
5075978564,189.84492,7453634352,190651359,7453634359,7,,
5075994761,189.86112,7453650549,190667555,7453650555,6,7453650476,
5076244891,190.11125,7453900679,190917685,7453900665,-14,,
5076495380,190.36174,7454151167,191168173,7454151134,-33,,
5076745491,190.61185,7454401277,191418284,7454401226,-51,,
5076995644,190.86201,7454651430,191668436,7454651359,-71,,
5077245798,191.11216,7454901582,191918588,7454901511,-71,,
5077496180,191.36254,7455151964,192168971,7455151893,-71,,
5077746479,191.61284,7455402261,192419268,7455402190,-71,,
5077996587,191.86295,7455652368,192669375,7455652297,-71,,
5078012841,191.87920,7455668621,192685627,7455668550,-71,7455668471,
5078263017,192.12938,7455918797,192935804,7455918706,-91,,
5078513193,192.37955,7456168972,193185979,7456168862,-110,,
5078763405,192.62977,7456419184,193436190,7456419055,-129,,
5079014017,192.88038,7456669794,193686801,7456669646,-148,,
5079264533,193.13089,7456920338,193937345,7456920190,-148,,
5079515210,193.38157,7457170986,194187993,7457170838,-148,,
5079765425,193.63179,7457421200,194438207,7457421052,-148,,
5080015477,193.88184,7457671251,194688258,7457671103,-148,,
5080031604,193.89796,7457687377,194704383,7457687228,-149,7457687257,
5080281890,194.14825,7457937663,194954670,7457937524,-139,,
5080532021,194.39838,7458187794,195204801,7458187661,-133,,
5080782527,194.64889,7458438298,195455305,7458438173,-125,,
5081032831,194.89919,7458688602,195705609,7458688484,-118,,
5081283526,195.14989,7458939296,195956303,7458939178,-118,,
5081533912,195.40027,7459189682,196206688,7459189564,-118,,
5081784477,195.65084,7459440245,196457252,7459440128,-117,,
5082035026,195.90139,7459690794,196707800,7459690676,-118,,
5082051057,195.91742,7459706823,196723830,7459706705,-118,7459706760,
5082301314,196.16768,7459957081,196974088,7459956977,-104,,
5082551915,196.41828,7460207680,197224687,7460207590,-90,,
5082802427,196.66879,7460458192,197475199,7460458117,-75,,
5083052707,196.91907,7460708471,197725478,7460708410,-61,,
5083303394,197.16976,7460959157,197976163,7460959096,-61,,
5083553582,197.41994,7461209343,198226350,7461209283,-60,,
5083803975,197.67034,7461459735,198476742,7461459674,-61,,
5084054317,197.92068,7461710078,198727084,7461710017,-61,,
5084070466,197.93683,7461726225,198743231,7461726164,-61,7461726077,
5084320825,198.18719,7461976585,198993592,7461976502,-83,,
5084571411,198.43777,7462227169,199244176,7462227065,-104,,
5084821543,198.68790,7462477301,199494307,7462477175,-126,,
5085071723,198.93808,7462727480,199744487,7462727334,-146,,
5085321872,199.18823,7462977627,199994634,7462977481,-146,,
5085572034,199.43840,7463227788,200244795,7463227643,-145,,
5085822388,199.68875,7463478141,200495148,7463477996,-145,,
5086072835,199.93920,7463728587,200745594,7463728441,-146,,
5086088970,199.95533,7463744721,200761728,7463744575,-146,7463744680,
5086339373,200.20573,7463995124,201012131,7463995005,-119,,
5086589690,200.45605,7464245441,201262448,7464245349,-92,,
5086839872,200.70623,7464495622,201512629,7464495556,-66,,
5087090003,200.95636,7464745753,201762759,7464745714,-39,,
5087340531,201.20689,7464996279,202013286,7464996240,-39,,
5087591167,201.45753,7465246915,202263922,7465246877,-38,,
5087841286,201.70765,7465497033,202514039,7465496994,-39,,
5088091559,201.95792,7465747304,202764310,7465747265,-39,,
5088107735,201.97410,7465763479,202780485,7465763440,-39,7465763357,
5088358302,202.22466,7466014047,203031054,7466013987,-60,,
5088609199,202.47556,7466264943,203281950,7466264863,-80,,
5088859658,202.72602,7466515401,203532408,7466515301,-100,,
5089110224,202.97659,7466765966,203782972,7466765846,-120,,
5089360385,203.22675,7467016126,204033133,7467016007,-119,,
5089610923,203.47728,7467266663,204283670,7467266543,-120,,
5089861349,203.72771,7467517088,204534095,7467516969,-119,,
5090111458,203.97782,7467767196,204784203,7467767077,-119,,
5090127442,203.99380,7467783179,204800185,7467783058,-121,7467783068,
5090378415,204.24478,7468034153,205051160,7468034035,-118,,
5090628594,204.49496,7468284331,205301338,7468284217,-114,,
5090879163,204.74552,7468534898,205551905,7468534786,-112,,
5091129351,204.99571,7468785085,205802092,7468784976,-109,,
5091380474,205.24684,7469036207,206053214,7469036098,-109,,
5091630739,205.49710,7469286472,206303479,7469286363,-109,,
5091881064,205.74742,7469536796,206553803,7469536687,-109,,
5092133051,205.99941,7469788782,206805789,7469788673,-109,,
5092150354,206.01672,7469806084,206823090,7469805975,-109,7469805475,
5092400828,206.26719,7470056558,207073565,7470056322,-236,,
5092651829,206.51819,7470307559,207324565,7470307198,-361,,
5092902177,206.76854,7470557905,207574912,7470557421,-484,,
5093152745,207.01911,7470808472,207825479,7470807865,-607,,
5093403046,207.26941,7471058772,208075779,7471058176,-596,,
5093653341,207.51970,7471309067,208326074,7471308460,-607,,
5093903812,207.77017,7471559536,208576543,7471558930,-606,,
5094154172,208.02053,7471809896,208826903,7471809290,-606,,
5094170158,208.03652,7471825881,208842888,7471825274,-607,7471825905,
5094420940,208.28730,7472076663,209093670,7472076214,-449,,
5094671398,208.53776,7472327121,209344127,7472326830,-291,,
5094921906,208.78827,7472577628,209594635,7472577495,-133,,
5095172851,209.03921,7472828572,209845578,7472828597,25,,
5095423149,209.28951,7473078869,210095875,7473078894,25,,
5095673711,209.54007,7473329430,210346437,7473329455,25,,
5095923844,209.79020,7473579561,210596568,7473579586,25,,
5096174025,210.04039,7473829741,210846747,7473829766,25,,
5096190172,210.05653,7473845887,210862894,7473845912,25,7473845890,
5096440577,210.30694,7474096293,211113300,7474096305,12,,
5096690666,210.55703,7474346381,211363388,7474346392,11,,
5096940930,210.80729,7474596644,211613651,7474596651,7,,
5097191061,211.05742,7474846774,211863781,7474846779,5,,
5097441204,211.30757,7475096917,212113924,7475096923,6,,
5097691409,211.55777,7475347120,212364127,7475347125,5,,
5097942305,211.80867,7475598015,212615022,7475598020,5,,
5098192879,212.05924,7475848589,212865595,7475848594,5,,
5098209489,212.07585,7475865197,212882203,7475865202,5,7475865128,
5098460010,212.32637,7476115718,213132724,7476115705,-13,,
5098710619,212.57698,7476366326,213383333,7476366296,-30,,
5098961351,212.82771,7476617057,213634063,7476617008,-49,,
5099212072,213.07843,7476867778,213884785,7476867711,-67,,
5099462862,213.32922,7477118567,214135574,7477118500,-67,,
5099713444,213.57980,7477369149,214386155,7477369082,-67,,
5099964260,213.83062,7477619964,214636970,7477619907,-57,,
5100214868,214.08123,7477870570,214887577,7477870503,-67,,
5100230934,214.09730,7477886635,214903642,7477886568,-67,7477886587,
5100481014,214.34737,7478136715,215153722,7478136652,-63,,
5100731525,214.59789,7478387225,215404231,7478387167,-58,,
5100981596,214.84796,7478637295,215654302,7478637243,-52,,
5101231706,215.09807,7478887404,215904411,7478887357,-47,,
5101482158,215.34852,7479137855,216154861,7479137808,-47,,
5101732467,215.59883,7479388164,216405171,7479388117,-47,,
5101982756,215.84912,7479638452,216655459,7479638406,-46,,
5102232882,216.09924,7479888577,216905584,7479888531,-46,,
5102249101,216.11546,7479904796,216921802,7479904749,-47,7479904662,
5102499585,216.36595,7480155280,217172287,7480155211,-69,,
5102749841,216.61620,7480405535,217422541,7480405445,-90,,
5103000007,216.86637,7480655699,217672707,7480655598,-101,,
5103250593,217.11695,7480906284,217923291,7480906153,-131,,
5103500713,217.36707,7481156404,218173411,7481156272,-132,,
5103750875,217.61724,7481406565,218423572,7481406433,-132,,
5104001052,217.86741,7481656742,218673749,7481656610,-132,,
5104251408,218.11777,7481907096,218924103,7481906965,-131,,
5104267550,218.13391,7481923238,218940244,7481923105,-133,7481923248,
5104517730,218.38409,7482173418,219190424,7482173323,-95,,
5104767926,218.63429,7482423613,219440620,7482423554,-59,,
5105018096,218.88446,7482673781,219690788,7482673758,-23,,
5105268721,219.13508,7482924405,219941412,7482924419,14,,
5105518841,219.38520,7483174525,220191531,7483174537,12,,
5105768985,219.63535,7483424667,220441674,7483424680,13,,
5106019413,219.88577,7483675094,220692101,7483675108,14,,
5106269765,220.13613,7483925446,220942453,7483925459,13,,
5106286211,220.15257,7483941890,220958897,7483941903,13,7483941819,
5106536753,220.40311,7484192433,221209439,7484192424,-9,,
5106787014,220.65338,7484442693,221459701,7484442665,-28,,
5107037605,220.90397,7484693284,221710290,7484693234,-50,,
5107287744,221.15410,7484943422,221960429,7484943352,-70,,
5107537905,221.40427,7485193582,222210589,7485193512,-70,,
5107788406,221.65477,7485444082,222461089,7485444012,-70,,
5108039148,221.90551,7485694822,222711829,7485694753,-69,,
5108289659,222.15602,7485945332,222962339,7485945263,-69,,
5108305860,222.17222,7485961532,222978539,7485961462,-70,7485961566,
5108555961,222.42232,7486211633,223228640,7486211588,-45,,
5108806531,222.67289,7486462202,223479209,7486462184,-18,,
5109056699,222.92306,7486712371,223729377,7486712379,8,,
5109307122,223.17348,7486962793,223979799,7486962828,35,,
5109557698,223.42406,7487213368,224230374,7487213403,35,,
5109807908,223.67427,7487463576,224480583,7487463612,36,,
5110058052,223.92441,7487713720,224730726,7487713755,35,,
5110308149,224.17451,7487963816,224980822,7487963851,35,,
5110324176,224.19054,7487979842,224996848,7487979877,35,7487979872,
5110574349,224.44071,7488230014,225247022,7488230049,35,,
5110824520,224.69088,7488480184,225497191,7488480218,34,,
5111074623,224.94098,7488730286,225747293,7488730320,34,,
5111325059,225.19142,7488980722,225997729,7488980754,32,,
5111575488,225.44185,7489231151,226248158,7489231183,32,,
5111825671,225.69203,7489481333,226498339,7489481364,31,,
5112076219,225.94258,7489731879,226748886,7489731911,32,,
5112326375,226.19274,7489982035,226999041,7489982067,32,,
5112342523,226.20888,7489998181,227015199,7489998224,43,7489998147,
5112592702,226.45906,7490248360,227265367,7490248375,15,,
5112842957,226.70932,7490498614,227515621,7490498614,0,,
5113093094,226.95945,7490748750,227765757,7490748734,-16,,
5113343628,227.20999,7490999283,228016290,7490999252,-31,,
5113593772,227.46013,7491249427,228266433,7491249405,-22,,
5113843945,227.71031,7491499598,228516605,7491499566,-32,,
5114094584,227.96095,7491750238,228767245,7491750206,-32,,
5114344754,228.21112,7492000407,229017414,7492000375,-32,,
5114360813,228.22717,7492016464,229033471,7492016432,-32,7492016483,
5114611703,228.47806,7492267354,229284361,7492267335,-19,,
5114862353,228.72871,7492518004,229535010,7492517997,-7,,
5115112954,228.97932,7492768604,229785610,7492768612,8,,
5115363411,229.22977,7493019060,230036067,7493019092,32,,
5115613561,229.47992,7493269209,230286215,7493269230,21,,
5115863707,229.73007,7493519354,230536361,7493519375,21,,
5116114362,229.98072,7493770007,230787014,7493770029,22,,
5116364526,230.23089,7494020171,231037178,7494020193,22,,
5116380848,230.24721,7494036491,231053498,7494036512,21,7494036549,
5116631514,230.49787,7494287158,231304165,7494287190,32,,
5116882210,230.74857,7494537853,231554859,7494537894,41,,
5117132669,230.99903,7494788311,231805318,7494788361,50,,
5117383216,231.24958,7495038857,232055864,7495038917,60,,
5117633410,231.49977,7495289051,232306057,7495289111,60,,
5117883542,231.74990,7495539181,232556187,7495539241,60,,
5118134669,232.00103,7495790307,232807313,7495790367,60,,
5118384799,232.25116,7496040437,233057444,7496040498,61,,
5118400963,232.26732,7496056599,233073606,7496056659,60,7496056664,
5118651419,232.51778,7496307055,233324062,7496307116,61,,
5118902329,232.76869,7496557964,233574970,7496558027,63,,
5119152514,233.01888,7496808149,233825156,7496808215,66,,
5119402657,233.26902,7497058292,234075299,7497058359,67,,
5119653453,233.51981,7497309087,234326094,7497309155,68,,
5119903595,233.76996,7497559228,234576235,7497559295,67,,
5120153738,234.02010,7497809369,234826376,7497809436,67,,
5120403832,234.27019,7498059462,235076469,7498059529,67,,
5120420004,234.28636,7498075633,235092640,7498075700,67,7498075674,
5120670342,234.53670,7498325971,235342978,7498326032,61,,
5120920473,234.78683,7498576101,235593108,7498576156,55,,
5121171030,235.03739,7498826658,235843665,7498826707,49,,
5121421212,235.28757,7499076839,236093845,7499076882,43,,
5121671329,235.53769,7499326956,236343962,7499326999,43,,
5121921709,235.78807,7499577334,236594341,7499577377,43,,
5122172223,236.03858,7499827847,236844854,7499827891,44,,
5122422871,236.28923,7500078494,237095501,7500078537,43,,
5122438987,236.30535,7500094609,237111616,7500094652,43,7500094606,
5122689159,236.55552,7500344782,237361789,7500344813,31,,
5122939755,236.80612,7500595376,237612383,7500595397,21,,
5123190330,237.05669,7500845950,237862957,7500845960,10,,
5123440503,237.30686,7501096123,238113130,7501096121,-2,,
5123691149,237.55751,7501346768,238363775,7501346766,-2,,
5123941308,237.80767,7501596927,238613934,7501596926,-1,,
5124192093,238.05845,7501847710,238864716,7501847708,-2,,
5124442194,238.30856,7502097811,239114817,7502097809,-2,,
5124458351,238.32471,7502113966,239130973,7502113964,-2,7502113993,
5124709280,238.57564,7502364895,239381902,7502364901,6,,
5124959736,238.82610,7502615350,239632357,7502615363,13,,
5125210210,239.07657,7502865824,239882831,7502865844,20,,
5125460397,239.32676,7503116010,240133016,7503116038,28,,
5125710924,239.57728,7503366535,240383542,7503366563,28,,
5125961649,239.82801,7503617260,240634267,7503617288,28,,
5126211901,240.07826,7503867510,240884517,7503867538,28,,
5126462300,240.32866,7504117909,241134916,7504117937,28,,
5126478597,240.34496,7504134215,241151221,7504134242,27,7504134216,
5126728997,240.59536,7504384605,241401612,7504384628,23,,
5126979331,240.84569,7504634938,241651945,7504634958,20,,
5127229599,241.09596,7504885206,241902213,7504885222,16,,
5127480066,241.34643,7505135671,242152678,7505135684,13,,
5127730912,241.59727,7505386517,242403524,7505386530,13,,
5127981639,241.84800,7505637242,242654249,7505637255,13,,
5128232374,242.09874,7505887976,242904983,7505887990,14,,
5128482798,242.34916,7506138400,243155407,7506138413,13,,
5128498744,242.36510,7506154344,243171351,7506154357,13,7506154383,
5128749376,242.61574,7506404977,243421983,7506404995,18,,
5128999742,242.86610,7506655343,243672349,7506655368,25,,
5129250291,243.11665,7506905890,243922896,7506905923,33,,
5129501016,243.36738,7507156615,244173622,7507156656,41,,
5129751610,243.61797,7507407207,244424214,7507407247,40,,
5130001792,243.86815,7507657388,244674395,7507657428,40,,
5130252211,244.11857,7507907807,244924813,7507907847,40,,
5130502833,244.36919,7508158427,245175434,7508158467,40,,
5130518988,244.38535,7508174581,245191588,7508174621,40,7508174497,
5130769402,244.63576,7508424995,245442002,7508425004,9,,
5131019641,244.88600,7508675233,245692240,7508675212,-21,,
5131269809,245.13617,7508925401,245942408,7508925349,-52,,
5131520377,245.38674,7509175969,246192976,7509175887,-82,,
5131771112,245.63747,7509426702,246443709,7509426620,-82,,
5132022164,245.88852,7509677754,246694760,7509677671,-83,,
5132273158,246.13952,7509928746,246945753,7509928665,-81,,
5132523534,246.38989,7510179122,247196128,7510179040,-82,,
5132539605,246.40597,7510195191,247212197,7510195109,-82,7510195131,
5132790535,246.65690,7510446122,247463129,7510446046,-76,,
5133041043,246.90740,7510696628,247713635,7510696558,-70,,
5133291304,247.15767,7510946889,247963895,7510946824,-65,,
5133541705,247.40807,7511197288,248214295,7511197231,-57,,
5133792170,247.65853,7511447752,248464759,7511447694,-58,,
5134042817,247.90918,7511698400,248715406,7511698342,-58,,
5134293145,248.15951,7511948726,248965733,7511948668,-58,,
5134543658,248.41002,7512199238,249216245,7512199180,-58,,
5134559736,248.42610,7512215316,249232322,7512215258,-58,7512215332,
5134810661,248.67702,7512466241,249483247,7512466201,-40,,
5135063533,248.92989,7512719111,249736117,7512719091,-20,,
5135314210,249.18057,7512969787,249986794,7512969787,0,,
5135564308,249.43067,7513219885,250236891,7513219903,18,,
5135814627,249.68099,7513470202,250487209,7513470221,19,,
5136065072,249.93143,7513720647,250737653,7513720665,18,,
5136316053,250.18241,7513971626,250988633,7513971644,18,,
5136566342,250.43270,7514221915,251238922,7514221933,18,,
5136582460,250.44882,7514238032,251255039,7514238050,18,7514238053,
5136832854,250.69922,7514488427,251505433,7514488445,18,,
5137083814,250.95018,7514739386,251756392,7514739406,20,,
5137334828,251.20119,7514990398,252007405,7514990419,21,,
5137585156,251.45152,7515240726,252257732,7515240749,23,,
5137835722,251.70208,7515491290,252508297,7515491313,23,,
5138086290,251.95265,7515741858,252758865,7515741881,23,,
5138336395,252.20276,7515991961,253008968,7515991984,23,,
5138586888,252.45325,7516242453,253259460,7516242476,23,,
5138604306,252.47067,7516259870,253276877,7516259893,23,7516259366,
5138854784,252.72115,7516510349,253527355,7516510240,-109,,
5139105351,252.97171,7516760915,253777922,7516760675,-240,,
5139355937,253.22230,7517011500,254028507,7517011129,-371,,
5139606429,253.47279,7517261991,254278998,7517261490,-501,,
5139857045,253.72341,7517512606,254529613,7517512105,-501,,
5140107495,253.97386,7517763055,254780062,7517762553,-502,,
5140358217,254.22458,7518013776,255030783,7518013274,-502,,
5140609160,254.47552,7518264719,255281725,7518264217,-502,,
5140625296,254.49166,7518280853,255297859,7518280351,-502,7518280821,
5140875713,254.74207,7518531270,255548277,7518530886,-384,,
5141126359,254.99272,7518781915,255798922,7518781650,-265,,
5141376495,255.24286,7519032051,256049058,7519031904,-147,,
5141626658,255.49302,7519282214,256299221,7519282184,-30,,
5141877164,255.74353,7519532718,256549725,7519532688,-30,,
5142127581,255.99394,7519783134,256800141,7519783105,-29,,
5142377720,256.24408,7520033272,257050279,7520033242,-30,,
5142628021,256.49438,7520283573,257300580,7520283543,-30,,
5142644469,256.51083,7520300020,257317026,7520299989,-31,7520299932,
5142895066,256.76143,7520550617,257567624,7520550573,-44,,
5143145277,257.01164,7520800826,257817833,7520800767,-59,,
5143395379,257.26174,7521050928,258067935,7521050855,-73,,
5143645491,257.51185,7521301038,258318045,7521300953,-85,,
5143896107,257.76247,7521551653,258568671,7521551578,-75,,
5144146249,258.01261,7521801796,258818803,7521801711,-85,,
5144396822,258.26318,7522052368,259069375,7522052282,-86,,
5144646945,258.51331,7522302489,259319496,7522302403,-86,,
5144663267,258.52963,7522318810,259335817,7522318724,-86,7522318776,
5144913423,258.77978,7522568967,259585974,7522568894,-73,,
5145163556,259.02992,7522819098,259836105,7522819039,-59,,
5145414294,259.28066,7523069835,260086842,7523069789,-46,,
5145664822,259.53118,7523320362,260337369,7523320330,-32,,
5145915150,259.78151,7523570689,260587696,7523570656,-33,,
5146165673,260.03203,7523821212,260838229,7523821189,-23,,
5146416717,260.28308,7524072255,261089262,7524072223,-32,,
5146667110,260.53347,7524322647,261339654,7524322614,-33,,
5146683086,260.54945,7524338622,261355629,7524338589,-33,7524338666,
5146934095,260.80046,7524589632,261606638,7524589618,-14,,
5147184228,261.05059,7524839763,261856769,7524839769,6,,
5147434876,261.30124,7525090410,262107457,7525090476,66,,
5147685291,261.55165,7525340824,262357831,7525340869,45,,
5147935702,261.80206,7525591234,262608241,7525591280,46,,
5148186204,262.05257,7525841735,262858742,7525841780,45,,
5148436865,262.30323,7526092396,263109403,7526092441,45,,
5148687025,262.55339,7526342554,263359561,7526342599,45,,
5148703430,262.56979,7526358958,263375965,7526359003,45,7526358839,
5148953947,262.82031,7526609475,263626482,7526609469,-6,,
5149204354,263.07072,7526859882,263876889,7526859838,-44,,
5149454770,263.32113,7527110297,264127304,7527110216,-81,,
5149705320,263.57168,7527360847,264377854,7527360739,-108,,
5149957013,263.82337,7527612538,264629545,7527612420,-118,,
5150207297,264.07366,7527862821,264879828,7527862703,-118,,
5150458055,264.32442,7528113579,265130585,7528113461,-118,,
5150708327,264.57469,7528363849,265380856,7528363732,-117,,
5150724408,264.59077,7528379929,265396936,7528379811,-118,7528379842,
5150974803,264.84116,7528630324,265647331,7528630214,-110,,
5151225120,265.09148,7528880641,265897647,7528880538,-103,,
5151475355,265.34172,7529130875,266147882,7529130782,-93,,
5151726326,265.59269,7529381845,266398852,7529381762,-83,,
5151976462,265.84282,7529631980,266648987,7529631897,-83,,
5152228986,266.09535,7529884503,266901510,7529884420,-83,,
5152479943,266.34630,7530135459,267152466,7530135375,-84,,
5152730321,266.59668,7530385919,267402926,7530385836,-83,,
5152746530,266.61289,7530402045,267419051,7530401961,-84,7530402157,
5152997397,266.86376,7530652911,267669917,7530652876,-35,,
5153247977,267.11434,7530903491,267920497,7530903506,15,,
5153498398,267.36476,7531153910,268170916,7531153975,65,,
5153749016,267.61538,7531404527,268421534,7531404641,114,,
5153999167,267.86553,7531654678,268671685,7531654793,115,,
5154249408,268.11577,7531904919,268921925,7531905033,114,,
5154499805,268.36617,7532155314,269172320,7532155428,114,,
5154750455,268.61682,7532405963,269422970,7532406078,115,,
5154766620,268.63298,7532422128,269439134,7532422242,114,7532422217,
5155016764,268.88313,7532672271,269689278,7532672379,108,,
5155267352,269.13371,7532922859,269939865,7532922961,102,,
5155517937,269.38430,7533173442,270190449,7533173540,98,,
5155768480,269.63484,7533423985,270440992,7533424076,91,,
5156019114,269.88547,7533674618,270691625,7533674709,91,,
5156269477,270.13584,7533924989,270941996,7533925081,92,,
5156519599,270.38596,7534175101,271192108,7534175192,91,,
5156770162,270.63652,7534425663,271442669,7534425754,91,,
5156786585,270.65295,7534442085,271459092,7534442176,91,7534441892,
5157037171,270.90353,7534692671,271709678,7534692690,19,,
5157287351,271.15371,7534942850,271959857,7534942798,-52,,
5157537986,271.40435,7535193485,272210492,7535193363,-122,,
5157788123,271.65448,7535443620,272460627,7535443428,-192,,
5158038689,271.90505,7535694185,272711192,7535693993,-192,,
5158288855,272.15522,7535944350,272961357,7535944158,-192,,
5158539446,272.40581,7536194941,273211948,7536194750,-191,,
5158790134,272.65650,7536445627,273462634,7536445435,-192,,
5158806428,272.67279,7536461920,273478926,7536461728,-192,7536461890,
5159057091,272.92345,7536712584,273729591,7536712436,-148,,
5159307355,273.17372,7536962847,273979854,7536962742,-105,,
5159558430,273.42479,7537213921,274230928,7537213859,-62,,
5159808637,273.67500,7537464128,274481134,7537464110,-18,,
5160059072,273.92543,7537714562,274731569,7537714555,-7,,
5160309248,274.17561,7537964737,274981744,7537964720,-17,,
5160560121,274.42648,7538215608,275232615,7538215591,-17,,
5160810385,274.67675,7538465872,275482879,7538465854,-18,,
5160826509,274.69287,7538481995,275499001,7538481976,-19,7538482061,
5161077126,274.94349,7538732611,275749618,7538732614,3,,
5161327527,275.19389,7538983012,276000019,7538983038,26,,
5161578270,275.44463,7539233754,276250761,7539233801,47,,
5161828454,275.69482,7539483938,276500944,7539484006,68,,
5162078807,275.94517,7539734289,276751296,7539734357,68,,
5162328929,276.19529,7539984411,277001418,7539984480,69,,
5162579425,276.44579,7540234906,277251913,7540234975,69,,
5162829612,276.69597,7540485091,277502098,7540485159,68,,
5162845780,276.71214,7540501259,277518265,7540501326,67,7540501302,
5163095923,276.96228,7540751401,277768408,7540751463,62,,
5163346049,277.21241,7541001526,278018533,7541001582,56,,
5163596207,277.46257,7541251683,278268690,7541251733,50,,
5163846780,277.71314,7541502256,278519262,7541502301,45,,
5164097429,277.96379,7541752905,278769912,7541752950,45,,
5164347804,278.21416,7542003278,279020285,7542003323,45,,
5164598350,278.46471,7542253823,279270840,7542253879,56,,
5164848499,278.71486,7542503971,279520977,7542504016,45,,
5164864757,278.73112,7542520229,279537235,7542520273,44,7542520241,
5165114882,278.98124,7542770353,279787359,7542770389,36,,
5165365318,279.23168,7543020788,280037794,7543020817,29,,
5165615618,279.48198,7543271087,280288094,7543271109,22,,
5165865758,279.73212,7543521226,280538233,7543521241,15,,
5166116244,279.98260,7543771711,280788718,7543771725,14,,
5166366823,280.23318,7544022289,281039296,7544022304,15,,
5166617290,280.48365,7544272756,281289763,7544272771,15,,
5166867456,280.73382,7544522921,281539928,7544522936,15,,
5166883668,280.75003,7544539132,281556139,7544539146,14,7544539176,
5167133795,281.00016,7544789259,281806265,7544789280,21,,
5167384173,281.25053,7545039636,282056643,7545039665,29,,
5167634865,281.50123,7545290328,282307334,7545290365,37,,
5167885509,281.75187,7545540971,282557978,7545541016,45,,
5168136032,282.00239,7545791492,282808498,7545791537,45,,
5168386589,282.25295,7546042048,283059055,7546042093,45,,
5168636696,282.50306,7546292154,283309161,7546292199,45,,
5168887307,282.75367,7546542765,283559782,7546542821,56,,
5168904050,282.77041,7546559506,283576512,7546559551,45,7546559265,
5169154195,283.02056,7546809653,283826659,7546809626,-27,,
5169404370,283.27073,7547059825,284076832,7547059728,-97,,
5169654581,283.52094,7547310036,284327043,7547309867,-169,,
5169905146,283.77151,7547560601,284577607,7547560362,-239,,
5170155411,284.02177,7547810864,284827871,7547810626,-238,,
5170406037,284.27240,7548061488,285078495,7548061249,-239,,
5170656323,284.52268,7548311774,285328782,7548311536,-238,,
5170906922,284.77328,7548562373,285579380,7548562135,-238,,
5170923449,284.78981,7548578899,285595905,7548578660,-239,7548578730,
5171174349,285.04071,7548829799,285846806,7548829577,-222,,
5171424502,285.29086,7549079950,286096957,7549079746,-204,,
5171675481,285.54184,7549330930,286347936,7549330744,-186,,
5171926350,285.79271,7549581798,286598805,7549581632,-166,,
5172176978,286.04334,7549832425,286849432,7549832258,-167,,
5172427420,286.29378,7550082866,287099872,7550082699,-167,,
5172678267,286.54463,7550333712,287350730,7550333556,-156,,
5172928891,286.79525,7550584335,287601342,7550584168,-167,,
5172945077,286.81144,7550600519,287617525,7550600352,-167,7550600611,
5173195803,287.06216,7550851252,287868258,7550851149,-103,,
5173446813,287.31317,7551102255,288119261,7551102218,-37,,
5173697478,287.56384,7551352919,288369925,7551352948,29,,
5173948008,287.81437,7551603448,288620454,7551603542,94,,
5174198355,288.06472,7551853794,288870801,7551853888,94,,
5174448517,288.31488,7552103955,289120962,7552104049,94,,
5174698971,288.56533,7552354408,289371425,7552354512,104,,
5174949411,288.81577,7552604848,289621855,7552604942,94,,
5174965656,288.83202,7552621091,289638097,7552621185,94,7552621064,
5175216154,289.08252,7552871590,289888596,7552871654,64,,
5175466311,289.33267,7553121745,290138752,7553121780,35,,
5175716949,289.58331,7553372382,290389389,7553372387,5,,
5175967242,289.83360,7553622674,290639681,7553622650,-24,,
5176217510,290.08387,7553872941,290889947,7553872916,-25,,
5176467801,290.33416,7554123232,291140238,7554123207,-25,,
5176718300,290.58466,7554373730,291390737,7554373705,-25,,
5176968888,290.83525,7554624317,291641324,7554624293,-24,,
5176985052,290.85141,7554640480,291657487,7554640455,-25,7554640520,
5177235686,291.10205,7554891115,291908122,7554891107,-8,,
5177486773,291.35313,7555142200,292159207,7555142208,8,,
5177737319,291.60368,7555392745,292409752,7555392769,24,,
5177987550,291.85391,7555642975,292659982,7555643017,42,,
5178238540,292.10490,7555893965,292910972,7555894007,42,,
5178488692,292.35505,7556144116,293161123,7556144157,41,,
5178739167,292.60553,7556394589,293411595,7556394630,41,,
5178989321,292.85568,7556644743,293661750,7556644785,42,,
5179005361,292.87172,7556660782,293677801,7556660835,53,7556660818,
5179255489,293.12185,7556910911,293927918,7556910950,39,,
5179505999,293.37236,7557161419,294178425,7557161457,38,,
5179756146,293.62251,7557411565,294428572,7557411604,39,,
5180006519,293.87288,7557661947,294678954,7557661985,38,,
5180257189,294.12355,7557912606,294929613,7557912644,38,,
5180507376,294.37374,7558162792,295179799,7558162830,38,,
5180757651,294.62401,7558413066,295430073,7558413104,38,,
5181008011,294.87437,7558663425,295680432,7558663463,38,,
5181024379,294.89074,7558679792,295696799,7558679829,37,7558679737,
5181274599,295.14096,7558930012,295947019,7558930027,15,,
5181524748,295.39111,7559180161,296197168,7559180153,-8,,
5181775342,295.64170,7559430754,296447761,7559430725,-29,,
5182025833,295.89219,7559681245,296698251,7559681192,-53,,
5182275996,296.14236,7559931406,296948412,7559931353,-53,,
5182526740,296.39310,7560182149,297199156,7560182096,-53,,
5182777684,296.64405,7560433092,297450099,7560433039,-53,,
5183027824,296.89418,7560683232,297700238,7560683179,-53,,
5183044313,296.91067,7560699719,297716726,7560699666,-53,7560699701,
5183294582,297.16094,7560949989,297966996,7560949945,-44,,
5183544755,297.41112,7561200161,298217167,7561200126,-35,,
5183794866,297.66123,7561450270,298467277,7561450244,-26,,
5184045026,297.91139,7561700431,298717437,7561700414,-17,,
5184295448,298.16181,7561950852,298967859,7561950836,-16,,
5184545632,298.41199,7562201034,299218040,7562201018,-16,,
5184796028,298.66239,7562451429,299468436,7562451413,-16,,
5185046589,298.91295,7562701989,299718996,7562701974,-15,,
5185062780,298.92914,7562718180,299735186,7562718163,-17,7562718150,
5185312915,299.17928,7562968315,299985322,7562968296,-19,,
5185563352,299.42971,7563218751,300235757,7563218728,-23,,
5185813768,299.68013,7563469165,300486171,7563469140,-25,,
5186064695,299.93106,7563720091,300737098,7563720064,-27,,
5186315082,300.18144,7563970477,300987484,7563970450,-27,,
5186569278,300.43564,7564224674,301241680,7564224646,-28,,
5186819435,300.68580,7564474830,301491837,7564474802,-28,,
5187070226,300.93659,7564725619,301742626,7564725592,-27,,
5187086472,300.95283,7564741865,301758871,7564741837,-28,7564741795,
5187336577,301.20294,7564991970,302008976,7564991932,-38,,
5187587030,301.45339,7565242421,302259428,7565242374,-47,,
5187837448,301.70381,7565492850,302509857,7565492793,-57,,
5188087702,301.95406,7565743092,302760099,7565743024,-68,,
5188337815,302.20418,7565993203,303010210,7565993135,-68,,
5188588216,302.45458,7566243603,303260610,7566243536,-67,,
5188838438,302.70480,7566493824,303510831,7566493757,-67,,
5189089124,302.95549,7566744511,303761518,7566744443,-68,,
5189105479,302.97184,7566760864,303777871,7566760796,-68,7566760768,
5189356039,303.22240,7567011425,304028435,7567011354,-71,,
5189606993,303.47335,7567262377,304279384,7567262295,-82,,
5189857417,303.72378,7567512801,304529808,7567512723,-78,,
5190107925,303.97429,7567763308,304780314,7567763212,-96,,
5190358678,304.22504,7568014059,305031066,7568013965,-94,,
5190608775,304.47514,7568264155,305281161,7568264060,-95,,
5190859424,304.72578,7568514808,305531814,7568514713,-95,,
5191109551,304.97591,7568764930,305781937,7568764836,-94,,
5191125706,304.99207,7568781083,305798089,7568780988,-95,7568781045,
5191375808,305.24217,7569031185,306048192,7569031104,-81,,
5191625977,305.49234,7569281355,306298372,7569281300,-55,,
5191876119,305.74248,7569531496,306548503,7569531455,-41,,
5192126690,305.99305,7569782065,306799071,7569782029,-36,,
5192376864,306.24322,7570032239,307049246,7570032203,-36,,
5192627414,306.49378,7570282787,307299793,7570282751,-36,,
5192878477,306.74484,7570533849,307550856,7570533813,-36,,
5193128598,306.99496,7570783970,307800976,7570783934,-36,,
5193144778,307.01114,7570800148,307817154,7570800112,-36,7570800240,
5193395123,307.26148,7571050494,308067501,7571050490,-4,,
5193645279,307.51164,7571300648,308317654,7571300677,29,,
5193895507,307.76187,7571550875,308567882,7571550937,62,,
5194145870,308.01223,7571801238,308818245,7571801332,94,,
5194396010,308.26237,7572051378,309068384,7572051472,94,,
5194646318,308.51268,7572301684,309318691,7572301778,94,,
5194896583,308.76294,7572551949,309568956,7572552043,94,,
5195146698,309.01306,7572802061,309819068,7572802156,95,,
5195163445,309.02981,7572818808,309835815,7572818902,94,7572819096,
5195413587,309.27995,7573068950,310085957,7573069093,143,,
5195663712,309.53007,7573319074,310336081,7573319267,193,,
5195914211,309.78057,7573569573,310586580,7573569814,241,,
5196164343,310.03070,7573819704,310836711,7573819994,290,,
5196414507,310.28087,7574069866,311086873,7574070157,291,,
5196665058,310.53142,7574320417,311337424,7574320708,291,,
5196915408,310.78177,7574570767,311587774,7574571057,290,,
5197166351,311.03271,7574821709,311838715,7574821999,290,,
5197182463,311.04882,7574837819,311854826,7574838109,290,7574837904,
5197433160,311.29952,7575088517,312105523,7575088756,239,,
5197683409,311.54977,7575338765,312355772,7575338953,188,,
5197933833,311.80019,7575589187,312606194,7575589325,138,,
5198184174,312.05054,7575839528,312856535,7575839624,96,,
5198434256,312.30062,7576089608,313106615,7576089694,86,,
5198684432,312.55079,7576339783,313356789,7576339869,86,,
5198934852,312.80121,7576590203,313607210,7576590289,86,,
5199185444,313.05181,7576840795,313857801,7576840881,86,,
5199201522,313.06788,7576856872,313873878,7576856957,85,7576856847,
5199451976,313.31834,7577107325,314124331,7577107383,58,,
5199702343,313.56870,7577357691,314374698,7577357723,32,,
5199952925,313.81929,7577608272,314625279,7577608276,4,,
5200203418,314.06978,7577858764,314875771,7577858741,-23,,
5200453588,314.31995,7578108933,315125940,7578108910,-23,,
5200703935,314.57030,7578359279,315376286,7578359257,-22,,
5200954088,314.82045,7578609431,315626438,7578609409,-22,,
5201204431,315.07079,7578859774,315876780,7578859750,-24,,
5201220583,315.08694,7578875924,315892931,7578875901,-23,7578875959,
5201470750,315.33711,7579126092,316143099,7579126083,-9,,
5201721033,315.58739,7579376375,316393382,7579376381,6,,
5201971417,315.83778,7579626757,316643764,7579626779,22,,
5202221869,316.08823,7579877208,316894214,7579877244,36,,
5202472260,316.33862,7580127598,317144605,7580127634,36,,
5202722602,316.58896,7580377940,317394946,7580377976,36,,
5202972766,316.83913,7580628102,317645109,7580628138,36,,
5203223131,317.08949,7580878466,317895473,7580878502,36,,
5203239127,317.10549,7580894461,317911468,7580894497,36,7580894494,
5203489234,317.35559,7581144568,318161575,7581144603,35,,
5203739509,317.60587,7581394843,318411850,7581394878,35,,
5203989689,317.85605,7581645022,318662029,7581645057,35,,
5204239852,318.10621,7581895184,318912191,7581895219,35,,
5204489951,318.35631,7582145282,319162288,7582145316,34,,
5204740555,318.60692,7582395885,319412892,7582395919,34,,
5204991169,318.85753,7582646499,319663506,7582646533,34,,
5205241449,319.10781,7582896778,319913785,7582896813,35,,
5205258251,319.12461,7582913579,319930585,7582913612,33,7582913360,
5205508406,319.37477,7583163734,320180741,7583163706,-28,,
5205758681,319.62504,7583414007,320431014,7583413915,-92,,
5206008852,319.87521,7583664178,320681185,7583664024,-154,,
5206259436,320.12580,7583914761,320931768,7583914545,-216,,
5206510329,320.37669,7584165654,321182661,7584165437,-217,,
5206760458,320.62682,7584415782,321432789,7584415566,-216,,
5207011442,320.87780,7584666765,321683771,7584666548,-217,,
5207261871,321.12823,7584917193,321934199,7584916976,-217,,
5207278111,321.14447,7584933432,321950438,7584933215,-217,7584933451,
5207528579,321.39494,7585183900,322200907,7585183742,-158,,
5207778717,321.64508,7585434037,322451044,7585433939,-98,,
5208028833,321.89519,7585684152,322701158,7585684114,-38,,
5208279111,322.14547,7585934428,322951434,7585934449,21,,
5208529620,322.39598,7586184936,323201943,7586184957,21,,
5208780000,322.64636,7586435316,323452323,7586435338,22,,
5209030493,322.89685,7586685809,323702816,7586685830,21,,
5209281087,323.14745,7586936401,323953408,7586936423,22,,
5209297341,323.16370,7586952654,323969661,7586952675,21,7586952711,
5209547903,323.41426,7587203217,324220223,7587203247,30,,
5209798224,323.66458,7587453536,324470544,7587453587,51,,
5210048400,323.91476,7587703711,324720718,7587703760,49,,
5210298614,324.16498,7587953925,324970932,7587953984,59,,
5210548914,324.41528,7588204223,325221230,7588204282,59,,
5210799042,324.66540,7588454350,325471357,7588454409,59,,
5211049172,324.91553,7588704479,325721486,7588704538,59,,
5211299338,325.16570,7588954646,325971652,7588954705,59,,
5211315623,325.18198,7588970928,325987935,7588970987,59,7588970885,
5211565794,325.43216,7589221100,326238107,7589221134,34,,
5211815975,325.68234,7589471280,326488287,7589471290,10,,
5212066116,325.93248,7589721421,326738427,7589721405,-16,,
5212316712,326.18307,7589972015,326989022,7589971974,-41,,
5212566942,326.43330,7590222245,327239252,7590222214,-31,,
5212817075,326.68344,7590472376,327489383,7590472336,-40,,
5213067525,326.93389,7590722825,327739832,7590722784,-41,,
5213317666,327.18403,7590972966,327989973,7590972925,-41,,
5213333916,327.20028,7590989214,328006220,7590989173,-41,7590989160,
5213584046,327.45041,7591239345,328256352,7591239300,-45,,
5213834641,327.70100,7591489939,328506945,7591489892,-47,,
5214084811,327.95117,7591740109,328757115,7591740059,-50,,
5214335323,328.20168,7591990619,329007625,7591990567,-52,,
5214585900,328.45226,7592241195,329258201,7592241143,-52,,
5214836064,328.70243,7592491359,329508366,7592491307,-52,,
5215086829,328.95319,7592742122,329759129,7592742071,-51,,
5215337112,329.20347,7592992404,330009410,7592992352,-52,,
5215353176,329.21954,7593008467,330025474,7593008415,-52,7593008484,
5215603676,329.47004,7593258967,330275974,7593258933,-34,,
5215854349,329.72071,7593509640,330526647,7593509622,-18,,
5216104498,329.97086,7593759788,330776795,7593759789,1,,
5216355059,330.22142,7594010348,331027355,7594010367,19,,
5216605466,330.47183,7594260755,331277762,7594260773,18,,
5216855622,330.72198,7594510909,331527916,7594510928,19,,
5217106029,330.97239,7594761315,331778322,7594761334,19,,
5217356187,331.22255,7595011473,332028480,7595011491,18,,
5217372307,331.23867,7595027591,332044598,7595027609,18,7595027672,
5217622474,331.48883,7595277759,332294766,7595277793,34,,
5217872609,331.73897,7595527892,332544899,7595527943,51,,
5218122777,331.98914,7595778059,332795066,7595778126,67,,
5218373412,332.23977,7596028694,333045701,7596028777,83,,
5218623598,332.48996,7596278878,333295885,7596278962,84,,
5218873731,332.74009,7596529011,333546018,7596529094,83,,
5219124221,332.99058,7596779501,333796507,7596779584,83,,
5219374830,333.24119,7597030109,334047116,7597030192,83,,
5219391176,333.25754,7597046454,334063460,7597046536,82,7597046501,
5219642208,333.50857,7597297486,334314492,7597297559,73,,
5219892314,333.75867,7597547590,334564597,7597547655,65,,
5220142444,334.00880,7597797719,334814726,7597797776,57,,
5220392751,334.25911,7598048024,335065031,7598048073,49,,
5220642878,334.50924,7598298150,335315157,7598298199,49,,
5220893437,334.75980,7598548710,335565716,7598548759,49,,
5221143676,335.01004,7598798958,335815965,7598799008,50,,
5221394163,335.26052,7599049434,336066441,7599049483,49,,
5221410609,335.27697,7599065879,336082886,7599065928,49,7599065820,
5221660701,335.52706,7599315972,336332979,7599315994,22,,
5221910855,335.77722,7599566125,336583132,7599566120,-5,,
5222160999,336.02736,7599816267,336833274,7599816236,-31,,
5222411582,336.27794,7600066860,337083866,7600066802,-58,,
5222661861,336.52822,7600317127,337334134,7600317070,-57,,
5222911999,336.77836,7600567264,337584270,7600567206,-58,,
5223162211,337.02857,7600817475,337834482,7600817417,-58,,
5223412310,337.27867,7601067574,338084580,7601067516,-58,,
5223428546,337.29491,7601083808,338100814,7601083750,-58,7601083843,
5223678781,337.54514,7601334043,338351050,7601334007,-36,,
5223929825,337.79619,7601585087,338602093,7601585075,-12,,
5224179919,338.04628,7601835181,338852187,7601835193,12,,
5224430521,338.29688,7602085781,339102788,7602085817,36,,
5224681260,338.54762,7602336519,339353526,7602336556,37,,
5224931845,338.79821,7602587103,339604110,7602587139,36,,
5225182356,339.04872,7602837614,339854620,7602837650,36,,
5225432746,339.29911,7603088002,340105008,7603088038,36,,
5225449010,339.31537,7603104266,340121272,7603104302,36,7603104307,
5225699382,339.56574,7603354638,340371645,7603354676,38,,
5225949507,339.81587,7603604761,340621768,7603604800,39,,
5226200138,340.06650,7603855392,340872409,7603855443,51,,
5226450555,340.31692,7604105808,341122815,7604105852,44,,
5226701006,340.56737,7604356258,341373264,7604356301,43,,
5226951351,340.81771,7604606602,341623609,7604606645,43,,
5227201516,341.06788,7604856766,341873773,7604856809,43,,
5227451686,341.31805,7605106935,342123942,7605106979,44,,
5227467844,341.33420,7605123092,342140099,7605123136,44,7605123098,
5227718374,341.58474,7605373621,342390628,7605373655,34,,
5227968997,341.83536,7605624244,342641250,7605624269,25,,
5228219157,342.08552,7605874404,342891411,7605874420,16,,
5228469497,342.33586,7606124743,343141750,7606124750,7,,
5228720290,342.58665,7606375535,343392542,7606375543,8,,
5228971134,342.83749,7606626379,343643385,7606626385,6,,
5229221822,343.08818,7606877065,343894071,7606877072,7,,
5229472080,343.33844,7607127323,344144330,7607127330,7,,
5229488383,343.35474,7607143624,344160630,7607143630,6,7607143733,
5229738504,343.60487,7607393746,344410753,7607393779,33,,
5229988660,343.85502,7607643901,344660907,7607643960,59,,
5230239009,344.10537,7607894249,344911255,7607894334,85,,
5230489553,344.35591,7608144791,345161798,7608144902,111,,
5230740275,344.60664,7608395512,345412519,7608395623,111,,
5230990629,344.85699,7608645865,345662872,7608645977,112,,
5231241159,345.10752,7608896396,345913402,7608896507,111,,
5231491415,345.35778,7609146651,346163658,7609146762,111,,
5231507666,345.37403,7609162901,346179907,7609163012,111,7609163010,
5231758344,345.62471,7609413578,346430585,7609413689,111,,
5232008777,345.87514,7609664011,346681017,7609664122,111,,
5232259442,346.12580,7609914674,346931681,7609914786,112,,
5232510061,346.37642,7610165293,347182299,7610165404,111,,
5232760888,346.62725,7610416118,347433125,7610416230,112,,
5233011232,346.87759,7610666461,347683468,7610666572,111,,
5233261746,347.12811,7610916974,347933981,7610917085,111,,
5233511914,347.37827,7611167141,348184148,7611167252,111,,
5233528098,347.39446,7611183324,348200331,7611183435,111,7611183365,
5233778254,347.64461,7611433481,348450488,7611433576,95,,
5234028418,347.89478,7611683645,348700652,7611683722,77,,
5234278583,348.14494,7611933808,348950815,7611933869,61,,
5234528983,348.39534,7612184208,349201215,7612184251,43,,
5234779430,348.64579,7612434654,349451671,7612434707,53,,
5235029621,348.89598,7612684843,349701849,7612684886,43,,
5235279789,349.14615,7612935011,349952018,7612935054,43,,
5235530132,349.39649,7613185352,350202359,7613185396,44,,
5235665815,349.53218,7613321035,350338041,7613321078,43,7613380761,
5235790886,349.65725,7613446105,350463112,7613453612,7507,,
5236041463,349.90782,7613696682,350713688,7613719145,22463,,
5236291804,350.15816,7613947022,350964029,7613984427,37405,,
5236542338,350.40870,7614197555,351214562,7614249913,52358,,
5236793247,350.65961,7614448463,351465470,7614508191,59728,,
5237043402,350.90976,7614698617,351715624,7614758345,59728,,
5237293645,351.16001,7614948859,351965866,7615008587,59728,,
5237543790,351.41015,7615199004,352216011,7615258732,59728,,
5237685776,351.55214,7615340989,352357995,7615400716,59727,7615340908,
5237810838,351.67720,7615466050,352483056,7615518297,52247,,
5238060969,351.92733,7615716181,352733187,7615753469,37288,,
5238311126,352.17749,7615966337,352983344,7615988674,22337,,
5238561249,352.42761,7616216458,353233465,7616223826,7368,,
5238811445,352.67781,7616466654,353483660,7616466575,-79,,
5239061596,352.92796,7616716804,353733811,7616716725,-79,,
5239312175,353.17854,7616967382,353984389,7616967304,-78,,
5239562655,353.42902,7617217860,354234867,7617217782,-78,,
5239704078,353.57044,7617359282,354376288,7617359203,-79,7617359250,
5239829164,353.69552,7617484370,354501376,7617484296,-74,,
5240079325,353.94569,7617734529,354751536,7617734469,-60,,
5240329868,354.19623,7617985071,355002078,7617985022,-49,,
5240580059,354.44642,7618235261,355252267,7618235225,-36,,
5240830672,354.69703,7618485874,355502881,7618485855,-19,,
5241081375,354.94774,7618736576,355753583,7618736546,-30,,
5241331611,355.19797,7618986811,356003817,7618986781,-30,,
5241581774,355.44813,7619236974,356253981,7619236944,-30,,
5241723228,355.58959,7619378425,356395432,7619378395,-30,7619378405,
5241848300,355.71466,7619503499,356520506,7619503470,-29,,
5242098971,355.96533,7619754168,356771185,7619754153,-15,,
5242349113,356.21547,7620004309,357021316,7620004287,-22,,
5242599267,356.46563,7620254463,357271470,7620254444,-19,,
5242849385,356.71575,7620504579,357521586,7620504561,-18,,
5243100122,356.96648,7620755316,357772322,7620755298,-18,,
5243350739,357.21710,7621005931,358022938,7621005913,-18,,
5243601312,357.46767,7621256504,358273511,7621256486,-18,,
5243742670,357.60903,7621397861,358414867,7621397842,-19,7621397880,
5243868201,357.73456,7621523392,358540399,7621523379,-13,,
5244118515,357.98488,7621773705,358790712,7621773701,-4,,
5244368647,358.23501,7622023836,359040843,7622023843,7,,
5244618809,358.48517,7622273998,359291005,7622274014,16,,
5244869349,358.73571,7622524536,359541543,7622524557,21,,
5245119692,358.98605,7622774878,359791885,7622774899,21,,
5245370110,359.23647,7623025295,360042303,7623025327,32,,
5245620413,359.48677,7623275598,360292605,7623275619,21,,
5245761959,359.62832,7623417142,360434148,7623417163,21,7623417135,
5245887254,359.75362,7623542437,360559443,7623542453,16,,
5246137393,360.00375,7623792576,360809583,7623792587,11,,
5246387715,360.25408,7624042897,361059904,7624042901,4,,
5246638348,360.50471,7624293530,361310537,7624293528,-2,,
5246888510,360.75487,7624543691,361560698,7624543685,-6,,
5247138634,361.00500,7624793813,361810820,7624793807,-6,,
5247388832,361.25519,7625044011,362061018,7625044006,-5,,
5247639050,361.50541,7625294227,362311234,7625294221,-6,,
5247780220,361.64658,7625435396,362452403,7625435390,-6,7625435402,
5247905715,361.77208,7625560891,362577898,7625560876,-15,,
5248156221,362.02258,7625811396,362828403,7625811388,-8,,
5248406834,362.27319,7626062008,363079015,7626062007,-1,,
5248657027,362.52339,7626312201,363329208,7626312206,5,,
5248907721,362.77408,7626562894,363579900,7626562902,8,,
5249158114,363.02447,7626813286,363830292,7626813294,8,,
5249408809,363.27517,7627063980,364080987,7627063988,8,,
5249659270,363.52563,7627314440,364331446,7627314448,8,,
5249800657,363.66702,7627455825,364472831,7627455844,19,7627455830,
5249925783,363.79214,7627580953,364597959,7627580960,7,,
5250175896,364.04226,7627831065,364848071,7627831072,7,,
5250426356,364.29272,7628081523,365098530,7628081530,7,,
5250676799,364.54316,7628331965,365348972,7628331972,7,,
5250926958,364.79332,7628582123,365599130,7628582130,7,,
5251177122,365.04348,7628832287,365849294,7628832295,8,,
5251427413,365.29377,7629082577,366099584,7629082584,7,,
5251677548,365.54391,7629332711,366349718,7629332718,7,,
5251818919,365.68528,7629474081,366491087,7629474087,6,7629474111,
5251943959,365.81032,7629599121,366616127,7629599130,9,,
5252194025,366.06039,7629849186,366866193,7629849203,17,,
5252444138,366.31050,7630099299,367116305,7630099321,22,,
5252694811,366.56117,7630349970,367366977,7630349999,29,,
5252945434,366.81180,7630600593,367617599,7630600625,32,,
5253196123,367.06248,7630851281,367868287,7630851313,32,,
5253446704,367.31306,7631101860,368118867,7631101892,32,,
5253697106,367.56347,7631352262,368369269,7631352294,32,,
5253838620,367.70498,7631493774,368510780,7631493806,32,7631493700,
5253963690,367.83005,7631618845,368635852,7631618855,10,,
5254213867,368.08023,7631869022,368886028,7631869007,-15,,
5254464068,368.33043,7632119221,369136228,7632119183,-38,,
5254714189,368.58055,7632369341,369386348,7632369280,-61,,
5254964502,368.83086,7632619654,369636661,7632619582,-72,,
5255214628,369.08099,7632869778,369886785,7632869706,-72,,
5255465203,369.33156,7633120353,370137360,7633120281,-72,,
5255715835,369.58220,7633370983,370387989,7633370911,-72,,
5255857028,369.72339,7633512175,370529182,7633512103,-72,7633512240,
5255982353,369.84871,7633637500,370654506,7633637445,-55,,
5256232549,370.09891,7633887696,370904703,7633887676,-20,,
5256483134,370.34949,7634138280,371155287,7634138296,16,,
5256733236,370.59960,7634388381,371405388,7634388431,50,,
5256983521,370.84988,7634638665,371655672,7634638732,67,,
5257234270,371.10063,7634889414,371906421,7634889481,67,,
5257484381,371.35074,7635139523,372156530,7635139591,68,,
5257734524,371.60089,7635389666,372406673,7635389733,67,,
5257876107,371.74247,7635531248,372548254,7635531314,66,7635531412,
5258001643,371.86800,7635656784,372673791,7635656862,78,,
5258252733,372.11909,7635907873,372924879,7635907976,103,,
5258502899,372.36926,7636158038,373175045,7636158167,129,,
5258753236,372.61960,7636408375,373425382,7636408529,154,,
5259003405,372.86977,7636658543,373675549,7636658709,166,,
5259253621,373.11998,7636908758,373925765,7636908924,166,,
5259503783,373.37014,7637158918,374175925,7637159084,166,,
5259754386,373.62075,7637409521,374426528,7637409687,166,,
5259896402,373.76276,7637551536,374568542,7637551701,165,7637551434,
5260021502,373.88786,7637676636,374693642,7637676767,131,,
5260272097,374.13846,7637927230,374944237,7637927296,66,,
5260522256,374.38862,7638177387,375194394,7638177386,-1,,
5260772407,374.63877,7638427537,375444544,7638427470,-67,,
5261022532,374.88889,7638677662,375694669,7638677562,-100,,
5261272665,375.13903,7638927794,375944801,7638927694,-100,,
5261523077,375.38944,7639178205,376195212,7639178105,-100,,
5261773462,375.63982,7639428589,376445595,7639428489,-100,,
5261914777,375.78114,7639569902,376586908,7639569802,-100,7639569855,
5262040186,375.90655,7639695313,376712320,7639695220,-93,,
5262290852,376.15721,7639945978,376962995,7639945908,-70,,
5262541378,376.40774,7640196503,377213509,7640196437,-66,,
5262791797,376.65816,7640446921,377463927,7640446869,-52,,
5263041949,376.90831,7640697071,377714078,7640697027,-44,,
5263292459,377.15882,7640947581,377964587,7640947536,-45,,
5263542858,377.40922,7641197980,378214987,7641197935,-45,,
5263793461,377.65982,7641448580,378465587,7641448536,-44,,
5263934809,377.80117,7641589927,378606933,7641589882,-45,7641589934,
5264060111,377.92647,7641715230,378732237,7641715192,-38,,
5264310352,378.17671,7641965470,378982477,7641965445,-25,,
5264560892,378.42725,7642216010,379233016,7642216006,-4,,
5264811844,378.67820,7642466960,379483967,7642466963,3,,
5265062317,378.92868,7642717433,379734439,7642717442,9,,
5265312914,379.17928,7642968028,379985035,7642968037,9,,
5265563351,379.42971,7643218464,380235471,7643218474,10,,
5265813465,379.67983,7643468577,380485583,7643468585,8,,
5265956215,379.82258,7643611326,380628333,7643611335,9,7643611333,
5266081277,379.94764,7643736390,380753396,7643736398,8,,
5266331616,380.19798,7643986727,381003734,7643986735,8,,
5266582376,380.44874,7644237486,381254493,7644237494,8,,
5266832529,380.69889,7644487638,381504644,7644487646,8,,
5267082817,380.94918,7644737925,381754932,7644737934,9,,
5267332976,381.19934,7644988083,382005090,7644988091,8,,
5267583152,381.44951,7645238258,382255265,7645238266,8,,
5267833725,381.70009,7645488831,382505838,7645488839,8,,
5267975142,381.84150,7645630246,382647253,7645630254,8,7645630234,
5268100192,381.96655,7645755296,382772303,7645755301,5,,
5268350767,382.21713,7646005871,383022878,7646005873,2,,
5268600913,382.46727,7646256017,383273024,7646256013,-4,,
5268851386,382.71775,7646506489,383523496,7646506481,-8,,
5269101782,382.96814,7646756884,383773891,7646756874,-10,,
5269351934,383.21830,7647007034,384024041,7647007023,-11,,
5269602196,383.46856,7647257295,384274302,7647257285,-10,,
5269852328,383.71869,7647507426,384524433,7647507415,-11,,
5269993818,383.86018,7647648915,384665922,7647648904,-11,7647648854,
5270118888,383.98525,7647773985,384790992,7647773969,-16,,
5270369253,384.23561,7648024349,385041356,7648024321,-28,,
5270619439,384.48580,7648274534,385291541,7648274493,-41,,
5270870350,384.73671,7648525445,385542451,7648525392,-53,,
5271120466,384.98683,7648775560,385792567,7648775501,-59,,
5271370611,385.23697,7649025705,386042712,7649025646,-59,,
5271621232,385.48759,7649276325,386293331,7649276266,-59,,
5271871441,385.73780,7649526533,386543539,7649526473,-60,,
5272012596,385.87896,7649667686,386684692,7649667627,-59,7649667665,
5272137820,386.00418,7649792911,386809917,7649792856,-55,,
5272387986,386.25435,7650043075,387060082,7650043031,-44,,
5272638344,386.50471,7650293432,387310439,7650293398,-34,,
5272889250,386.75561,7650544337,387561344,7650544313,-24,,
5273139333,387.00569,7650794419,387811426,7650794400,-19,,
5273389898,387.25626,7651044983,388061990,7651044964,-19,,
5273639998,387.50636,7651295084,388312090,7651295065,-19,,
5273890405,387.75677,7651545490,388562496,7651545471,-19,,
5274031659,387.89802,7651686742,388703748,7651686722,-20,7651686828,
5274157221,388.02358,7651812304,388829311,7651812299,-5,,
5274407795,388.27416,7652062877,389079884,7652062899,22,,
5274657926,388.52429,7652313007,389330014,7652313056,49,,
5274908461,388.77482,7652563541,389580548,7652563617,76,,
5275158624,389.02499,7652813703,389830710,7652813802,99,,
5275408763,389.27512,7653063842,390080848,7653063930,88,,
5275658977,389.52534,7653314055,390331061,7653314143,88,,
5275910024,389.77639,7653565101,390582108,7653565189,88,,
5276051976,389.91834,7653707051,390724058,7653707139,88,7653706772,
5276177015,390.04338,7653832092,390849098,7653832134,42,,
5276427360,390.29372,7654082435,391099442,7654082386,-49,,
5276677708,390.54407,7654332782,391349788,7654332641,-141,,
5276928261,390.79462,7654583334,391600341,7654583102,-232,,
5277179085,391.04545,7654834157,391851164,7654833880,-277,,
5277429721,391.29608,7655084791,392101798,7655084515,-276,,
5277680182,391.54654,7655335252,392352258,7655334975,-277,,
5277930296,391.79666,7655585365,392602372,7655585089,-276,,
5278071528,391.93789,7655726596,392743603,7655726319,-277,7655726667,
5278196575,392.06294,7655851643,392868649,7655851409,-234,,
5278446875,392.31324,7656101942,393118949,7656101796,-146,,
5278697448,392.56381,7656352515,393369522,7656352457,-58,,
5278947815,392.81418,7656602881,393619887,7656602911,30,,
5279198259,393.06462,7656853324,393870331,7656853397,73,,
5279448533,393.31489,7657103598,394120604,7657103671,73,,
5279699176,393.56554,7657354239,394371246,7657354312,73,,
5279949260,393.81562,7657604322,394621329,7657604395,73,,
5280090538,393.95690,7657745599,394762605,7657745671,72,7657745600,
5280215612,394.08197,7657870673,394887680,7657870738,65,,
5280466180,394.33254,7658121239,395138246,7658121286,47,,
5280716715,394.58308,7658371774,395388781,7658371803,29,,
5280966802,394.83316,7658621861,395638867,7658621873,12,,
5281216934,395.08330,7658871993,395888999,7658871996,3,,
5281467458,395.33382,7659122515,396139522,7659122518,3,,
5281717604,395.58396,7659372661,396389667,7659372664,3,,
5281968011,395.83437,7659623066,396640073,7659623070,4,,
5282109348,395.97571,7659764401,396781408,7659764404,3,7659764447,
5282234418,396.10078,7659889472,396906479,7659889480,8,,
5282484914,396.35127,7660139967,397156974,7660139986,19,,
5282735352,396.60171,7660390405,397407411,7660390435,30,,
5282985965,396.85233,7660641017,397658024,7660641059,42,,
5283236677,397.10304,7660891728,397908734,7660891775,47,,
5283486800,397.35316,7661141850,398158857,7661141898,48,,
5283737483,397.60384,7661392533,398409539,7661392580,47,,
5283987880,397.85424,7661642929,398659936,7661642977,48,,
5284129490,397.99585,7661784537,398801543,7661784583,46,7661784528,
5284254569,398.12093,7661909617,398926624,7661909656,39,,
5284504760,398.37112,7662159806,399176813,7662159832,26,,
5284754874,398.62124,7662409919,399426926,7662409931,12,,
5285005208,398.87157,7662660252,399677259,7662660251,-1,,
5285255387,399.12175,7662910431,399927438,7662910424,-7,,
5285506026,399.37239,7663161068,400178075,7663161061,-7,,
5285756273,399.62263,7663411314,400428321,7663411307,-7,,
5286007469,399.87383,7663662511,400679517,7663662504,-7,,
5286149245,400.01561,7663804284,400821291,7663804277,-7,7663804045,
5286274761,400.14112,7663929801,400946808,7663929764,-37,,
5286524897,400.39126,7664179937,401196943,7664179843,-94,,
5286775513,400.64187,7664430552,401447559,7664430400,-152,,
5287026115,400.89248,7664681152,401698159,7664680942,-210,,
5287276648,401.14301,7664931684,401948691,7664931447,-237,,
5287526863,401.39322,7665181898,402198905,7665181660,-238,,
5287776995,401.64336,7665432030,402449048,7665431803,-227,,
5288027538,401.89390,7665682571,402699578,7665682344,-227,,
5288168700,402.03506,7665823733,402840739,7665823494,-239,7665823769,
5288293733,402.16009,7665948766,402965772,7665948561,-205,,
5288543860,402.41022,7666198893,403215899,7666198758,-135,,
5288794129,402.66049,7666449160,403466167,7666449095,-65,,
5289044408,402.91077,7666699438,403716445,7666699441,3,,
5289294956,403.16132,7666949985,403966992,7666950023,38,,
5289545073,403.41143,7667200101,404217108,7667200140,39,,
5289795497,403.66186,7667450525,404467532,7667450563,38,,
5290045610,403.91197,7667700636,404717643,7667700674,38,,
5290186989,404.05335,7667842014,404859021,7667842052,38,7667842027,
5290312425,404.17879,7667967450,404984457,7667967485,35,,
5290562559,404.42892,7668217583,405234590,7668217612,29,,
5290812707,404.67907,7668467731,405484738,7668467754,23,,
5291063325,404.92969,7668718348,405735355,7668718365,17,,
5291313942,405.18030,7668968965,405985972,7668968980,15,,
5291564189,405.43055,7669219209,406236216,7669219223,14,,
5291814843,405.68120,7669469864,406486871,7669469878,14,,
5292065022,405.93138,7669720041,406737047,7669720055,14,,
5292206812,406.07317,7669861830,406878836,7669861844,14,7669861699,
5292331896,406.19826,7669986914,407003921,7669986911,-3,,
5292582368,406.44873,7670237385,407254392,7670237346,-39,,
5292832667,406.69903,7670487684,407504690,7670487609,-75,,
5293082858,406.94922,7670737873,407754880,7670737762,-111,,
5293333022,407.19938,7670988036,408005043,7670987907,-129,,
5293583167,407.44953,7671238182,408255189,7671238053,-129,,
5293833379,407.69974,7671488393,408505399,7671488264,-129,,
5294083540,407.94990,7671738553,408755559,7671738434,-119,,
5294224646,408.09101,7671879657,408896663,7671879527,-130,7671879736,
5294349701,408.21606,7672004712,409021719,7672004609,-103,,
5294599880,408.46624,7672254890,409271897,7672254840,-50,,
5294850050,408.71641,7672505059,409522066,7672505061,2,,
5295100200,408.96656,7672755209,409772216,7672755265,56,,
5295350345,409.21671,7673005353,410022360,7673005434,81,,
5295600982,409.46734,7673255989,410272996,7673256071,82,,
5295851425,409.71779,7673506431,410523437,7673506512,81,,
5296101544,409.96790,7673756550,410773556,7673756631,81,,
5296243015,410.10938,7673898018,410915024,7673898099,81,7673897950,
5296368083,410.23444,7674023087,411040094,7674023151,64,,
5296618574,410.48494,7674273577,411290584,7674273604,27,,
5296868742,410.73510,7674523745,411540752,7674523735,-10,,
5297118888,410.98525,7674773889,411790896,7674773843,-46,,
5297369043,411.23540,7675024044,412041051,7675023978,-66,,
5297619308,411.48567,7675274306,412291313,7675274241,-65,,
5297869438,411.73580,7675524436,412541443,7675524370,-66,,
5298120057,411.98642,7675775055,412792061,7675774989,-66,,
5298261322,412.12768,7675916318,412933324,7675916252,-66,7675916366,
5298386405,412.25277,7676041403,413058409,7676041351,-52,,
5298636916,412.50328,7676291913,413308919,7676291901,-12,,
5298887409,412.75377,7676542405,413559412,7676542412,7,,
5299137594,413.00396,7676792589,413809595,7676792625,36,,
5299387906,413.25427,7677042899,414059906,7677042950,51,,
5299638356,413.50472,7677293349,414310356,7677293399,50,,
5299888524,413.75489,7677543516,414560523,7677543567,51,,
5300138683,414.00504,7677793673,414810680,7677793724,51,,
5300279749,414.14611,7677934739,414951745,7677934789,50,7677934791,
5300404858,414.27122,7678059847,415076854,7678059897,50,,
5300654991,414.52135,7678309980,415326997,7678310042,62,,
5300906025,414.77239,7678561014,415578020,7678561066,52,,
5301156134,415.02249,7678811121,415828127,7678811174,53,,
5301406521,415.27288,7679061507,416078514,7679061561,54,,
5301657453,415.52381,7679312438,416329445,7679312492,54,,
5301908093,415.77445,7679563076,416580083,7679563130,54,,
5302158333,416.02469,7679813317,416830323,7679813371,54,,
5302300073,416.16643,7679955056,416972062,7679955110,54,7679955140,
5302425156,416.29152,7680080148,417097155,7680080205,57,,
5302675420,416.54178,7680330402,417347409,7680330467,65,,
5302926350,416.79271,7680581331,417598338,7680581416,85,,
5303176974,417.04334,7680831953,417848960,7680832036,83,,
5303427431,417.29379,7681082410,418099417,7681082496,86,,
5303678330,417.54469,7681333309,418350316,7681333395,86,,
5303928985,417.79535,7681583962,418600969,7681584059,97,,
5304179449,418.04581,7681834425,418851432,7681834511,86,,
5304320612,418.18697,7681975586,418992592,7681975672,86,7681975549,
5304445860,418.31222,7682100835,419117841,7682100906,71,,
5304696001,418.56236,7682350976,419367982,7682351016,40,,
5304946246,418.81261,7682601220,419618226,7682601230,10,,
5305196860,419.06322,7682851832,419868839,7682851813,-19,,
5305447015,419.31338,7683101987,420118993,7683101952,-35,,
5305697173,419.56353,7683352143,420369150,7683352109,-34,,
5305947438,419.81380,7683602408,420619415,7683602374,-34,,
5306198331,420.06469,7683853300,420870307,7683853265,-35,,
5306339662,420.20602,7683994629,421011636,7683994594,-35,7683994529,
5306464715,420.33108,7684119683,421136689,7684119638,-45,,
5306715401,420.58176,7684370368,421387374,7684370309,-59,,
5306965507,420.83187,7684620483,421637489,7684620408,-75,,
5307215655,421.08202,7684870620,421887627,7684870529,-91,,
5307466185,421.33255,7685121148,422138155,7685121050,-98,,
5307716442,421.58280,7685371405,422388412,7685371306,-99,,
5307966619,421.83298,7685621581,422638587,7685621482,-99,,
5308217234,422.08360,7685872196,422889203,7685872098,-98,,
5308358865,422.22523,7686013826,423030832,7686013726,-100,7686013753,
5308483916,422.35028,7686138876,423155883,7686138781,-95,,
5308734372,422.60073,7686389332,423406339,7686389243,-89,,
5308984900,422.85126,7686639859,423656866,7686639777,-82,,
5309235429,423.10179,7686890388,423907395,7686890313,-75,,
5309486329,423.35269,7687141287,424158294,7687141216,-71,,
5309736485,423.60285,7687391441,424408448,7687391370,-71,,
5309986818,423.85318,7687641774,424658781,7687641703,-71,,
5310237028,424.10339,7687891982,424908989,7687891911,-71,,
5310378458,424.24482,7688033411,425050418,7688033340,-71,7688033589,
5310503529,424.36989,7688158483,425175490,7688158443,-40,,
5310754400,424.62076,7688409352,425426359,7688409376,24,,
5311004563,424.87092,7688659516,425676522,7688659602,86,,
5311254730,425.12109,7688909682,425926689,7688909831,149,,
5311504853,425.37121,7689159803,426176810,7689159983,180,,
5311755388,425.62175,7689410337,426427344,7689410517,180,,
5312005829,425.87219,7689660777,426677783,7689660956,179,,
5312255983,426.12234,7689910931,426927938,7689911112,181,,
5312397317,426.26368,7690052263,427069270,7690052443,180,7690052291,
5312522392,426.38875,7690177337,427194354,7690177508,171,,
5312772781,426.63914,7690427726,427444733,7690427849,123,,
5313022939,426.88930,7690677883,427694890,7690677978,95,,
5313273416,427.13978,7690928360,427945367,7690928408,48,,
5313524203,427.39056,7691179146,428196153,7691179176,30,,
5313774806,427.64117,7691429749,428446755,7691429779,30,,
5314024947,427.89131,7691679888,428696895,7691679919,31,,
5314275366,428.14173,7691930306,428947313,7691930337,31,,
5314416673,428.28303,7692071611,429088617,7692071641,30,7692071643,
5314541759,428.40812,7692196698,429213705,7692196728,30,,
5314792310,428.65867,7692447248,429464255,7692447279,31,,
5315042439,428.90880,7692697376,429714383,7692697409,33,,
5315292817,429.15918,7692947753,429964760,7692947787,34,,
5315543309,429.40967,7693198244,430215251,7693198278,34,,
5315793967,429.66033,7693448903,430465910,7693448937,34,,
5316044169,429.91053,7693699103,430716109,7693699137,34,,
5316294614,430.16098,7693949547,430966554,7693949582,35,,
5316435954,430.30232,7694090885,431107892,7694090919,34,7694090789,
5316561029,430.42739,7694215972,431232978,7694215988,16,,
5316811415,430.67778,7694466345,431483352,7694466330,-15,,
5317061547,430.92791,7694716477,431733484,7694716430,-47,,
5317311698,431.17806,7694966627,431983634,7694966548,-79,,
5317562219,431.42858,7695217146,432234153,7695217051,-95,,
5317812358,431.67872,7695467286,432484292,7695467191,-95,,
5318062532,431.92889,7695717459,432734465,7695717364,-95,,
5318312845,432.17921,7695967771,432984778,7695967676,-95,,
5318454364,432.32072,7696109288,433126295,7696109193,-95,7696109348,
5318579436,432.44580,7696234362,433251369,7696234285,-77,,
5318829601,432.69596,7696484525,433501532,7696484488,-37,,
5319079734,432.94610,7696734658,433751664,7696734660,2,,
5319329878,433.19624,7696984801,434001807,7696984842,41,,
5319580019,433.44638,7697234940,434251947,7697235012,72,,
5319830375,433.69674,7697485295,434502302,7697485356,61,,
5320080919,433.94728,7697735839,434752846,7697735910,71,,
5320331119,434.19748,7697986037,435003044,7697986098,61,,
5320472775,434.33914,7698127692,435144698,7698127753,61,7698127544,
5320598294,434.46465,7698253211,435270217,7698253245,34,,
5320848426,434.71479,7698503343,435520350,7698503326,-17,,
5321098554,434.96492,7698753470,435770476,7698753402,-68,,
5321349166,435.21553,7699004082,436021089,7699003962,-120,,
5321599359,435.46572,7699254273,436271280,7699254128,-145,,
5321849568,435.71593,7699504481,436521488,7699504335,-146,,
5322099970,435.96633,7699754883,436771889,7699754737,-146,,
5322350331,436.21669,7700005242,437022249,7700005097,-145,,
5322491449,436.35781,7700146359,437163366,7700146213,-146,7700146410,
5322616991,436.48335,7700271901,437288907,7700271778,-123,,
5322867449,436.73381,7700522358,437539365,7700522285,-73,,
5323117586,436.98395,7700772495,437789502,7700772473,-22,,
5323368062,437.23442,7701022971,438039977,7701022998,27,,
5323618512,437.48487,7701273419,438290425,7701273480,61,,
5323868645,437.73501,7701523552,438540559,7701523604,52,,
5324118786,437.98515,7701773692,438790699,7701773744,52,,
5324368934,438.23530,7702023839,439040856,7702023902,63,,
5324510417,438.37678,7702165320,439182326,7702165371,51,7702165326,
5324635495,438.50186,7702290399,439307406,7702290445,46,,
5324886078,438.75244,7702540980,439557987,7702541016,36,,
5325136196,439.00256,7702791097,439808104,7702791121,24,,
5325386810,439.25317,7703041710,440058717,7703041724,14,,
5325636968,439.50333,7703291867,440308874,7703291875,8,,
5325887136,439.75350,7703542036,440559043,7703542044,8,,
5326137407,440.00377,7703792305,440809312,7703792313,8,,
5326387708,440.25407,7704042605,441059611,7704042613,8,,
5326528974,440.39533,7704183870,441200876,7704183877,7,7704183951,
5326654328,440.52069,7704309224,441326230,7704309231,7,,
5326904916,440.77128,7704559812,441576819,7704559852,40,,
5327155422,441.02178,7704810316,441827323,7704810368,52,,
5327406060,441.27242,7705060953,442077959,7705061026,73,,
5327656235,441.52260,7705311128,442328135,7705311211,83,,
5327906759,441.77312,7705561650,442578657,7705561744,94,,
5328156895,442.02326,7705811787,442828794,7705811870,83,,
5328407062,442.27342,7706061953,443078959,7706062036,83,,
5328548370,442.41473,7706203258,443220265,7706203341,83,7706203290,
5328673452,442.53981,7706328342,443345349,7706328419,77,,
5328924376,442.79074,7706579265,443596272,7706579329,64,,
5329174502,443.04086,7706829390,443846396,7706829441,51,,
5329424678,443.29104,7707079564,444096571,7707079604,40,,
5329674847,443.54121,7707329733,444346740,7707329766,33,,
5329925167,443.79153,7707580052,444597058,7707580085,33,,
5330175298,444.04166,7707830181,444847187,7707830214,33,,
5330425437,444.29180,7708080319,445097326,7708080352,33,,
5330566541,444.43290,7708221422,445238428,7708221455,33,7708221464,
5330691619,444.55798,7708346501,445363507,7708346534,33,,
5330941782,444.80814,7708596664,445613671,7708596700,36,,
5331191867,445.05823,7708846747,445863754,7708846786,39,,
5331442046,445.30841,7709096925,446113932,7709096967,42,,
5331692190,445.55855,7709347068,446364075,7709347112,44,,
5331942346,445.80871,7709597223,446614230,7709597268,45,,
5332192513,446.05887,7709847389,446864396,7709847433,44,,
5332442654,446.30901,7710097529,447114536,7710097574,45,,
5332584356,446.45072,7710239230,447256237,7710239274,44,7710239208,
5332709686,446.57605,7710364560,447381567,7710364596,36,,
5332959950,446.82631,7710614824,447631831,7710614843,19,,
5333210704,447.07707,7710865577,447882583,7710865580,3,,
5333460845,447.32721,7711115718,448132725,7711115716,-2,,
5333711413,447.57777,7711366285,448383292,7711366264,-21,,
5333961595,447.82796,7711616465,448633471,7711616444,-21,,
5334212087,448.07845,7711866956,448883963,7711866935,-21,,
5334462679,448.32904,7712117548,449134555,7712117527,-21,,
5334604108,448.47047,7712258975,449275981,7712258954,-21,7712258841,
5334729493,448.59585,7712384361,449401368,7712384325,-36,,
5334979743,448.84610,7712634609,449651616,7712634546,-63,,
5335230268,449.09663,7712885133,449902140,7712885042,-91,,
5335480424,449.34679,7713135288,450152294,7713135168,-120,,
5335730823,449.59718,7713385688,450402695,7713385555,-133,,
5335981497,449.84786,7713636360,450653367,7713636228,-132,,
5336231657,450.09802,7713886520,450903526,7713886387,-133,,
5336481757,450.34812,7714136618,451153624,7714136484,-134,,
5336622995,450.48936,7714277854,451294860,7714277721,-133,7714277896,
5336748066,450.61443,7714402927,451419934,7714402815,-112,,
5336998303,450.86466,7714653163,451670170,7714653096,-67,,
5337248723,451.11508,7714903581,451920588,7714903558,-23,,
5337498876,451.36524,7715153733,452170740,7715153754,21,,
5337749015,451.61538,7715403870,452420877,7715403914,44,,
5337999409,451.86577,7715654264,452671271,7715654307,43,,
5338249542,452.11590,7715904397,452921404,7715904440,43,,
5338500154,452.36651,7716155008,453172015,7716155051,43,,
5338641429,452.50779,7716296281,453313288,7716296324,43,7716296333,
5338766479,452.63284,7716421333,453438339,7716421368,35,,
5339016625,452.88299,7716671477,453688495,7716671528,51,,
5339266835,453.13320,7716921686,453938693,7716921733,47,,
5339516988,453.38335,7717171838,454188845,7717171890,52,,
5339767139,453.63350,7717421989,454438996,7717422043,54,,
5340017265,453.88363,7717672112,454689119,7717672167,55,,
5340267411,454.13377,7717922259,454939266,7717922313,54,,
5340517553,454.38391,7718172400,455189406,7718172454,54,,
5340659269,454.52563,7718314115,455331121,7718314169,54,7718314230,
5340784739,454.65110,7718439584,455456591,7718439645,61,,
5341034875,454.90124,7718689721,455706728,7718689798,77,,
5341285028,455.15139,7718939872,455956879,7718939965,93,,
5341535171,455.40153,7719190014,456207020,7719190123,109,,
5341785356,455.65172,7719440198,456457205,7719440315,117,,
5342035516,455.90188,7719690357,456707364,7719690475,118,,
5342285662,456.15202,7719940503,456957509,7719940620,117,,
5342535789,456.40215,7720190628,457207635,7720190745,117,,
5342676935,456.54330,7720331774,457348780,7720331891,117,7720331832,
5342802118,456.66848,7720456957,457473975,7720457077,120,,
5343052296,456.91866,7720707133,457724140,7720707228,95,,
5343302576,457.16894,7720957413,457974419,7720957494,81,,
5343552713,457.41907,7721207549,458224556,7721207616,67,,
5343802857,457.66922,7721457693,458474710,7721457763,70,,
5344052993,457.91935,7721707828,458724834,7721707888,60,,
5344303843,458.17020,7721958677,458975683,7721958737,60,,
5344554005,458.42037,7722208837,459225843,7722208897,60,,
5344695306,458.56167,7722350137,459367144,7722350197,60,7722350154,
5344820408,458.68677,7722475239,459492246,7722475295,56,,
5345070782,458.93714,7722725613,459742619,7722725658,45,,
5345320948,459.18731,7722975778,459992785,7722975812,34,,
5345571365,459.43773,7723226194,460243200,7723226218,24,,
5345821541,459.68790,7723476370,460493376,7723476389,19,,
5346072184,459.93854,7723727011,460744018,7723727030,19,,
5346322745,460.18911,7723977571,460994578,7723977591,20,,
5346573326,460.43969,7724228151,461245158,7724228170,19,,
5346714487,460.58085,7724369310,461386316,7724369329,19,7724369321,
5346839844,460.70621,7724494669,461511676,7724494687,18,,
5347090002,460.95636,7724744826,461761833,7724744841,15,,
5347340146,461.20651,7724994968,462011975,7724994983,15,,
5347590328,461.45669,7725245149,462262156,7725245162,13,,
5347840947,461.70731,7725495767,462512774,7725495780,13,,
5348091422,461.95778,7725746242,462763248,7725746254,12,,
5348341608,462.20797,7725996428,463013435,7725996440,12,,
5348591769,462.45813,7726246587,463263594,7726246600,13,,
5348733022,462.59938,7726387838,463404844,7726387850,12,7726387844,
5348858122,462.72448,7726512939,463529947,7726512950,11,,
5349108280,462.97464,7726763097,463780104,7726763107,10,,
5349358423,463.22478,7727013239,464030246,7727013248,9,,
5349608579,463.47494,7727263394,464280400,7727263402,8,,
5349858749,463.72511,7727513562,464530569,7727513571,9,,
5350108892,463.97525,7727763705,464780712,7727763713,8,,
5350359170,464.22553,7728013981,465030988,7728013989,8,,
5350609540,464.47590,7728264350,465281357,7728264358,8,,
5350750978,464.61734,7728405787,465422794,7728405795,8,7728405777,
5350876383,464.74274,7728531193,465548200,7728531198,5,,
5351126523,464.99288,7728781332,465798339,7728781333,1,,
5351376672,465.24303,7729031480,466048487,7729031478,-2,,
5351627103,465.49346,7729281909,466298916,7729281902,-7,,
5351877246,465.74361,7729532052,466549059,7729532043,-9,,
5352127835,465.99420,7729782641,466799648,7729782632,-9,,
5352377978,466.24434,7730032783,467049789,7730032774,-9,,
5352628128,466.49449,7730282932,467299938,7730282923,-9,,
5352769443,466.63580,7730424245,467441252,7730424236,-9,7730424295,
5352894857,466.76122,7730549660,467566667,7730549658,-2,,
5353145017,467.01138,7730799819,467816826,7730799832,13,,
5353395566,467.26193,7731050367,468067374,7731050395,28,,
5353645990,467.51235,7731300790,468317796,7731300833,43,,
5353896227,467.76259,7731551027,468568034,7731551078,51,,
5354146781,468.01314,7731801580,468818587,7731801632,52,,
5354397439,468.26380,7732052237,469069244,7732052288,51,,
5354647801,468.51416,7732302598,469319605,7732302649,51,,
5354789027,468.65539,7732443823,469460829,7732443873,50,7732443802,
5354914078,468.78044,7732568872,469585879,7732568916,44,,
5355164210,469.03057,7732819005,469836012,7732819034,29,,
5355414755,469.28112,7733069549,470086556,7733069574,25,,
5355665411,469.53177,7733320204,470337210,7733320203,-1,,
5355916010,469.78237,7733570803,470587809,7733570795,-8,,
5356166123,470.03248,7733820915,470837921,7733820906,-9,,
5356416514,470.28287,7734071304,471088310,7734071296,-8,,
5356666640,470.53300,7734321429,471338436,7734321421,-8,,
5356807970,470.67433,7734462758,471479765,7734462750,-8,7734462745,
5356933059,470.79942,7734587847,471604854,7734587838,-9,,
5357183219,471.04958,7734838007,471855014,7734837998,-9,,
5357433383,471.29974,7735088169,472105176,7735088159,-10,,
5357683525,471.54989,7735338310,472355317,7735338300,-10,,
5357934356,471.80072,7735589141,472606148,7735589130,-11,,
5358184454,472.05082,7735839239,472856246,7735839228,-11,,
5358434647,472.30101,7736089430,473106437,7736089419,-11,,
5358684816,472.55118,7736339598,473356605,7736339587,-11,,
5358826077,472.69244,7736480857,473497863,7736480846,-11,7736480983,
5358951128,472.81749,7736605909,473622916,7736605917,8,,
5359201583,473.06794,7736856364,473873371,7736856405,41,,
5359451704,473.31806,7737106483,474123490,7737106559,76,,
5359701816,473.56818,7737356594,474373601,7737356705,111,,
5359951928,473.81829,7737606706,474623713,7737606834,128,,
5360202090,474.06845,7737856867,474873873,7737856995,128,,
5360452251,474.31861,7738107028,475124035,7738107156,128,,
5360702428,474.56879,7738357203,475374210,7738357332,129,,
5360843503,474.70986,7738498277,475515283,7738498404,127,7738498380,
5360968565,474.83493,7738623339,475640345,7738623473,134,,
5361218968,475.08533,7738873741,475890748,7738873860,119,,
5361469124,475.33549,7739123896,476140903,7739124009,113,,
5361719260,475.58562,7739374031,476391038,7739374138,107,,
5361969364,475.83573,7739624134,476641140,7739624239,105,,
5362219980,476.08634,7739874750,476891757,7739874855,105,,
5362470456,476.33682,7740125224,477142230,7740125329,105,,
5362720913,476.58727,7740375690,477392697,7740375795,105,,
5362862570,476.72893,7740517336,477534343,7740517441,105,7740517395,
5362987640,476.85400,7740642407,477659414,7740642506,99,,
5363237805,477.10417,7740892571,477909578,7740892659,88,,
5363487913,477.35427,7741142679,478159685,7741142756,77,,
5363738019,477.60438,7741392783,478409790,7741392849,66,,
5363988159,477.85452,7741642922,478659929,7741642982,60,,
5364238674,478.10503,7741893437,478910444,7741893497,60,,
5364488843,478.35520,7742143604,479160611,7742143664,60,,
5364739436,478.60580,7742394196,479411203,7742394256,60,,
5364880747,478.74711,7742535506,479552513,7742535566,60,7742535466,
5365006051,478.87241,7742660810,479677816,7742660857,47,,
5365256537,479.12290,7742911295,479928302,7742911318,23,,
5365506668,479.37303,7743161425,480178432,7743161424,-1,,
5365757268,479.62363,7743412025,480429032,7743411998,-27,,
5366007778,479.87414,7743662534,480679541,7743662495,-39,,
5366257989,480.12435,7743912744,480929751,7743912705,-39,,
5366508158,480.37452,7744162911,481179918,7744162872,-39,,
5366758351,480.62471,7744413105,481430111,7744413066,-39,,
5366899875,480.76624,7744554628,481571634,7744554588,-40,7744554662,
5367025429,480.89179,7744680190,481697197,7744680160,-30,,
5367275806,481.14217,7744930558,481947565,7744930547,-11,,
5367526342,481.39270,7745181092,482198099,7745181100,8,,
5367776482,481.64284,7745431232,482448239,7745431259,27,,
5368026626,481.89299,7745681375,482698381,7745681410,35,,
5368276905,482.14327,7745931654,482948661,7745931701,47,,
5368527061,482.39342,7746181808,483198815,7746181845,37,,
5368777643,482.64400,7746432390,483449396,7746432426,36,,
5368919135,482.78550,7746573879,483590886,7746573915,36,7746573928,
5369044225,482.91059,7746698971,483715978,7746699008,37,,
5369294546,483.16091,7746949290,483966296,7746949330,40,,
5369544852,483.41121,7747199596,484216602,7747199640,44,,
5369795825,483.66219,7747450568,484467575,7747450616,48,,
5370046236,483.91260,7747700977,484717984,7747701027,50,,
5370296393,484.16275,7747951134,484968141,7747951184,50,,
5370546754,484.41312,7748201495,485218502,7748201555,60,,
5370797236,484.66360,7748451975,485468983,7748452026,51,,
5370938313,484.80467,7748593051,485610057,7748593100,49,7748593138,
5371063403,484.92976,7748718141,485735147,7748718195,54,,
5371313557,485.17992,7748968294,485985301,7748968359,65,,
5371563680,485.43004,7749218416,486235423,7749218490,74,,
5371813805,485.68017,7749468540,486485547,7749468624,84,,
5372063933,485.93029,7749718667,486735683,7749718766,99,,
5372314063,486.18042,7749968796,486985802,7749968885,89,,
5372564538,486.43090,7750219280,487236287,7750219369,89,,
5372814856,486.68122,7750469589,487486595,7750469678,89,,
5372955993,486.82235,7750610723,487627730,7750610812,89,7750610763,
5373081040,486.94740,7750735770,487752777,7750735854,84,,
5373331573,487.19793,7750986304,488003310,7750986376,72,,
5373581724,487.44808,7751236452,488253459,7751236513,61,,
5373831878,487.69824,7751486606,488503613,7751486654,48,,
5374082902,487.94926,7751737630,488754637,7751737672,42,,
5374333094,488.19946,7751987820,489004827,7751987863,43,,
5374583247,488.44961,7752237972,489254979,7752238015,43,,
5374833383,488.69974,7752488107,489505113,7752488149,42,,
5374974647,488.84101,7752629371,489646377,7752629412,41,7752629407,
5375099702,488.96606,7752754425,489771432,7752754466,41,,
5375349797,489.21616,7753004520,490021526,7753004560,40,,
5375599930,489.46629,7753254653,490271660,7753254692,39,,
5375850235,489.71660,7753504957,490521964,7753504995,38,,
5376100362,489.96672,7753755082,490772089,7753755120,38,,
5376351024,490.21738,7754005744,491022751,7754005782,38,,
5376601182,490.46754,7754255900,491272906,7754255938,38,,
5376851497,490.71786,7754506215,491523221,7754506253,38,,
5376992698,490.85906,7754647414,491664420,7754647452,38,7754647464,
5377117895,490.98426,7754772611,491789618,7754772651,40,,
5377368067,491.23443,7755022783,492039789,7755022827,44,,
5377618216,491.48458,7755272930,492289937,7755272977,47,,
5377868389,491.73475,7755523104,492540111,7755523155,51,,
5378118843,491.98520,7755773556,492790563,7755773608,52,,
5378369125,492.23549,7756023837,493040844,7756023890,53,,
5378619434,492.48579,7756274146,493291153,7756274198,52,,
5378870332,492.73669,7756525043,493542049,7756525095,52,,
5379011441,492.87780,7756666150,493683156,7756666201,51,7756666208,
5379136513,493.00287,7756791222,493808229,7756791275,53,,
5379387092,493.25345,7757041801,494058808,7757041856,55,,
5379637228,493.50359,7757291935,494308942,7757291992,57,,
5379887444,493.75380,7757542150,494559157,7757542209,59,,
5380137812,494.00417,7757792517,494809524,7757792577,60,,
5380388470,494.25483,7758043175,495060182,7758043235,60,,
5380638991,494.50535,7758293695,495310702,7758293755,60,,
5380889616,494.75598,7758544320,495561327,7758544380,60,,
5381031483,494.89784,7758686184,495703191,7758686244,60,7758686416,
5381156622,495.02298,7758811324,495828331,7758811405,81,,
5381406736,495.27310,7759061438,496078445,7759061563,125,,
5381656885,495.52325,7759311585,496328591,7759311753,168,,
5381907448,495.77381,7759562148,496579154,7759562360,212,,
5382157622,496.02398,7759812320,496829327,7759812553,233,,
5382408156,496.27452,7760062854,497079860,7760063087,233,,
5382658259,496.52462,7760312954,497329961,7760313187,233,,
5382908575,496.77494,7760563272,497580278,7760563505,233,,
5383050220,496.91658,7760704915,497721921,7760705148,233,7760704705,
5383175761,497.04212,7760830456,497847463,7760830633,177,,
5383425914,497.29228,7761080609,498097615,7761080676,67,,
5383676382,497.54274,7761331076,498348083,7761331033,-43,,
5383926529,497.79289,7761581222,498598229,7761581069,-153,,
5384176655,498.04302,7761831347,498848354,7761831139,-208,,
5384426796,498.29316,7762081487,499098493,7762081279,-208,,
5384677098,498.54346,7762331787,499348794,7762331579,-208,,
5384927520,498.79388,7762582209,499599226,7762582012,-197,,
5385068810,498.93517,7762723497,499740504,7762723289,-208,7762723586,
5385194399,499.06076,7762849086,499866093,7762848916,-170,,
5385444784,499.31115,7763099472,500116478,7763099376,-96,,
5385694949,499.56131,7763349636,500366642,7763349615,-21,,
5385945135,499.81150,7763599819,500616826,7763599872,53,,
5386195397,500.06176,7763850081,500867088,7763850171,90,,
5386445535,500.31190,7764100217,501117224,7764100307,90,,
5386695641,500.56200,7764350323,501367330,7764350414,91,,
5386945798,500.81216,7764600479,501617486,7764600569,90,,
5387087041,500.95340,7764741721,501758728,7764741811,90,7764741834,
5387212111,501.07847,7764866791,501883798,7764866884,93,,
5387462340,501.32870,7765117019,502134026,7765117117,98,,
5387712751,501.57911,7765367430,502384437,7765367536,106,,
5387962848,501.82921,7765617526,502634533,7765617637,111,,
5388213449,502.07981,7765868127,502885134,7765868242,115,,
5388464064,502.33042,7766118741,503135748,7766118856,115,,
5388714222,502.58058,7766368897,503385904,7766369013,116,,
5388964771,502.83113,7766619445,503636452,7766619561,116,,
5389106114,502.97247,7766760787,503777793,7766760902,115,7766760774,
5389231210,503.09757,7766885884,503902891,7766885983,99,,
5389481339,503.34770,7767136011,504153017,7767136079,68,,
5389731499,503.59786,7767386170,504403177,7767386206,36,,
5389981621,503.84798,7767636292,504653299,7767636297,5,,
5390231725,504.09809,7767886396,504903403,7767886385,-11,,
5390481879,504.34824,7768136549,505153556,7768136539,-10,,
5390732047,504.59841,7768386715,505403722,7768386705,-10,,
5390982301,504.84866,7768636968,505653974,7768636957,-11,,
5391123533,504.98989,7768778198,505795205,7768778187,-11,7768778266,
5391248914,505.11527,7768903589,505920596,7768903588,-1,,
5391499409,505.36577,7769154074,506171081,7769154093,19,,
5391749585,505.61595,7769404250,506421256,7769404289,39,,
5391999749,505.86611,7769654423,506671429,7769654481,58,,
5392249932,506.11629,7769904595,506921602,7769904664,69,,
5392500185,506.36655,7770154846,507171852,7770154915,69,,
5392750351,506.61671,7770405012,507422019,7770405081,69,,
5393000524,506.86689,7770655195,507672201,7770655264,69,,
5393141973,507.00833,7770796631,507813638,7770796700,69,7770796719,
5393267063,507.13342,7770921722,507938729,7770921794,72,,
5393517354,507.38371,7771172012,508189019,7771172089,77,,
5393767974,507.63434,7771422632,508439639,7771422715,83,,
5394018137,507.88450,7771672793,508689799,7771672880,87,,
5394268258,508.13462,7771922914,508939920,7771923004,90,,
5394518422,508.38478,7772173076,509190083,7772173167,91,,
5394769100,508.63546,7772423754,509440761,7772423844,90,,
5395019382,508.88574,7772674035,509691042,7772674125,90,,
5395170126,509.03649,7772824777,509841783,7772824867,90,7772828802,
5395295243,509.16160,7772949895,509966902,7772950478,583,,
5395545379,509.41174,7773200029,510217036,7773201596,1567,,
5395795902,509.66226,7773450552,510467558,7773453105,2553,,
5396046445,509.91281,7773701094,510718101,7773704634,3540,,
5396296570,510.16293,7773951218,510968225,7773955245,4027,,
5396547157,510.41352,7774201814,511218820,7774205841,4027,,
5396797270,510.66363,7774451916,511468923,7774455943,4027,,
5397047405,510.91377,7774702050,511719057,7774706077,4027,,
5397188833,511.05519,7774843477,511860484,7774847504,4027,7774843677,
5397313903,511.18026,7774968548,511985555,7774972095,3547,,
5397564263,511.43062,7775218906,512235913,7775221496,2590,,
5397814767,511.68113,7775469411,512486418,7775471053,1642,,
5398064929,511.93129,7775719571,512736577,7775720246,675,,
5398315427,512.18179,7775970068,512987075,7775970269,201,,
5398566110,512.43247,7776220750,513237756,7776220951,201,,
5398816238,512.68260,7776470877,513487884,7776471079,202,,
5399066402,512.93276,7776721040,513738047,7776721242,202,,
5399207952,513.07431,7776862590,513879596,7776862791,201,7776862701,
5399333267,513.19963,7776987905,514004911,7776988095,190,,
5399583686,513.45005,7777238322,514255329,7777238490,168,,
5399833852,513.70021,7777488487,514505493,7777488633,146,,
5400083980,513.95034,7777738615,514755621,7777738739,124,,
5400334568,514.20093,7777989203,515006210,7777989316,113,,
5400585039,514.45140,7778239672,515256678,7778239785,113,,
5400835672,514.70203,7778490305,515507312,7778490428,123,,
5401086230,514.95259,7778740861,515757868,7778740974,113,,
5401227537,515.09390,7778882166,515899173,7778882279,113,7778882282,
5401352800,515.21916,7779007430,516024437,7779007544,114,,
5401603392,515.46975,7779258022,516275028,7779258137,115,,
5401854349,515.72071,7779508977,516525984,7779509095,118,,
5402104479,515.97084,7779759106,516776113,7779759224,118,,
5402354587,516.22095,7780009213,517026220,7780009331,118,,
5402604723,516.47108,7780259348,517276354,7780259466,118,,
5402854872,516.72123,7780509498,517526504,7780509616,118,,
5403105015,516.97138,7780759639,517776646,7780759757,118,,
5403246485,517.11285,7780901107,517918113,7780901225,118,7780901203,
5403371561,517.23792,7781026184,518043191,7781026298,114,,
5403621818,517.48818,7781276440,518293447,7781276549,109,,
5403871947,517.73831,7781526568,518543575,7781526672,104,,
5404122075,517.98844,7781776696,518793703,7781776795,99,,
5404372200,518.23856,7782026819,519043826,7782026916,97,,
5404622667,518.48903,7782277286,519294293,7782277383,97,,
5404872820,518.73918,7782527438,519544444,7782527535,97,,
5405123405,518.98977,7782778023,519795030,7782778120,97,,
5405264761,519.13112,7782919376,519936382,7782919473,97,7782919379,
5405390330,519.25669,7783044947,520061954,7783045033,86,,
5405640471,519.50683,7783295086,520312093,7783295149,63,,
5405890835,519.75720,7783545450,520562457,7783545489,39,,
5406141009,520.00737,7783795623,520812630,7783795639,16,,
5406391323,520.25768,7784045936,521062942,7784045941,5,,
5406641664,520.50802,7784296275,521313282,7784296281,6,,
5406891881,520.75824,7784546491,521563498,7784546497,6,,
5407142683,521.00904,7784797293,521814300,7784797298,5,,
5407283824,521.15018,7784938432,521955439,7784938437,5,7784938424,
5407408894,521.27526,7785063502,522080509,7785063507,5,,
5407659401,521.52576,7785314008,522331015,7785314009,1,,
5407909510,521.77587,7785564127,522581134,7785564126,-1,,
5408159688,522.02605,7785814294,522831301,7785814291,-3,,
5408409828,522.27619,7786064433,523081440,7786064428,-5,,
5408660423,522.52678,7786315028,523332045,7786315033,5,,
5408910857,522.77722,7786565460,523582467,7786565454,-6,,
5409160999,523.02736,7786815602,523832609,7786815596,-6,,
5409302763,523.16912,7786957364,523974371,7786957358,-6,7786957407,
5409427878,523.29424,7787082479,524099485,7787082478,-1,,
5409678377,523.54474,7787332977,524349984,7787332989,12,,
5409928978,523.79534,7787583578,524600585,7787583603,25,,
5410179385,524.04575,7787833984,524850991,7787834021,37,,
5410429531,524.29589,7788084130,525101137,7788084174,44,,
5410679787,524.54615,7788334385,525351392,7788334440,55,,
5410929965,524.79633,7788584561,525601568,7788584605,44,,
5411180078,525.04644,7788834673,525851679,7788834717,44,,
5411321966,525.18833,7788976559,525993565,7788976603,44,7788976459,
5411447333,525.31369,7789101927,526118934,7789101952,25,,
5411697451,525.56381,7789352045,526369051,7789352035,-10,,
5411947619,525.81398,7789602212,526619219,7789602166,-46,,
5412197754,526.06412,7789852345,526869352,7789852264,-81,,
5412447899,526.31426,7790102489,527119495,7790102390,-99,,
5412698019,526.56438,7790352609,527369615,7790352510,-99,,
5412948166,526.81453,7790602756,527619763,7790602657,-99,,
5413198313,527.06467,7790852902,527869919,7790852813,-89,,
5413339522,527.20588,7790994108,528011115,7790994009,-99,7790994159,
5413464601,527.33096,7791119188,528136195,7791119108,-80,,
5413714746,527.58111,7791369332,528386339,7791369290,-42,,
5413964878,527.83124,7791619463,528636470,7791619458,-5,,
5414215013,528.08137,7791869598,528886604,7791869631,33,,
5414465182,528.33154,7792119766,529136773,7792119818,52,,
5414715418,528.58178,7792370001,529387008,7792370064,63,,
5414965940,528.83230,7792620521,529637528,7792620573,52,,
5415216177,529.08254,7792870758,529887765,7792870811,53,,
5415357288,529.22365,7793011867,530028874,7793011919,52,7793011882,
5415482835,529.34920,7793137416,530154423,7793137464,48,,
5415732999,529.59936,7793387579,530404586,7793387618,39,,
5415983172,529.84953,7793637750,530654757,7793637780,30,,
5416233318,530.09968,7793887896,530904902,7793887916,20,,
5416483553,530.34991,7794138128,531155135,7794138145,17,,
5416734182,530.60054,7794388757,531405763,7794388773,16,,
5416984304,530.85067,7794638878,531655885,7794638895,17,,
5417234457,531.10082,7794889030,531906036,7794889046,16,,
5417375814,531.24217,7795030387,532047393,7795030402,15,7795030315,
5417500890,531.36725,7795155463,532172469,7795155466,3,,
5417751079,531.61744,7795405650,532422657,7795405633,-17,,
5418001228,531.86759,7795655799,532672806,7795655761,-38,,
5418251416,532.11778,7795905986,532922993,7795905927,-59,,
5418502346,532.36871,7796156915,533173922,7796156845,-70,,
5418752503,532.61886,7796407071,533424078,7796407001,-70,,
5419003050,532.86941,7796657617,533674624,7796657547,-70,,
5419253182,533.11954,7796907748,533924755,7796907678,-70,,
5419394430,533.26079,7797048995,534066001,7797048925,-70,7797049080,
5419519959,533.38632,7797174525,534191531,7797174474,-51,,
5419770100,533.63646,7797424665,534441682,7797424664,-1,,
5420020279,533.88664,7797674842,534691849,7797674870,28,,
5420270831,534.13719,7797925395,534942402,7797925464,69,,
5420521437,534.38780,7798176000,535193006,7798176087,87,,
5420771596,534.63796,7798426157,535443164,7798426245,88,,
5421022036,534.88840,7798676596,535693603,7798676683,87,,
5421272183,535.13854,7798926742,535943749,7798926829,87,,
5421413551,535.27991,7799068110,536085116,7799068196,86,7799068155,
5421538890,535.40525,7799193448,536210455,7799193529,81,,
5421789043,535.65540,7799443600,536460607,7799443672,72,,
5422039218,535.90558,7799693785,536710791,7799693846,61,,
5422289415,536.15578,7799943971,536960977,7799944023,52,,
5422539578,536.40594,7800194134,537211140,7800194181,47,,
5422789762,536.65612,7800444316,537461323,7800444363,47,,
5423039892,536.90625,7800694446,537711452,7800694493,47,,
5423290434,537.15679,7800944986,537961993,7800945034,48,,
5423431758,537.29812,7801086308,538103314,7801086355,47,7801086329,
5423556815,537.42318,7801211365,538228372,7801211409,44,,
5423807475,537.67384,7801462027,538479034,7801462064,37,,
5424057851,537.92421,7801712403,538729410,7801712435,32,,
5424308079,538.17444,7801962627,538979634,7801962652,25,,
5424558330,538.42469,7802212877,539229884,7802212901,24,,
5424808751,538.67511,7802463297,539480304,7802463321,24,,
5425059331,538.92569,7802713877,539730884,7802713901,24,,
5425309628,539.17599,7802964175,539981182,7802964199,24,,
5425450968,539.31733,7803105511,540122518,7803105534,23,7803105398,
5425576051,539.44241,7803230595,540247602,7803230602,7,,
5425826219,539.69258,7803480763,540497770,7803480735,-28,,
5426076406,539.94277,7803730949,540747956,7803730888,-61,,
5426326817,540.19318,7803981358,540998365,7803981264,-94,,
5426576954,540.44331,7804231494,541248500,7804231383,-111,,
5426827857,540.69422,7804482396,541499403,7804482285,-111,,
5427078335,540.94470,7804732874,541749881,7804732763,-111,,
5427328619,541.19498,7804983156,542000163,7804983045,-111,,
5427472782,541.33914,7805127319,542144325,7805127207,-112,7805126004,
5427598364,541.46473,7805252902,542269908,7805252639,-263,,
5427848539,541.71490,7805503076,542520082,7805502512,-564,,
5428099128,541.96549,7805753663,542770670,7805752798,-865,,
5428349589,542.21595,7806004124,543021131,7806002959,-1165,,
5428599700,542.46606,7806254233,543271240,7806252920,-1313,,
5428849809,542.71617,7806504341,543521348,7806503028,-1313,,
5429100467,542.96683,7806754998,543772005,7806753685,-1313,,
5429350736,543.21710,7807005267,544022274,7807003954,-1313,,
5429492004,543.35837,7807146533,544163539,7807145220,-1313,7807146609,
5429617454,543.48382,7807271983,544288990,7807270856,-1127,,
5429868049,543.73441,7807522578,544539585,7807521789,-789,,
5430118538,543.98490,7807773066,544790073,7807772625,-441,,
5430368901,544.23526,7808023429,545040435,7808023336,-93,,
5430619415,544.48578,7808273942,545290948,7808274020,78,,
5430869545,544.73591,7808524071,545541078,7808524149,78,,
5431119865,544.98623,7808774390,545791396,7808774468,78,,
5431369995,545.23636,7809024519,546041526,7809024608,89,,
5431511148,545.37751,7809165671,546182677,7809165748,77,7809165713,
5431636203,545.50256,7809290725,546307732,7809290799,74,,
5431886349,545.75271,7809540870,546557877,7809540936,66,,
5432136483,546.00284,7809791004,546808010,7809791060,56,,
5432386960,546.25332,7810041480,547058486,7810041528,48,,
5432637119,546.50348,7810291639,547308645,7810291683,44,,
5432887295,546.75366,7810541814,547558821,7810541858,44,,
5433137446,547.00381,7810791963,547808970,7810792007,44,,
5433387909,547.25427,7811042425,548059432,7811042469,44,,
5433529120,547.39548,7811183635,548200641,7811183678,43,7811183681,
5433654347,547.52071,7811308862,548325869,7811308907,45,,
5433904526,547.77089,7811559040,548576047,7811559085,45,,
5434154820,548.02118,7811809333,548826340,7811809379,46,,
5434404953,548.27131,7812059466,549076473,7812059513,47,,
5434655069,548.52143,7812309580,549326587,7812309628,48,,
5434905644,548.77201,7812560155,549577172,7812560214,59,,
5435156046,549.02241,7812810556,549827563,7812810605,49,,
5435406353,549.27271,7813060863,550077870,7813060911,48,,
WARN: A server response timed out.
5436031600,549.89796,7813686105,550703112,7813686153,48,,
5436047800,549.91416,7813702305,550719311,7813702352,47,7813702389,
5436298146,550.16451,7813952652,550969660,7813952710,58,,
5436548710,550.41507,7814203215,551220222,7814203283,68,,
5436798846,550.66521,7814453351,551470358,7814453427,76,,
5437049256,550.91562,7814703760,551720767,7814703846,86,,
5437299426,551.16579,7814953928,551970935,7814954015,87,,
5437549579,551.41594,7815204080,552221087,7815204166,86,,
5437800181,551.66654,7815454682,552471699,7815454779,97,,
5438050332,551.91669,7815704831,552721837,7815704917,86,,
5438066316,551.93268,7815720814,552737820,7815720900,86,7815720946,
5438316452,552.18281,7815970951,552987957,7815971049,98,,
5438566733,552.43309,7816221230,553238236,7816221340,110,,
5438816869,552.68323,7816471367,553488373,7816471489,122,,
5439067374,552.93373,7816721871,553738878,7816722005,134,,
5439317542,553.18390,7816972037,553989044,7816972172,135,,
5439567675,553.43404,7817222170,554239176,7817222304,134,,
5439817845,553.68421,7817472338,554489345,7817472472,134,,
5440067993,553.93435,7817722485,554739492,7817722619,134,,
5440084087,553.95045,7817738579,554755585,7817738712,133,7817738651,
5440334353,554.20071,7817988845,555005851,7817988964,119,,
5440584978,554.45134,7818239478,555256484,7818239582,104,,
5440835427,554.70179,7818489917,555506924,7818490006,89,,
5441085683,554.95204,7818740172,555757179,7818740246,74,,
5441336048,555.20241,7818990537,556007544,7818990611,74,,
5441586499,555.45286,7819240986,556257993,7819241061,75,,
5441836730,555.70309,7819491216,556508223,7819491290,74,,
5442086883,555.95324,7819741368,556758375,7819741443,75,,
5442103110,555.96947,7819757595,556774601,7819757669,74,7819757673,
5442353252,556.21961,7820007737,557024754,7820007823,86,,
5442603597,556.46996,7820258080,557275087,7820258157,77,,
5442853749,556.72011,7820508231,557525238,7820508310,79,,
5443104285,556.97065,7820758767,557775773,7820758857,90,,
5443354413,557.22077,7821008894,558025901,7821008974,80,,
5443604648,557.47101,7821259129,558276136,7821259209,80,,
5443854846,557.72121,7821509325,558526331,7821509405,80,,
5444105475,557.97184,7821759953,558776960,7821760034,81,,
5444121718,557.98808,7821776196,558793202,7821776276,80,7821776335,
5444371916,558.23828,7822026394,559043401,7822026489,95,,
5444622297,558.48866,7822276773,559293779,7822276883,110,,
5444872907,558.73927,7822527382,559544389,7822527509,127,,
5445123432,558.98979,7822777906,559794913,7822778047,141,,
5445374082,559.24044,7823028556,560045562,7823028697,141,,
5445624497,559.49086,7823278969,560295976,7823279111,142,,
5445875095,559.74146,7823529567,560546573,7823529708,141,,
5446125227,559.99159,7823779698,560796705,7823779839,141,,
5446141328,560.00769,7823795797,560812804,7823795938,141,7823795827,
5446392014,560.25838,7824046485,561063492,7824046598,113,,
5446642261,560.50862,7824296731,561313737,7824296817,86,,
5446892408,560.75877,7824546877,561563883,7824546936,59,,
5447142574,561.00893,7824797041,561814048,7824797072,31,,
5447392713,561.25907,7825047180,562064186,7825047211,31,,
5447642851,561.50921,7825297316,562314323,7825297347,31,,
5447892972,561.75933,7825547437,562564444,7825547468,31,,
5448143504,562.00986,7825797967,562814974,7825797999,32,,
5448159753,562.02611,7825814216,562831222,7825814247,31,7825814272,
5448409966,562.27633,7826064428,563081435,7826064466,38,,
5448660105,562.52647,7826314567,563331573,7826314612,45,,
5448910595,562.77696,7826565057,563582064,7826565119,62,,
5449160752,563.02711,7826815213,563832220,7826815271,58,,
5449411420,563.27778,7827065878,564082885,7827065937,59,,
5449662348,563.52871,7827316806,564333813,7827316864,58,,
5449912967,563.77933,7827567425,564584432,7827567483,58,,
5450163145,564.02951,7827817601,564834608,7827817659,58,,
5450179235,564.04560,7827833691,564850697,7827833748,57,7827833776,
5450429510,564.29587,7828083965,565100972,7828084029,64,,
5450680093,564.54645,7828334547,565351553,7828334619,72,,
5450930177,564.79654,7828584630,565601637,7828584709,79,,
5451180327,565.04669,7828834781,565851788,7828834868,87,,
5451430529,565.29689,7829084981,566101988,7829085068,87,,
5451680662,565.54702,7829335113,566352120,7829335200,87,,
5451931088,565.79745,7829585538,566602545,7829585625,87,,
5452181233,566.04759,7829835682,566852689,7829835769,87,,
5452198037,566.06440,7829852485,566869491,7829852572,87,7829852228,
5452448550,566.31491,7830102998,567120016,7830103009,11,,
5452698699,566.56506,7830353146,567370153,7830353061,-85,,
5452948868,566.81523,7830603314,567620320,7830603143,-171,,
5453198992,567.06535,7830853437,567870444,7830853182,-255,,
5453449484,567.31584,7831103929,568120936,7831103673,-256,,
5453699753,567.56611,7831354198,568371205,7831353943,-255,,
5453950325,567.81669,7831604768,568621775,7831604512,-256,,
5454200938,568.06730,7831855381,568872387,7831855125,-256,,
5454217288,568.08365,7831871729,568888735,7831871473,-256,7831871631,
5454467428,568.33379,7832121869,569138876,7832121653,-216,,
5454717538,568.58390,7832371978,569388985,7832371802,-176,,
5454967679,568.83404,7832622118,569639134,7832621991,-127,,
5455217879,569.08424,7832872318,569889325,7832872222,-96,,
5455468057,569.33442,7833122494,570139501,7833122399,-95,,
5455718624,569.58498,7833373060,570390067,7833372964,-96,,
5455968770,569.83513,7833623206,570640212,7833623110,-96,,
5456218863,570.08522,7833873298,570890305,7833873202,-96,,
5456234938,570.10130,7833889372,570906378,7833889276,-96,7833889429,
5456485069,570.35143,7834139503,571156509,7834139446,-57,,
5456735348,570.60171,7834389781,571406787,7834389763,-18,,
5456985993,570.85235,7834640426,571657432,7834640447,21,,
5457236142,571.10250,7834890574,571907581,7834890633,59,,
5457486344,571.35271,7835140775,572157782,7835140844,69,,
5457736473,571.60283,7835390902,572407909,7835390961,59,,
5457986780,571.85314,7835641209,572658216,7835641268,59,,
5458236889,572.10325,7835891317,572908323,7835891376,59,,
5458253105,572.11947,7835907532,572924538,7835907591,59,7835907523,
5458503571,572.36993,7836157998,573175005,7836158041,43,,
5458753721,572.62008,7836408147,573425154,7836408172,25,,
5459004122,572.87048,7836658547,573675555,7836658557,10,,
5459254341,573.12070,7836908766,573925772,7836908759,-7,,
5459504490,573.37085,7837158914,574175920,7837158906,-8,,
5459754599,573.62096,7837409021,574426028,7837409014,-7,,
5460004743,573.87110,7837659163,574676170,7837659156,-7,,
5460254937,574.12130,7837909358,574926364,7837909350,-8,,
5460271169,574.13753,7837925589,574942595,7837925581,-8,7837925720,
5460521797,574.38816,7838176216,575193223,7838176243,27,,
5460771958,574.63832,7838426377,575443384,7838426440,63,,
5461022326,574.88869,7838676744,575693751,7838676842,98,,
5461272937,575.13930,7838927355,575944362,7838927488,133,,
5461523428,575.38979,7839177844,576194851,7839177978,134,,
5461774081,575.64044,7839428496,576445503,7839428629,133,,
5462024510,575.89087,7839678925,576695932,7839679058,133,,
5462274692,576.14105,7839929105,576946112,7839929238,133,,
5462290818,576.15718,7839945230,576962236,7839945363,133,7839945311,
5462540958,576.40732,7840195370,577212378,7840195491,121,,
5462791238,576.65760,7840445649,577462655,7840445756,107,,
5463041524,576.90788,7840695934,577712941,7840696030,96,,
5463291667,577.15803,7840946076,577963083,7840946159,83,,
5463541810,577.40817,7841196219,578213226,7841196302,83,,
5463791949,577.65831,7841446357,578463364,7841446441,84,,
5464042762,577.90912,7841697169,578714175,7841697252,83,,
5464292910,578.15927,7841947317,578964324,7841947400,83,,
5464309255,578.17562,7841963661,578980667,7841963743,82,7841963642,
5464559372,578.42573,7842213778,579230784,7842213835,57,,
5464809893,578.67625,7842464298,579481305,7842464330,32,,
5465060126,578.92649,7842714529,579731536,7842714537,8,,
5465310331,579.17669,7842964734,579981740,7842964717,-17,,
5465560689,579.42705,7843215090,580232096,7843215073,-17,,
5465810846,579.67721,7843465246,580482252,7843465229,-17,,
5466061436,579.92780,7843715836,580732843,7843715819,-17,,
5466312409,580.17877,7843966808,580983815,7843966791,-17,,
5466328592,580.19495,7843982990,580999997,7843982973,-17,7843983061,
5466578774,580.44514,7844233172,581250179,7844233177,5,,
5466828930,580.69529,7844483328,581500335,7844483356,28,,
5467079095,580.94546,7844733492,581750499,7844733542,50,,
5467329644,581.19601,7844984040,582001047,7844984113,73,,
5467579988,581.44635,7845234381,582251388,7845234455,74,,
5467830593,581.69695,7845484986,582501992,7845485059,73,,
5468080863,581.94722,7845735255,582752262,7845735328,73,,
5468331427,582.19779,7845985819,583002826,7845985893,74,,
5468347667,582.21403,7846002058,583019064,7846002130,72,7846002128,
5468598148,582.46451,7846252539,583269546,7846252612,73,,
5468848310,582.71467,7846502700,583519707,7846502772,72,,
5469098442,582.96480,7846752832,583769838,7846752904,72,,
5469348627,583.21499,7847003016,584020022,7847003088,72,,
5469599137,583.46550,7847253525,584270531,7847253597,72,,
5469849271,583.71563,7847503658,584520665,7847503730,72,,
5470099577,583.96594,7847753962,584770969,7847754034,72,,
5470349741,584.21610,7848004126,585021133,7848004198,72,,
5470365863,584.23222,7848020247,585037253,7848020319,72,7848020337,
5470616011,584.48237,7848270394,585287401,7848270471,77,,
5470866159,584.73252,7848520541,585537548,7848520623,82,,
5471116459,584.98282,7848770841,585787847,7848770928,87,,
5471366619,585.23298,7849021001,586038008,7849021093,92,,
5471617095,585.48346,7849271475,586288482,7849271567,92,,
5471867566,585.73393,7849521946,586538952,7849522038,92,,
5472117701,585.98406,7849772080,586789087,7849772172,92,,
5472367852,586.23421,7850022230,587039236,7850022322,92,,
5472383950,586.25031,7850038327,587055333,7850038418,91,7850038400,
5472634531,586.50089,7850288908,587305915,7850288995,87,,
5472884689,586.75105,7850539065,587556072,7850539148,83,,
5473134831,587.00119,7850789206,587806213,7850789285,79,,
5473384972,587.25133,7851039347,588056354,7851039422,75,,
5473635411,587.50177,7851289784,588306791,7851289859,75,,
5473885565,587.75193,7851539937,588556945,7851540013,76,,
5474135735,588.00210,7851790106,588807113,7851790181,75,,
5474385879,588.25224,7852040249,589057256,7852040325,76,,
5474402004,588.26837,7852056373,589073379,7852056448,75,7852056419,
5474652103,588.51846,7852306472,589323479,7852306541,69,,
5474902349,588.76871,7852556718,589573724,7852556779,61,,
5475152499,589.01886,7852806867,589823873,7852806922,55,,
5475403129,589.26949,7853057496,590074503,7853057545,49,,
5475653271,589.51963,7853307636,590324643,7853307685,49,,
5475903777,589.77014,7853558143,590575150,7853558191,48,,
5476153936,590.02030,7853808300,590825306,7853808347,47,,
5476404063,590.27042,7854058426,591075433,7854058474,48,,
5476420300,590.28666,7854074662,591091668,7854074710,48,7854074785,
5476670458,590.53682,7854324820,591341827,7854324887,67,,
5476920918,590.78728,7854575280,591592287,7854575367,87,,
5477171384,591.03774,7854825744,591842750,7854825850,106,,
5477421641,591.28800,7855076001,592093008,7855076126,125,,
5477671798,591.53816,7855326156,592343163,7855326281,125,,
5477921912,591.78827,7855576270,592593276,7855576395,125,,
5478172047,592.03841,7855826403,592843410,7855826529,126,,
5478422481,592.28884,7856076838,593093854,7856076973,135,,
5478438500,592.30486,7856092856,593109862,7856092981,125,7856092888,
5478688671,592.55503,7856343027,593360033,7856343128,101,,
5478938795,592.80516,7856593149,593610156,7856593228,79,,
5479189326,593.05569,7856843679,593860686,7856843737,58,,
5479439928,593.30629,7857094281,594111288,7857094315,34,,
5479690461,593.55682,7857344813,594361820,7857344847,34,,
5479940617,593.80698,7857594968,594611975,7857595002,34,,
5480190789,594.05715,7857845139,594862145,7857845173,34,,
5480440958,594.30732,7858095306,595112313,7858095341,35,,
5480457308,594.32367,7858111655,595128661,7858111688,33,7858111690,
5480707902,594.57426,7858362249,595379255,7858362284,35,,
5480958474,594.82484,7858612821,595629828,7858612858,37,,
5481208627,595.07499,7858862973,595879980,7858863011,38,,
5481459144,595.32551,7859113489,596130496,7859113526,37,,
5481709748,595.57611,7859364091,596381098,7859364128,37,,
5481960097,595.82646,7859614441,596631448,7859614478,37,,
5482210265,596.07663,7859864608,596881615,7859864645,37,,
5482460918,596.32728,7860115259,597132266,7860115296,37,,
5482477471,596.34383,7860131811,597148818,7860131848,37,7860131753,
5482728107,596.59447,7860382447,597399453,7860382460,13,,
5482978266,596.84463,7860632605,597649612,7860632596,-9,,
5483228400,597.09476,7860882739,597899746,7860882705,-34,,
5483478530,597.34489,7861132868,598149875,7861132811,-57,,
5483728720,597.59508,7861383058,598400065,7861383001,-57,,
5483978901,597.84526,7861633237,598650244,7861633181,-56,,
5484229096,598.09546,7861883431,598900438,7861883374,-57,,
5484479206,598.34557,7862133540,599150547,7862133483,-57,,
5484495181,598.36154,7862149515,599166521,7862149457,-58,7862149609,
5484745334,598.61170,7862399667,599416674,7862399647,-20,,
5484995495,598.86186,7862649827,599666834,7862649846,19,,
5485245644,599.11200,7862899975,599916981,7862900032,57,,
5485495803,599.36216,7863150134,600167140,7863150230,96,,
5485745948,599.61231,7863400279,600417285,7863400375,96,,
5485996361,599.86272,7863650690,600667697,7863650786,96,,
5486246508,600.11287,7863900836,600917843,7863900932,96,,
5486496650,600.36301,7864150988,601167994,7864151084,96,,
5486512861,600.37922,7864167187,601184194,7864167283,96,7864167185,
5486763371,600.62973,7864417697,601434704,7864417769,72,,
5487013879,600.88024,7864668205,601685211,7864668252,47,,
5487264022,601.13038,7864918347,601935353,7864918381,34,,
5487514187,601.38055,7865168510,602185516,7865168510,0,,
5487764317,601.63068,7865418639,602435646,7865418639,0,,
5488014455,601.88082,7865668777,602685783,7865668777,0,,
5488264603,602.13096,7865918924,602935931,7865918924,0,,
5488514743,602.38110,7866169063,603186070,7866169064,1,,
5488530957,602.39732,7866185276,603202283,7866185276,0,7866185382,
5488781107,602.64747,7866435426,603452433,7866435453,27,,
5489031236,602.89760,7866685554,603702561,7866685607,53,,
5489281375,603.14774,7866935693,603952700,7866935773,80,,
5489531745,603.39811,7867186061,604203067,7867186168,107,,
5489782145,603.64851,7867436460,604453467,7867436567,107,,
5490032309,603.89867,7867686623,604703629,7867686730,107,,
5490282683,604.14904,7867936997,604954004,7867937104,107,,
5490532849,604.39921,7868187161,605204168,7868187268,107,,
5490553529,604.41989,7868207840,605224846,7868207947,107,7868208048,
5490803704,604.67007,7868458016,605475023,7868458148,132,,
5491054346,604.92071,7868708657,605725663,7868708815,158,,
5491304905,605.17127,7868959216,605976222,7868959401,185,,
5491555413,605.42177,7869209722,606226728,7869209932,210,,
5491806058,605.67242,7869460365,606477372,7869460575,210,,
5492056366,605.92273,7869710673,606727680,7869710884,211,,
5492306553,606.17291,7869960859,606977866,7869961070,211,,
5492556705,606.42307,7870211010,607228017,7870211221,211,,
5492572945,606.43931,7870227249,607244255,7870227459,210,7870227269,
5492823079,606.68944,7870477383,607494390,7870477547,164,,
5493073249,606.93961,7870727553,607744560,7870727670,117,,
5493323648,607.19001,7870977952,607994959,7870978021,69,,
5493573795,607.44016,7871228097,608245104,7871228119,22,,
5493823959,607.69032,7871478261,608495268,7871478283,22,,
5494074081,607.94044,7871728382,608745388,7871728404,22,,
5494324400,608.19076,7871978699,608995706,7871978722,23,,
5494574575,608.44094,7872228873,609245880,7872228895,22,,
5494590772,608.45713,7872245069,609262076,7872245091,22,7872245148,
5494840901,608.70726,7872495199,609512206,7872495235,36,,
5495091462,608.95782,7872745758,609762765,7872745809,51,,
5495341614,609.20798,7872995910,610012916,7872995976,66,,
5495591788,609.45815,7873246082,610263088,7873246162,80,,
5495841970,609.70833,7873496264,610513271,7873496344,80,,
5496092596,609.95896,7873746888,610763895,7873746968,80,,
5496342744,610.20911,7873997036,611014042,7873997116,80,,
5496592907,610.45927,7874247198,611264205,7874247278,80,,
5496609358,610.47572,7874263648,611280655,7874263728,80,7874263585,
5496859792,610.72615,7874514082,611531088,7874514127,45,,
5497109988,610.97635,7874764277,611781283,7874764287,10,,
5497360115,611.22648,7875014403,612031410,7875014379,-24,,
5497610245,611.47661,7875264532,612281538,7875264471,-61,,
5497860541,611.72690,7875514827,612531834,7875514766,-61,,
5498110686,611.97705,7875764972,612781978,7875764911,-61,,
5498361719,612.22808,7876016003,613033010,7876015943,-60,,
5498611859,612.47822,7876266143,613283150,7876266083,-60,,
5498628052,612.49441,7876282336,613299342,7876282275,-61,7876282394,
5498878367,612.74473,7876532650,613549657,7876532618,-32,,
5499128494,612.99486,7876782777,613799784,7876782776,-1,,
5499378660,613.24502,7877032942,614049948,7877032971,29,,
5499629201,613.49556,7877283491,614300498,7877283552,61,,
5499879484,613.74585,7877533764,614550781,7877533834,70,,
5500129663,613.99602,7877783941,614800948,7877784001,60,,
5500379818,614.24618,7878034096,615051102,7878034156,60,,
5500630347,614.49671,7878284624,615301631,7878284685,61,,
5500646527,614.51289,7878300802,615317808,7878300862,60,7878300857,
5500897142,614.76350,7878551419,615568426,7878551487,68,,
5501147397,615.01376,7878801672,615818679,7878801730,58,,
5501397829,615.26419,7879052103,616069110,7879052160,57,,
5501648334,615.51469,7879302617,616319623,7879302673,56,,
5501898475,615.76484,7879552748,616569755,7879552814,66,,
5502148865,616.01523,7879803137,616820143,7879803193,56,,
5502399397,616.26576,7880053667,617070674,7880053724,57,,
5502649530,616.51589,7880303799,617320806,7880303855,56,,
5502665796,616.53216,7880320064,617337071,7880320120,56,7880320113,
5502915934,616.78229,7880570202,617587208,7880570256,54,,
5503166343,617.03270,7880820610,617837617,7880820663,53,,
5503416487,617.28285,7881070755,618087762,7881070808,53,,
5503666620,617.53298,7881320886,618337893,7881320936,50,,
5503917359,617.78372,7881571625,618588632,7881571675,50,,
5504167488,618.03385,7881821752,618838759,7881821802,50,,
5504417640,618.28400,7882071903,619088910,7882071953,50,,
5504667816,618.53418,7882322078,619339085,7882322129,51,,
5504684015,618.55038,7882338276,619355283,7882338326,50,7882338296,
5504934450,618.80081,7882588712,619605718,7882588754,42,,
5505184583,619.05094,7882838843,619855850,7882838878,35,,
5505434823,619.30118,7883089082,620106089,7883089110,28,,
5505684959,619.55132,7883339218,620356224,7883339239,21,,
5505935113,619.80147,7883589372,620606379,7883589403,31,,
5506185242,620.05160,7883839499,620856506,7883839521,22,,
5506435756,620.30212,7884090012,621107019,7884090033,21,,
5506686339,620.55270,7884340595,621357601,7884340616,21,,
5506702503,620.56886,7884356757,621373763,7884356778,21,7884356853,
5506953063,620.81942,7884607317,621624324,7884607357,40,,
5507203437,621.06980,7884857690,621874697,7884857749,59,,
5507454330,621.32069,7885108583,622125590,7885108662,79,,
5507704450,621.57081,7885358701,622375708,7885358799,98,,
5507954547,621.82091,7885608797,622625804,7885608895,98,,
5508204649,622.07101,7885858900,622875907,7885858998,98,,
5508454977,622.32134,7886109227,623126233,7886109325,98,,
5508705411,622.57177,7886359660,623376667,7886359758,98,,
5508721772,622.58813,7886376019,623393025,7886376117,98,7886376016,
5508971908,622.83827,7886626155,623643162,7886626228,73,,
5509222350,623.08871,7886876596,623893603,7886876646,50,,
5509472519,623.33888,7887126765,624143771,7887126788,23,,
5509722645,623.58901,7887376889,624393896,7887376889,0,,
5509973467,623.83983,7887627710,624644716,7887627709,-1,,
5510223607,624.08997,7887877849,624894856,7887877848,-1,,
5510473745,624.34011,7888127986,625144992,7888127985,-1,,
5510723903,624.59026,7888378144,625395150,7888378143,-1,,
5510740096,624.60646,7888394337,625411343,7888394335,-2,7888394375,
5510990329,624.85669,7888644570,625661576,7888644579,9,,
5511240589,625.10695,7888894828,625911835,7888894847,19,,
5511490853,625.35721,7889145091,626162097,7889145121,30,,
5511740993,625.60735,7889395230,626412237,7889395270,40,,
5511991150,625.85751,7889645386,626662393,7889645426,40,,
5512241279,626.10764,7889895515,626912522,7889895555,40,,
5512491464,626.35783,7890145698,627162705,7890145739,41,,
5512742373,626.60873,7890396606,627413613,7890396646,40,,
5512758568,626.62493,7890412800,627429806,7890412840,40,7890412890,
5513008742,626.87510,7890662974,627679981,7890663027,53,,
5513259145,627.12551,7890913378,627930385,7890913444,66,,
5513509305,627.37567,7891163536,628180543,7891163616,80,,
5513759522,627.62588,7891413753,628430759,7891413845,92,,
5514009649,627.87601,7891663879,628680885,7891663971,92,,
5514259912,628.12627,7891914140,628931147,7891914233,93,,
5514510461,628.37682,7892164689,629181696,7892164781,92,,
5514760975,628.62734,7892415201,629432208,7892415294,93,,
5514777922,628.64428,7892432148,629449154,7892432239,91,7892431870,
5515028083,628.89444,7892682308,629699315,7892682307,-1,,
5515278342,629.14470,7892932567,629949573,7892932475,-92,,
5515528552,629.39491,7893182775,630199782,7893182591,-184,,
5515779165,629.64553,7893433389,630450396,7893433113,-276,,
5516029330,629.89569,7893683553,630700559,7893683277,-276,,
5516279702,630.14606,7893933923,630950930,7893933648,-275,,
5516529842,630.39620,7894184063,631201069,7894183787,-276,,
5516780048,630.64641,7894434268,631451275,7894433993,-275,,
5516796151,630.66251,7894450369,631467376,7894450093,-276,7894450469,
5517046333,630.91269,7894700551,631717558,7894700380,-171,,
5517296503,631.16286,7894950720,631967727,7894950633,-87,,
5517546639,631.41300,7895200855,632217862,7895200864,9,,
5517797417,631.66378,7895451633,632468640,7895451735,102,,
5518047563,631.91392,7895701779,632718786,7895701881,102,,
5518297703,632.16406,7895951917,632968924,7895952020,103,,
5518547855,632.41422,7896202068,633219075,7896202170,102,,
5518798357,632.66472,7896452569,633469576,7896452671,102,,
5518814513,632.68087,7896468724,633485730,7896468826,102,7896468838,
5519064686,632.93105,7896718897,633735904,7896719002,105,,
5519314806,633.18117,7896969016,633986023,7896969126,110,,
5519565343,633.43170,7897219552,634236559,7897219665,113,,
5519815923,633.68228,7897470131,634487138,7897470247,116,,
5520066387,633.93275,7897720594,634737601,7897720710,116,,
5520316535,634.18290,7897970741,634987748,7897970857,116,,
5520566988,634.43335,7898221194,635238200,7898221309,115,,
5520817129,634.68349,7898471335,635488341,7898471451,116,,
5520833728,634.70009,7898487933,635504939,7898488048,115,7898487971,
5521083832,634.95019,7898738036,635755042,7898738132,96,,
5521334366,635.20073,7898988568,636005575,7898988647,79,,
5521584742,635.45110,7899238944,636255951,7899239003,59,,
5521835045,635.70141,7899489246,636506253,7899489286,40,,
5522085200,635.95156,7899739400,636756407,7899739440,40,,
5522335504,636.20186,7899989703,637006710,7899989744,41,,
5522585661,636.45202,7900239860,637256867,7900239900,40,,
5522835759,636.70212,7900489956,637506963,7900489996,40,,
5522857622,636.72398,7900511818,637528825,7900511858,40,7900511990,
5523107872,636.97423,7900762069,637779075,7900762140,71,,
5523358351,637.22471,7901012547,638029555,7901012654,107,,
5523608508,637.47487,7901262703,638279710,7901262842,139,,
5523858652,637.72501,7901512846,638529853,7901513020,174,,
5524109281,637.97564,7901763474,638780481,7901763647,173,,
5524359582,638.22594,7902013775,639030782,7902013948,173,,
5524609736,638.47610,7902263927,639280934,7902264100,173,,
5524859894,638.72626,7902514084,639531091,7902514258,174,,
5524876078,638.74244,7902530267,639547274,7902530440,173,7902530355,
5525126307,638.99267,7902780497,639797503,7902780648,151,,
5525376447,639.24281,7903030636,640047643,7903030766,130,,
5525626601,639.49296,7903280788,640297795,7903280897,109,,
5525876753,639.74311,7903530941,640547948,7903531030,89,,
5526126917,639.99328,7903781104,640798111,7903781194,90,,
5526377312,640.24367,7904031497,641048504,7904031586,89,,
5526627670,640.49403,7904281854,641298860,7904281943,89,,
5526878353,640.74471,7904532536,641549553,7904532636,100,,
5526894454,640.76081,7904548636,641565642,7904548725,89,7904548710,
5527144591,641.01095,7904798774,641815780,7904798858,84,,
5527395122,641.26148,7905049304,642066311,7905049385,81,,
5527645245,641.51161,7905299425,642316432,7905299504,79,,
5527895382,641.76174,7905549562,642566568,7905549637,75,,
5528145554,642.01192,7905799733,642816740,7905799809,76,,
5528395710,642.26207,7906049889,643066896,7906049964,75,,
5528646348,642.51271,7906300525,643317531,7906300600,75,,
5528896489,642.76285,7906550666,643567673,7906550741,75,,
5528912702,642.77906,7906566877,643583884,7906566952,75,7906566976,
5529162871,643.02923,7906817046,643834053,7906817129,83,,
5529413008,643.27937,7907067182,644084189,7907067270,88,,
5529663148,643.52951,7907317322,644334329,7907317418,96,,
5529913570,643.77993,7907567743,644584749,7907567844,101,,
5530164094,644.03045,7907818265,644835272,7907818366,101,,
5530414603,644.28096,7908068773,645085780,7908068875,102,,
5530665197,644.53156,7908319367,645336374,7908319468,101,,
5530915467,644.78183,7908569637,645586644,7908569738,101,,
5530931995,644.79836,7908586163,645603170,7908586264,101,7908586176,
5531182335,645.04870,7908836504,645853510,7908836583,79,,
5531432486,645.29885,7909086653,646103660,7909086711,58,,
5531682837,645.54920,7909337003,646354010,7909337039,36,,
5531933443,645.79980,7909587609,646604616,7909587623,14,,
5532184123,646.05048,7909838288,646855295,7909838303,15,,
5532435043,646.30140,7910089206,647106213,7910089220,14,,
5532685215,646.55158,7910339378,647356384,7910339392,14,,
5532935656,646.80202,7910589819,647606826,7910589833,14,,
5532951817,646.81818,7910605977,647622983,7910605991,14,7910606088,
5533202267,647.06863,7910856428,647873436,7910856467,39,,
5533452844,647.31921,7911107005,648124012,7911107068,63,,
5533703002,647.56936,7911357160,648374167,7911357249,89,,
5533953520,647.81988,7911607679,648624686,7911607792,113,,
5534204056,648.07042,7911858213,648875220,7911858327,114,,
5534454345,648.32071,7912108502,649125519,7912108625,123,,
5534704509,648.57087,7912358664,649375671,7912358777,113,,
5534954659,648.82102,7912608813,649625820,7912608926,113,,
5534971079,648.83744,7912625232,649642239,7912625345,113,7912625100,
5535221459,649.08782,7912875612,649892619,7912875664,52,,
5535471949,649.33831,7913126101,650143119,7913126102,1,,
5535722461,649.58882,7913376613,650393620,7913376544,-69,,
5535972887,649.83925,7913627038,650644045,7913626908,-130,,
5536223028,650.08939,7913877178,650894185,7913877048,-130,,
5536473212,650.33957,7914127362,651144369,7914127233,-129,,
5536723334,650.58970,7914377482,651394489,7914377352,-130,,
5536973456,650.83982,7914627603,651644610,7914627473,-130,,
5536989671,650.85603,7914643817,651660823,7914643687,-130,7914643902,
5537239794,651.10615,7914893940,651910947,7914893865,-75,,
5537490460,651.35682,7915144605,652161612,7915144583,-22,,
5537741451,651.60781,7915395596,652412603,7915395629,33,,
5537991650,651.85801,7915645795,652662802,7915645881,86,,
5538241966,652.10833,7915896110,652913117,7915896196,86,,
5538492350,652.35871,7916146493,653163500,7916146580,87,,
5538742516,652.60888,7916396658,653413665,7916396755,97,,
5538993218,652.85958,7916647359,653664376,7916647455,96,,
5539009545,652.87591,7916663684,653680690,7916663769,85,7916663877,
5539259917,653.12628,7916914056,653931063,7916914168,112,,
5539510349,653.37671,7917164488,654181495,7917164628,140,,
5539760849,653.62721,7917414987,654431994,7917415156,169,,
5540011496,653.87786,7917665633,654682650,7917665838,205,,
5540261896,654.12826,7917916032,654933040,7917916229,197,,
5540512225,654.37859,7918166360,655183367,7918166556,196,,
5540762578,654.62894,7918416713,655433720,7918416908,195,,
5541013054,654.87941,7918667188,655684195,7918667383,195,,
5541029212,654.89557,7918683344,655700350,7918683539,195,7918683462,
5541279492,655.14585,7918933624,655950631,7918933801,177,,
5541529881,655.39624,7919184012,656201018,7919184170,158,,
5541780124,655.64648,7919434254,656451261,7919434394,140,,
5542030390,655.89675,7919684520,656701527,7919684641,121,,
5542280814,656.14717,7919934943,656951950,7919935064,121,,
5542531413,656.39777,7920185541,657202548,7920185662,121,,
5542781593,656.64795,7920435719,657452726,7920435839,120,,
5543032127,656.89849,7920686253,657703260,7920686373,120,,
5543048236,656.91460,7920702361,657719368,7920702481,120,7920702433,
5543298401,657.16476,7920952526,657969533,7920952634,108,,
5543548559,657.41492,7921202683,658219690,7921202779,96,,
5543798674,657.66503,7921452797,658469804,7921452881,84,,
5544049113,657.91547,7921703235,658720242,7921703319,84,,
5544299400,658.16576,7921953521,658970528,7921953594,73,,
5544549742,658.41610,7922203862,659220869,7922203936,74,,
5544799913,658.66627,7922454032,659471039,7922454105,73,,
5545050079,658.91644,7922704197,659721203,7922704270,73,,
5545066351,658.93271,7922720468,659737475,7922720541,73,7922720494,
5545316490,659.18285,7922970608,659987615,7922970669,61,,
5545566598,659.43296,7923220715,660237721,7923220764,49,,
5545816733,659.68309,7923470850,660487856,7923470888,38,,
5546067358,659.93372,7923721473,660738479,7923721500,27,,
5546317517,660.18388,7923971632,660988639,7923971659,27,,
5546567696,660.43406,7924221808,661238815,7924221835,27,,
5546817821,660.68418,7924471934,661488940,7924471961,27,,
5547068073,660.93443,7924722184,661739190,7924722211,27,,
5547084459,660.95082,7924738569,661755575,7924738596,27,7924738662,
5547334829,661.20119,7924988940,662005947,7924988983,43,,
5547584956,661.45132,7925239065,662256072,7925239126,61,,
5547835219,661.70158,7925489327,662506334,7925489406,79,,
5548085342,661.95170,7925739450,662756457,7925739545,95,,
5548335843,662.20220,7925989951,663006957,7925990046,95,,
5548586022,662.45238,7926240129,663257136,7926240224,95,,
5548836169,662.70253,7926490274,663507281,7926490369,95,,
5549086322,662.95268,7926740427,663757433,7926740522,95,,
5549102432,662.96879,7926756535,663773541,7926756630,95,7926756719,
5549352881,663.21924,7927006985,664023992,7927007114,129,,
5549603418,663.46978,7927257520,664274527,7927257662,142,,
5549853565,663.71993,7927507666,664524672,7927507830,164,,
5550103676,663.97004,7927757775,664774782,7927757961,186,,
5550353791,664.22015,7928007892,665024909,7928008089,197,,
5550604256,664.47062,7928258359,665275366,7928258546,187,,
5550855377,664.72174,7928509475,665526481,7928509661,186,,
5551105996,664.97236,7928760094,665777100,7928760280,186,,
5551122244,664.98861,7928776340,665793346,7928776526,186,7928776448,
5551372786,665.23915,7929026882,666043889,7929027049,167,,
5551623000,665.48936,7929277096,666294103,7929277244,148,,
5551873145,665.73951,7929527239,666544246,7929527368,129,,
5552123505,665.98987,7929777598,666794605,7929777709,111,,
5552373859,666.24022,7930027964,667044970,7930028074,110,,
5552623986,666.49035,7930278077,667295084,7930278187,110,,
5552874350,666.74071,7930528442,667545450,7930528553,111,,
5553124993,666.99135,7930779083,667796090,7930779193,110,,
5553141937,667.00830,7930796027,667813033,7930796137,110,7930795691,
5553392321,667.25868,7931046412,668063419,7931046411,-1,,
5553642941,667.50930,7931297030,668314037,7931296918,-112,,
5553893552,667.75991,7931547639,668564645,7931547415,-224,,
5554144293,668.01065,7931798380,668815387,7931798056,-324,,
5554394471,668.26083,7932048556,669065563,7932048222,-334,,
5554644565,668.51093,7932298650,669315656,7932298316,-334,,
5554895117,668.76148,7932549200,669566207,7932548866,-334,,
5555145271,669.01163,7932799354,669816371,7932799030,-324,,
5555161574,669.02793,7932815656,669832662,7932815322,-334,7932815692,
5555412062,669.27842,7933066143,670083161,7933065912,-231,,
5555662842,669.52920,7933316923,670333930,7933316776,-147,,
5555913291,669.77965,7933567371,670584388,7933567327,-44,,
5556163437,670.02980,7933817517,670834523,7933817555,38,,
5556413829,670.28019,7934067909,671084916,7934067947,38,,
5556663957,670.53032,7934318034,671335041,7934318073,39,,
5556914521,670.78088,7934568598,671585604,7934568636,38,,
5557164649,671.03101,7934818724,671835731,7934818763,39,,
5557180777,671.04714,7934834851,671851858,7934834889,38,7934834986,
5557431118,671.29748,7935085192,672102199,7935085265,73,,
5557681275,671.54764,7935335348,672352354,7935335435,87,,
5557931554,671.79791,7935585627,672602634,7935585739,112,,
5558181689,672.04805,7935835761,672852768,7935835898,137,,
5558431839,672.29820,7936085911,673102918,7936086047,136,,
5558682209,672.54857,7936336280,673353287,7936336416,136,,
5558932285,672.79865,7936586355,673603362,7936586491,136,,
5559182523,673.04888,7936836591,673853598,7936836727,136,,
5559198656,673.06502,7936852723,673869730,7936852859,136,7936852792,
5559449214,673.31557,7937103281,674120288,7937103401,120,,
5559699708,673.56607,7937353774,674370781,7937353878,104,,
5559950343,673.81670,7937604409,674621416,7937604497,88,,
5560200791,674.06715,7937854856,674871862,7937854927,71,,
5560451424,674.31778,7938105488,675122495,7938105560,72,,
5560702331,674.56869,7938356395,675373402,7938356467,72,,
5560952814,674.81917,7938606876,675623883,7938606947,71,,
5561203892,675.07025,7938857953,675874960,7938858025,72,,
5561220090,675.08645,7938874151,675891157,7938874222,71,7938874263,
5561470757,675.33712,7939124817,676141824,7939124899,82,,
5561725265,675.59163,7939379324,676396331,7939379417,93,,
5561976311,675.84267,7939630370,676647376,7939630474,104,,
5562228244,676.09461,7939882301,676899308,7939882415,114,,
5562478489,676.34485,7940132545,677149552,7940132659,114,,
5562728644,676.59501,7940382700,677399707,7940382814,114,,
5562978904,676.84527,7940632959,677649966,7940633073,114,,
5563229177,677.09554,7940883231,677900237,7940883345,114,,
5563245484,677.11185,7940899538,677916544,7940899652,114,7940899563,
5563496034,677.36239,7941150087,678167094,7941150180,93,,
5563746578,677.61294,7941400631,678417638,7941400701,70,,
5563996905,677.86327,7941650957,678667963,7941651006,49,,
5564247260,678.11362,7941901311,678918328,7941901349,38,,
5564497813,678.36417,7942151863,679168869,7942151890,27,,
5564748179,678.61454,7942402228,679419235,7942402255,27,,
5564998580,678.86494,7942652627,679669633,7942652654,27,,
5565249222,679.11558,7942903268,679920275,7942903295,27,,
5565265424,679.13179,7942919470,679936476,7942919496,26,7942919530,
5565516062,679.38242,7943170108,680187115,7943170143,35,,
5565766633,679.63299,7943420679,680437685,7943420722,43,,
5566016882,679.88324,7943670927,680687933,7943670980,53,,
5566267437,680.13380,7943921480,680938487,7943921542,62,,
5566517579,680.38394,7944171621,681188627,7944171683,62,,
5566767717,680.63408,7944421759,681438766,7944421821,62,,
5567017862,680.88422,7944671903,681688909,7944671965,62,,
5567268538,681.13490,7944922578,681939585,7944922640,62,,
5567285409,681.15177,7944939448,681956454,7944939510,62,7944939850,
5567535531,681.40189,7945189569,682206576,7945189716,147,,
5567785663,681.65202,7945439700,682456706,7945439933,233,,
5568035911,681.90227,7945689948,682706954,7945690266,318,,
5568286351,682.15271,7945940387,682957394,7945940791,404,,
5568536753,682.40311,7946190789,683207796,7946191193,404,,
5568787168,682.65353,7946441202,683458209,7946441606,404,,
5569037265,682.90363,7946691299,683708305,7946691703,404,,
5569287412,683.15377,7946941444,683958451,7946941849,405,,
5569303596,683.16996,7946957627,683974634,7946958031,404,7946957696,
5569553741,683.42010,7947207773,684224780,7947208093,320,,
5569804192,683.67055,7947458223,684475230,7947458460,237,,
5570054350,683.92071,7947708380,684725387,7947708533,153,,
5570304495,684.17086,7947958523,684975530,7947958593,70,,
5570554769,684.42113,7948208797,685225804,7948208867,70,,
5570804875,684.67124,7948458902,685475909,7948458973,71,,
5571055019,684.92138,7948709045,685726051,7948709115,70,,
5571305456,685.17182,7948959481,685976488,7948959552,71,,
5571321527,685.18789,7948975552,685992558,7948975621,69,7948975585,
5571571659,685.43802,7949225682,686242689,7949225746,64,,
5571822110,685.68847,7949476133,686493139,7949476190,57,,
5572072219,685.93858,7949726241,686743248,7949726295,54,,
5572322349,686.18871,7949976370,686993377,7949976417,47,,
5572572519,686.43888,7950226539,687243546,7950226587,48,,
5572822736,686.68910,7950476756,687493763,7950476803,47,,
5573072872,686.93923,7950726891,687743898,7950726938,47,,
5573323396,687.18976,7950977414,687994421,7950977461,47,,
5573339610,687.20597,7950993627,688010634,7950993674,47,7950993772,
5573590116,687.45648,7951244133,688261140,7951244204,71,,
5573840252,687.70661,7951494269,688511276,7951494365,96,,
5574090634,687.95700,7951744649,688761656,7951744771,122,,
5574340901,688.20726,7951994916,689011922,7951995062,146,,
5574591302,688.45766,7952245315,689262333,7952245472,157,,
5574841493,688.70785,7952495505,689512511,7952495651,146,,
5575091837,688.95820,7952745848,689762855,7952745994,146,,
5575342456,689.20882,7952996467,690013484,7952996624,157,,
5575359036,689.22540,7953013046,690030052,7953013192,146,7953012934,
5575609540,689.47590,7953263550,690280557,7953263631,81,,
5575859687,689.72605,7953513696,690530703,7953513714,18,,
5576110161,689.97652,7953764169,690781175,7953764123,-46,,
5576360681,690.22704,7954014688,691031695,7954014578,-110,,
5576610810,690.47717,7954264816,691281823,7954264706,-110,,
5576860982,690.72734,7954514988,691531994,7954514877,-111,,
5577111582,690.97794,7954765586,691782593,7954765476,-110,,
5577362010,691.22837,7955016013,692033020,7955015903,-110,,
5577378264,691.24463,7955032266,692049272,7955032156,-110,7955032323,
5577628420,691.49478,7955282422,692299428,7955282355,-67,,
5577878569,691.74493,7955532572,692549579,7955532547,-25,,
5578128723,691.99508,7955782724,692799731,7955782741,17,,
5578378840,692.24520,7956032841,693049848,7956032900,59,,
5578629229,692.49559,7956283228,693300235,7956283287,59,,
5578879352,692.74571,7956533350,693550357,7956533409,59,,
5579129491,692.99585,7956783489,693800495,7956783548,59,,
5579379997,693.24636,7957033993,694050999,7957034052,59,,
5579396064,693.26243,7957050059,694067066,7957050118,59,7957050197,
5579646343,693.51270,7957300338,694317345,7957300419,81,,
5579896814,693.76318,7957550808,694567815,7957550909,101,,
5580147789,694.01415,7957801782,694818789,7957801902,120,,
5580398349,694.26471,7958052343,695069349,7958052483,140,,
5580648666,694.51503,7958302658,695319665,7958302798,140,,
5580898797,694.76516,7958552789,695569796,7958552929,140,,
5581148918,695.01528,7958802908,695819914,7958803048,140,,
5581399067,695.26543,7959053057,696070063,7959053197,140,,
5581416218,695.28258,7959070206,696087212,7959070346,140,7959070503,
5581666360,695.53272,7959320348,696337354,7959320527,179,,
5581916735,695.78310,7959570722,696587729,7959570941,219,,
5582166871,696.03323,7959820858,696837865,7959821117,259,,
5582417037,696.28340,7960071022,697088029,7960071321,299,,
5582667430,696.53379,7960321414,697338421,7960321713,299,,
5582917587,696.78395,7960571571,697588578,7960571871,300,,
5583168039,697.03440,7960822022,697839029,7960822321,299,,
5583418204,697.28457,7961072187,698089194,7961072497,310,,
5583434270,697.30063,7961088252,698105258,7961088550,298,7961088387,
5583684580,697.55094,7961338561,698355568,7961338819,258,,
5583934831,697.80119,7961588812,698605819,7961589029,217,,
5584184978,698.05134,7961838958,698855965,7961839135,177,,
5584435590,698.30195,7962089568,699106575,7962089705,137,,
5584686449,698.55281,7962340426,699357433,7962340563,137,,
5584937025,698.80339,7962591002,699608009,7962591139,137,,
5585187641,699.05400,7962841616,699858623,7962841754,138,,
5585437786,699.30415,7963091761,700108767,7963091898,137,,
5585454014,699.32038,7963107989,700124995,7963108137,148,7963108029,
5585704124,699.57048,7963358098,700375105,7963358211,113,,
5585954270,699.82063,7963608244,700625250,7963608333,89,,
5586204408,700.07077,7963858380,700875387,7963858446,66,,
5586454560,700.32092,7964108531,701125538,7964108573,42,,
5586705581,700.57194,7964359551,701376557,7964359593,42,,
5586955815,700.82218,7964609785,701626792,7964609828,43,,
5587206071,701.07243,7964860039,701877045,7964860080,41,,
5587456777,701.32314,7965110745,702127752,7965110787,42,,
5587472822,701.33918,7965126789,702143795,7965126830,41,7965126953,
5587723405,701.58977,7965377372,702394378,7965377444,72,,
5587973554,701.83992,7965627520,702644527,7965627624,104,,
5588223832,702.09019,7965877797,702894803,7965877932,135,,
5588473957,702.34032,7966127921,703144928,7966128088,167,,
5588724075,702.59044,7966378037,703395044,7966378204,167,,
5588974349,702.84071,7966628312,703645319,7966628478,166,,
5589224454,703.09082,7966878415,703895422,7966878582,167,,
5589475112,703.34147,7967129072,704146079,7967129238,166,,
5589491308,703.35767,7967145267,704162273,7967145433,166,7967145334,
5589741426,703.60779,7967395386,704412393,7967395527,141,,
5589991882,703.85824,7967645840,704662847,7967645957,117,,
5590242054,704.10842,7967896013,704913020,7967896106,93,,
5590492596,704.35896,7968146553,705163560,7968146622,69,,
5590742837,704.60920,7968396794,705413801,7968396863,69,,
5590993233,704.85959,7968647188,705664194,7968647257,69,,
5591243580,705.10994,7968897534,705914541,7968897603,69,,
5591494158,705.36052,7969148111,706165117,7969148180,69,,
5591510324,705.37668,7969164277,706181283,7969164346,69,7969164478,
5591761042,705.62740,7969414994,706432001,7969415096,102,,
5592011579,705.87794,7969665530,706682537,7969665666,136,,
5592262320,706.12868,7969916270,706933277,7969916440,170,,
5592512939,706.37930,7970166888,707183895,7970167091,203,,
5592763424,706.62978,7970417373,707434380,7970417576,203,,
5593014289,706.88065,7970668237,707685244,7970668440,203,,
5593264844,707.13121,7970918792,707935799,7970919006,214,,
5593515400,707.38176,7971169347,708186353,7971169550,203,,
5593531835,707.39820,7971185780,708202787,7971185983,203,7971185817,
5593782364,707.64873,7971436310,708453316,7971436471,161,,
5594032572,707.89893,7971686516,708703523,7971686637,121,,
5594282837,708.14920,7971936781,708953787,7971936861,80,,
5594532998,708.39936,7972186941,709203948,7972186980,39,,
5594783381,708.64974,7972437323,709454330,7972437362,39,,
5595033515,708.89988,7972687456,709704463,7972687495,39,,
5595283704,709.15007,7972937645,709954652,7972937684,39,,
5595534340,709.40070,7973188278,710205285,7973188318,40,,
5595550807,709.41717,7973204745,710221751,7973204784,39,7973204646,
5595801069,709.66743,7973455007,710472014,7973455013,6,,
5596051901,709.91826,7973705838,710722845,7973705809,-29,,
5596302489,710.16885,7973956426,710973432,7973956363,-63,,
5596553027,710.41939,7974206963,711223970,7974206867,-96,,
5596803656,710.67002,7974457590,711474597,7974457493,-97,,
5597053836,710.92020,7974707769,711724776,7974707672,-97,,
5597303994,711.17035,7974957927,711974933,7974957830,-97,,
5597554945,711.42131,7975208877,712225883,7975208780,-97,,
5597571075,711.43744,7975225005,712242012,7975224908,-97,7975225146,
5597821571,711.68793,7975475503,712492510,7975475466,-37,,
5598072085,711.93845,7975726015,712743021,7975726037,22,,
5598322717,712.18908,7975976646,712993653,7975976729,83,,
5598575230,712.44159,7976229158,713246165,7976229300,142,,
5598825736,712.69210,7976479663,713496670,7976479805,142,,
5599076358,712.94272,7976730284,713747291,7976730427,143,,
5599329447,713.19581,7976983372,714000379,7976983514,142,,
5599580000,713.44636,7977233924,714250931,7977234067,143,,
5599597392,713.46375,7977251315,714268321,7977251457,142,7977250803,
5599847801,713.71416,7977501724,714518731,7977501702,-22,,
5600098380,713.96474,7977752302,714769309,7977752117,-185,,
5600352725,714.21909,7978006647,715023654,7978006297,-350,,
5600603247,714.46961,7978257169,715274175,7978256658,-511,,
5600854142,714.72050,7978508062,715525069,7978507552,-510,,
5601104895,714.97126,7978758814,715775821,7978758304,-510,,
5601355583,715.22194,7979009501,716026508,7979008991,-510,,
5601606621,715.47298,7979260539,716277546,7979260029,-510,,
5601622887,715.48925,7979276804,716293810,7979276293,-511,7979276951,
5601873900,715.74026,7979527817,716544824,7979527472,-345,,
5602126497,715.99286,7979780412,716797419,7979780233,-179,,
5602377346,716.24371,7980031261,717048268,7980031248,-13,,
5602627497,716.49386,7980281410,717298417,7980281559,149,,
5602877800,716.74416,7980531713,717548720,7980531862,149,,
5603128556,716.99492,7980782468,717799475,7980782618,150,,
5603378979,717.24534,7981032890,718049896,7981033039,149,,
5603629119,717.49548,7981283029,718300035,7981283178,149,,
5603645265,717.51163,7981299174,718316180,7981299323,149,7981299225,
5603895393,717.76175,7981549302,718566309,7981549426,124,,
5604145495,718.01186,7981799403,718816410,7981799503,100,,
5604396185,718.26255,7982050093,719067100,7982050170,77,,
5604646408,718.51277,7982300314,719317320,7982300367,53,,
5604897192,718.76355,7982551097,719568104,7982551150,53,,
5605147369,719.01373,7982801274,719818280,7982801327,53,,
5605397515,719.26388,7983051420,720068427,7983051473,53,,
5605647687,719.51405,7983301590,720318597,7983301643,53,,
5605663777,719.53014,7983317679,720334685,7983317732,53,7983317805,
5605913891,719.78025,7983567794,720584801,7983567867,73,,
5606164514,720.03088,7983818415,720835422,7983818507,92,,
5606414675,720.28104,7984068575,721085581,7984068684,109,,
5606665292,720.53165,7984319191,721336198,7984319319,128,,
5606915856,720.78222,7984569755,721586761,7984569883,128,,
5607166511,721.03287,7984820409,721837416,7984820537,128,,
5607416598,721.28296,7985070494,722087500,7985070622,128,,
5607666669,721.53303,7985320564,722337571,7985320692,128,,
5607718795,721.58516,7985372690,722389696,7985372817,127,7985369143,
5607969316,721.83568,7985623211,722640218,7985622418,-793,,
5608219686,722.08605,7985873581,722890588,7985871870,-1711,,
5608470352,722.33671,7986124246,723141253,7986121613,-2633,,
5608720897,722.58726,7986374789,723391796,7986371244,-3545,,
5608971610,722.83797,7986625501,723642508,7986621957,-3544,,
5609221738,723.08810,7986875628,723892635,7986872084,-3544,,
5609472358,723.33872,7987126247,724143253,7987122702,-3545,,
5609722876,723.58924,7987376764,724393771,7987373220,-3544,,
5609739215,723.60558,7987393102,724410108,7987389557,-3545,7987393203,
5609990171,723.85653,7987644059,724661065,7987641429,-2630,,
5610240648,724.10701,7987894535,724911541,7987892819,-1716,,
5610490893,724.35725,7988144778,725161785,7988143975,-803,,
5610741189,724.60755,7988395074,725412081,7988395177,103,,
5610992156,724.85852,7988646041,725663047,7988646144,103,,
5611242400,725.10876,7988896283,725913290,7988896386,103,,
5611492920,725.35928,7989146802,726163809,7989146905,103,,
5611743662,725.61002,7989397544,726414550,7989397647,103,,
5611760038,725.62640,7989413919,726430925,7989414021,102,7989414018,
5612010431,725.87679,7989664312,726681318,7989664413,101,,
5612260891,726.12725,7989914770,726931777,7989914871,101,,
5612511479,726.37784,7990165357,727182364,7990165459,102,,
5612762047,726.62841,7990415925,727432931,7990416026,101,,
5613012383,726.87874,7990666259,727683266,7990666360,101,,
5613262957,727.12932,7990916833,727933840,7990916934,101,,
5613513865,727.38023,7991167740,728184747,7991167841,101,,
5613764465,727.63083,7991418339,728435346,7991418441,102,,
5613783586,727.64995,7991437460,728454466,7991437561,101,7991436115,
5614033971,727.90033,7991687845,728704852,7991687584,-261,,
5614284691,728.15105,7991938564,728955570,7991937941,-623,,
5614535749,728.40211,7992189621,729206627,7992188636,-985,,
5614786237,728.65260,7992440107,729457114,7992438764,-1343,,
5615036545,728.90291,7992690414,729707420,7992689071,-1343,,
5615287212,729.15357,7992941080,729958087,7992939737,-1343,,
5615537614,729.40397,7993191481,730208488,7993190138,-1343,,
5615788619,729.65498,7993442486,730459493,7993441144,-1342,,
5615804712,729.67107,7993458577,730475584,7993457234,-1343,7993458698,
5616055285,729.92165,7993709151,730726157,7993708174,-977,,
5616306046,730.17241,7993959911,730976917,7993959302,-609,,
5616556515,730.42288,7994210379,731227386,7994210139,-240,,
5616807166,730.67353,7994461030,731478036,7994461153,123,,
5617057726,730.92409,7994711589,731728596,7994711713,124,,
5617308304,731.17467,7994962165,731979172,7994962288,123,,
5617558552,731.42491,7995212413,732229420,7995212537,124,,
5617808628,731.67499,7995462487,732479494,7995462611,124,,
5617825010,731.69137,7995478869,732495875,7995478991,122,7995478893,
5618075566,731.94193,7995729424,732746431,7995729523,99,,
5618326294,732.19265,7995980152,732997159,7995980226,74,,
5618577004,732.44336,7996230861,733247868,7996230912,51,,
5618827646,732.69401,7996481503,733498510,7996481529,26,,
5619078259,732.94462,7996732114,733749121,7996732141,27,,
5619328876,733.19524,7996982730,733999736,7996982756,26,,
5619579364,733.44573,7997233217,734250224,7997233243,26,,
5619830021,733.69638,7997483873,734500880,7997483899,26,,
5619846214,733.71258,7997500066,734517072,7997500091,25,7997500171,
5620096802,733.96316,7997750653,734767660,7997750700,47,,
5620347685,734.21405,7998001535,735018542,7998001602,67,,
5620598192,734.46455,7998252041,735269048,7998252128,87,,
5620848457,734.71482,7998502306,735519313,7998502413,107,,
5621098869,734.96523,7998752717,735769724,7998752824,107,,
5621349072,735.21543,7999002919,736019926,7999003026,107,,
5621599506,735.46587,7999253352,736270359,7999253459,107,,
5621850019,735.71638,7999503864,736520871,7999503971,107,,
5621866037,735.73240,7999519881,736536888,7999519988,107,7999519961,
5622116247,735.98261,7999770091,736787098,7999770191,100,,
5622367172,736.23353,8000021015,737038022,8000021110,95,,
5622617794,736.48415,8000271636,737288643,8000271724,88,,
5622868367,736.73473,8000522209,737539215,8000522291,82,,
5623118862,736.98522,8000772702,737789708,8000772784,82,,
5623369414,737.23577,8001023254,738040260,8001023336,82,,
5623620062,737.48642,8001273901,738290908,8001273984,83,,
5623870560,737.73692,8001524399,738541406,8001524481,82,,
5623886604,737.75297,8001540441,738557448,8001540523,82,8001540598,
5624137005,738.00337,8001790842,738807849,8001790943,101,,
5624387638,738.25400,8002041475,739058481,8002041596,121,,
5624637825,738.50419,8002291661,739308667,8002291800,139,,
5624888318,738.75468,8002542152,739559158,8002542311,159,,
5625138792,739.00515,8002792625,739809632,8002792784,159,,
5625389363,739.25572,8003043195,740060202,8003043355,160,,
5625640068,739.50643,8003293899,740310906,8003294059,160,,
5625890694,739.75706,8003544525,740561532,8003544685,160,,
5625906747,739.77311,8003560577,740577584,8003560736,159,8003560723,
5626157532,740.02389,8003811362,740828369,8003811518,156,,
5626408204,740.27457,8004062033,741079040,8004062186,153,,
5626659255,740.52562,8004313084,741330091,8004313235,151,,
5626909704,740.77607,8004563531,741580538,8004563679,148,,
5627160594,741.02696,8004814420,741831427,8004814568,148,,
5627411311,741.27767,8005065137,742082143,8005065285,148,,
5627662073,741.52843,8005315897,742332904,8005316045,148,,
5627912361,741.77872,8005566184,742583190,8005566332,148,,
5627928368,741.79473,8005582190,742599197,8005582338,148,8005582336,
5628178480,742.04484,8005832302,742849314,8005832456,154,,
5628433787,742.30015,8006087609,743104616,8006087757,148,,
5628684245,742.55061,8006338066,743355073,8006338214,148,,
5628934799,742.80116,8006588619,743605626,8006588767,148,,
5629188461,743.05482,8006842280,743859287,8006842428,148,,
5629444140,743.31050,8007097959,744114966,8007098107,148,,
5629694418,743.56078,8007348236,744365242,8007348384,148,,
5629950419,743.81678,8007604235,744621242,8007604383,148,,
5629975709,743.84207,8007629525,744646531,8007629672,147,8007625171,
5630227307,744.09367,8007881122,744898129,8007880137,-985,,
5630477600,744.34396,8008131414,745148420,8008129303,-2111,,
5630755318,744.62168,8008409132,745426138,8008405772,-3360,,
5631016036,744.88240,8008669850,745686857,8008665499,-4351,,
5631266902,745.13326,8008920713,745937720,8008916361,-4352,,
5631517290,745.38365,8009171102,746188108,8009166750,-4352,,
5631767848,745.63421,8009421659,746438665,8009417307,-4352,,
5632027618,745.89398,8009681428,746698434,8009677076,-4352,,
5632047516,745.91388,8009701324,746718331,8009696972,-4352,8009699471,
5632297879,746.16424,8009951687,746968693,8009947960,-3727,,
5632548672,746.41503,8010202479,747219485,8010199379,-3100,,
5632800800,746.66716,8010454607,747471613,8010452138,-2469,,
5633051222,746.91758,8010705027,747722033,8010703175,-1852,,
5633301796,747.16816,8010955600,747972607,8010953748,-1852,,
5633552416,747.41878,8011206219,748223226,8011204367,-1852,,
5633802986,747.66935,8011456788,748473794,8011454936,-1852,,
5634053268,747.91963,8011707070,748724077,8011705219,-1851,,
5634069530,747.93589,8011723331,748740337,8011721479,-1852,8011723337,
5634319785,748.18615,8011973588,748990594,8011972200,-1388,,
5634570928,748.43729,8012224728,749241734,8012223808,-920,,
5634821071,748.68743,8012474871,749491878,8012474416,-455,,
5635072766,748.93913,8012726565,749743571,8012726573,8,,
5635323728,749.19009,8012977525,749994532,8012977533,8,,
5635574173,749.44053,8013227970,750244976,8013227978,8,,
5635825152,749.69151,8013478947,750495954,8013478955,8,,
5636076153,749.94251,8013729947,750746954,8013729956,9,,
5636092327,749.95869,8013746121,750763127,8013746128,7,8013746235,
5636349886,750.21625,8014003680,751020686,8014003715,35,,
5636600305,750.46667,8014254098,751271105,8014254161,63,,
5636850989,750.71735,8014504782,751521788,8014504871,89,,
5637101654,750.96802,8014755445,751772452,8014755561,116,,
5637351997,751.21836,8015005787,752022793,8015005903,116,,
5637602617,751.46898,8015256406,752273413,8015256522,116,,
5637852905,751.71927,8015506693,752523700,8015506810,117,,
5638103377,751.96974,8015757165,752774172,8015757281,116,,
5638119606,751.98597,8015773393,752790399,8015773509,116,8015773404,
5638369777,752.23614,8016023563,753040570,8016023654,91,,
5638620276,752.48664,8016274061,753291068,8016274126,65,,
5638870884,752.73725,8016524667,753541674,8016524707,40,,
5639121203,752.98756,8016774986,753791992,8016774999,13,,
5639371653,753.23801,8017025436,754042443,8017025449,13,,
5639621925,753.48829,8017275707,754292714,8017275720,13,,
5639872307,753.73867,8017526089,754543096,8017526102,13,,
5640122518,753.98888,8017776298,754793305,8017776311,13,,
5640138591,754.00495,8017792370,754809377,8017792383,13,8017792531,
5640389447,754.25581,8018043230,755060237,8018043280,50,,
5640639859,754.50622,8018293637,755310643,8018293725,88,,
5640890129,754.75649,8018543906,755560913,8018544032,126,,
5641140442,755.00680,8018794218,755811225,8018794382,164,,
5641391053,755.25741,8019044828,756061835,8019044992,164,,
5641641752,755.50811,8019295527,756312534,8019295690,163,,
5641892551,755.75891,8019546326,756563332,8019546489,163,,
5642142746,756.00911,8019796519,756813526,8019796682,163,,
5642159904,756.02626,8019813677,756830683,8019813839,162,8019813527,
5642410168,756.27653,8020063940,757080947,8020064025,85,,
5642660523,756.52688,8020314295,757331302,8020314302,7,,
5642911167,756.77753,8020564937,757581944,8020564868,-69,,
5643162700,757.02906,8020816470,757833477,8020816322,-148,,
5643413200,757.27956,8021066968,758083975,8021066820,-148,,
5643663813,757.53017,8021317580,758334587,8021317433,-147,,
5643914410,757.78077,8021568176,758585183,8021568028,-148,,
5644164800,758.03116,8021818566,758835573,8021818418,-148,,
5644180986,758.04735,8021834751,758851757,8021834602,-149,8021834899,
5644431469,758.29783,8022085234,759102241,8022085160,-74,,
5644682063,758.54842,8022335827,759352833,8022335827,0,,
5644933034,758.79940,8022586797,759603804,8022586873,76,,
5645183365,759.04973,8022837127,759854134,8022837277,150,,
5645433863,759.30022,8023087624,760104631,8023087774,150,,
5645684124,759.55048,8023337885,760354891,8023338035,150,,
5645937024,759.80339,8023590784,760607791,8023590934,150,,
5646188775,760.05514,8023842533,760859540,8023842683,150,,
5646207669,760.07403,8023861426,760878433,8023861576,150,8023860148,
5646457914,760.32427,8024111671,761128678,8024111465,-206,,
5646708444,760.57480,8024362201,761379208,8024361636,-565,,
5646959114,760.82547,8024612871,761629877,8024611949,-922,,
5647210031,761.07639,8024863787,761880794,8024862510,-1277,,
5647460403,761.32676,8025114158,762131164,8025112881,-1277,,
5647710636,761.57700,8025364390,762381396,8025363113,-1277,,
5647961245,761.82761,8025614997,762632003,8025613720,-1277,,
5648211631,762.07799,8025865383,762882389,8025864106,-1277,,
5648227776,762.09414,8025881526,762898533,8025880249,-1277,8025881656,
5648477918,762.34428,8026131668,763148675,8026130742,-926,,
5648728354,762.59471,8026382104,763399110,8026381531,-573,,
5648979440,762.84580,8026633189,763650196,8026632971,-218,,
5649230351,763.09671,8026884099,763901106,8026884231,132,,
5649480607,763.34697,8027134355,764151362,8027134486,131,,
5649730845,763.59721,8027384591,764401598,8027384722,131,,
5649982186,763.84855,8027635932,764652938,8027636063,131,,
5650232928,764.09929,8027886673,764903679,8027886804,131,,
5650249031,764.11539,8027902775,764919781,8027902905,130,8027902912,
5650499229,764.36559,8028152973,765169980,8028153106,133,,
5650749667,764.61603,8028403409,765420416,8028403544,135,,
5651000115,764.86648,8028653856,765670863,8028653993,137,,
5651250399,765.11676,8028904139,765921146,8028904279,140,,
5651500581,765.36694,8029154321,766171328,8029154460,139,,
5651751382,765.61774,8029405121,766422127,8029405260,139,,
5652002234,765.86860,8029655972,766672979,8029656111,139,,
5652252431,766.11879,8029906168,766923175,8029906307,139,,
5652269206,766.13557,8029922943,766939949,8029923081,138,8029922889,
5652520072,766.38643,8030173808,767190815,8030173900,92,,
5652770693,766.63705,8030424428,767441435,8030424472,44,,
5653021005,766.88737,8030674740,767691746,8030674736,-4,,
5653271452,767.13781,8030925185,767942192,8030925133,-52,,
5653521995,767.38836,8031175727,768192733,8031175675,-52,,
5653772471,767.63883,8031426202,768443209,8031426150,-52,,
5654025281,767.89164,8031679011,768696018,8031678959,-52,,
5654283784,768.15014,8031937514,768954521,8031937462,-52,,
5654300398,768.16676,8031954126,768971133,8031954074,-52,8031954112,
5654550448,768.41681,8032204177,769221183,8032204135,-42,,
5654800626,768.66699,8032454354,769471361,8032454322,-32,,
5655050919,768.91728,8032704647,769721654,8032704626,-21,,
5655301706,769.16807,8032955433,769972439,8032955421,-12,,
5655552134,769.41850,8033205859,770222866,8033205848,-11,,
5655802388,769.66875,8033456112,770473119,8033456100,-12,,
5656053045,769.91941,8033706769,770723776,8033706757,-12,,
5656303470,770.16983,8033957192,770974199,8033957180,-12,,
5656319749,770.18611,8033973470,770990476,8033973458,-12,8033973604,
5656570066,770.43643,8034223787,771240794,8034223812,25,,
5656820212,770.68657,8034473933,771490940,8034473994,61,,
5657070710,770.93707,8034724431,771741438,8034724529,98,,
5657321011,771.18737,8034974731,771991738,8034974867,136,,
5657571565,771.43793,8035225284,772242291,8035225420,136,,
5657821950,771.68831,8035475667,772492674,8035475803,136,,
5658072599,771.93896,8035726315,772743322,8035726452,137,,
5658323695,772.19006,8035977411,772994418,8035977547,136,,
5658339832,772.20619,8035993546,773010552,8035993693,147,8035993668,
5658590432,772.45679,8036244146,773261164,8036244289,143,,
5658840949,772.70731,8036494662,773511669,8036494792,130,,
5659091636,772.95800,8036745349,773762356,8036745476,127,,
5659342187,773.20855,8036995899,774012906,8036996023,124,,
5659592421,773.45878,8037246132,774263139,8037246256,124,,
5659842544,773.70890,8037496253,774513260,8037496378,125,,
5660093346,773.95971,8037747055,774764062,8037747179,124,,
5660343496,774.20986,8037997204,775014211,8037997339,135,,
5660359797,774.22616,8038013504,775030511,8038013628,124,8038013606,
5660610273,774.47663,8038263980,775280987,8038264100,120,,
5660860766,774.72713,8038514473,775531479,8038514591,118,,
5661120665,774.98703,8038774370,775791377,8038774486,116,,
5661370868,775.23723,8039024573,776041579,8039024687,114,,
5661621802,775.48816,8039275506,776292512,8039275620,114,,
5661872132,775.73849,8039525835,776542841,8039525949,114,,
5662122328,775.98869,8039776031,776793038,8039776145,114,,
5662372901,776.23926,8040026602,777043609,8040026717,115,,
5662389125,776.25549,8040042825,777059832,8040042939,114,8040042861,
5662639279,776.50564,8040292979,777309985,8040293073,94,,
5662889508,776.75587,8040543207,777560224,8040543292,85,,
5663140087,777.00645,8040793785,777810792,8040793841,56,,
5663390372,777.25673,8041044069,778061075,8041044107,38,,
5663640611,777.50697,8041294307,778311314,8041294345,38,,
5663892467,777.75883,8041546163,778563170,8041546201,38,,
5664144163,778.01052,8041797858,778814865,8041797896,38,,
5664394437,778.26080,8042048131,779065138,8042048169,38,,
5664412965,778.27933,8042066657,779083664,8042066695,38,8042065814,
5664663472,778.52983,8042317165,779334172,8042316982,-183,,
5664914269,778.78063,8042567962,779584968,8042567559,-403,,
5665165057,779.03142,8042818748,779835755,8042818124,-624,,
5665415308,779.28167,8043068998,780086005,8043068157,-841,,
5665665809,779.53217,8043319498,780336505,8043318656,-842,,
5665916309,779.78267,8043569998,780587004,8043569156,-842,,
5666166940,780.03330,8043820628,780837634,8043819786,-842,,
5666417197,780.28356,8044070883,781087890,8044070041,-842,,
5666433404,780.29976,8044087090,781104096,8044086248,-842,8044087267,
5666684082,780.55044,8044337767,781354774,8044337181,-586,,
5666934776,780.80114,8044588460,781605467,8044588131,-329,,
5667185010,781.05137,8044838694,781855701,8044838620,-74,,
5667438189,781.30455,8045091872,782108879,8045092051,179,,
5667688873,781.55523,8045342555,782359561,8045342734,179,,
5667939223,781.80558,8045592904,782609911,8045593083,179,,
5668189918,782.05628,8045843599,782860605,8045843778,179,,
5668440537,782.30690,8046094216,783111223,8046094396,180,,
5668456758,782.32312,8046110436,783127442,8046110614,178,8046110459,
5668707409,782.57377,8046361087,783378093,8046361226,139,,
5668957874,782.82424,8046611551,783628558,8046611652,101,,
5669208155,783.07452,8046861831,783878838,8046861894,63,,
5669458622,783.32498,8047112297,784129304,8047112322,25,,
5669709353,783.57571,8047363029,784380035,8047363054,25,,
5669959815,783.82618,8047613489,784630496,8047613514,25,,
5670210327,784.07669,8047864000,784881007,8047864026,26,,
5670464509,784.33087,8048118181,785135188,8048118206,25,,
5670480954,784.34731,8048134626,785151632,8048134650,24,8048134514,
5670731186,784.59755,8048384857,785401864,8048384847,-10,,
5670981932,784.84829,8048635602,785652609,8048635559,-43,,
5671232529,785.09889,8048886198,785903205,8048886121,-77,,
5671483764,785.35013,8049137433,786154439,8049137323,-110,,
5671734182,785.60054,8049387849,786404855,8049387739,-110,,
5671984870,785.85123,8049638537,786655544,8049638427,-110,,
5672235771,786.10213,8049889437,786906444,8049889327,-110,,
5672486301,786.35266,8050139967,787156973,8050139857,-110,,
5672502641,786.36900,8050156306,787173312,8050156196,-110,8050156373,
5672753466,786.61983,8050407130,787424137,8050407065,-65,,
5673004206,786.87057,8050657870,787674876,8050657849,-21,,
5673254542,787.12090,8050908204,787925211,8050908229,25,,
5673505253,787.37161,8051158914,788175921,8051158983,69,,
5673755564,787.62193,8051409224,788426231,8051409293,69,,
5674005899,787.87226,8051659558,788676565,8051659627,69,,
5674256685,788.12305,8051910343,788927350,8051910412,69,,
5674507414,788.37378,8052161073,789178080,8052161142,69,,
5674523561,788.38992,8052177217,789194224,8052177286,69,8052177332,
5674774359,788.64072,8052428017,789445023,8052428098,81,,
5675024877,788.89124,8052678534,789695540,8052678626,92,,
5675275468,789.14183,8052929124,789946131,8052929229,105,,
5675526139,789.39250,8053179793,790196800,8053179911,118,,
5675776628,789.64299,8053430281,790447288,8053430398,117,,
5676028164,789.89453,8053681817,790698824,8053681934,117,,
5676283414,790.14977,8053937065,790954072,8053937182,117,,
5676534048,790.40041,8054187698,791204705,8054187815,117,,
5676550237,790.41660,8054203886,791220892,8054204003,117,8054203883,
5676801234,790.66760,8054454883,791471890,8054454971,88,,
5677051394,790.91776,8054705042,791722049,8054705100,58,,
5677301714,791.16808,8054955362,791972369,8054955391,29,,
5677551875,791.41824,8055205522,792222528,8055205521,-1,,
5677802458,791.66882,8055456104,792473111,8055456103,-1,,
5678052696,791.91906,8055706342,792723348,8055706341,-1,,
5678302981,792.16934,8055956626,792973633,8055956625,-1,,
5678553769,792.42013,8056207412,793224419,8056207411,-1,,
5678571161,792.43752,8056224803,793241810,8056224802,-1,8056224342,
5678821726,792.68809,8056475368,793492375,8056475251,-117,,
5679072321,792.93868,8056725962,793742969,8056725731,-231,,
5679325784,793.19214,8056979424,793996430,8056979077,-347,,
5679575887,793.44225,8057229526,794246533,8057229066,-460,,
5679826229,793.69259,8057479868,794496875,8057479409,-459,,
5680077185,793.94355,8057730823,794747830,8057730364,-459,,
5680327477,794.19384,8057981115,794998121,8057980655,-460,,
5680577969,794.44433,8058231606,795248612,8058231146,-460,,
5680594043,794.46040,8058247678,795264696,8058247229,-449,8058247791,
5680844578,794.71094,8058498213,795515220,8058497896,-317,,
5681094782,794.96114,8058748417,795765423,8058748244,-173,,
5681344886,795.21125,8058998519,796015526,8058998490,-29,,
5681595438,795.46180,8059249070,796266077,8059249184,114,,
5681847760,795.71412,8059501392,796518399,8059501506,114,,
5682098252,795.96461,8059751882,796768888,8059751996,114,,
5682348734,796.21510,8060002365,797019371,8060002479,114,,
5682598903,796.46526,8060252533,797269550,8060252658,125,,
5682615295,796.48166,8060268923,797285930,8060269037,114,8060269165,
5682865890,796.73225,8060519518,797536525,8060519665,147,,
5683116717,796.98308,8060770344,797787351,8060770524,180,,
5683367011,797.23337,8061020637,798037643,8061020849,212,,
5683617392,797.48375,8061271018,798288024,8061271261,243,,
5683867793,797.73415,8061521416,798538423,8061521660,244,,
5684118325,797.98469,8061771949,798788955,8061772193,244,,
5684368491,798.23485,8062022113,799039120,8062022357,244,,
5684618682,798.48504,8062272304,799289311,8062272548,244,,
5684634838,798.50120,8062288458,799305465,8062288702,244,8062288534,
5684885415,798.75178,8062539036,799556042,8062539238,202,,
5685135542,799.00190,8062789162,799806169,8062789322,160,,
5685386216,799.25258,8063039835,800056842,8063039954,119,,
5685636313,799.50267,8063289931,800306938,8063290008,77,,
5685886852,799.75321,8063540469,800557476,8063540546,77,,
5686137385,800.00375,8063791002,800808009,8063791079,77,,
5686388493,800.25485,8064042108,801059115,8064042185,77,,
5686639101,800.50546,8064292716,801309722,8064292793,77,,
5686655316,800.52168,8064308929,801325936,8064309006,77,8064309038,
5686905793,800.77215,8064559406,801576413,8064559491,85,,
5687156195,801.02256,8064809807,801826814,8064809900,93,,
5687406441,801.27280,8065060054,802077060,8065060156,102,,
5687656857,801.52322,8065310468,802327475,8065310578,110,,
5687907365,801.77373,8065560975,802577982,8065561085,110,,
5688158002,802.02436,8065811611,802828617,8065811721,110,,
5688408140,802.27450,8066061748,803078755,8066061858,110,,
5688658718,802.52508,8066312325,803329332,8066312435,110,,
5688675457,802.54182,8066329063,803346070,8066329173,110,8066328883,
5688926197,802.79256,8066579804,803596810,8066579841,37,,
5689176334,803.04269,8066829940,803846947,8066829905,-35,,
5689426870,803.29323,8067080475,804097492,8067080378,-97,,
5689677302,803.54366,8067330906,804347913,8067330729,-177,,
5689927636,803.79400,8067581239,804598246,8067581061,-178,,
5690177974,804.04434,8067831577,804848583,8067831399,-178,,
5690428425,804.29479,8068082027,805099044,8068081860,-167,,
5690678987,804.54535,8068332587,805349594,8068332409,-178,,
5690695149,804.56151,8068348749,805365755,8068348570,-179,8068348917,
5690945688,804.81205,8068599287,805616294,8068599195,-92,,
5691195836,805.06220,8068849435,805866442,8068849430,-5,,
5691446362,805.31272,8069099959,806116966,8069100043,84,,
5691696845,805.56321,8069350442,806367449,8069350612,170,,
5691947649,805.81401,8069601245,806618252,8069601415,170,,
5692198132,806.06449,8069851735,806868742,8069851906,171,,
5692448652,806.31501,8070102247,807119253,8070102416,169,,
5692699150,806.56551,8070352743,807369750,8070352913,170,,
5692716921,806.58328,8070370514,807387520,8070370683,169,8070369708,
5692967080,806.83344,8070620672,807637679,8070620598,-74,,
5693217229,807.08359,8070870820,807887827,8070870503,-317,,
5693467859,807.33422,8071121449,808138456,8071120888,-561,,
5693718219,807.58458,8071371808,808388815,8071371004,-804,,
5693968635,807.83500,8071622223,808639230,8071621420,-803,,
5694219125,808.08549,8071872713,808889719,8071871909,-804,,
5694470252,808.33661,8072123838,809140845,8072123034,-804,,
5694734783,808.60114,8072388369,809405375,8072387565,-804,,
5694752314,808.61868,8072405898,809422904,8072405094,-804,8072405267,
5695002554,808.86892,8072656139,809673146,8072655379,-760,,
5695253222,809.11958,8072906806,809923813,8072906090,-716,,
5695504326,809.37069,8073157909,810174916,8073157238,-671,,
5695755110,809.62147,8073408693,810425699,8073408064,-629,,
5696005782,809.87214,8073659363,810676369,8073658734,-629,,
5696256481,810.12284,8073910062,810927068,8073909433,-629,,
5696506681,810.37304,8074160260,811177267,8074159631,-629,,
5696757165,810.62353,8074410743,811427750,8074410114,-629,,
5696773372,810.63973,8074426949,811443956,8074426320,-629,8074427152,
5697023471,810.88983,8074677048,811694055,8074676628,-420,,
5697273620,811.13998,8074927196,811944203,8074926983,-213,,
5697523997,811.39036,8075177574,812194581,8075177570,-4,,
5697774345,811.64071,8075427920,812444927,8075428125,205,,
5698024445,811.89081,8075678019,812695026,8075678223,204,,
5698274950,812.14131,8075928522,812945529,8075928727,205,,
5698525296,812.39166,8076178869,813195876,8076179073,204,,
5698775924,812.64229,8076429496,813446502,8076429700,204,,
5698792022,812.65838,8076445592,813462599,8076445796,204,8076445710,
5699042156,812.90852,8076695727,813712734,8076695909,182,,
5699292741,813.15910,8076946310,813963317,8076946472,162,,
5699542958,813.40932,8077196527,814213533,8077196667,140,,
5699793652,813.66001,8077447220,814464227,8077447339,119,,
5700043824,813.91018,8077697392,814714399,8077697512,120,,
5700294380,814.16074,8077947947,814964954,8077948066,119,,
5700544561,814.41092,8078198126,815215133,8078198246,120,,
5700794678,814.66104,8078448242,815465250,8078448362,120,,
5700810882,814.67724,8078464446,815481452,8078464565,119,8078464601,
5701061023,814.92738,8078714586,815731593,8078714718,132,,
5701311193,815.17755,8078964756,815981763,8078964899,143,,
5701561488,815.42785,8079215048,816232055,8079215205,157,,
5701811641,815.67800,8079465202,816482208,8079465370,168,,
5702062129,815.92849,8079715688,816732695,8079715856,168,,
5702312406,816.17877,8079965965,816982972,8079966134,169,,
5702563321,816.42968,8080216879,817233886,8080217047,168,,
5702814326,816.68069,8080467883,817484890,8080468051,168,,
5702830783,816.69714,8080484339,817501346,8080484507,168,8080484362,
5703081131,816.94749,8080734688,817751695,8080734820,132,,
5703331609,817.19797,8080985165,818002171,8080985261,96,,
5703582133,817.44849,8081235687,818252694,8081235748,61,,
5703832517,817.69888,8081486070,818503077,8081486094,24,,
5704083095,817.94946,8081736647,818753654,8081736671,24,,
5704333218,818.19958,8081986770,819003776,8081986794,24,,
5704583371,818.44973,8082236921,819253928,8082236946,25,,
5704833540,818.69990,8082487090,819504097,8082487114,24,,
5704850094,818.71645,8082503642,819520649,8082503678,36,8082503901,
5705100255,818.96662,8082753804,819770811,8082753886,82,,
5705350384,819.21674,8083003933,820020940,8083004075,142,,
5705600536,819.46690,8083254084,820271091,8083254297,213,,
5705850690,819.71705,8083504236,820521243,8083504498,262,,
5706101035,819.96740,8083754580,820771587,8083754842,262,,
5706351142,820.21750,8084004686,821021693,8084004947,261,,
5706601250,820.46761,8084254793,821271800,8084255055,262,,
5706851778,820.71814,8084505321,821522328,8084505582,261,,
5706867909,820.73427,8084521451,821538457,8084521711,260,8084521547,
5707118681,820.98504,8084772223,821789230,8084772453,230,,
5707368803,821.23516,8085022345,822039352,8085022525,180,,
5707619011,821.48537,8085272550,822289557,8085272689,139,,
5707869464,821.73582,8085523003,822540010,8085523101,98,,
5708119569,821.98593,8085773107,822790114,8085773205,98,,
5708369704,822.23607,8086023241,823040248,8086023340,99,,
5708619868,822.48623,8086273404,823290411,8086273502,98,,
5708870312,822.73667,8086523847,823540853,8086523945,98,,
5708887880,822.75424,8086541414,823558420,8086541512,98,8086540837,
5709138019,823.00438,8086791553,823808560,8086791483,-70,,
5709388612,823.25497,8087042145,824059152,8087041906,-239,,
5709638777,823.50514,8087292309,824309316,8087291902,-407,,
5709888887,823.75525,8087542419,824559426,8087541844,-575,,
5710139440,824.00580,8087792972,824809989,8087792407,-565,,
5710389623,824.25598,8088043153,825060159,8088042578,-575,,
5710639984,824.50635,8088293513,825310520,8088292939,-574,,
5710890158,824.75652,8088543686,825560693,8088543111,-575,,
5710906609,824.77297,8088560136,825577142,8088559561,-575,8088560360,
5711156873,825.02323,8088810400,825827407,8088810028,-372,,
5711407343,825.27370,8089060870,826077876,8089060701,-169,,
5711657873,825.52423,8089311399,826328405,8089311434,35,,
5711908140,825.77450,8089561664,826578671,8089561901,237,,
5712158410,826.02477,8089811934,826828941,8089812172,238,,
5712408663,826.27502,8090062187,827079194,8090062424,237,,
5712659164,826.52553,8090312686,827329693,8090312923,237,,
5712909296,826.77566,8090562817,827579824,8090563054,237,,
5712925589,826.79195,8090579110,827596116,8090579346,236,8090579319,
5713175728,827.04209,8090829248,827846255,8090829479,231,,
5713426329,827.29269,8091079849,828096855,8091080073,224,,
5713676552,827.54291,8091330071,828347078,8091330288,217,,
5713926841,827.79320,8091580358,828597365,8091580569,211,,
5714176991,828.04335,8091830507,828847514,8091830719,212,,
5714427393,828.29375,8092080908,829097915,8092081119,211,,
5714677543,828.54390,8092331058,829348065,8092331269,211,,
5714927695,828.79406,8092581209,829598215,8092581420,211,,
5714943809,828.81017,8092597323,829614329,8092597534,211,8092597515,
5715194286,829.06065,8092847799,829864806,8092848006,207,,
5715444433,829.31079,8093097945,830114952,8093098147,202,,
5715694635,829.56100,8093348146,830365153,8093348344,198,,
5715944790,829.81115,8093598300,830615308,8093598495,195,,
5716195417,830.06178,8093848926,830865933,8093849120,194,,
5716445576,830.31194,8094099085,831116092,8094099279,194,,
5716695692,830.56205,8094349199,831366205,8094349393,194,,
5716945826,830.81219,8094599332,831616339,8094599526,194,,
5716962145,830.82851,8094615650,831632656,8094615843,193,8094615652,
5717212763,831.07912,8094866268,831883275,8094866404,136,,
5717462950,831.32931,8095116456,832133462,8095116548,92,,
5717713492,831.57985,8095366997,832384004,8095367044,47,,
5717964038,831.83040,8095617541,832634548,8095617545,4,,
5718214351,832.08071,8095867854,832884861,8095867858,4,,
5718465041,832.33140,8096118542,833135549,8096118547,5,,
5718715841,832.58220,8096369342,833386349,8096369346,4,,
5718966331,832.83269,8096619830,833636837,8096619834,4,,
5718982347,832.84871,8096635846,833652852,8096635849,3,8096635987,
5719232588,833.09895,8096886087,833903093,8096886116,29,,
5719483227,833.34959,8097136725,834153731,8097136792,67,,
5719733384,833.59974,8097386882,834403889,8097386987,105,,
5719983725,833.85009,8097637222,834654228,8097637365,143,,
5720233823,834.10018,8097887319,834904325,8097887462,143,,
5720483997,834.35036,8098137491,835154497,8098137634,143,,
5720734635,834.60100,8098388128,835405135,8098388271,143,,
5720985304,834.85167,8098638796,835655803,8098638939,143,,
5721005754,834.87212,8098659246,835676252,8098659388,142,8098657307,
5721255857,835.12222,8098909349,835926355,8098908971,-378,,
5721506000,835.37236,8099159491,836176498,8099158593,-898,,
5721756169,835.62253,8099409659,836426665,8099408241,-1418,,
5722006563,835.87292,8099660051,836677058,8099658115,-1936,,
5722256743,836.12310,8099910232,836927239,8099908295,-1937,,
5722506879,836.37324,8100160366,837177373,8100158441,-1925,,
5722757034,836.62339,8100410520,837427526,8100408583,-1937,,
5723007178,836.87354,8100660663,837677670,8100658737,-1926,,
5723023792,836.89015,8100677276,837694282,8100675339,-1937,8100677193,
5723273943,837.14030,8100927427,837944434,8100925954,-1473,,
5723524104,837.39046,8101177587,838194594,8101176578,-1009,,
5723774681,837.64104,8101428163,838445170,8101427620,-543,,
5724025045,837.89141,8101678526,838695533,8101678445,-81,,
5724275432,838.14179,8101928912,838945919,8101928831,-81,,
5724525551,838.39191,8102179030,839196038,8102178950,-80,,
5724776481,838.64284,8102429961,839446978,8102429891,-70,,
5725026712,838.89307,8102680191,839697198,8102680110,-81,,
5725042898,838.90926,8102696375,839713381,8102696294,-81,8102696524,
5725293572,839.15993,8102947050,839964056,8102947027,-23,,
5725543813,839.41017,8103197289,840214296,8103197324,35,,
5725793937,839.66030,8103447412,840464419,8103447505,93,,
5726044099,839.91046,8103697573,840714580,8103697724,151,,
5726294340,840.16070,8103947813,840964820,8103947965,152,,
5726544503,840.41086,8104197976,841214982,8104198127,151,,
5726794633,840.66099,8104448104,841465111,8104448255,151,,
5727045038,840.91140,8104698508,841715515,8104698659,151,,
5727114909,840.98127,8104768378,841785385,8104768529,151,8104795399,
5727365040,841.23140,8105018509,842035527,8105025396,6887,,
5727615165,841.48153,8105268634,842285641,8105282233,13599,,
5727865450,841.73181,8105518919,842535926,8105539246,20327,,
5728116305,841.98267,8105769773,842786780,8105796817,27044,,
5728366417,842.23278,8106019883,843036890,8106046916,27033,,
5728616991,842.48335,8106270457,843287464,8106297490,27033,,
5728867451,842.73381,8106520915,843537922,8106547948,27033,,
5729117819,842.98418,8106771282,843788290,8106798316,27034,,
5729134078,843.00044,8106787540,843804547,8106814573,27033,8106787708,
5729384232,843.25059,8107037695,844054702,8107058008,20313,,
5729634379,843.50074,8107287840,844304847,8107301433,13593,,
5729885128,843.75149,8107538588,844555595,8107545445,6857,,
5730135497,844.00186,8107788957,844805964,8107789138,181,,
5730385755,844.25212,8108039215,845056222,8108039396,181,,
5730636330,844.50269,8108289788,845306795,8108289958,170,,
5730886642,844.75300,8108540099,845557106,8108540270,171,,
5731136755,845.00312,8108790211,845807218,8108790381,170,,
5731153144,845.01950,8108806600,845823606,8108806769,169,8108806813,
5731403438,845.26980,8109056893,846073900,8109057073,180,,
5731654357,845.52072,8109307811,846324817,8109308003,192,,
5731904816,845.77118,8109558270,846575276,8109558473,203,,
5732155870,846.02223,8109809323,846826330,8109809538,215,,
5732406153,846.27251,8110059604,847076611,8110059820,216,,
5732656315,846.52268,8110309766,847326773,8110309981,215,,
5732906687,846.77305,8110560137,847577143,8110560352,215,,
5733156881,847.02324,8110810330,847827337,8110810545,215,,
5733173059,847.03942,8110826508,847843514,8110826723,215,8110826636,
5733423590,847.28995,8111077038,848094045,8111077231,193,,
5733674301,847.54066,8111327748,848344755,8111327920,172,,
5733924715,847.79108,8111578161,848595168,8111578312,151,,
5734175299,848.04166,8111828745,848845752,8111828876,131,,
5734425475,848.29184,8112078919,849095926,8112079049,130,,
5734675632,848.54199,8112329075,849346082,8112329205,130,,
5734925751,848.79211,8112579192,849596199,8112579323,131,,
5735175943,849.04230,8112829387,849846403,8112829527,140,,
5735192093,849.05845,8112845534,849862540,8112845664,130,8112845688,
5735442228,849.30859,8113095669,850112676,8113095806,137,,
5735692744,849.55911,8113346184,850363191,8113346328,144,,
5735943589,849.80995,8113597028,850614035,8113597178,150,,
5736193826,850.06019,8113847265,850864272,8113847421,156,,
5736443978,850.31034,8114097415,851114422,8114097572,157,,
5736694609,850.56097,8114348046,851365053,8114348202,156,,
5736944758,850.81112,8114598194,851615200,8114598350,156,,
5737195256,851.06162,8114848690,851865697,8114848846,156,,
5737211269,851.07763,8114864703,851881709,8114864858,155,8114864829,
5737461906,851.32827,8115115339,852132346,8115115487,148,,
5737712051,851.57841,8115365484,852382491,8115365627,143,,
5737962614,851.82898,8115616046,852633053,8115616181,135,,
5738213184,852.07955,8115866615,852883622,8115866743,128,,
5738463359,852.32972,8116116789,853133796,8116116917,128,,
5738713530,852.57989,8116366959,853383966,8116367087,128,,
5738963948,852.83031,8116617376,853634383,8116617504,128,,
5739214370,853.08073,8116867797,853884803,8116867925,128,,
5739231007,853.09737,8116884434,853901440,8116884561,127,8116884330,
5739481774,853.34813,8117135200,854152206,8117135269,69,,
5739732036,853.59840,8117385461,854402468,8117385474,13,,
5739982783,853.84914,8117636207,854653213,8117636161,-46,,
5740234259,854.10062,8117887683,854904690,8117887581,-102,,
5740485128,854.35149,8118138551,855155558,8118138449,-102,,
5740735357,854.60172,8118388780,855405786,8118388678,-102,,
5740986736,854.85310,8118640156,855657163,8118640055,-101,,
5741237245,855.10361,8118890665,855907671,8118890563,-102,,
5741253432,855.11979,8118906851,855923858,8118906749,-102,8118906914,
5741503673,855.37003,8119157093,856174100,8119157033,-60,,
5741753801,855.62016,8119407219,856424226,8119407200,-19,,
5742004409,855.87077,8119657827,856674833,8119657850,23,,
5742254722,856.12108,8119908138,856925145,8119908203,65,,
5742504902,856.37126,8120158317,857175324,8120158382,65,,
5742755571,856.62193,8120408987,857425994,8120409051,64,,
5743005866,856.87223,8120659280,857676286,8120659344,64,,
5743256583,857.12294,8120909997,857927004,8120910072,75,,
5743273011,857.13937,8120926424,857943430,8120926487,63,8120926542,
5743523870,857.39023,8121177283,858194290,8121177360,77,,
5743774343,857.64070,8121427754,858444761,8121427846,92,,
5744024495,857.89086,8121677906,858694913,8121678012,106,,
5744274605,858.14097,8121928015,858945021,8121928134,119,,
5744525213,858.39157,8122178621,859195628,8122178741,120,,
5744775381,858.64174,8122428788,859445795,8122428908,120,,
5745025797,858.89216,8122679203,859696209,8122679323,120,,
5745275971,859.14233,8122929378,859946385,8122929499,121,,
5745292128,859.15849,8122945534,859962540,8122945654,120,8122945692,
5745542837,859.40920,8123196243,860213250,8123196373,130,,
5745793137,859.65950,8123446541,860463548,8123446682,141,,
5746043382,859.90974,8123696786,860713792,8123696936,150,,
5746294339,860.16070,8123947741,860964748,8123947902,161,,
5746544842,860.41120,8124198243,861215250,8124198403,160,,
5746795007,860.66137,8124448408,861465415,8124448568,160,,
5747045500,860.91186,8124698899,861715906,8124699059,160,,
5747295673,861.16203,8124949072,861966079,8124949232,160,,
5747311767,861.17813,8124965164,861982171,8124965324,160,8124965327,
5747561863,861.42822,8125215260,862232267,8125215422,162,,
5747811945,861.67831,8125465342,862482349,8125465504,162,,
5748062307,861.92867,8125715703,862732709,8125715867,164,,
5748312844,862.17921,8125966240,862983247,8125966405,165,,
5748563736,862.43010,8126217130,863234137,8126217295,165,,
5748814078,862.68044,8126467471,863484477,8126467636,165,,
5749064716,862.93108,8126718108,863735115,8126718273,165,,
5749315470,863.18183,8126968861,863985868,8126969026,165,,
5749331739,863.19810,8126985129,864002136,8126985294,165,8126985307,
5749582357,863.44872,8127235747,864252753,8127235915,168,,
5749833077,863.69944,8127486466,864503473,8127486638,172,,
5750083648,863.95001,8127737036,864754043,8127737212,176,,
5750333777,864.20014,8127987166,865004173,8127987347,181,,
5750584255,864.45062,8128237642,865254648,8128237822,180,,
5750834907,864.70127,8128488294,865505301,8128488474,180,,
5751085171,864.95153,8128738556,865755563,8128738737,181,,
5751335379,865.20174,8128988763,866005769,8128988943,180,,
5751351382,865.21774,8129004766,866021772,8129004945,179,8129004893,
5751601830,865.46819,8129255213,866272220,8129255380,167,,
5751851963,865.71832,8129505346,866522352,8129505501,155,,
5752102606,865.96897,8129755988,866772995,8129756131,143,,
5752352785,866.21915,8130006165,867023171,8130006295,130,,
5752603651,866.47001,8130257030,867274037,8130257160,130,,
5752854065,866.72043,8130507444,867524451,8130507574,130,,
5753104401,866.97076,8130757780,867774786,8130757910,130,,
5753354558,867.22092,8131007936,868024943,8131008067,131,,
5753370611,867.23697,8131023987,868040994,8131024117,130,8131024200,
5753620948,867.48731,8131274324,868291331,8131274476,152,,
5753871536,867.73790,8131524912,868541919,8131525085,173,,
5754122117,867.98848,8131775492,868792499,8131775686,194,,
5754372543,868.23890,8132025917,869042924,8132026132,215,,
5754622983,868.48934,8132276355,869293362,8132276570,215,,
5754873184,868.73955,8132526556,869543563,8132526771,215,,
5755123561,868.98992,8132776932,869793939,8132777147,215,,
5755373742,869.24010,8133027112,870044118,8133027327,215,,
5755389951,869.25631,8133043320,870060327,8133043535,215,8133043483,
5755640551,869.50691,8133293920,870310927,8133294122,202,,
5755890710,869.75707,8133544079,870561086,8133544268,189,,
5756140917,870.00728,8133794285,870811291,8133794461,176,,
5756391449,870.25781,8134044815,871061822,8134044979,164,,
5756641991,870.50835,8134295357,871312364,8134295521,164,,
5756892128,870.75849,8134545493,871562500,8134545657,164,,
5757142569,871.00893,8134795933,871812939,8134796108,175,,
5757392754,871.25911,8135046117,872063124,8135046281,164,,
5757409043,871.27540,8135062405,872079411,8135062568,163,8135062562,
5757659392,871.52575,8135312753,872329759,8135312915,162,,
5757910350,871.77671,8135563710,872580717,8135563872,162,,
5758161021,872.02738,8135814381,872831388,8135814541,160,,
5758411414,872.27778,8136064773,873081780,8136064932,159,,
5758661707,872.52807,8136315066,873332072,8136315225,159,,
5758912238,872.77860,8136565595,873582602,8136565754,159,,
5759163081,873.02944,8136816438,873833445,8136816597,159,,
5759413261,873.27962,8137066616,874083622,8137066775,159,,
5759429354,873.29571,8137082709,874099715,8137082867,158,8137082813,
5759679882,873.54624,8137333236,874350243,8137333380,144,,
5759930192,873.79655,8137583545,874600551,8137583676,131,,
5760180363,874.04672,8137833716,874850723,8137833836,120,,
5760430684,874.29705,8138084036,875101043,8138084143,107,,
5760680823,874.54718,8138334174,875351181,8138334280,106,,
5760931119,874.79748,8138584469,875601476,8138584575,106,,
5761181977,875.04834,8138835326,875852333,8138835432,106,,
5761432093,875.29845,8139085441,876102448,8139085547,106,,
5761448329,875.31469,8139101676,876118682,8139101782,106,8139101796,
5761698739,875.56510,8139352087,876369094,8139352198,111,,
5761949511,875.81587,8139602857,876619864,8139602971,114,,
5762199928,876.06629,8139853274,876870281,8139853393,119,,
5762450102,876.31646,8140103447,877120454,8140103569,122,,
5762700451,876.56681,8140353795,877370802,8140353917,122,,
5762951128,876.81749,8140604471,877621478,8140604594,123,,
5763201452,877.06781,8140854795,877871802,8140854917,122,,
5763452352,877.31871,8141105694,878122701,8141105816,122,,
5763468508,877.33487,8141121849,878138855,8141121970,121,8141121958,
5763718726,877.58509,8141372066,878389073,8141372184,118,,
5763968880,877.83524,8141622220,878639226,8141622336,116,,
5764219250,878.08561,8141872589,878889596,8141872702,113,,
5764469407,878.33577,8142122744,879139750,8142122855,111,,
5764719798,878.58616,8142373135,879390142,8142373246,111,,
5764969947,878.83631,8142623282,879640288,8142623393,111,,
5765220788,879.08715,8142874123,879891129,8142874234,111,,
5765471279,879.33764,8143124614,880141620,8143124725,111,,
5765487742,879.35410,8143141075,880158081,8143141186,111,8143141120,
5765737880,879.60424,8143391213,880408220,8143391308,95,,
5765988237,879.85460,8143641569,880658576,8143641648,79,,
5766238780,880.10514,8143892111,880909118,8143892175,64,,
5766489132,880.35549,8144142463,881159470,8144142510,47,,
5766739903,880.60626,8144393232,881410239,8144393279,47,,
5766990362,880.85672,8144643691,881660697,8144643738,47,,
5767241225,881.10759,8144894552,881911559,8144894599,47,,
5767491696,881.35806,8145145023,882162029,8145145070,47,,
5767508020,881.37438,8145161345,882178351,8145161392,47,8145161437,
5767758333,881.62469,8145411660,882428667,8145411718,58,,
5768008487,881.87485,8145661812,882678819,8145661882,70,,
5768259045,882.12541,8145912369,882929376,8145912452,83,,
5768509210,882.37557,8146162534,883179540,8146162627,93,,
5768759370,882.62573,8146412692,883429699,8146412786,94,,
5769009938,882.87630,8146663260,883680267,8146663353,93,,
5769260364,883.12672,8146913684,883930691,8146913778,94,,
5769510798,883.37716,8147164118,884181125,8147164211,93,,
5769530636,883.39700,8147183955,884200961,8147184047,92,8147182361,
5769781230,883.64759,8147434548,884451555,8147434218,-330,,
5770031550,883.89791,8147684868,884701875,8147684116,-752,,
5770282303,884.14866,8147935621,884952628,8147934447,-1174,,
5770532662,884.39902,8148185979,885202985,8148184387,-1592,,
5770783053,884.64941,8148436368,885453375,8148434776,-1592,,
5771033408,884.89977,8148686722,885703729,8148685130,-1592,,
5771283601,885.14996,8148936914,885953921,8148935322,-1592,,
5771534195,885.40056,8149187507,886204514,8149185915,-1592,,
5771551936,885.41830,8149205248,886222254,8149203656,-1592,8149204597,
5771802257,885.66862,8149455569,886472575,8149454212,-1357,,
5772052337,885.91870,8149705647,886722654,8149704526,-1121,,
5772303017,886.16938,8149956327,886973333,8149955443,-884,,
5772553165,886.41953,8150206473,887223480,8150205824,-649,,
5772803723,886.67008,8150457031,887474037,8150456382,-649,,
5773054361,886.92072,8150707668,887724675,8150707019,-649,,
5773304788,887.17115,8150958094,887975101,8150957446,-648,,
5773555435,887.42180,8151208741,888225748,8151208092,-649,,
5773571653,887.43801,8151224958,888241964,8151224309,-649,8151225050,
5773822367,887.68873,8151475671,888492678,8151475208,-463,,
5774072909,887.93927,8151726213,888743220,8151725936,-277,,
5774323705,888.19007,8151977007,888994014,8151976918,-89,,
5774573839,888.44020,8152227140,889244147,8152227234,94,,
5774824471,888.69083,8152477771,889494778,8152477865,94,,
5775074607,888.94097,8152727906,889744913,8152728000,94,,
5775324754,889.19111,8152978055,889995062,8152978149,94,,
5775574872,889.44123,8153228170,890245177,8153228264,94,,
5775591107,889.45747,8153244405,890261411,8153244498,93,8153244599,
5775841170,889.70753,8153494468,890511475,8153494587,119,,
5776091313,889.95767,8153744610,890761617,8153744754,144,,
5776341809,890.20817,8153995105,891012111,8153995275,170,,
5776592280,890.45864,8154245575,891262582,8154245771,196,,
5776842546,890.70891,8154495839,891512846,8154496036,197,,
5777092907,890.95927,8154746200,891763206,8154746396,196,,
5777343789,891.21015,8154997081,892014087,8154997277,196,,
5777594733,891.46109,8155248024,892265031,8155248221,197,,
5777611039,891.47740,8155264328,892281335,8155264524,196,8155264422,
5777861439,891.72780,8155514729,892531736,8155514901,172,,
5778111669,891.97803,8155764958,892781965,8155765104,146,,
5778361779,892.22814,8156015068,893032074,8156015189,121,,
5778612262,892.47862,8156265549,893282556,8156265646,97,,
5778862880,892.72924,8156516167,893533173,8156516263,96,,
5779113050,892.97941,8156766335,893783342,8156766432,97,,
5779363668,893.23003,8157016953,894033959,8157017049,96,,
5779614280,893.48064,8157267564,894284570,8157267660,96,,
5779630400,893.49676,8157283682,894300689,8157283778,96,8157283898,
5779880793,893.74715,8157534075,894551082,8157534201,126,,
5780131124,893.99748,8157784406,894801412,8157784562,156,,
5780381856,894.24822,8158035138,895052144,8158035324,186,,
5780632390,894.49875,8158285671,895302677,8158285888,217,,
5780884586,894.75095,8158537866,895554872,8158538083,217,,
5781135087,895.00145,8158788366,895805373,8158788583,217,,
5781385368,895.25173,8159038646,896055653,8159038863,217,,
5781636272,895.50263,8159289548,896306555,8159289765,217,,
5781652561,895.51892,8159305837,896322843,8159306054,217,8159305989,
5781903011,895.76937,8159556286,896573293,8159556486,200,,
5782153102,896.01946,8159806376,896823383,8159806561,185,,
5782403347,896.26971,8160056620,897073627,8160056789,169,,
5782653477,896.51984,8160306751,897323757,8160306905,154,,
5782903750,896.77011,8160557023,897574029,8160557177,154,,
5783153950,897.02031,8160807221,897824228,8160807376,155,,
5783404080,897.27044,8161057350,898074357,8161057504,154,,
5783654349,897.52071,8161307619,898324625,8161307773,154,,
5783670552,897.53691,8161323820,898340827,8161323974,154,8161324000,
5783920687,897.78705,8161573955,898590962,8161574116,161,,
5784171008,898.03737,8161824275,898841282,8161824443,168,,
5784421658,898.28802,8162074924,899091931,8162075099,175,,
5784672191,898.53855,8162325456,899342463,8162325638,182,,
5784922772,898.78913,8162576035,899593042,8162576218,183,,
5785172966,899.03933,8162826230,899843237,8162826412,182,,
5785423107,899.28947,8163076370,900093377,8163076552,182,,
5785673423,899.53978,8163326685,900343692,8163326868,183,,
5785689552,899.55591,8163342814,900359820,8163342995,181,8163342994,
5785939910,899.80627,8163593172,900610178,8163593354,182,,
5786190447,900.05681,8163843707,900860714,8163843889,182,,
5786440808,900.30717,8164094067,901111074,8164094249,182,,
5786691328,900.55769,8164344587,901361594,8164344769,182,,
5786941592,900.80795,8164594850,901611856,8164595031,181,,
5787191781,901.05814,8164845036,901862043,8164845219,183,,
5787441911,901.30827,8165095166,902112172,8165095348,182,,
5787692194,901.55855,8165345450,902362457,8165345632,182,,
5787708293,901.57465,8165361548,902378554,8165361730,182,8165361672,
5787958828,901.82519,8165612083,902629090,8165612250,167,,
5788209423,902.07578,8165862676,902879683,8165862830,154,,
5788459645,902.32601,8166112898,903129905,8166113039,141,,
5788709795,902.57616,8166363046,903380053,8166363172,126,,
5788960331,902.82669,8166613582,903630589,8166613709,127,,
5789210883,903.07724,8166864146,903881153,8166864272,126,,
5789461111,903.32747,8167114360,904131366,8167114486,126,,
5789711498,903.57786,8167364745,904381752,8167364871,126,,
5789727578,903.59394,8167380824,904397831,8167380950,126,8167381040,
5789977826,903.84419,8167631073,904648080,8167631222,149,,
5790228135,904.09450,8167881382,904898389,8167881554,172,,
5790478710,904.34507,8168131956,905148963,8168132151,195,,
5790728861,904.59522,8168382105,905399112,8168382324,219,,
5790979471,904.84583,8168632714,905649720,8168632932,218,,
5791230349,905.09671,8168883592,905900598,8168883810,218,,
5791480917,905.34728,8169134159,906151165,8169134377,218,,
5791731111,905.59747,8169384350,906401357,8169384568,218,,
5791747279,905.61364,8169400518,906417524,8169400736,218,8169400645,
5791997638,905.86400,8169650878,906667885,8169651074,196,,
5792247925,906.11429,8169901163,906918170,8169901336,173,,
5792498207,906.36457,8170151444,907168450,8170151595,151,,
5792748369,906.61473,8170401607,907418613,8170401736,129,,
5792998681,906.86504,8170651918,907668925,8170652047,129,,
5793249748,907.11611,8170902984,907919991,8170903124,140,,
5793499884,907.36625,8171153118,908170125,8171153248,130,,
5793750266,907.61663,8171403499,908420505,8171403628,129,,
5793766448,907.63281,8171419680,908436687,8171419809,129,8171419814,
5794016785,907.88315,8171670018,908687025,8171670148,130,,
5794267427,908.13379,8171920658,908937665,8171920791,133,,
5794517585,908.38395,8172170815,909187822,8172170948,133,,
5794768473,908.63483,8172421702,909438709,8172421837,135,,
5795019028,908.88539,8172672256,909689263,8172672391,135,,
5795269553,909.13591,8172922782,909939788,8172922917,135,,
5795520065,909.38643,8173173293,910190299,8173173427,134,,
5795770626,909.63699,8173423853,910440859,8173423988,135,,
5795786732,909.65309,8173439957,910456964,8173440092,135,8173440133,
5796036905,909.90327,8173690130,910707137,8173690276,146,,
5796287356,910.15372,8173940581,910957588,8173940747,166,,
5796538234,910.40459,8174191457,911208464,8174191624,167,,
5796788732,910.65509,8174441954,911458961,8174442132,178,,
5797038885,910.90525,8174692107,911709114,8174692285,178,,
5797289015,911.15538,8174942236,911959243,8174942415,179,,
5797539697,911.40606,8175192918,912209925,8175193096,178,,
5797790350,911.65671,8175443569,912460576,8175443748,179,,
5797806443,911.67280,8175459661,912476668,8175459839,178,8175459796,
5798056875,911.92324,8175710093,912727100,8175710260,167,,
5798307542,912.17390,8175960760,912977767,8175960917,157,,
5798558141,912.42450,8176211358,913228364,8176211505,147,,
5798808478,912.67484,8176461693,913478700,8176461830,137,,
5799058614,912.92498,8176711829,913728836,8176711965,136,,
5799308932,913.17529,8176962145,913979152,8176962292,147,,
5799559363,913.42572,8177212575,914229582,8177212711,136,,
5799809855,913.67622,8177463067,914480073,8177463203,136,,
5799825926,913.69229,8177479137,914496143,8177479272,135,8177479383,
5800076120,913.94248,8177729330,914746337,8177729493,163,,
5800326901,914.19326,8177980111,914997118,8177980303,192,,
5800577163,914.44352,8178230372,915247378,8178230592,220,,
5800827802,914.69416,8178481010,915498017,8178481258,248,,
5801078148,914.94451,8178731356,915748362,8178731604,248,,
5801328794,915.19515,8178982000,915999007,8178982248,248,,
5801579386,915.44575,8179232591,916249598,8179232839,248,,
5801829808,915.69617,8179483013,916500020,8179483262,249,,
5801846006,915.71237,8179499209,916516215,8179499457,248,8179499308,
5802096720,915.96308,8179749924,916766930,8179750134,210,,
5802346898,916.21326,8180000100,917017107,8180000274,174,,
5802597182,916.46354,8180250384,917267390,8180250521,137,,
5802847364,916.71372,8180500566,917517572,8180500667,101,,
5803098090,916.96445,8180751290,917768297,8180751392,102,,
5803348912,917.21527,8181002111,918019118,8181002212,101,,
5803599255,917.46562,8181252453,918269460,8181252554,101,,
5803849744,917.71610,8181502941,918519948,8181503042,101,,
5803866031,917.73239,8181519227,918536234,8181519328,101,8181519376,
5804116176,917.98254,8181769373,918786379,8181769486,113,,
5804366288,918.23265,8182019483,919036490,8182019609,126,,
5804616529,918.48289,8182269723,919286730,8182269863,140,,
5804866652,918.73301,8182519845,919536852,8182519996,151,,
5805116781,918.98314,8182769974,919786981,8182770125,151,,
5805366923,919.23328,8183020115,920037133,8183020277,162,,
5805617437,919.48380,8183270628,920287634,8183270779,151,,
5805868049,919.73441,8183521240,920538247,8183521391,151,,
5805884358,919.75072,8183537547,920554553,8183537697,150,8183537749,
5806134613,920.00097,8183787802,920804809,8183787957,155,,
5806384761,920.25112,8184037949,921054955,8184038121,172,,
5806634919,920.50128,8184288106,921305112,8184288294,188,,
5806885238,920.75160,8184538424,921555431,8184538628,204,,
5807135746,921.00211,8184788931,921805938,8184789135,204,,
5807385968,921.25233,8185039152,922056159,8185039356,204,,
5807636426,921.50279,8185289610,922306617,8185289814,204,,
5807886922,921.75328,8185540106,922557112,8185540309,203,,
5807903206,921.76957,8185556388,922573395,8185556592,204,8185556486,
5808154238,922.02060,8185807421,922824428,8185807599,178,,
5808404355,922.27072,8186057536,923074542,8186057688,152,,
5808654941,922.52130,8186308122,923325129,8186308248,126,,
5808905109,922.77147,8186558288,923575295,8186558389,101,,
5809155506,923.02187,8186808684,923825691,8186808784,100,,
5809405828,923.27219,8187059006,924076013,8187059106,100,,
5809656632,923.52299,8187309809,924326816,8187309910,101,,
5809907129,923.77349,8187560304,924577311,8187560405,101,,
5809923311,923.78967,8187576486,924593492,8187576586,100,8187576662,
5810173467,924.03983,8187826642,924843649,8187826762,120,,
5810423751,924.29011,8188076925,925093932,8188077063,138,,
5810674112,924.54047,8188327285,925344292,8188327444,159,,
5810924765,924.79113,8188577937,925594944,8188578115,178,,
5811175380,925.04174,8188828551,925845558,8188828729,178,,
5811425992,925.29235,8189079163,926096170,8189079341,178,,
5811676634,925.54300,8189329803,926346810,8189329981,178,,
5811927092,925.79345,8189580260,926597267,8189580438,178,,
5811943297,925.80966,8189596464,926613471,8189596642,178,8189596641,
5812193563,926.05992,8189846730,926863737,8189846907,177,,
5812444255,926.31062,8190097422,927114429,8190097599,177,,
5812694831,926.56119,8190347998,927365005,8190348177,179,,
5812945469,926.81183,8190598635,927615641,8190598813,178,,
5813195685,927.06205,8190848849,927865856,8190849028,179,,
5813445805,927.31217,8191098969,928115975,8191099146,177,,
5813696289,927.56265,8191349451,928366458,8191349629,178,,
5813946532,927.81289,8191599693,928616700,8191599872,179,,
5813962610,927.82897,8191615770,928632777,8191615948,178,8191615991,
5814213257,928.07962,8191866417,928883424,8191866606,189,,
5814463840,928.33020,8192116999,929134006,8192117199,200,,
5814714065,928.58043,8192367223,929384230,8192367435,212,,
5814964702,928.83106,8192617860,929634866,8192618082,222,,
5815216466,929.08283,8192869624,929886630,8192869846,222,,
5815466843,929.33320,8193120000,930137006,8193120222,222,,
5815717227,929.58359,8193370382,930387389,8193370604,222,,
5815967513,929.83387,8193620667,930637674,8193620889,222,,
5815983712,929.85007,8193636866,930653872,8193637087,221,8193637007,
5816234274,930.10064,8193887427,930904434,8193887629,202,,
5816484446,930.35081,8194137599,931154606,8194137782,183,,
5816735278,930.60164,8194388429,931405436,8194388592,163,,
5816985868,930.85223,8194639018,931656025,8194639162,144,,
5817236249,931.10261,8194889398,931906405,8194889542,144,,
5817487221,931.35358,8195140370,932157377,8195140513,143,,
5817737334,931.60370,8195390483,932407490,8195390626,143,,
5817990348,931.85671,8195643495,932660502,8195643639,144,,
5818006249,931.87261,8195659396,932676402,8195659539,143,8195659574,
5818256809,932.12317,8195909956,932926963,8195910107,151,,
5818507508,932.37387,8196160653,933177660,8196160814,161,,
5818757675,932.62404,8196410821,933427827,8196410991,170,,
5819008090,932.87445,8196661233,933678240,8196661413,180,,
5819258824,933.12518,8196911966,933928973,8196912146,180,,
5819509340,933.37570,8197162482,934179488,8197162662,180,,
5819759788,933.62615,8197412929,934429935,8197413109,180,,
5820010064,933.87643,8197663205,934680211,8197663385,180,,
5820026435,933.89280,8197679573,934696580,8197679753,180,8197679588,
5820280841,934.14720,8197933981,934950988,8197934119,138,,
5820531296,934.39766,8198184435,935201441,8198184532,97,,
5820800283,934.66664,8198453421,935470428,8198453475,54,,
5821055715,934.92208,8198708851,935725858,8198708868,17,,
5821314386,935.18075,8198967521,935984529,8198967539,18,,
5821566267,935.43263,8199219401,936236408,8199219418,17,,
5821818858,935.68522,8199471991,936488998,8199472008,17,,
5822069626,935.93599,8199722759,936739766,8199722777,18,,
5822085819,935.95218,8199738950,936755957,8199738967,17,8199739050,
5822352402,936.21876,8200005534,937022540,8200005573,39,,
5822608903,936.47526,8200262033,937279040,8200262094,61,,
5822863953,936.73031,8200517082,937534089,8200517165,83,,
5823114224,936.98059,8200767353,937784360,8200767454,101,,
5823371554,937.23792,8201024682,938041689,8201024783,101,,
5823622408,937.48877,8201275536,938292542,8201275637,101,,
5823879449,937.74581,8201532575,938549581,8201532676,101,,
5824130226,937.99659,8201783351,938800358,8201783452,101,,
5824146431,938.01279,8201799555,938816562,8201799656,101,8201799807,
5824403295,938.26966,8202056419,939073426,8202056558,139,,
5824653996,938.52036,8202307120,939324126,8202307298,178,,
5824916964,938.78332,8202570087,939587093,8202570304,217,,
5825167453,939.03381,8202820575,939837581,8202820827,252,,
5825417930,939.28429,8203071050,940088057,8203071303,253,,
5825668293,939.53465,8203321413,940338420,8203321666,253,,
5825919173,939.78553,8203572292,940589298,8203572545,253,,
5826169683,940.03604,8203822801,940839808,8203823054,253,,
5826185801,940.05216,8203838918,940855925,8203839171,253,8203839103,
5826436413,940.30277,8204089531,941106538,8204089766,235,,
5826687346,940.55371,8204340462,941357469,8204340681,219,,
5826937610,940.80397,8204590725,941607732,8204590927,202,,
5827188363,941.05472,8204841477,941858484,8204841663,186,,
5827438782,941.30514,8205091896,942108903,8205092082,186,,
5827689182,941.55554,8205342294,942359301,8205342480,186,,
5827940077,941.80644,8205593189,942610196,8205593376,187,,
5828190479,942.05684,8205843589,942860596,8205843775,186,,
5828206616,942.07298,8205859725,942876732,8205859911,186,8205859973,
5828457238,942.32360,8206110347,943127354,8206110548,201,,
5828707500,942.57386,8206360609,943377616,8206360826,217,,
5828958176,942.82454,8206611284,943628291,8206611517,233,,
5829208354,943.07471,8206861462,943878469,8206861712,250,,
5829458859,943.32522,8207111981,944128987,8207112230,249,,
5829709043,943.57540,8207362148,944379155,8207362398,250,,
5829959653,943.82601,8207612757,944629764,8207613007,250,,
5830210504,944.07686,8207863608,944880614,8207863856,248,,
5830226821,944.09318,8207879923,944896930,8207880172,249,8207880020,
5830477431,944.34379,8208130533,945147540,8208130744,211,,
5830728143,944.59450,8208381244,945398251,8208381418,174,,
5830978784,944.84515,8208631884,945648891,8208632021,137,,
5831229244,945.09560,8208882344,945899351,8208882443,99,,
5831479551,945.34591,8209132650,946149657,8209132749,99,,
5831730237,945.59660,8209383335,946400342,8209383434,99,,
5831981097,945.84746,8209634194,946651201,8209634294,100,,
5832231337,946.09770,8209884434,946901441,8209884533,99,,
5832261575,946.12794,8209914670,946931676,8209914769,99,8209907829,
5832512280,946.37864,8210165375,947182382,8210163727,-1648,,
5832762467,946.62883,8210415562,947432569,8210412182,-3380,,
5833013055,946.87942,8210666149,947683155,8210661032,-5117,,
5833263343,947.12970,8210916435,947933442,8210909597,-6838,,
5833513864,947.38022,8211166955,948183962,8211160117,-6838,,
5833763975,947.63034,8211417067,948434074,8211410228,-6839,,
5834014914,947.88127,8211668004,948685011,8211661165,-6839,,
5834265242,948.13160,8211918332,948935338,8211911493,-6839,,
5834281235,948.14760,8211934324,948951330,8211927484,-6840,8211934475,
5834531786,948.39815,8212184875,949201881,8212179787,-5088,,
5834782853,948.64921,8212435940,949452947,8212432607,-3333,,
5835032996,948.89936,8212686083,949703090,8212684500,-1583,,
5835283542,949.14990,8212936628,949953635,8212936781,153,,
5835534140,949.40050,8213187224,950204231,8213187377,153,,
5835784769,949.65113,8213437852,950454859,8213438006,154,,
5836035348,949.90171,8213688430,950705437,8213688583,153,,
5836285461,950.15182,8213938543,950955550,8213938696,153,,
5836301632,950.16799,8213954714,950971720,8213954866,152,8213954947,
5836552077,950.41844,8214205159,951222166,8214205331,172,,
5836802689,950.66905,8214455769,951472776,8214455962,193,,
5837052876,950.91924,8214705956,951722963,8214706170,214,,
5837303339,951.16970,8214956417,951973424,8214956652,235,,
5837554131,951.42049,8215207209,952224215,8215207444,235,,
5837804316,951.67068,8215457392,952474399,8215457628,236,,
5838054542,951.92090,8215707617,952724624,8215707852,235,,
5838304889,952.17125,8215957963,952974970,8215958199,236,,
5838320955,952.18732,8215974028,952991035,8215974263,235,8215974185,
5838581153,952.44751,8216234227,953251234,8216234442,215,,
5838831631,952.69799,8216484705,953501712,8216484902,197,,
5839081766,952.94813,8216734839,953751845,8216735016,177,,
5839332377,953.19874,8216985449,954002456,8216985608,159,,
5839583066,953.44943,8217236137,954253143,8217236296,159,,
5839833404,953.69976,8217486473,954503480,8217486632,159,,
5840083669,953.95003,8217736737,954753744,8217736896,159,,
5840334107,954.20047,8217987174,955004181,8217987334,160,,
5840350285,954.21665,8218003351,955020358,8218003510,159,8218003526,
5840600656,954.46702,8218253722,955270729,8218253885,163,,
5840850796,954.71716,8218503862,955520868,8218504030,168,,
5841101126,954.96749,8218754191,955771197,8218754364,173,,
5841351682,955.21804,8219004746,956021753,8219004924,178,,
5841602466,955.46883,8219255529,956272536,8219255706,177,,
5841852647,955.71901,8219505709,956522716,8219505886,177,,
5842102790,955.96915,8219755852,956772859,8219756029,177,,
5842353419,956.21978,8220006479,957023486,8220006656,177,,
5842369781,956.23614,8220022840,957039846,8220023017,177,8220022976,
5842620311,956.48667,8220273382,957290389,8220273551,169,,
5842870749,956.73711,8220523807,957540814,8220523966,159,,
5843121233,956.98759,8220774291,957791297,8220774439,148,,
5843371432,957.23779,8221024488,958041494,8221024626,138,,
5843622067,957.48843,8221275122,958292129,8221275261,139,,
5843872201,957.73856,8221525256,958542263,8221525395,139,,
5844122950,957.98931,8221776004,958793011,8221776143,139,,
5844373198,958.23956,8222026251,959043258,8222026390,139,,
5844389496,958.25586,8222042549,959059555,8222042687,138,8222042652,
5844639637,958.50600,8222292702,959309709,8222292832,130,,
5844890014,958.75638,8222543066,959560073,8222543187,121,,
5845140157,959.00652,8222793207,959810214,8222793320,113,,
5845390686,959.25705,8223043735,960060742,8223043841,106,,
5845641182,959.50754,8223294230,960311236,8223294335,105,,
5845891410,959.75777,8223544457,960561463,8223544562,105,,
5846141559,960.00792,8223794605,960811612,8223794710,105,,
5846392499,960.25886,8224045545,961062552,8224045650,105,,
5846408690,960.27505,8224061736,961078742,8224061840,104,8224061904,
5846659189,960.52555,8224312234,961329241,8224312356,122,,
5846910112,960.77647,8224563156,961580163,8224563293,137,,
5847160618,961.02698,8224813661,961830667,8224813815,154,,
5847411357,961.27772,8225064399,962081406,8225064569,170,,
5847661871,961.52823,8225314912,962331919,8225315083,171,,
5847912108,961.77847,8225565149,962582155,8225565319,170,,
5848162905,962.02927,8225815944,962832951,8225816114,170,,
5848413124,962.27949,8226066163,963083169,8226066333,170,,
5848429504,962.29587,8226082542,963099548,8226082711,169,8226082639,
5848679784,962.54615,8226332821,963349828,8226332974,153,,
5848929912,962.79627,8226582950,963599957,8226583084,134,,
5849180338,963.04670,8226833375,963850382,8226833492,117,,
5849430956,963.29732,8227083992,964100999,8227084091,99,,
5849681294,963.54765,8227334329,964351335,8227334428,99,,
5849931944,963.79831,8227584977,964601984,8227585076,99,,
5850182554,964.04891,8227835586,964852593,8227835685,99,,
5850433364,964.29972,8228086396,965103402,8228086495,99,,
5850449531,964.31589,8228102561,965119567,8228102659,98,8228102831,
5850700028,964.56639,8228353059,965370065,8228353200,141,,
5850950494,964.81686,8228603523,965620530,8228603709,186,,
5851200778,965.06714,8228853806,965870813,8228854036,230,,
5851451317,965.31768,8229104345,966121352,8229104618,273,,
5851702255,965.56862,8229355282,966372289,8229355554,272,,
5851952775,965.81914,8229605801,966622808,8229606073,272,,
5852203818,966.07018,8229856843,966873850,8229857115,272,,
5852454067,966.32043,8230107092,967124098,8230107364,272,,
5852470256,966.33662,8230123280,967140286,8230123551,271,8230123430,
5852720388,966.58675,8230373411,967390418,8230373653,242,,
5852971038,966.83740,8230624059,967641066,8230624271,212,,
5853221538,967.08790,8230874560,967891567,8230874743,183,,
5853471792,967.33815,8231124813,968141819,8231124965,152,,
5853722157,967.58852,8231375177,968392184,8231375329,152,,
5853972668,967.83903,8231625687,968642694,8231625840,153,,
5854222855,968.08922,8231875873,968892880,8231876026,153,,
5854473224,968.33959,8232126242,969143249,8232126394,152,,
5854489340,968.35570,8232142357,969159363,8232142508,151,8232142599,
5854739906,968.60627,8232392922,969409929,8232393096,174,,
5854990441,968.85680,8232643456,969660462,8232643653,197,,
5855240796,969.10716,8232893810,969910817,8232894031,221,,
5855491532,969.35789,8233144545,970161552,8233144789,244,,
5855741898,969.60826,8233394910,970411917,8233395154,244,,
5855992311,969.85867,8233645322,970662329,8233645567,245,,
5856242572,970.10893,8233895583,970912590,8233895828,245,,
5856493174,970.35954,8234146184,971163191,8234146428,244,,
5856509402,970.37576,8234162411,971179418,8234162655,244,8234162548,
5856759965,970.62633,8234412974,971429981,8234413191,217,,
5857010088,970.87645,8234663097,971680104,8234663289,192,,
5857260581,971.12694,8234913589,971930595,8234913754,165,,
5857511129,971.37749,8235164136,972181143,8235164276,140,,
5857761300,971.62766,8235414306,972431313,8235414445,139,,
5858011463,971.87782,8235664467,972681474,8235664606,139,,
5858262018,972.12838,8235915021,972932028,8235915161,140,,
5858512175,972.37854,8236165178,973182185,8236165317,139,,
5858528736,972.39510,8236181737,973198743,8236181875,138,8236181897,
5858779422,972.64578,8236432424,973449431,8236432568,144,,
5859030211,972.89657,8236683213,973700219,8236683363,150,,
5859280741,973.14710,8236933742,973950749,8236933898,156,,
5859531502,973.39786,8237184501,974201508,8237184664,163,,
5859781676,973.64804,8237434674,974451681,8237434837,163,,
5860032191,973.89855,8237685189,974702196,8237685362,173,,
5860282820,974.14918,8237935817,974952823,8237935979,162,,
5860533149,974.39951,8238186144,975203151,8238186306,162,,
5860549293,974.41565,8238202287,975219293,8238202449,162,8238202523,
5860799665,974.66603,8238452659,975469666,8238452840,181,,
5861049821,974.91618,8238702815,975719822,8238703014,199,,
5861300543,975.16690,8238953536,975970543,8238953755,219,,
5861550671,975.41703,8239203663,976220669,8239203901,238,,
5861801426,975.66779,8239454417,976471424,8239454655,238,,
5862052123,975.91848,8239705113,976722120,8239705351,238,,
5862302353,976.16871,8239955342,976972349,8239955581,239,,
5862552970,976.41933,8240205958,977222965,8240206197,239,,
5862569256,976.43562,8240222243,977239249,8240222481,238,8240222400,
5862819768,976.68613,8240472755,977489762,8240472974,219,,
5863070618,976.93698,8240723604,977740610,8240723802,198,,
5863338920,977.20528,8240991907,978008914,8240992084,177,,
5863589547,977.45591,8241242531,978259538,8241242691,160,,
5863840163,977.70652,8241493146,978510153,8241493305,159,,
5864090975,977.95734,8241743958,978760965,8241744118,160,,
5864341340,978.20770,8241994323,979011330,8241994482,159,,
5864591742,978.45810,8242244723,979261730,8242244883,160,,
5864607831,978.47419,8242260811,979277817,8242260970,159,8242261038,
5864857979,978.72434,8242510960,979527966,8242511135,175,,
5865108386,978.97475,8242761366,979778372,8242761559,193,,
5865359028,979.22539,8243012006,980029013,8243012217,211,,
5865609182,979.47554,8243262159,980279166,8243262388,229,,
5865860202,979.72656,8243513178,980530185,8243513407,229,,
5866110574,979.97694,8243763550,980780556,8243763779,229,,
5866360705,980.22707,8244013680,981030687,8244013910,230,,
5866610862,980.47722,8244263837,981280844,8244264066,229,,
5866627077,980.49344,8244280050,981297057,8244280279,229,8244280230,
5866877612,980.74397,8244530585,981547592,8244530802,217,,
5867127772,980.99413,8244780745,981797752,8244780951,206,,
5867378136,981.24450,8245031107,982048113,8245031301,194,,
5867628293,981.49465,8245281264,982298271,8245281456,192,,
5867878447,981.74481,8245531417,982548424,8245531599,182,,
5868128962,981.99532,8245781931,982798938,8245782113,182,,
5868379180,982.24554,8246032147,983049154,8246032329,182,,
5868629736,982.49610,8246282703,983299709,8246282885,182,,
5868645962,982.51232,8246298928,983315934,8246299110,182,8246299109,
5868896296,982.76266,8246549262,983566268,8246549443,181,,
5869147064,983.01342,8246800030,983817037,8246800213,183,,
5869397317,983.26368,8247050281,984067288,8247050463,182,,
5869647828,983.51419,8247300791,984317798,8247300974,183,,
5869898660,983.76502,8247551623,984568630,8247551807,184,,
5870149298,984.01566,8247802259,984819265,8247802442,183,,
5870399840,984.26620,8248052800,985069807,8248052983,183,,
5870650223,984.51658,8248303183,985320189,8248303366,183,,
5870666408,984.53277,8248319366,985336372,8248319549,183,8248319524,
5870916773,984.78313,8248569731,985586738,8248569907,176,,
5871166888,985.03325,8248819845,985836852,8248820016,171,,
5871417459,985.28382,8249070416,986087423,8249070582,166,,
5871667732,985.53409,8249320688,986337695,8249320848,160,,
5871918290,985.78465,8249571246,986588252,8249571406,160,,
5872168686,986.03505,8249821641,986838647,8249821801,160,,
5872419194,986.28556,8250072147,987089154,8250072307,160,,
5872669323,986.53568,8250322275,987339281,8250322435,160,,
5872685588,986.55195,8250338539,987355545,8250338698,159,8250338666,
5872936577,986.80294,8250589528,987606535,8250589679,151,,
5873187191,987.05355,8250840141,987857148,8250840284,143,,
5873437479,987.30384,8251090428,988107435,8251090564,136,,
5873688302,987.55466,8251341251,988358257,8251341380,129,,
5873938706,987.80507,8251591655,988608662,8251591784,129,,
5874189515,988.05588,8251842463,988859470,8251842593,130,,
5874440035,988.30640,8252092982,989109999,8252093122,140,,
5874690428,988.55679,8252343373,989360380,8252343502,129,,
5874706670,988.57303,8252359615,989376621,8252359744,129,8252359830,
5874956767,988.82313,8252609712,989626718,8252609861,149,,
5875207074,989.07344,8252860017,989877023,8252860189,172,,
5875457235,989.32360,8253110177,990127183,8253110371,194,,
5875707776,989.57414,8253360718,990377725,8253360935,217,,
5875957997,989.82436,8253610938,990627944,8253611154,216,,
5876208423,990.07478,8253861363,990878370,8253861580,217,,
5876458589,990.32495,8254111528,991128535,8254111745,217,,
5876709347,990.57571,8254362286,991379292,8254362503,217,,
5876725619,990.59198,8254378556,991395562,8254378773,217,8254378737,
5876976156,990.84252,8254629094,991646101,8254629303,209,,
5877226809,991.09317,8254879745,991896752,8254879944,199,,
5877476920,991.34328,8255129855,992146862,8255130047,192,,
5877727077,991.59344,8255380011,992397018,8255380194,183,,
5877977424,991.84379,8255630358,992647364,8255630541,183,,
5878227670,992.09403,8255880603,992897610,8255880786,183,,
5878478314,992.34468,8256131246,993148252,8256131429,183,,
5878728829,992.59519,8256381760,993398767,8256381943,183,,
5878745147,992.61151,8256398076,993415083,8256398259,183,8256398169,
5878995990,992.86235,8256648920,993665927,8256649081,161,,
5879246369,993.11273,8256899298,993916305,8256899437,139,,
5879496656,993.36302,8257149584,994166591,8257149701,117,,
5879746809,993.61317,8257399737,994416744,8257399832,95,,
5879997254,993.86361,8257650180,994667187,8257650275,95,,
5880248020,994.11438,8257900945,994917951,8257901040,95,,
5880498561,994.36492,8258151485,995168492,8258151580,95,,
5880749319,994.61568,8258402242,995419249,8258402337,95,,
5880765476,994.63184,8258418398,995435416,8258418505,107,8258418612,
5881016112,994.88247,8258669034,995686041,8258669159,125,,
5881266664,995.13302,8258919585,995936593,8258919741,156,,
5881517065,995.38343,8259169987,996186993,8259170172,185,,
5881767420,995.63378,8259420340,996437347,8259420557,217,,
5882018267,995.88463,8259671186,996688193,8259671402,216,,
5882268719,996.13508,8259921637,996938644,8259921853,216,,
5882519438,996.38580,8260172355,997189362,8260172571,216,,
5882770019,996.63638,8260422936,997439943,8260423153,217,,
5882786319,996.65268,8260439234,997456241,8260439450,216,8260439547,
5883036460,996.90282,8260689375,997706382,8260689615,240,,
5883287300,997.15366,8260940215,997957222,8260940480,265,,
5883537520,997.40388,8261190434,998207441,8261190725,291,,
5883787838,997.65420,8261440750,998457757,8261441065,315,,
5884038535,997.90490,8261691447,998708454,8261691761,314,,
5884289249,998.15561,8261942161,998959168,8261942475,314,,
5884539363,998.40572,8262192274,999209281,8262192589,315,,
5884789945,998.65631,8262442854,999459860,8262443168,314,,
5884806115,998.67248,8262459024,999476030,8262459338,314,8262459298,
5885056438,998.92280,8262709347,999726353,8262709651,304,,
5885306682,999.17304,8262959590,999976597,8262959885,295,,
5885556971,999.42333,8263209877,1000226884,8263210163,286,,
5885807609,999.67397,8263460515,1000477522,8263460791,276,,
5886057741,999.92410,8263710646,1000727653,8263710923,277,,
5886307920,1000.17428,8263960824,1000977831,8263961100,276,,
5886558371,1000.42473,8264211275,1001228282,8264211552,277,,
5886808746,1000.67511,8264461648,1001478655,8264461925,277,,
5886825047,1000.69141,8264477948,1001494954,8264478224,276,8264478172,
5887075309,1000.94167,8264728210,1001745217,8264728472,262,,
5887325427,1001.19179,8264978327,1001995334,8264978578,251,,
5887575938,1001.44230,8265228837,1002245844,8265229075,238,,
5887826328,1001.69269,8265479227,1002496234,8265479454,227,,
5888076982,1001.94334,8265729879,1002746886,8265730106,227,,
5888327142,1002.19350,8265980039,1002997046,8265980266,227,,
5888578199,1002.44456,8266231094,1003248102,8266231321,227,,
5888828735,1002.69510,8266481630,1003498637,8266481857,227,,
5888845534,1002.71190,8266498428,1003515435,8266498654,226,8266498440,
5889096113,1002.96247,8266749008,1003766015,8266749180,172,,
5889346416,1003.21278,8266999310,1004016317,8266999430,120,,
5889596877,1003.46324,8267249770,1004266777,8267249848,78,,
5889847355,1003.71372,8267500246,1004517253,8267500261,15,,
5890097985,1003.96435,8267750876,1004767882,8267750891,15,,
5890348558,1004.21492,8268001448,1005018454,8268001463,15,,
5890598755,1004.46512,8268251644,1005268651,8268251659,15,,
5890849287,1004.71565,8268502175,1005519181,8268502190,15,,
5890865474,1004.73184,8268518361,1005535367,8268518375,14,8268518579,
5891116093,1004.98245,8268768979,1005785986,8268769045,66,,
5891366831,1005.23319,8269019717,1006036724,8269019835,118,,
5891617742,1005.48410,8269270628,1006287634,8269270797,169,,
5891870485,1005.73685,8269523369,1006540376,8269523589,220,,
5892121414,1005.98778,8269774298,1006791305,8269774518,220,,
5892371866,1006.23823,8270024748,1007041755,8270024968,220,,
5892622345,1006.48871,8270275226,1007292233,8270275446,220,,
5892873066,1006.73943,8270525947,1007542954,8270526167,220,,
5892889277,1006.75564,8270542168,1007559174,8270542387,219,8270542343,
5893139438,1007.00580,8270792317,1007809325,8270792530,213,,
5893390054,1007.25641,8271042932,1008059939,8271043136,204,,
5893640508,1007.50687,8271293386,1008310393,8271293582,196,,
5893891418,1007.75778,8271544295,1008561302,8271544485,190,,
5894141585,1008.00795,8271794462,1008811469,8271794651,189,,
5894392084,1008.25845,8272044960,1009061967,8272045149,189,,
5894642681,1008.50904,8272295555,1009312562,8272295745,190,,
5894893491,1008.75985,8272546364,1009563371,8272546554,190,,
5894909713,1008.77607,8272562585,1009579603,8272562785,200,8272562755,
5895160117,1009.02648,8272812990,1009829997,8272813175,185,,
5895410419,1009.27678,8273063291,1010080298,8273063473,182,,
5895660588,1009.52695,8273313459,1010330466,8273313636,177,,
5895910955,1009.77732,8273563824,1010580831,8273563996,172,,
5896161549,1010.02791,8273814417,1010831424,8273814590,173,,
5896411906,1010.27827,8274064774,1011081781,8274064947,173,,
5896662136,1010.52850,8274315003,1011332010,8274315176,173,,
5896912442,1010.77880,8274565309,1011582315,8274565481,172,,
5896928648,1010.79501,8274581513,1011598520,8274581685,172,8274581686,
5897178944,1011.04530,8274831809,1011848816,8274831982,173,,
5897429089,1011.29545,8275081954,1012098961,8275082126,172,,
5897679285,1011.54565,8275332148,1012349155,8275332321,173,,
5897929861,1011.79622,8275582724,1012599731,8275582898,174,,
5898180907,1012.04727,8275833768,1012850776,8275833943,175,,
5898431359,1012.29772,8276084219,1013101226,8276084404,185,,
5898681575,1012.54794,8276334435,1013351441,8276334609,174,,
5898931721,1012.79808,8276584581,1013601587,8276584755,174,,
5898947952,1012.81431,8276600811,1013617817,8276600984,173,8276601032,
5899198261,1013.06462,8276851119,1013868126,8276851304,185,,
5899448346,1013.31471,8277101203,1014118210,8277101401,198,,
5899698469,1013.56483,8277351326,1014368363,8277351567,241,,
5899948974,1013.81534,8277601829,1014618836,8277602053,224,,
5900199054,1014.06542,8277851908,1014868915,8277852131,223,,
5900449185,1014.31555,8278102037,1015119044,8278102261,224,,
5900699766,1014.56613,8278352618,1015369625,8278352841,223,,
5900950313,1014.81667,8278603164,1015620171,8278603388,224,,
5900966419,1014.83278,8278619269,1015636275,8278619492,223,8278619482,
5901216999,1015.08336,8278869850,1015886856,8278870071,221,,
5901467380,1015.33374,8279120230,1016137237,8279120449,219,,
5901717761,1015.58412,8279370610,1016387618,8279370828,218,,
5901968586,1015.83495,8279621434,1016638441,8279621649,215,,
5902218703,1016.08506,8279871550,1016888557,8279871766,216,,
5902469110,1016.33547,8280121957,1017138963,8280122172,215,,
5902719264,1016.58563,8280372110,1017389117,8280372325,215,,
5902969617,1016.83598,8280622462,1017639469,8280622677,215,,
5902985800,1016.85216,8280638643,1017655649,8280638858,215,8280638878,
5903236174,1017.10253,8280889017,1017906024,8280889240,223,,
5903486369,1017.35273,8281139212,1018156218,8281139443,231,,
5903736536,1017.60290,8281389377,1018406384,8281389617,240,,
5903986889,1017.85325,8281639731,1018656738,8281639979,248,,
5904237446,1018.10381,8281890287,1018907294,8281890535,248,,
5904488207,1018.35457,8282141046,1019158053,8282141294,248,,
5904738644,1018.60501,8282391483,1019408490,8282391731,248,,
5904989140,1018.85550,8282641977,1019658984,8282642226,249,,
5905005146,1018.87151,8282657983,1019674989,8282658230,247,8282658183,
5905255672,1019.12203,8282908508,1019925515,8282908736,228,,
5905505998,1019.37236,8283158833,1020175840,8283159052,219,,
5905756779,1019.62314,8283409614,1020426620,8283409824,210,,
5906007178,1019.87354,8283660012,1020677019,8283660214,202,,
5906257471,1020.12383,8283910304,1020927311,8283910506,202,,
5906507892,1020.37425,8284160724,1021177730,8284160926,202,,
5906758580,1020.62494,8284411411,1021428418,8284411614,203,,
5907009114,1020.87548,8284661945,1021678952,8284662147,202,,
5907025457,1020.89182,8284678286,1021695293,8284678488,202,8284678399,
5907276243,1021.14260,8284929072,1021946079,8284929253,181,,
5907527059,1021.39342,8285179888,1022196895,8285180046,158,,
5907777530,1021.64389,8285430357,1022447364,8285430494,137,,
5908027966,1021.89433,8285680792,1022697799,8285680907,115,,
5908278594,1022.14495,8285931420,1022948427,8285931535,115,,
5908529189,1022.39555,8286182014,1023199021,8286182129,115,,
5908779326,1022.64569,8286432151,1023449158,8286432266,115,,
5909029916,1022.89628,8286682739,1023699746,8286682854,115,,
5909046202,1022.91256,8286699024,1023716031,8286699139,115,8286699335,
5909296536,1023.16290,8286949358,1023966365,8286949521,163,,
5909546888,1023.41325,8287199709,1024216716,8287199922,213,,
5909797114,1023.66347,8287449934,1024466941,8287450196,262,,
5910047593,1023.91395,8287700412,1024717419,8287700724,312,,
5910298652,1024.16501,8287951470,1024968477,8287951783,313,,
5910548796,1024.41516,8288201613,1025218622,8288201928,315,,
5910798934,1024.66530,8288451751,1025468758,8288452063,312,,
5911049536,1024.91590,8288702351,1025719358,8288702664,313,,
5911065929,1024.93229,8288718743,1025735750,8288719055,312,8288718893,
5911316098,1025.18246,8288968912,1025985919,8288969183,271,,
5911566587,1025.43295,8289219401,1026236408,8289219632,231,,
5911817088,1025.68345,8289469901,1026486908,8289470093,192,,
5912067412,1025.93377,8289720225,1026737232,8289720386,161,,
5912317854,1026.18421,8289970666,1026987673,8289970817,151,,
5912568139,1026.43450,8290220949,1027237956,8290221100,151,,
5912818548,1026.68491,8290471357,1027488363,8290471508,151,,
5913068703,1026.93506,8290721512,1027738519,8290721663,151,,
5913085030,1026.95139,8290737838,1027754844,8290737988,150,8290738039,
5913335331,1027.20169,8290988139,1028005145,8290988302,163,,
5913586439,1027.45280,8291239245,1028256252,8291239422,177,,
5913836888,1027.70325,8291489694,1028506701,8291489884,190,,
5914087057,1027.95342,8291739862,1028756869,8291740066,204,,
5914337630,1028.20399,8291990435,1029007442,8291990638,203,,
5914588228,1028.45459,8292241032,1029258038,8292241235,203,,
5914838810,1028.70517,8292491612,1029508619,8292491816,204,,
5915089289,1028.95565,8292742090,1029759097,8292742294,204,,
5915105339,1028.97170,8292758140,1029775146,8292758354,214,8292758378,
5915355431,1029.22179,8293008232,1030025238,8293008444,212,,
5915606253,1029.47261,8293259052,1030276059,8293259273,221,,
5915856370,1029.72273,8293509169,1030526176,8293509400,231,,
5916106509,1029.97287,8293759307,1030776314,8293759547,240,,
5916356690,1030.22305,8294009488,1031026495,8294009728,240,,
5916606883,1030.47324,8294259679,1031276686,8294259919,240,,
5916857422,1030.72378,8294510218,1031527225,8294510458,240,,
5917107924,1030.97429,8294760719,1031777726,8294760959,240,,
5917124111,1030.99047,8294776904,1031793911,8294777144,240,8294777090,
5917374853,1031.24121,8295027646,1032044653,8295027872,226,,
5917625513,1031.49187,8295278305,1032295312,8295278519,214,,
5917875888,1031.74225,8295528680,1032545687,8295528880,200,,
5918126343,1031.99270,8295779134,1032796141,8295779321,187,,
5918376754,1032.24311,8296029544,1033046551,8296029731,187,,
5918627600,1032.49396,8296280389,1033297396,8296280576,187,,
5918878030,1032.74439,8296530818,1033547825,8296531005,187,,
5919128551,1032.99491,8296781338,1033798345,8296781526,188,,
5919144616,1033.01098,8296797403,1033814409,8296797590,187,8296797679,
5919395374,1033.26174,8297048160,1034065167,8297048370,210,,
5919646227,1033.51259,8297299012,1034316019,8297299244,232,,
5919896997,1033.76336,8297549782,1034566789,8297550037,255,,
5920147421,1034.01378,8297800205,1034817212,8297800483,278,,
5920397556,1034.26392,8298050339,1035067345,8298050617,278,,
5920648084,1034.51445,8298300865,1035317873,8298301144,279,,
5920898945,1034.76531,8298551726,1035568733,8298552004,278,,
5921149445,1035.01581,8298802224,1035819231,8298802502,278,,
5921165722,1035.03208,8298818500,1035835506,8298818778,278,8298818729,
5921415831,1035.28219,8299068611,1036085617,8299068876,265,,
5921665947,1035.53231,8299318725,1036335732,8299318979,254,,
5921916070,1035.78243,8299568847,1036585854,8299569089,242,,
5922166257,1036.03262,8299819033,1036836040,8299819264,231,,
5922416393,1036.28275,8300069168,1037086175,8300069399,231,,
5922666559,1036.53292,8300319333,1037336340,8300319564,231,,
5922916755,1036.78312,8300569528,1037586535,8300569760,232,,
5923166902,1037.03326,8300819674,1037836681,8300819905,231,,
5923183067,1037.04943,8300835838,1037852844,8300836068,230,8300836019,
5923433383,1037.29974,8301086155,1038103161,8301086365,210,,
5923683734,1037.55010,8301336505,1038353512,8301336706,201,,
5923934346,1037.80071,8301587117,1038604124,8301587310,193,,
5924184765,1038.05113,8301837534,1038854541,8301837717,183,,
5924435270,1038.30163,8302088039,1039105046,8302088223,184,,
5924685962,1038.55232,8302338729,1039355736,8302338912,183,,
5924936536,1038.80290,8302589302,1039606309,8302589486,184,,
5925186996,1039.05336,8302839762,1039856768,8302839955,193,,
5925203180,1039.06954,8302855945,1039872951,8302856128,183,8302856187,
5925453431,1039.31979,8303106195,1040123202,8303106394,199,,
5925703951,1039.57031,8303356714,1040373722,8303356938,224,,
5925954063,1039.82042,8303606826,1040623833,8303607055,229,,
5926204893,1040.07125,8303857655,1040874662,8303857910,255,,
5926455514,1040.32188,8304108275,1041125282,8304108519,244,,
5926706039,1040.57240,8304358799,1041375806,8304359043,244,,
5926956134,1040.82249,8304608894,1041625900,8304609137,243,,
5927206672,1041.07303,8304859430,1041876437,8304859675,245,,
5927222740,1041.08910,8304875497,1041892503,8304875741,244,8304875739,
5927473428,1041.33979,8305126185,1042143192,8305126430,245,,
5927724017,1041.59038,8305376773,1042393780,8305377018,245,,
5927974588,1041.84095,8305627344,1042644351,8305627588,244,,
5928224921,1042.09128,8305877675,1042894693,8305877931,256,,
5928475430,1042.34179,8306128184,1043145191,8306128428,244,,
5928726015,1042.59238,8306378768,1043395774,8306379011,243,,
5928976134,1042.84250,8306628887,1043645894,8306629142,255,,
5929226939,1043.09330,8306879690,1043896696,8306879934,244,,
5929243101,1043.10946,8306895851,1043912858,8306896095,244,8306896023,
5929494040,1043.36040,8307146790,1044163796,8307147016,226,,
5929744861,1043.61122,8307397610,1044414617,8307397818,208,,
5929995411,1043.86177,8307648159,1044665177,8307648360,201,,
5930245572,1044.11193,8307898319,1044915326,8307898493,174,,
5930495985,1044.36235,8308148732,1045165739,8308148906,174,,
5930746528,1044.61289,8308399274,1045416281,8308399447,173,,
5930996682,1044.86304,8308649427,1045666434,8308649600,173,,
5931247518,1045.11388,8308900263,1045917270,8308900436,173,,
5931263705,1045.13007,8308916447,1045933454,8308916620,173,8308916653,
5931514112,1045.38047,8309166855,1046183862,8309167035,180,,
5931764586,1045.63095,8309417328,1046434335,8309417517,189,,
5932014768,1045.88113,8309667510,1046684516,8309667708,198,,
5932264894,1046.13126,8309917635,1046934642,8309917842,207,,
5932515401,1046.38176,8310168140,1047185147,8310168348,208,,
5932766214,1046.63258,8310418952,1047435959,8310419159,207,,
5933016669,1046.88303,8310669407,1047686414,8310669614,207,,
5933267303,1047.13366,8310920039,1047937046,8310920246,207,,
5933283413,1047.14977,8310936149,1047953155,8310936355,206,8310936369,
5933533576,1047.39994,8311186312,1048203318,8311186514,202,,
5933784307,1047.65067,8311437041,1048454048,8311437251,210,,
5934034458,1047.90082,8311687192,1048704199,8311687407,215,,
5934285019,1048.15138,8311937752,1048954759,8311937974,222,,
5934535336,1048.40170,8312188069,1049205086,8312188302,233,,
5934785463,1048.65182,8312438194,1049455201,8312438417,223,,
5935035856,1048.90222,8312688587,1049705594,8312688809,222,,
5935286335,1049.15270,8312939064,1049956071,8312939287,223,,
5935302321,1049.16868,8312955049,1049972056,8312955271,222,8312955253,
5935552636,1049.41900,8313205365,1050222372,8313205583,218,,
5935802787,1049.66915,8313455514,1050472521,8313455729,215,,
5936053223,1049.91958,8313705949,1050722955,8313706159,210,,
5936304048,1050.17041,8313956774,1050973781,8313956981,207,,
5936554659,1050.42102,8314207385,1051224391,8314207591,206,,
5936804833,1050.67119,8314457557,1051474564,8314457763,206,,
5937054975,1050.92134,8314707698,1051724705,8314707904,206,,
5937305369,1051.17173,8314958091,1051975098,8314958298,207,,
5937321455,1051.18782,8314974177,1051991195,8314974394,217,8314974338,
5937571591,1051.43795,8315224313,1052241320,8315224508,195,,
5937821680,1051.68804,8315474402,1052491408,8315474586,184,,
5938072174,1051.93854,8315724894,1052741900,8315725068,174,,
5938322565,1052.18893,8315975283,1052992290,8315975447,164,,
5938573227,1052.43959,8316225945,1053242951,8316226108,163,,
5938823448,1052.68981,8316476165,1053493172,8316476328,163,,
5939074059,1052.94042,8316726776,1053743782,8316726939,163,,
5939324308,1053.19067,8316977048,1053994055,8316977211,163,,
5939341978,1053.20834,8316994693,1054011699,8316994855,162,8316994420,
5939592575,1053.45894,8317245290,1054262297,8317245343,53,,
5939843155,1053.70952,8317495869,1054512875,8317495814,-55,,
5940093425,1053.95979,8317746137,1054763144,8317745974,-163,,
5940344005,1054.21037,8317996716,1055013723,8317996446,-270,,
5940594530,1054.46089,8318247240,1055264247,8318246970,-270,,
5940844872,1054.71123,8318497581,1055514588,8318497311,-270,,
5941095858,1054.96222,8318748566,1055765573,8318748295,-271,,
5941346367,1055.21273,8318999076,1056016083,8318998805,-271,,
5941362475,1055.22884,8319015194,1056032200,8319014922,-272,8319015461,
5941613074,1055.47943,8319265781,1056282788,8319265648,-133,,
5941863667,1055.73003,8319516374,1056533381,8319516379,5,,
5942113841,1055.98020,8319766547,1056783554,8319766691,144,,
5942364396,1056.23076,8320017101,1057034107,8320017382,281,,
5942614952,1056.48131,8320267655,1057284662,8320267936,281,,
5942865468,1056.73183,8320518170,1057535177,8320518451,281,,
5943115579,1056.98194,8320768281,1057785288,8320768562,281,,
5943365671,1057.23203,8321018371,1058035378,8321018652,281,,
5943381838,1057.24820,8321034538,1058051544,8321034819,281,8321034775,
5943632099,1057.49846,8321284798,1058301805,8321285068,270,,
5943882778,1057.74914,8321535478,1058552484,8321535737,259,,
5944132955,1057.99932,8321785653,1058802660,8321785902,249,,
5944383110,1058.24947,8322035807,1059052814,8322036047,240,,
5944633987,1058.50035,8322286683,1059303689,8322286922,239,,
5944884144,1058.75050,8322536839,1059553846,8322537078,239,,
5945134938,1059.00130,8322787633,1059804639,8322787872,239,,
5945385036,1059.25140,8323037729,1060054736,8323037968,239,,
5945401130,1059.26749,8323053823,1060070829,8323054062,239,8323054041,
5945651405,1059.51777,8323304097,1060321104,8323304331,234,,
5945901753,1059.76811,8323554444,1060571451,8323554674,230,,
5946152233,1060.01859,8323804923,1060821930,8323805148,225,,
5946402597,1060.26896,8324055288,1061072295,8324055508,220,,
5946653155,1060.51952,8324305844,1061322851,8324306064,220,,
5946903286,1060.76965,8324555974,1061572981,8324556195,221,,
5947153804,1061.02016,8324806491,1061823498,8324806711,220,,
5947404464,1061.27083,8325057151,1062074157,8325057371,220,,
5947420529,1061.28689,8325073214,1062090220,8325073434,220,8325073493,
5947670992,1061.53735,8325323677,1062340684,8325323912,235,,
5947921140,1061.78750,8325573824,1062590831,8325574075,251,,
5948171933,1062.03829,8325824617,1062841623,8325824882,265,,
5948422352,1062.28871,8326075034,1063092041,8326075315,281,,
5948672495,1062.53886,8326325177,1063342184,8326325458,281,,
5948922645,1062.78901,8326575327,1063592334,8326575619,292,,
5949172968,1063.03933,8326825649,1063842656,8326825930,281,,
5949423074,1063.28943,8327075754,1064092760,8327076035,281,,
5949439409,1063.30577,8327092087,1064109094,8327092368,281,8327092381,
5949689531,1063.55589,8327342210,1064359217,8327342494,284,,
5949939671,1063.80603,8327592348,1064609355,8327592636,288,,
5950190331,1064.05669,8327843008,1064860015,8327843300,292,,
5950440489,1064.30685,8328093164,1065110170,8328093459,295,,
5950690626,1064.55699,8328343301,1065360308,8328343596,295,,
5950941094,1064.80745,8328593767,1065610774,8328594063,296,,
5951191438,1065.05780,8328844111,1065861118,8328844406,295,,
5951441567,1065.30793,8329094241,1066111258,8329094546,305,,
5951457813,1065.32417,8329110485,1066127491,8329110779,294,8329110761,
5951708425,1065.57479,8329361096,1066378103,8329361387,291,,
5951958567,1065.82493,8329611237,1066628244,8329611523,286,,
5952208722,1066.07508,8329861391,1066878398,8329861673,282,,
5952458842,1066.32520,8330111510,1067128517,8330111788,278,,
5952708974,1066.57533,8330361642,1067378648,8330361920,278,,
5952959114,1066.82548,8330611780,1067628787,8330612058,278,,
5953209641,1067.07600,8330862307,1067879314,8330862585,278,,
5953460414,1067.32677,8331113079,1068130086,8331113358,279,,
5953476418,1067.34278,8331129081,1068146087,8331129359,278,8331129366,
5953726547,1067.59291,8331379211,1068396218,8331379492,281,,
5953977026,1067.84339,8331629689,1068646696,8331629972,283,,
5954227528,1068.09389,8331880190,1068897197,8331880476,286,,
5954478334,1068.34470,8332130997,1069148013,8332131294,297,,
5954729351,1068.59571,8332382011,1069399018,8332382299,288,,
5954979850,1068.84621,8332632509,1069649516,8332632796,287,,
5955230303,1069.09666,8332882961,1069899968,8332883248,287,,
5955480408,1069.34677,8333133065,1070150072,8333133352,287,,
5955496626,1069.36299,8333149283,1070166289,8333149569,286,8333149499,
5955746765,1069.61313,8333399421,1070416428,8333399691,270,,
5955996918,1069.86328,8333649574,1070666580,8333649826,252,,
5956247103,1070.11346,8333899758,1070916765,8333899993,235,,
5956497402,1070.36376,8334150056,1071167063,8334150275,219,,
5956748130,1070.61449,8334400784,1071417791,8334401003,219,,
5956998461,1070.86482,8334651114,1071668121,8334651332,218,,
5957249067,1071.11543,8334901718,1071918725,8334901936,218,,
5957499225,1071.36559,8335151875,1072168881,8335152093,218,,
5957515327,1071.38169,8335167976,1072184982,8335168205,229,8335168174,
5957766319,1071.63268,8335418968,1072435975,8335419181,213,,
5958016967,1071.88333,8335669615,1072686621,8335669823,208,,
5958267560,1072.13392,8335920207,1072937213,8335920411,204,,
5958518017,1072.38438,8336170664,1073187671,8336170865,201,,
5958768394,1072.63476,8336421041,1073438048,8336421242,201,,
5959018561,1072.88492,8336671207,1073688214,8336671407,200,,
5959268691,1073.13505,8336921336,1073938343,8336921547,211,,
5959518829,1073.38519,8337171472,1074188479,8337171673,201,,
5959535067,1073.40143,8337187710,1074204716,8337187909,199,8337187946,
5959785641,1073.65200,8337438284,1074455291,8337438493,209,,
5960035800,1073.90216,8337688442,1074705449,8337688661,219,,
5960286349,1074.15271,8337938989,1074955996,8337939218,229,,
5960536518,1074.40288,8338189158,1075206165,8338189396,238,,
5960786847,1074.65321,8338439486,1075456492,8338439724,238,,
5961037486,1074.90385,8338690124,1075707131,8338690363,239,,
5961287863,1075.15422,8338940501,1075957507,8338940749,248,,
5961538010,1075.40437,8339190646,1076207653,8339190884,238,,
5961554212,1075.42057,8339206847,1076223853,8339207085,238,8339207012,
5961804341,1075.67070,8339456976,1076473982,8339457196,220,,
5962054691,1075.92105,8339707326,1076724332,8339707529,203,,
5962305123,1076.17148,8339957756,1076974763,8339957942,186,,
5962555373,1076.42173,8340208006,1077225012,8340208172,166,,
5962806040,1076.67240,8340458671,1077475678,8340458838,167,,
5963056126,1076.92249,8340708756,1077725762,8340708923,167,,
5963306325,1077.17269,8340958955,1077975961,8340959122,167,,
5963556661,1077.42302,8341209290,1078226296,8341209457,167,,
5963572892,1077.43925,8341225519,1078242525,8341225685,166,8341225669,
5963823299,1077.68966,8341475927,1078492934,8341476089,162,,
5964073974,1077.94034,8341726602,1078743609,8341726761,159,,
5964324732,1078.19109,8341977359,1078994366,8341977514,155,,
5964575265,1078.44163,8342227891,1079244898,8342228043,152,,
5964826009,1078.69237,8342478633,1079495640,8342478785,152,,
5965076335,1078.94270,8342728960,1079745967,8342729112,152,,
5965326477,1079.19284,8342979099,1079996106,8342979252,153,,
5965576652,1079.44301,8343229274,1080246281,8343229426,152,,
5965592794,1079.45916,8343245414,1080262421,8343245566,152,8343245651,
5965843480,1079.70984,8343496100,1080513107,8343496274,174,,
5966093753,1079.96011,8343746373,1080763380,8343746568,195,,
5966343941,1080.21030,8343996560,1081013568,8343996777,217,,
5966594053,1080.46041,8344246671,1081263678,8344246909,238,,
5966844167,1080.71053,8344496784,1081513791,8344497022,238,,
5967094671,1080.96103,8344747287,1081764294,8344747525,238,,
5967344816,1081.21118,8344997431,1082014438,8344997669,238,,
5967595815,1081.46218,8345248429,1082265436,8345248668,239,,
5967611962,1081.47832,8345264575,1082281582,8345264813,238,8345264844,
5967862320,1081.72868,8345514933,1082531940,8345515180,247,,
5968112937,1081.97930,8345765549,1082782556,8345765803,254,,
5968363397,1082.22976,8346016009,1083033016,8346016271,262,,
5968613546,1082.47991,8346266156,1083283163,8346266427,271,,
5968864125,1082.73049,8346516736,1083533743,8346517006,270,,
5969114296,1082.98066,8346766905,1083783912,8346767176,271,,
5969364467,1083.23083,8347017075,1084034082,8347017346,271,,
5969614855,1083.48122,8347267462,1084284468,8347267732,270,,
5969631223,1083.49758,8347283830,1084300836,8347284099,269,8347284010,
5969881357,1083.74772,8347533963,1084550969,8347534202,239,,
5970132153,1083.99851,8347784758,1084801764,8347784978,220,,
5970382850,1084.24921,8348035454,1085052461,8348035656,202,,
5970633502,1084.49986,8348286105,1085303112,8348286287,182,,
5970883869,1084.75023,8348536472,1085553478,8348536654,182,,
5971134052,1085.00041,8348786655,1085803662,8348786838,183,,
5971384145,1085.25051,8349036746,1086053753,8349036928,182,,
5971634275,1085.50064,8349286875,1086303882,8349287057,182,,
5971650235,1085.51660,8349302835,1086319841,8349303016,181,8349303068,
5971900861,1085.76722,8349553461,1086570468,8349553656,195,,
5972151503,1086.01786,8349804101,1086821108,8349804310,209,,
5972401861,1086.26822,8350054458,1087071465,8350054680,222,,
5972652491,1086.51885,8350305088,1087322095,8350305323,235,,
5972902718,1086.76908,8350555314,1087572320,8350555549,235,,
5973152882,1087.01924,8350805477,1087822484,8350805712,235,,
5973403302,1087.26966,8351055895,1088072902,8351056131,236,,
5973653458,1087.51982,8351306051,1088323058,8351306286,235,,
5973669602,1087.53596,8351322194,1088339200,8351322428,234,8351322461,
5973919898,1087.78626,8351572490,1088589497,8351572734,244,,
5974170255,1088.03662,8351822846,1088839853,8351823098,252,,
5974421316,1088.28768,8352073907,1089090914,8352074168,261,,
5974671865,1088.53823,8352324454,1089341461,8352324724,270,,
5974922074,1088.78843,8352574663,1089591670,8352574932,269,,
5975172560,1089.03892,8352825147,1089842154,8352825416,269,,
5975422873,1089.28923,8353075459,1090092466,8353075728,269,,
5975673407,1089.53977,8353325992,1090342999,8353326261,269,,
5975689525,1089.55589,8353342109,1090359115,8353342378,269,8353342339,
5975939905,1089.80627,8353592490,1090609497,8353592748,258,,
5976190344,1090.05670,8353842928,1090859935,8353843178,250,,
5976440772,1090.30713,8354093355,1091110362,8354093596,241,,
5976691531,1090.55789,8354344113,1091361121,8354344345,232,,
5976942075,1090.80844,8354594656,1091611663,8354594888,232,,
5977192615,1091.05898,8354845196,1091862202,8354845427,231,,
5977442792,1091.30915,8355095372,1092112378,8355095603,231,,
5977693204,1091.55957,8355345782,1092362789,8355346013,231,,
5977709266,1091.57563,8355361844,1092378850,8355362074,230,8355362046,
5977960044,1091.82641,8355612622,1092629628,8355612846,224,,
5978210197,1092.07656,8355862774,1092879790,8355863001,227,,
5978460759,1092.32712,8356113334,1093130341,8356113545,211,,
5978711069,1092.57743,8356363644,1093380651,8356363849,205,,
5978961661,1092.82802,8356614235,1093631242,8356614440,205,,
5979212045,1093.07841,8356864618,1093881624,8356864822,204,,
5979462563,1093.32892,8357115135,1094132142,8357115339,204,,
5979713464,1093.57983,8357366036,1094383042,8357366240,204,,
5979729684,1093.59605,8357382254,1094399261,8357382458,204,8357382511,
5979979834,1093.84620,8357632405,1094649412,8357632622,217,,
5980230486,1094.09685,8357883055,1094900062,8357883287,232,,
5980481085,1094.34745,8358133654,1095150660,8358133899,245,,
5980731736,1094.59810,8358384304,1095401311,8358384564,260,,
5980982334,1094.84869,8358634900,1095651908,8358635160,260,,
5981232786,1095.09915,8358885353,1095902360,8358885623,270,,
5981483385,1095.34975,8359135951,1096152968,8359136220,269,,
5981734278,1095.60064,8359386842,1096403849,8359387101,259,,
5981750402,1095.61676,8359402965,1096419972,8359403224,259,8359403237,
5982001016,1095.86738,8359653580,1096670587,8359653843,263,,
5982251383,1096.11774,8359903945,1096920952,8359904213,268,,
5982502296,1096.36866,8360154857,1097171864,8360155129,272,,
5982752426,1096.61879,8360404987,1097421994,8360405261,274,,
5983003067,1096.86943,8360655627,1097672634,8360655912,285,,
5983253208,1097.11957,8360905766,1097922773,8360906040,274,,
5983503871,1097.37023,8361156428,1098173435,8361156703,275,,
5983754535,1097.62090,8361407092,1098424099,8361407367,275,,
5983770742,1097.63710,8361423298,1098440305,8361423572,274,8361423536,
5984021398,1097.88776,8361673955,1098690962,8361674220,265,,
5984271618,1098.13798,8361924173,1098941179,8361924429,256,,
5984521779,1098.38814,8362174334,1099191341,8362174592,258,,
5984772145,1098.63851,8362424699,1099441706,8362424938,239,,
5985022344,1098.88871,8362674897,1099691904,8362675147,250,,
5985272521,1099.13888,8362925072,1099942079,8362925312,240,,
5985522657,1099.38902,8363175208,1100192214,8363175447,239,,
5985772810,1099.63917,8363425360,1100442367,8363425599,239,,
5985789193,1099.65555,8363441741,1100458748,8363441980,239,8363441939,
5986039617,1099.90598,8363692166,1100709173,8363692385,219,,
5986289804,1100.15617,8363942352,1100959359,8363942564,212,,
5986540357,1100.40672,8364192904,1101209911,8364193109,205,,
5986790906,1100.65727,8364443452,1101460459,8364443651,199,,
5987041510,1100.90787,8364694055,1101711062,8364694254,199,,
5987291649,1101.15801,8364944193,1101961200,8364944393,200,,
5987541808,1101.40817,8365194350,1102211357,8365194550,200,,
5987791947,1101.65831,8365444490,1102461497,8365444689,199,,
5987808173,1101.67453,8365460714,1102477721,8365460913,199,8365460912,
5988058329,1101.92469,8365710870,1102727877,8365711071,201,,
5988308511,1102.17487,8365961052,1102978058,8365961252,200,,
5988558883,1102.42524,8366211422,1103228429,8366211622,200,,
5988809226,1102.67559,8366461765,1103478771,8366461965,200,,
5989059612,1102.92597,8366712150,1103729157,8366712350,200,,
5989309760,1103.17612,8366962298,1103979304,8366962498,200,,
5989560298,1103.42666,8367212834,1104229841,8367213035,201,,
5989810890,1103.67725,8367463426,1104480432,8367463626,200,,
5989827111,1103.69347,8367479646,1104496652,8367479845,199,8367479861,
5990077175,1103.94354,8367729709,1104746716,8367729912,203,,
5990327516,1104.19388,8367980051,1104997057,8367980259,208,,
5990578546,1104.44491,8368231078,1105248085,8368231291,213,,
5990829112,1104.69547,8368481643,1105498650,8368481861,218,,
5991079901,1104.94626,8368732432,1105749438,8368732649,217,,
5991330407,1105.19677,8368982938,1105999944,8368983155,217,,
5991580542,1105.44690,8369233071,1106250077,8369233288,217,,
5991831291,1105.69765,8369483819,1106500826,8369484036,217,,
5991847563,1105.71392,8369500090,1106517096,8369500307,217,8369500252,
5992097983,1105.96434,8369750510,1106767517,8369750713,203,,
5992348153,1106.21451,8370000680,1107017687,8370000870,190,,
5992598787,1106.46515,8370251312,1107268319,8370251500,188,,
5992848880,1106.71524,8370501404,1107518411,8370501569,165,,
5993099034,1106.96539,8370751558,1107768564,8370751722,164,,
5993349589,1107.21595,8371002112,1108019118,8371002276,164,,
5993599852,1107.46621,8371252375,1108269393,8371252550,175,,
5993850304,1107.71666,8371502826,1108519833,8371502990,164,,
5993866572,1107.73293,8371519093,1108536099,8371519257,164,8371519314,
5994117040,1107.98340,8371769561,1108786568,8371769739,178,,
5994367624,1108.23399,8372020143,1109037150,8372020336,193,,
5994618457,1108.48482,8372270976,1109287983,8372271185,209,,
5994869020,1108.73538,8372521537,1109538544,8372521760,223,,
5995119125,1108.98549,8372771641,1109788647,8372771864,223,,
5995369936,1109.23630,8373022452,1110039458,8373022675,223,,
5995620479,1109.48684,8373272994,1110290000,8373273217,223,,
5995870984,1109.73735,8373523497,1110540504,8373523721,224,,
5995887287,1109.75365,8373539799,1110556806,8373540022,223,8373539971,
5996137519,1110.00388,8373790032,1110807039,8373790243,211,,
5996387818,1110.25418,8374040331,1111057338,8374040529,198,,
5996638418,1110.50478,8374290929,1111307936,8374291116,187,,
5996888928,1110.75529,8374541439,1111558446,8374541613,174,,
5997139410,1111.00577,8374791919,1111808926,8374792093,174,,
5997390000,1111.25636,8375042509,1112059515,8375042683,174,,
5997640517,1111.50688,8375293024,1112310031,8375293198,174,,
5997891066,1111.75743,8375543572,1112560578,8375543746,174,,
5997907184,1111.77355,8375559689,1112576696,8375559863,174,8375559878,
5998157765,1112.02413,8375810271,1112827277,8375810448,177,,
5998408191,1112.27455,8376060696,1113077703,8376060877,181,,
5998658782,1112.52514,8376311286,1113328293,8376311472,186,,
5998908924,1112.77528,8376561428,1113578435,8376561618,190,,
5999159352,1113.02571,8376811855,1113828861,8376812045,190,,
5999409825,1113.27619,8377062327,1114079334,8377062517,190,,
5999660575,1113.52694,8377313075,1114330081,8377313265,190,,
5999910719,1113.77708,8377563218,1114580225,8377563408,190,,
5999927047,1113.79341,8377579545,1114596551,8377579735,190,8377579829,
6000177762,1114.04412,8377830261,1114847267,8377830475,214,,
6000428060,1114.29442,8378080558,1115097564,8378080795,237,,
6000678295,1114.54466,8378330791,1115347798,8378331053,262,,
6000933359,1114.79972,8378585854,1115602861,8378586140,286,,
6001183971,1115.05033,8378836466,1115853473,8378836752,286,,
6001434387,1115.30075,8379086881,1116103888,8379087168,287,,
6001684855,1115.55122,8379337348,1116354354,8379337634,286,,
6001935667,1115.80203,8379588159,1116605166,8379588445,286,,
6001951658,1115.81802,8379604150,1116621156,8379604436,286,8379604434,
6002202205,1116.06857,8379854696,1116871703,8379854981,285,,
6002452450,1116.31881,8380104941,1117121948,8380105226,285,,
6002702637,1116.56900,8380355127,1117372134,8380355412,285,,
6002953003,1116.81936,8380605491,1117622498,8380605777,286,,
6003203611,1117.06997,8380856098,1117873105,8380856385,287,,
6003454348,1117.32071,8381106834,1118123841,8381107120,286,,
6003704768,1117.57113,8381357254,1118374261,8381357540,286,,
6003954912,1117.82127,8381607397,1118624404,8381607683,286,,
6003971125,1117.83749,8381623609,1118640616,8381623895,286,8381623840,
6004221238,1118.08760,8381873722,1118890729,8381873997,275,,
6004471393,1118.33775,8382123876,1119140883,8382124141,265,,
6004721967,1118.58833,8382374450,1119391467,8382374715,265,,
6004972125,1118.83849,8382624606,1119641613,8382624850,244,,
6005222365,1119.08873,8382874846,1119891852,8382875090,244,,
6005472511,1119.33887,8383124992,1120142009,8383125246,254,,
6005722857,1119.58922,8383375336,1120392343,8383375580,244,,
6005973006,1119.83937,8383625484,1120642491,8383625728,244,,
6005989335,1119.85570,8383641811,1120658818,8383642055,244,8383641971,
6006239652,1120.10601,8383892129,1120909136,8383892352,223,,
6006490019,1120.35638,8384142495,1121159502,8384142698,203,,
6006740422,1120.60678,8384392898,1121409904,8384393080,182,,
6006990957,1120.85732,8384643432,1121660439,8384643594,162,,
6007241481,1121.10784,8384893955,1121910962,8384894117,162,,
6007492082,1121.35844,8385144554,1122161561,8385144716,162,,
6007742726,1121.60909,8385395198,1122412204,8385395360,162,,
6007992879,1121.85924,8385645350,1122662357,8385645512,162,,
6008008974,1121.87533,8385661444,1122678450,8385661605,161,8385661718,
6008259456,1122.12582,8385911925,1122928932,8385912116,191,,
6008509958,1122.37632,8386162426,1123179433,8386162645,219,,
6008760675,1122.62704,8386413143,1123430150,8386413391,248,,
6009010811,1122.87717,8386663279,1123680286,8386663566,287,,
6009261374,1123.12774,8386913840,1123930847,8386914116,276,,
6009511534,1123.37790,8387164000,1124181007,8387164277,277,,
6009761660,1123.62802,8387414124,1124431131,8387414400,276,,
6010012213,1123.87857,8387664676,1124681683,8387664952,276,,
6010028403,1123.89476,8387680866,1124697872,8387681141,275,8387681100,
6010278793,1124.14515,8387931255,1124948262,8387931521,266,,
6010529738,1124.39610,8388182200,1125199207,8388182456,256,,
6010780340,1124.64670,8388432801,1125449808,8388433046,245,,
6011030537,1124.89690,8388682997,1125700003,8388683233,236,,
6011281316,1125.14768,8388933775,1125950782,8388934011,236,,
6011531676,1125.39804,8389184134,1126201141,8389184370,236,,
6011782783,1125.64914,8389435240,1126452247,8389435476,236,,
6012033416,1125.89978,8389685872,1126702879,8389686108,236,,
6012049493,1125.91585,8389701948,1126718966,8389702195,247,8389702167,
6012300049,1126.16641,8389952504,1126969510,8389952736,232,,
6012551141,1126.41750,8390203595,1127220602,8390203824,229,,
6012801626,1126.66799,8390454080,1127471087,8390454305,225,,
6013052262,1126.91862,8390704714,1127721721,8390704935,221,,
6013302500,1127.16886,8390954951,1127971958,8390955172,221,,
6013552623,1127.41898,8391205074,1128222081,8391205296,222,,
6013802778,1127.66914,8391455228,1128472235,8391455450,222,,
6014053172,1127.91953,8391705622,1128722640,8391705855,233,,
6014069329,1127.93569,8391721777,1128738795,8391722009,232,8391722047,
6014319845,1128.18621,8391972293,1128989301,8391972527,234,,
6014570283,1128.43664,8392222731,1129239738,8392222977,246,,
6014821107,1128.68747,8392473554,1129490561,8392473823,269,,
6015071220,1128.93758,8392723665,1129740672,8392723938,273,,
6015322014,1129.18837,8392974459,1129991466,8392974731,272,,
6015572656,1129.43902,8393225100,1130242107,8393225372,272,,
6015823233,1129.68959,8393475676,1130492683,8393475948,272,,
6016073402,1129.93976,8393725844,1130742850,8393726116,272,,
6016089566,1129.95593,8393742007,1130759013,8393742278,271,8393742364,
6016340299,1130.20666,8393992740,1131009747,8393993033,293,,
6016591116,1130.45748,8394243557,1131260564,8394243872,315,,
6016841916,1130.70828,8394494355,1131511362,8394494693,338,,
6017092641,1130.95900,8394745079,1131762086,8394745439,360,,
6017343326,1131.20969,8394995763,1132012770,8394996122,359,,
6017593934,1131.46030,8395246370,1132263377,8395246730,360,,
6017844076,1131.71044,8395496512,1132513519,8395496872,360,,
6018094451,1131.96081,8395746886,1132763893,8395747246,360,,
6018110621,1131.97698,8395763054,1132780060,8395763412,358,8395763268,
6018360851,1132.22721,8396013284,1133030291,8396013607,323,,
6018611408,1132.47777,8396263842,1133280848,8396264129,287,,
6018862355,1132.72872,8396514788,1133531795,8396515039,251,,
6019113101,1132.97946,8396765532,1133782539,8396765748,216,,
6019363766,1133.23013,8397016196,1134033203,8397016412,216,,
6019614320,1133.48068,8397266749,1134283756,8397266965,216,,
6019864481,1133.73084,8397516909,1134533916,8397517126,217,,
6020115285,1133.98165,8397767713,1134784719,8397767929,216,,
6020131399,1133.99776,8397783825,1134800832,8397784041,216,8397784057,
6020382086,1134.24845,8398034513,1135051519,8398034733,220,,
6020632650,1134.49901,8398285075,1135302082,8398285301,226,,
6020883411,1134.74977,8398535835,1135552842,8398536065,230,,
6021133811,1135.00017,8398786236,1135803242,8398786470,234,,
6021384124,1135.25049,8399036548,1136053555,8399036782,234,,
6021634642,1135.50100,8399287064,1136304071,8399287299,235,,
6021885259,1135.75162,8399537681,1136554688,8399537926,245,,
6022135649,1136.00201,8399788070,1136805077,8399788304,234,,
6022151900,1136.01826,8399804319,1136821326,8399804553,234,8399804533,
6022402897,1136.26926,8400055316,1137072322,8400055545,229,,
6022653450,1136.51981,8400305868,1137322875,8400306092,224,,
6022904057,1136.77042,8400556474,1137573481,8400556695,221,,
6023154246,1137.02061,8400806662,1137823669,8400806877,215,,
6023404388,1137.27075,8401056803,1138073810,8401057019,216,,
6023654655,1137.52102,8401307071,1138324078,8401307286,215,,
6023904794,1137.77115,8401557208,1138574214,8401557423,215,,
6024155176,1138.02154,8401807589,1138824596,8401807805,216,,
6024171641,1138.03800,8401824054,1138841060,8401824269,215,8401824185,
6024422342,1138.28870,8402074754,1139091761,8402074948,194,,
6024672536,1138.53890,8402324947,1139341954,8402325120,173,,
6024922675,1138.78904,8402575086,1139592093,8402575239,153,,
6025173213,1139.03957,8402825623,1139842630,8402825756,133,,
6025423662,1139.29002,8403076070,1140093077,8403076204,134,,
6025673785,1139.54015,8403326193,1140343210,8403326337,144,,
6025924249,1139.79061,8403576655,1140593662,8403576789,134,,
6026174686,1140.04105,8403827093,1140844099,8403827226,133,,
6026191044,1140.05741,8403843449,1140860455,8403843582,133,8403843626,
6026441833,1140.30819,8404094238,1141111245,8404094383,145,,
6026692623,1140.55898,8404345028,1141362035,8404345184,156,,
6026943168,1140.80953,8404595572,1141612579,8404595740,168,,
6027193769,1141.06013,8404846172,1141863178,8404846351,179,,
6027444381,1141.31074,8405096783,1142113789,8405096962,179,,
6027694767,1141.56113,8405347167,1142364174,8405347346,179,,
6027945033,1141.81139,8405597432,1142614438,8405597611,179,,
6028195426,1142.06179,8405847824,1142864831,8405848004,180,,
6028211696,1142.07806,8405864093,1142881100,8405864273,180,8405864278,
6028462368,1142.32873,8406114766,1143131773,8406114946,180,,
6028713176,1142.57954,8406365574,1143382581,8406365756,182,,
6028963463,1142.82982,8406615859,1143632866,8406616044,185,,
6029213957,1143.08032,8406866352,1143883359,8406866538,186,,
6029464095,1143.33046,8407116490,1144133497,8407116676,186,,
6029714702,1143.58106,8407367096,1144384103,8407367293,197,,
6029965047,1143.83141,8407617439,1144634446,8407617625,186,,
6030215680,1144.08204,8407868071,1144885078,8407868257,186,,
6030231802,1144.09816,8407884192,1144901199,8407884378,186,8407884477,
6030482147,1144.34851,8408134538,1145151545,8408134748,210,,
6030732934,1144.59929,8408385323,1145402330,8408385560,237,,
6030983242,1144.84960,8408635630,1145652637,8408635892,262,,
6031233441,1145.09980,8408885830,1145902837,8408886117,287,,
6031483555,1145.34992,8409135943,1146152949,8409136230,287,,
6031734351,1145.60071,8409386737,1146403744,8409387024,287,,
6031984855,1145.85122,8409637241,1146654247,8409637528,287,,
6032235751,1146.10211,8409888136,1146905143,8409888423,287,,
6032251967,1146.11833,8409904350,1146921357,8409904637,287,8409904663,
6032502182,1146.36854,8410154566,1147171572,8410154859,293,,
6032752818,1146.61918,8410405201,1147422208,8410405502,301,,
6033003304,1146.86966,8410655685,1147672692,8410655993,308,,
6033253687,1147.12005,8410906067,1147923074,8410906381,314,,
6033504120,1147.37048,8411156499,1148173506,8411156814,315,,
6033754940,1147.62130,8411407319,1148424325,8411407633,314,,
6034005656,1147.87202,8411658034,1148675041,8411658348,314,,
6034255878,1148.12224,8411908255,1148925262,8411908569,314,,
6034272818,1148.13918,8411925194,1148942201,8411925508,314,8411925075,
6034522955,1148.38932,8412175331,1149192338,8412175537,206,,
6034773661,1148.64002,8412426036,1149443043,8412426133,97,,
6035024500,1148.89086,8412676874,1149693881,8412676865,-9,,
6035274841,1149.14120,8412927214,1149944220,8412927097,-117,,
6035525278,1149.39164,8413177651,1150194657,8413177533,-118,,
6035775862,1149.64222,8413428233,1150445240,8413428117,-116,,
6036026031,1149.89239,8413678402,1150695409,8413678286,-116,,
6036276664,1150.14303,8413929034,1150946041,8413928917,-117,,
6036292701,1150.15906,8413945071,1150962077,8413944953,-118,8413945352,
6036543147,1150.40951,8414195517,1151212523,8414195499,-18,,
6036793457,1150.65982,8414445825,1151462832,8414445909,84,,
6037048014,1150.91438,8414700382,1151717388,8414700567,185,,
6037298230,1151.16459,8414950596,1151967603,8414950879,283,,
6037552946,1151.41931,8415205312,1152222319,8415205595,283,,
6037803246,1151.66961,8415455610,1152472617,8415455893,283,,
6038053698,1151.92006,8415706062,1152723069,8415706346,284,,
6038303938,1152.17030,8415956301,1152973307,8415956584,283,,
6038319896,1152.18626,8415972257,1152989264,8415972540,283,8415972490,
6038570413,1152.43677,8416222775,1153239781,8416223044,269,,
6038820553,1152.68691,8416472915,1153489921,8416473172,257,,
6039071187,1152.93755,8416723548,1153740554,8416723793,245,,
6039321586,1153.18795,8416973946,1153990953,8416974180,234,,
6039571888,1153.43825,8417224247,1154241253,8417224481,234,,
6039822350,1153.68871,8417474707,1154491714,8417474942,235,,
6040072519,1153.93888,8417724876,1154741882,8417725110,234,,
6040322783,1154.18914,8417975138,1154992145,8417975373,235,,
6040338933,1154.20529,8417991288,1155008294,8417991522,234,8417991597,
6040589097,1154.45546,8418241451,1155258458,8418241704,253,,
6040839571,1154.70593,8418491924,1155508931,8418492197,273,,
6041089737,1154.95610,8418742089,1155759096,8418742380,291,,
6041340088,1155.20645,8418992440,1156009447,8418992752,312,,
6041590432,1155.45679,8419242783,1156259790,8419243094,311,,
6041840946,1155.70731,8419493297,1156510303,8419493608,311,,
6042091264,1155.95763,8419743614,1156760620,8419743924,310,,
6042342116,1156.20848,8419994464,1157011470,8419994775,311,,
6042358292,1156.22465,8420010640,1157027646,8420010950,310,8420010937,
6042608831,1156.47519,8420261179,1157278186,8420261487,308,,
6042859384,1156.72574,8420511731,1157528738,8420512035,304,,
6043109559,1156.97592,8420761904,1157778910,8420762205,301,,
6043360200,1157.22656,8421012544,1158029551,8421012843,299,,
6043610314,1157.47667,8421262658,1158279665,8421262958,300,,
6043860465,1157.72683,8421512809,1158529816,8421513108,299,,
6044110623,1157.97698,8421762965,1158779972,8421763264,299,,
6044360786,1158.22715,8422013127,1159030134,8422013426,299,,
6044377702,1158.24406,8422030042,1159047049,8422030341,299,8422029885,
6044627808,1158.49417,8422280148,1159297154,8422280332,184,,
6044877980,1158.74434,8422530320,1159547326,8422530391,71,,
6045128105,1158.99447,8422780444,1159797450,8422780401,-43,,
6045378366,1159.24473,8423030703,1160047710,8423030547,-156,,
6045629114,1159.49547,8423281451,1160298458,8423281295,-156,,
6045879950,1159.74631,8423532285,1160549291,8423532129,-156,,
6046130089,1159.99645,8423782424,1160799431,8423782269,-155,,
6046380249,1160.24661,8424032583,1161049590,8424032427,-156,,
6046396342,1160.26270,8424048676,1161065682,8424048519,-157,8424049001,
6046646458,1160.51282,8424298791,1161315798,8424298755,-36,,
6046896961,1160.76332,8424549293,1161566299,8424549378,85,,
6047147364,1161.01373,8424799695,1161816702,8424799901,206,,
6047398004,1161.26436,8425050334,1162067341,8425050662,328,,
6047648193,1161.51455,8425300523,1162317529,8425300849,326,,
6047898348,1161.76471,8425550676,1162567683,8425551004,328,,
6048148915,1162.01528,8425801243,1162818250,8425801570,327,,
6048399073,1162.26543,8426051410,1163068416,8426051736,326,,
6048415359,1162.28172,8426067685,1163084691,8426068012,327,8426067971,
6048666051,1162.53241,8426318377,1163335395,8426318705,328,,
6048916209,1162.78257,8426568534,1163585541,8426568841,307,,
6049166785,1163.03315,8426819110,1163836116,8426819407,297,,
6049417215,1163.28358,8427069538,1164086545,8427069826,288,,
6049667613,1163.53397,8427319936,1164336942,8427320224,288,,
6049918220,1163.78458,8427570541,1164587547,8427570829,288,,
6050168345,1164.03471,8427820665,1164837672,8427820954,289,,
6050418513,1164.28487,8428070832,1165087839,8428071121,289,,
6050434585,1164.30095,8428086903,1165103910,8428087191,288,8428087136,
6050685354,1164.55172,8428337673,1165354679,8428337948,275,,
6050935981,1164.80234,8428588298,1165605305,8428588560,262,,
6051186597,1165.05296,8428838915,1165855922,8428839175,260,,
6051436801,1165.30316,8429089118,1166106124,8429089353,235,,
6051687054,1165.55342,8429339370,1166356377,8429339615,245,,
6051937217,1165.80358,8429589532,1166606539,8429589768,236,,
6052187396,1166.05376,8429839709,1166856716,8429839945,236,,
6052437580,1166.30394,8430089892,1167106899,8430090127,235,,
6052453817,1166.32018,8430106128,1167123134,8430106363,235,8430106364,
6052703985,1166.57035,8430356297,1167373304,8430356533,236,,
6052954138,1166.82050,8430606449,1167623456,8430606685,236,,
6053204307,1167.07067,8430856617,1167873623,8430856854,237,,
6053454454,1167.32082,8431106762,1168123769,8431107000,238,,
6053704576,1167.57094,8431356885,1168373891,8431357123,238,,
6053954754,1167.82111,8431607072,1168624078,8431607310,238,,
6054204864,1168.07122,8431857170,1168874177,8431857408,238,,
6054454993,1168.32135,8432107298,1169124305,8432107536,238,,
6054471050,1168.33741,8432123354,1169140360,8432123592,238,8432123606,
6054721618,1168.58798,8432373922,1169390929,8432374165,243,,
6054971793,1168.83815,8432624097,1169641103,8432624343,246,,
6055222369,1169.08873,8432874671,1169891677,8432874921,250,,
6055472609,1169.33897,8433124911,1170141917,8433125165,254,,
6055722942,1169.58930,8433375242,1170392249,8433375496,254,,
6055973094,1169.83946,8433625394,1170642400,8433625648,254,,
6056223602,1170.08996,8433875902,1170892909,8433876157,255,,
6056473780,1170.34014,8434126079,1171143085,8434126343,264,,
6056490053,1170.35641,8434142350,1171159357,8434142604,254,8434142519,
6056740230,1170.60659,8434392527,1171409534,8434392760,233,,
6056990672,1170.85703,8434642968,1171659975,8434643180,212,,
6057241300,1171.10766,8434893595,1171910602,8434893786,191,,
6057491433,1171.35779,8435143727,1172160734,8435143897,170,,
6057741914,1171.60828,8435394207,1172411214,8435394377,170,,
6057992676,1171.85904,8435644968,1172661975,8435645139,171,,
6058242817,1172.10918,8435895108,1172912114,8435895278,170,,
6058493032,1172.35939,8436145323,1173162330,8436145493,170,,
6058509482,1172.37584,8436161772,1173178778,8436161942,170,8436161916,
6058759730,1172.62609,8436412021,1173429027,8436412184,163,,
6059009915,1172.87628,8436662204,1173679210,8436662361,157,,
6059260500,1173.12686,8436912788,1173929795,8436912940,152,,
6059511067,1173.37743,8437163354,1174180360,8437163500,146,,
6059761418,1173.62778,8437413705,1174430711,8437413851,146,,
6060011894,1173.87826,8437664179,1174681186,8437664325,146,,
6060262352,1174.12871,8437914636,1174931643,8437914783,147,,
6060512500,1174.37886,8438164783,1175181790,8438164929,146,,
6060528681,1174.39504,8438180963,1175197970,8438181109,146,8438181168,
6060779047,1174.64541,8438431329,1175448336,8438431490,161,,
6061029605,1174.89597,8438681886,1175698893,8438682062,176,,
6061279712,1175.14607,8438931994,1175949000,8438932185,191,,
6061530050,1175.39641,8439182330,1176199337,8439182536,206,,
6061780450,1175.64681,8439432730,1176449737,8439432936,206,,
6062030571,1175.89693,8439682850,1176699856,8439683055,205,,
6062280682,1176.14704,8439932959,1176949966,8439933165,206,,
6062531120,1176.39748,8440183396,1177200402,8440183602,206,,
6062547215,1176.41358,8440199490,1177216497,8440199696,206,8440199746,
6062797482,1176.66384,8440449757,1177466765,8440449976,219,,
6063047673,1176.91403,8440699948,1177716955,8440700179,231,,
6063297854,1177.16422,8440950127,1177967134,8440950371,244,,
6063548048,1177.41441,8441200321,1178217328,8441200578,257,,
6063798329,1177.66469,8441450601,1178467608,8441450858,257,,
6064048469,1177.91483,8441700740,1178717747,8441700997,257,,
6064298862,1178.16522,8441951133,1178968139,8441951390,257,,
6064549267,1178.41563,8442201536,1179218543,8442201793,257,,
6064565601,1178.43196,8442217869,1179234876,8442218126,257,8442218110,
6064816228,1178.68259,8442468496,1179485503,8442468749,253,,
6065066583,1178.93294,8442718850,1179735856,8442719098,248,,
6065316963,1179.18332,8442969230,1179986237,8442969476,246,,
6065567127,1179.43349,8443219393,1180236399,8443219635,242,,
6065817702,1179.68406,8443469967,1180486974,8443470209,242,,
6066067862,1179.93422,8443720127,1180737133,8443720369,242,,
6066318347,1180.18471,8443970610,1180987617,8443970863,253,,
6066568482,1180.43484,8444220744,1181237751,8444220986,242,,
6066584685,1180.45105,8444236946,1181253953,8444237188,242,8444237272,
6066835759,1180.70212,8444488020,1181505027,8444488283,263,,
6067086352,1180.95271,8444738612,1181755619,8444738898,286,,
6067336666,1181.20303,8444988926,1182005932,8444989233,307,,
6067586916,1181.45328,8445239175,1182256182,8445239503,328,,
6067837330,1181.70369,8445489587,1182506594,8445489915,328,,
6068087561,1181.95392,8445739817,1182756824,8445740146,329,,
6068338335,1182.20470,8445990590,1183007597,8445990919,329,,
6068588661,1182.45502,8446240917,1183257924,8446241245,328,,
6068604764,1182.47113,8446257018,1183274025,8446257346,328,8446257283,
6068854881,1182.72124,8446507135,1183524142,8446507448,313,,
6069105012,1182.97137,8446757265,1183774272,8446757562,297,,
6069355546,1183.22191,8447007799,1184024805,8447008080,281,,
6069606043,1183.47240,8447258294,1184275300,8447258560,266,,
6069856222,1183.72258,8447508472,1184525479,8447508739,267,,
6070106518,1183.97288,8447758768,1184775775,8447759045,277,,
6070356659,1184.22302,8448008908,1185025915,8448009174,266,,
6070606808,1184.47317,8448259056,1185276063,8448259322,266,,
6070623073,1184.48943,8448275331,1185292337,8448275596,265,8448275528,
6070873830,1184.74019,8448526076,1185543083,8448526328,252,,
6071124524,1184.99088,8448776771,1185793777,8448777008,237,,
6071380830,1185.24719,8449033076,1186050082,8449033299,223,,
6071631835,1185.49820,8449284079,1186301086,8449284289,210,,
6071885739,1185.75210,8449537983,1186554989,8449538192,209,,
6072136355,1186.00272,8449788597,1186805604,8449788808,211,,
6072386553,1186.25291,8450038794,1187055801,8450039004,210,,
6072639957,1186.50632,8450292197,1187309204,8450292407,210,,
6072656077,1186.52244,8450308316,1187325323,8450308526,210,8450308610,
6072906193,1186.77255,8450558433,1187575439,8450558664,231,,
6073156324,1187.02268,8450808562,1187825569,8450808815,253,,
6073406609,1187.27297,8451058846,1188075853,8451059121,275,,
6073656905,1187.52327,8451309143,1188326150,8451309439,296,,
6073907382,1187.77374,8451559619,1188576626,8451559915,296,,
6074157705,1188.02407,8451809940,1188826946,8451810236,296,,
6074408224,1188.27458,8452060458,1189077464,8452060754,296,,
6074658385,1188.52475,8452310619,1189327625,8452310915,296,,
6074674589,1188.54095,8452326822,1189343828,8452327117,295,8452327136,
6074925012,1188.79137,8452577245,1189594252,8452577545,300,,
6075175635,1189.04200,8452827866,1189844873,8452828172,306,,
6075425747,1189.29211,8453077977,1190094984,8453078288,311,,
6075675949,1189.54231,8453328179,1190345185,8453328505,326,,
6075926378,1189.79274,8453578606,1190595613,8453578922,316,,
6076176730,1190.04309,8453828959,1190845966,8453829275,316,,
6076427222,1190.29358,8454079450,1191096457,8454079766,316,,
6076677663,1190.54402,8454329889,1191346896,8454330205,316,,
6076693808,1190.56017,8454346033,1191363040,8454346349,316,8454346330,
6076944097,1190.81046,8454596323,1191613330,8454596634,311,,
6077194794,1191.06116,8454847018,1191864025,8454847324,306,,
6077445247,1191.31161,8455097470,1192114477,8455097773,303,,
6077696036,1191.56240,8455348258,1192365264,8455348556,298,,
6077946172,1191.81253,8455598393,1192615400,8455598691,298,,
6078196807,1192.06317,8455849027,1192866034,8455849325,298,,
6078447433,1192.31379,8456099652,1193116659,8456099951,299,,
6078697742,1192.56410,8456349961,1193366968,8456350259,298,,
6078713912,1192.58027,8456366131,1193383137,8456366428,297,8456366367,
6078964093,1192.83045,8456616311,1193633318,8456616594,283,,
6079214960,1193.08132,8456867177,1193884184,8456867445,268,,
6079465279,1193.33164,8457117496,1194134503,8457117749,253,,
6079715600,1193.58196,8457367816,1194384823,8457368054,238,,
6079966457,1193.83282,8457618672,1194635679,8457618911,239,,
6080216574,1194.08293,8457868787,1194885794,8457869026,239,,
6080466709,1194.33307,8458118921,1195135928,8458119160,239,,
6080717025,1194.58339,8458369236,1195386243,8458369475,239,,
6080733225,1194.59959,8458385435,1195402441,8458385673,238,8458385692,
6080983981,1194.85034,8458636191,1195653198,8458636435,244,,
6081234524,1195.10089,8458886734,1195903741,8458886984,250,,
6081484644,1195.35100,8459136854,1196153860,8459137108,254,,
6081734812,1195.60117,8459387020,1196404027,8459387279,259,,
6081984915,1195.85128,8459637122,1196654128,8459637381,259,,
6082235374,1196.10173,8459887580,1196904587,8459887840,260,,
6082485861,1196.35222,8460138067,1197155073,8460138326,259,,
6082736444,1196.60280,8460388648,1197405655,8460388907,259,,
6082752850,1196.61921,8460405054,1197422060,8460405313,259,8460405284,
6083003558,1196.86992,8460655761,1197672768,8460656013,252,,
6083253964,1197.12033,8460906166,1197923173,8460906411,245,,
6083504739,1197.37110,8461156940,1198173947,8461157178,238,,
6083754956,1197.62132,8461407157,1198424164,8461407390,233,,
6084006691,1197.87305,8461658919,1198675926,8461659152,233,,
6084259279,1198.12564,8461911478,1198928485,8461911711,233,,
6084510027,1198.37639,8462162225,1199179232,8462162457,232,,
6084760533,1198.62689,8462412730,1199429737,8462412962,232,,
6084776619,1198.64298,8462428815,1199445822,8462429047,232,8462429087,
6085027151,1198.89351,8462679347,1199696354,8462679588,241,,
6085277489,1199.14385,8462929684,1199946690,8462929936,252,,
6085527791,1199.39415,8463179986,1200196993,8463180249,263,,
6085778424,1199.64478,8463430618,1200447635,8463430902,284,,
6086028581,1199.89494,8463680775,1200697782,8463681048,273,,
6086279114,1200.14548,8463931307,1200948313,8463931580,273,,
6086529292,1200.39565,8464181484,1201198490,8464181757,273,,
6086779457,1200.64582,8464431648,1201448654,8464431921,273,,
6086795671,1200.66203,8464447861,1201464867,8464448133,272,8464448210,
6087046288,1200.91265,8464698477,1201715483,8464698769,292,,
6087296919,1201.16328,8464949108,1201966115,8464949430,322,,
6087547040,1201.41340,8465199227,1202216234,8465199558,331,,
6087797396,1201.66376,8465449582,1202466589,8465449933,351,,
6088047657,1201.91402,8465699843,1202716849,8465700193,350,,
6088298762,1202.16512,8465950947,1202967954,8465951298,351,,
6088548945,1202.41531,8466201129,1203218136,8466201480,351,,
6088799322,1202.66568,8466451505,1203468512,8466451856,351,,
6088815506,1202.68187,8466467689,1203484695,8466468039,350,8466467908,
6089065791,1202.93215,8466717973,1203734980,8466718292,319,,
6089315947,1203.18231,8466968129,1203985136,8466968415,286,,
6089566342,1203.43270,8467218522,1204235529,8467218776,254,,
6089816510,1203.68287,8467468690,1204485697,8467468911,221,,
6090066659,1203.93302,8467718837,1204735844,8467719058,221,,
6090316915,1204.18328,8467969092,1204986099,8467969314,222,,
6090567598,1204.43396,8468219775,1205236782,8468219996,221,,
6090818180,1204.68454,8468470355,1205487362,8468470577,222,,
6090834317,1204.70068,8468486491,1205503498,8468486712,221,8468486790,
6091084664,1204.95103,8468736840,1205753846,8468737080,240,,
6091334808,1205.20117,8468987007,1206004014,8468987268,261,,
6091585023,1205.45138,8469237197,1206254204,8469237477,280,,
6091835343,1205.70170,8469487515,1206504522,8469487815,300,,
6092085480,1205.95184,8469737652,1206754659,8469737952,300,,
6092336118,1206.20248,8469988289,1207005295,8469988589,300,,
6092587015,1206.45338,8470239184,1207256191,8470239484,300,,
6092837518,1206.70388,8470489686,1207506693,8470489986,300,,
6092853856,1206.72022,8470506024,1207523030,8470506323,299,8470506227,
6093105446,1206.97181,8470757613,1207774620,8470757888,275,,
6093363686,1207.23005,8471015853,1208032860,8471016105,252,,
6093626394,1207.49275,8471278559,1208295566,8471278785,226,,
6093876830,1207.74319,8471528995,1208546001,8471529200,205,,
6094127245,1207.99361,8471779409,1208796416,8471779614,205,,
6094385063,1208.25142,8472037226,1209054233,8472037431,205,,
6094638710,1208.50507,8472290872,1209307879,8472291077,205,,
6094889393,1208.75575,8472541555,1209558562,8472541760,205,,
6094905356,1208.77172,8472557517,1209574523,8472557721,204,8472557875,
6095155966,1209.02233,8472808133,1209825140,8472808376,243,,
6095406673,1209.27303,8473058832,1210075839,8473059114,282,,
6095657397,1209.52376,8473309555,1210326562,8473309876,321,,
6095910172,1209.77653,8473562330,1210579336,8473562690,360,,
6096161713,1210.02807,8473813869,1210830876,8473814229,360,,
6096411953,1210.27831,8474064109,1211081116,8474064469,360,,
6096662093,1210.52845,8474314248,1211331255,8474314608,360,,
6096912709,1210.77907,8474564863,1211581870,8474565223,360,,
6096930908,1210.79727,8474583061,1211600068,8474583421,360,8474582221,
6097181525,1211.04789,8474833678,1211850684,8474833737,59,,
6097432416,1211.29878,8475084568,1212101575,8475084326,-242,,
6097683163,1211.54952,8475335314,1212352321,8475334772,-542,,
6097933319,1211.79968,8475585470,1212602477,8475584631,-839,,
6098183952,1212.05031,8475836101,1212853108,8475835262,-839,,
6098434403,1212.30076,8476086552,1213103559,8476085713,-839,,
6098684992,1212.55135,8476337139,1213354146,8476336301,-838,,
6098935321,1212.80168,8476587468,1213604475,8476586629,-839,,
6098951501,1212.81786,8476603647,1213620653,8476602807,-840,8476603955,
6099202349,1213.06871,8476854496,1213871502,8476853944,-552,,
6099452700,1213.31906,8477104846,1214121853,8477104582,-264,,
6099702826,1213.56919,8477354970,1214371977,8477354995,25,,
6099954784,1213.82114,8477606928,1214623934,8477607238,310,,
6100206793,1214.07315,8477858935,1214875942,8477859245,310,,
6100457810,1214.32417,8478109951,1215126958,8478110261,310,,
6100708191,1214.57455,8478360331,1215377337,8478360641,310,,
6100958693,1214.82505,8478610833,1215627839,8478611143,310,,
6100975947,1214.84231,8478628085,1215645092,8478628395,310,8478627739,
6101226493,1215.09285,8478878631,1215895638,8478878776,145,,
6101477610,1215.34397,8479129748,1216146755,8479129730,-18,,
6101728356,1215.59472,8479380494,1216397500,8479380311,-183,,
6101982762,1215.84912,8479634899,1216651905,8479634554,-345,,
6102234522,1216.10088,8479886657,1216903664,8479886312,-345,,
6102501074,1216.36743,8480153208,1217170215,8480152864,-344,,
6102751503,1216.61786,8480403637,1217420644,8480403292,-345,,
6103002154,1216.86851,8480654286,1217671293,8480653941,-345,,
6103018453,1216.88481,8480670584,1217687591,8480670239,-345,8480670840,
6103268677,1217.13504,8480920808,1217937815,8480920613,-195,,
6103518924,1217.38529,8481171054,1218188061,8481171012,-42,,
6103769533,1217.63589,8481421662,1218438669,8481421770,108,,
6104019686,1217.88605,8481671815,1218688821,8481672073,258,,
6104270293,1218.13665,8481922421,1218939428,8481922679,258,,
6104520775,1218.38714,8482172902,1219189908,8482173160,258,,
6104771410,1218.63777,8482423536,1219440543,8482423794,258,,
6105021536,1218.88790,8482673661,1219690668,8482673919,258,,
6105037627,1218.90399,8482689751,1219706758,8482690009,258,8482690005,
6105287954,1219.15431,8482940092,1219957099,8482940348,256,,
6105538881,1219.40524,8483191004,1220208010,8483191260,256,,
6105789345,1219.65571,8483441468,1220458475,8483441723,255,,
6106039564,1219.90593,8483691685,1220708692,8483691940,255,,
6106289877,1220.15624,8483941997,1220959004,8483942252,255,,
6106540378,1220.40674,8484192498,1221209505,8484192753,255,,
6106790967,1220.65733,8484443086,1221460093,8484443341,255,,
6107041487,1220.90785,8484693606,1221710612,8484693861,255,,
6107057917,1220.92428,8484710034,1221727041,8484710289,255,8484710210,
6107308445,1221.17481,8484960562,1221977569,8484960788,226,,
6107558927,1221.42529,8485211043,1222228049,8485211253,210,,
6107809069,1221.67543,8485461184,1222478191,8485461377,193,,
6108059425,1221.92579,8485711539,1222728546,8485711716,177,,
6108309670,1222.17603,8485961784,1222978790,8485961961,177,,
6108559951,1222.42631,8486212063,1223229070,8486212241,178,,
6108810337,1222.67670,8486462448,1223479454,8486462625,177,,
6109060482,1222.92684,8486712594,1223729601,8486712782,188,,
6109076844,1222.94321,8486728953,1223745960,8486729130,177,8486729126,
6109327015,1223.19338,8486979126,1223996132,8486979301,175,,
6109577171,1223.44353,8487229280,1224246286,8487229455,175,,
6109827423,1223.69378,8487479531,1224496538,8487479705,174,,
6110078033,1223.94439,8487730140,1224747147,8487730314,174,,
6110328175,1224.19454,8487980281,1224997287,8487980455,174,,
6110578329,1224.44469,8488230434,1225247440,8488230608,174,,
6110828493,1224.69485,8488480598,1225497605,8488480772,174,,
6111079086,1224.94545,8488731189,1225748196,8488731363,174,,
6111095296,1224.96166,8488747398,1225764404,8488747572,174,8488747606,
6111345490,1225.21185,8488997592,1226014599,8488997775,183,,
6111595969,1225.46233,8489248071,1226265088,8489248274,203,,
6111846413,1225.71277,8489498514,1226515520,8489498715,201,,
6112096721,1225.96308,8489748822,1226765828,8489749032,210,,
6112346878,1226.21324,8489998977,1227015984,8489999187,210,,
6112597792,1226.46415,8490249890,1227266897,8490250100,210,,
6112847924,1226.71429,8490500022,1227517029,8490500232,210,,
6113098485,1226.96485,8490750581,1227767588,8490750791,210,,
6113114848,1226.98121,8490766944,1227783950,8490767154,210,8490767249,
6113364946,1227.23131,8491017041,1228034048,8491017275,234,,
6113615844,1227.48221,8491267938,1228284945,8491268196,258,,
6113866021,1227.73238,8491518115,1228535121,8491518397,282,,
6114116591,1227.98295,8491768685,1228785691,8491768991,306,,
6114367316,1228.23368,8492019409,1229036416,8492019716,307,,
6114617830,1228.48419,8492269921,1229286928,8492270228,307,,
6114867984,1228.73435,8492520075,1229537082,8492520382,307,,
6115118335,1228.98470,8492770424,1229787432,8492770732,308,,
6115136713,1229.00307,8492788802,1229805808,8492789108,306,8492790136,
6115387340,1229.25370,8493039428,1230056435,8493039993,565,,
6115637942,1229.50430,8493290037,1230307048,8493290863,826,,
6115888178,1229.75454,8493540264,1230557271,8493541344,1080,,
6116138312,1230.00467,8493790397,1230807404,8493791733,1336,,
6116388458,1230.25482,8494040541,1231057548,8494041878,1337,,
6116638622,1230.50498,8494290707,1231307714,8494292043,1336,,
6116888994,1230.75536,8494541077,1231558084,8494542413,1336,,
6117139385,1231.00575,8494791467,1231808474,8494792803,1336,,
6117156286,1231.02265,8494808368,1231825374,8494809703,1335,8494808606,
6117406553,1231.27291,8495058634,1232075640,8495059687,1053,,
6117656680,1231.52304,8495308761,1232325767,8495309543,782,,
6117906854,1231.77321,8495558934,1232575940,8495559445,511,,
6118157025,1232.02339,8495809103,1232826110,8495809343,240,,
6118407533,1232.27389,8496059610,1233076617,8496059850,240,,
6118657892,1232.52425,8496309968,1233326975,8496310208,240,,
6118908216,1232.77458,8496560291,1233577298,8496560531,240,,
6119158616,1233.02498,8496810691,1233827698,8496810931,240,,
6119174944,1233.04130,8496827018,1233844024,8496827258,240,8496827246,
6119425538,1233.29190,8497077622,1234094629,8497077860,238,,
6119675690,1233.54205,8497327763,1234344770,8497327998,235,,
6119926332,1233.79269,8497578405,1234595411,8497578638,233,,
6120176509,1234.04287,8497828581,1234845588,8497828811,230,,
6120426815,1234.29318,8498078885,1235095892,8498079115,230,,
6120677178,1234.54354,8498329247,1235346254,8498329477,230,,
6120927610,1234.79397,8498579678,1235596685,8498579909,231,,
6121178152,1235.04451,8498830219,1235847226,8498830449,230,,
6121195361,1235.06172,8498847427,1235864433,8498847657,230,8498847263,
6121445752,1235.31211,8499097818,1236114825,8499097949,131,,
6121696055,1235.56242,8499348122,1236365129,8499348155,33,,
6121946599,1235.81296,8499598665,1236615671,8499598600,-65,,
6122196752,1236.06311,8499848817,1236865823,8499848655,-162,,
6122446881,1236.31324,8500098944,1237115951,8500098782,-162,,
6122697058,1236.56342,8500349121,1237366127,8500348959,-162,,
6122947396,1236.81376,8500599457,1237616464,8500599295,-162,,
6123197497,1237.06386,8500849558,1237866565,8500849396,-162,,
6123213871,1237.08023,8500865931,1237882937,8500865769,-162,8500866061,
6123464508,1237.33087,8501116568,1238133575,8501116479,-89,,
6123715036,1237.58140,8501367094,1238384101,8501367080,-14,,
6123965455,1237.83182,8501617512,1238634519,8501617571,59,,
6124215560,1238.08192,8501867618,1238884625,8501867750,132,,
6124465696,1238.33206,8502117752,1239134758,8502117884,132,,
6124716387,1238.58275,8502368443,1239385449,8502368575,132,,
6124966529,1238.83289,8502618583,1239635590,8502618715,132,,
6125216663,1239.08302,8502868716,1239885723,8502868848,132,,
6125232812,1239.09917,8502884864,1239901870,8502884996,132,8502885129,
6125483235,1239.34960,8503135287,1240152294,8503135454,167,,
6125733639,1239.60000,8503385690,1240402697,8503385889,199,,
6125983819,1239.85018,8503635869,1240652876,8503636103,234,,
6126234746,1240.10111,8503886795,1240903802,8503887062,267,,
6126485054,1240.35142,8504137103,1241154110,8504137370,267,,
6126735647,1240.60201,8504387696,1241404702,8504387963,267,,
6126985823,1240.85218,8504637871,1241654877,8504638137,266,,
6127236283,1241.10264,8504888330,1241905336,8504888597,267,,
6127253066,1241.11943,8504905111,1241922117,8504905378,267,8504905064,
6127503645,1241.37001,8505155691,1242172697,8505155879,188,,
6127753807,1241.62017,8505405851,1242422858,8505405961,110,,
6128004237,1241.87060,8505656281,1242673288,8505656314,33,,
6128254887,1242.12125,8505906930,1242923936,8505906883,-47,,
6128505478,1242.37184,8506157519,1243174526,8506157474,-45,,
6128755577,1242.62194,8506407618,1243424624,8506407572,-46,,
6129005942,1242.87230,8506657982,1243674989,8506657937,-45,,
6129256203,1243.12256,8506908242,1243925249,8506908197,-45,,
6129272316,1243.13868,8506924354,1243941361,8506924309,-45,8506924636,
6129522468,1243.38883,8507174507,1244191513,8507174542,35,,
6129772600,1243.63896,8507424638,1244441644,8507424756,118,,
6130022906,1243.88927,8507674941,1244691948,8507675142,201,,
6130273413,1244.13977,8507925448,1244942455,8507925731,283,,
6130523894,1244.39026,8508175928,1245192935,8508176211,283,,
6130774403,1244.64076,8508426436,1245443443,8508426719,283,,
6131024598,1244.89096,8508676630,1245693637,8508676914,284,,
6131275130,1245.14149,8508927161,1245944168,8508927445,284,,
6131291324,1245.15768,8508943354,1245960360,8508943637,283,8508943604,
6131541596,1245.40796,8509193626,1246210633,8509193901,275,,
6131792072,1245.65843,8509444103,1246461110,8509444371,268,,
6132042488,1245.90885,8509694517,1246711524,8509694777,260,,
6132293119,1246.15948,8509945307,1246962316,8509945561,254,,
6132543515,1246.40988,8510195543,1247212550,8510195795,252,,
6132794105,1246.66047,8510446131,1247463138,8510446383,252,,
6133044706,1246.91107,8510696731,1247713738,8510696984,253,,
6133295320,1247.16168,8510947344,1247964351,8510947596,252,,
6133311329,1247.17769,8510963352,1247980359,8510963604,252,8510963634,
6133561441,1247.42780,8511213464,1248230471,8511213723,259,,
6133811859,1247.67822,8511463882,1248480889,8511464149,267,,
6134062292,1247.92865,8511714315,1248731334,8511714603,288,,
6134312933,1248.17929,8511964955,1248981961,8511965238,283,,
6134563541,1248.42990,8512215561,1249232568,8512215845,284,,
6134814331,1248.68069,8512466350,1249483357,8512466634,284,,
6135064467,1248.93083,8512716485,1249733492,8512716779,294,,
6135314812,1249.18117,8512966829,1249983836,8512967113,284,,
6135331318,1249.19768,8512983334,1250000341,8512983617,283,8512983632,
6135581487,1249.44785,8513233503,1250250510,8513233790,287,,
6135832058,1249.69842,8513484074,1250501081,8513484376,302,,
6136082770,1249.94913,8513734784,1250751790,8513735080,296,,
6136333264,1250.19962,8513985277,1251002284,8513985578,301,,
6136583357,1250.44972,8514235371,1251252378,8514235671,300,,
6136833459,1250.69982,8514485471,1251502477,8514485771,300,,
6137083791,1250.95015,8514735802,1251752809,8514736102,300,,
6137334333,1251.20069,8514986343,1252003350,8514986643,300,,
6137350515,1251.21688,8515002524,1252019530,8515002824,300,8515002676,
6137600653,1251.46701,8515252663,1252269670,8515252927,264,,
6137850807,1251.71717,8515502814,1252519821,8515503041,227,,
6138101430,1251.96779,8515753437,1252770444,8515753628,191,,
6138352020,1252.21838,8516004027,1253021034,8516004180,153,,
6138602622,1252.46898,8516254627,1253271634,8516254780,153,,
6138853138,1252.71950,8516505143,1253522150,8516505296,153,,
6139103256,1252.96962,8516755260,1253772267,8516755413,153,,
6139353395,1253.21976,8517005399,1254022405,8517005552,153,,
6139369551,1253.23591,8517021553,1254038559,8517021706,153,8517021809,
6139619667,1253.48603,8517271670,1254288677,8517271849,179,,
6139869838,1253.73620,8517521838,1254538845,8517522045,207,,
6140120203,1253.98656,8517772204,1254789211,8517772436,232,,
6140370359,1254.23672,8518022359,1255039365,8518022617,258,,
6140620511,1254.48687,8518272510,1255289516,8518272768,258,,
6140871048,1254.73741,8518523045,1255540052,8518523314,269,,
6141121204,1254.98756,8518773200,1255790206,8518773458,258,,
6141371549,1255.23791,8519023544,1256040551,8519023803,259,,
6141387991,1255.25435,8519039985,1256056992,8519040243,258,8519040122,
6141638480,1255.50484,8519290476,1256307483,8519290704,228,,
6141889003,1255.75536,8519540998,1256558005,8519541197,199,,
6142139563,1256.00592,8519791556,1256808563,8519791726,170,,
6142389710,1256.25607,8520041703,1257058709,8520041842,139,,
6142640296,1256.50666,8520292287,1257309294,8520292426,139,,
6142890420,1256.75678,8520542411,1257559418,8520542550,139,,
6143140598,1257.00696,8520792587,1257809594,8520792726,139,,
6143390724,1257.25708,8521042712,1258059719,8521042851,139,,
6143406935,1257.27330,8521058923,1258075929,8521059062,139,8521059202,
6143657769,1257.52413,8521309756,1258326763,8521309930,174,,
6143907906,1257.77427,8521559892,1258576899,8521560101,209,,
6144158260,1258.02462,8521810246,1258827253,8521810491,245,,
6144408399,1258.27476,8522060384,1259077391,8522060665,281,,
6144658583,1258.52494,8522310567,1259327573,8522310848,281,,
6144908678,1258.77504,8522560661,1259577668,8522560942,281,,
6145158849,1259.02521,8522810832,1259827838,8522811123,291,,
6145409019,1259.27538,8523061000,1260078007,8523061281,281,,
6145425627,1259.29199,8523077607,1260094613,8523077888,281,8523077760,
6145676249,1259.54261,8523328230,1260345237,8523328479,249,,
6145926481,1259.79284,8523578461,1260595468,8523578678,217,,
6146177033,1260.04339,8523829011,1260846018,8523829196,185,,
6146427529,1260.29389,8524079507,1261096514,8524079661,154,,
6146677918,1260.54428,8524329895,1261346902,8524330049,154,,
6146928098,1260.79446,8524580075,1261597082,8524580230,155,,
6147178443,1261.04480,8524830418,1261847424,8524830572,154,,
6147429105,1261.29547,8525081079,1262098086,8525081234,155,,
6147560487,1261.42685,8525212459,1262229466,8525212613,154,8525269908,
6147685914,1261.55228,8525337888,1262354894,8525345227,7339,,
6147936061,1261.80242,8525588033,1262605040,8525609706,21673,,
6148186269,1262.05263,8525838240,1262855247,8525874248,36008,,
6148436782,1262.30314,8526088752,1263105759,8526139114,50362,,
6148687267,1262.55363,8526339236,1263356243,8526396686,57450,,
6148938206,1262.80457,8526590175,1263607182,8526647625,57450,,
6149188353,1263.05471,8526840322,1263857339,8526897783,57461,,
6149438535,1263.30490,8527090503,1264107510,8527147953,57450,,
6149580264,1263.44663,8527232229,1264249235,8527289679,57450,8527232536,
6149705336,1263.57170,8527357302,1264374309,8527407606,50304,,
6149955484,1263.82184,8527607449,1264624456,8527643458,36009,,
6150206056,1264.07242,8527858021,1264875027,8527879712,21691,,
6150456949,1264.32331,8528108913,1265125920,8528116268,7355,,
6150707096,1264.57346,8528359059,1265376066,8528359368,309,,
6150957260,1264.82362,8528609222,1265626239,8528609542,320,,
6151207899,1265.07426,8528859860,1265876867,8528860169,309,,
6151458082,1265.32444,8529110042,1266127049,8529110352,310,,
6151599324,1265.46568,8529251282,1266268288,8529251591,309,8529251491,
6151724839,1265.59120,8529376798,1266393805,8529377094,296,,
6151974970,1265.84133,8529626929,1266643935,8529627201,272,,
6152226062,1266.09242,8529878020,1266895026,8529878267,247,,
6152476310,1266.34267,8530128266,1267145272,8530128489,223,,
6152726466,1266.59283,8530378422,1267395429,8530378633,211,,
6152977025,1266.84339,8530628980,1267645986,8530629191,211,,
6153227905,1267.09427,8530879859,1267896866,8530880070,211,,
6153478342,1267.34470,8531130295,1268147302,8531130506,211,,
6153619736,1267.48610,8531271688,1268288694,8531271899,211,8531271843,
6153744798,1267.61116,8531396748,1268413755,8531396951,203,,
6153995163,1267.86152,8531647115,1268664122,8531647305,190,,
6154245559,1268.11192,8531897510,1268914516,8531897687,177,,
6154495685,1268.36205,8532147634,1269164641,8532147798,164,,
6154745831,1268.61219,8532397780,1269414787,8532397937,157,,
6154996155,1268.86252,8532648102,1269665109,8532648260,158,,
6155246646,1269.11301,8532898593,1269915600,8532898750,157,,
6155496807,1269.36317,8533148753,1270165759,8533148910,157,,
6155638297,1269.50466,8533290241,1270307248,8533290398,157,8533290564,
6155763736,1269.63010,8533415681,1270432687,8533415858,177,,
6156014255,1269.88062,8533666198,1270683205,8533666417,219,,
6156264996,1270.13136,8533916938,1270933945,8533917200,262,,
6156515557,1270.38192,8534167499,1271184506,8534167803,304,,
6156766232,1270.63259,8534418173,1271435180,8534418499,326,,
6157016524,1270.88288,8534668464,1271685471,8534668789,325,,
6157267283,1271.13364,8534919222,1271936229,8534919548,326,,
6157517433,1271.38379,8535169372,1272186378,8535169697,325,,
6157658727,1271.52509,8535310664,1272327670,8535310988,324,8535310878,
6157783791,1271.65015,8535435728,1272452735,8535436038,310,,
6158033869,1271.90023,8535685806,1272702812,8535686089,283,,
6158284047,1272.15041,8535935982,1272952989,8535936238,256,,
6158534679,1272.40104,8536186613,1273203620,8536186843,230,,
6158784818,1272.65118,8536436751,1273453758,8536436967,216,,
6159035247,1272.90161,8536687181,1273704187,8536687397,216,,
6159285366,1273.15173,8536937298,1273954305,8536937514,216,,
6159535519,1273.40188,8537187450,1274204457,8537187667,217,,
6159677198,1273.54356,8537329128,1274346134,8537329344,216,8537329469,
6159802275,1273.66864,8537454206,1274471212,8537454437,231,,
6160052892,1273.91925,8537704821,1274721828,8537705084,263,,
6160303084,1274.16944,8537955013,1274972020,8537955308,295,,
6160553384,1274.41974,8538205311,1275222318,8538205639,328,,
6160803855,1274.67022,8538455781,1275472788,8538456124,343,,
6161054790,1274.92115,8538706715,1275723722,8538707058,343,,
6161305069,1275.17143,8538956994,1275974001,8538957337,343,,
6161555351,1275.42171,8539207275,1276224281,8539207618,343,,
6161696888,1275.56325,8539348810,1276365816,8539349153,343,8539349093,
6161822122,1275.68848,8539474045,1276491051,8539474380,335,,
6162073077,1275.93944,8539724999,1276742006,8539725321,322,,
6162323416,1276.18978,8539975337,1276992344,8539975644,307,,
6162573716,1276.44008,8540225636,1277242643,8540225928,292,,
6162824009,1276.69037,8540475928,1277492935,8540476213,285,,
6163074167,1276.94053,8540726086,1277743093,8540726371,285,,
6163324588,1277.19095,8540976505,1277993512,8540976790,285,,
6163575351,1277.44171,8541227267,1278244274,8541227553,286,,
6163716715,1277.58308,8541368630,1278385637,8541368915,285,8541368805,
6163841821,1277.70818,8541493736,1278510743,8541494007,271,,
6164092793,1277.95915,8541744709,1278761716,8541744953,244,,
6164342957,1278.20932,8541994871,1279011878,8541995089,218,,
6164593105,1278.45947,8542245018,1279262025,8542245209,191,,
6164843407,1278.70977,8542495320,1279512327,8542495496,176,,
6165093554,1278.95991,8542745466,1279762472,8542745642,176,,
6165343844,1279.21021,8542995755,1280012762,8542995931,176,,
6165594288,1279.46065,8543246197,1280263204,8543246373,176,,
6165735644,1279.60200,8543387552,1280404559,8543387728,176,8543387862,
6165860721,1279.72708,8543512629,1280529636,8543512821,192,,
6166111144,1279.97751,8543763052,1280780058,8543763278,226,,
6166361306,1280.22767,8544013213,1281030220,8544013474,261,,
6166611931,1280.47829,8544263837,1281280843,8544264131,294,,
6166862484,1280.72885,8544514390,1281531397,8544514702,312,,
6167112661,1280.97902,8544764566,1281781573,8544764877,311,,
6167362840,1281.22920,8545014743,1282031749,8545015054,311,,
6167613090,1281.47945,8545264993,1282282010,8545265314,321,,
6167754432,1281.62079,8545406334,1282423340,8545406645,311,8545406512,
6167879496,1281.74586,8545531397,1282548404,8545531691,294,,
6168129665,1281.99603,8545781565,1282798572,8545781826,261,,
6168379833,1282.24619,8546031732,1283048739,8546031962,230,,
6168630307,1282.49667,8546282206,1283299212,8546282402,196,,
6168880444,1282.74680,8546532343,1283549349,8546532523,180,,
6169130960,1282.99732,8546782857,1283799864,8546783038,181,,
6169381062,1283.24742,8547032958,1284049965,8547033139,181,,
6169631145,1283.49751,8547283040,1284300047,8547283220,180,,
6169772664,1283.63902,8547424558,1284441564,8547424749,191,8547424709,
6169897750,1283.76411,8547549645,1284566652,8547549831,186,,
6170147880,1284.01424,8547799774,1284816791,8547799953,179,,
6170398352,1284.26471,8548050245,1285067252,8548050407,162,,
6170648513,1284.51487,8548300404,1285317411,8548300561,157,,
6170898757,1284.76512,8548550648,1285567654,8548550801,153,,
6171149628,1285.01599,8548801517,1285818524,8548801670,153,,
6171399899,1285.26626,8549051788,1286068795,8549051942,154,,
6171650420,1285.51678,8549302309,1286319316,8549302462,153,,
6171791562,1285.65792,8549443449,1286460455,8549443601,152,8549443725,
6171916632,1285.78299,8549568520,1286585527,8549568688,168,,
6172166841,1286.03320,8549818728,1286835734,8549818927,199,,
6172417635,1286.28400,8550069521,1287086527,8550069752,231,,
6172667787,1286.53415,8550319671,1287336677,8550319933,262,,
6172918330,1286.78469,8550570214,1287587221,8550570493,279,,
6173168475,1287.03484,8550820357,1287837363,8550820635,278,,
6173418706,1287.28507,8551070587,1288087594,8551070865,278,,
6173668866,1287.53523,8551320748,1288337755,8551321037,289,,
6173811617,1287.67798,8551463497,1288480503,8551463774,277,8551463064,
6173937104,1287.80346,8551588985,1288605992,8551589173,188,,
6174187326,1288.05369,8551839206,1288856213,8551839217,11,,
6174437507,1288.30387,8552089385,1289106391,8552089219,-166,,
6174687838,1288.55420,8552339715,1289356722,8552339372,-343,,
6174938337,1288.80470,8552590213,1289607220,8552589783,-430,,
6175188529,1289.05489,8552840404,1289857411,8552839973,-431,,
6175438876,1289.30524,8553090750,1290107756,8553090319,-431,,
6175689032,1289.55539,8553340905,1290357912,8553340475,-430,,
6175830486,1289.69685,8553482359,1290499365,8553481927,-432,8553482704,
6175955559,1289.82192,8553607432,1290624439,8553607108,-324,,
6176206048,1290.07241,8553857920,1290874926,8553857781,-139,,
6176456414,1290.32278,8554108286,1291125293,8554108343,57,,
6176706576,1290.57294,8554358446,1291375453,8554358696,250,,
6176956736,1290.82310,8554608605,1291625612,8554608952,347,,
6177207277,1291.07364,8554859146,1291876152,8554859493,347,,
6177457824,1291.32418,8555109692,1292126699,8555110039,347,,
6177708054,1291.57442,8555359921,1292376928,8555360268,347,,
6177849172,1291.71553,8555501037,1292518044,8555501385,348,8555501360,
6177974278,1291.84064,8555626143,1292643150,8555626487,344,,
6178224489,1292.09085,8555876353,1292893360,8555876692,339,,
6178475009,1292.34137,8556126872,1293143879,8556127206,334,,
6178725156,1292.59152,8556377020,1293394026,8556377346,326,,
6178976031,1292.84239,8556627893,1293644899,8556628218,325,,
6179226732,1293.09309,8556878593,1293895600,8556878918,325,,
6179476862,1293.34322,8557128723,1294145730,8557129049,326,,
6179727083,1293.59344,8557378942,1294395960,8557379279,337,,
6179868962,1293.73532,8557520819,1294537826,8557521144,325,8557520973,
6179994198,1293.86056,8557646057,1294663064,8557646361,304,,
6180244645,1294.11101,8557896502,1294913509,8557896764,262,,
6180494848,1294.36121,8558146704,1295163710,8558146922,218,,
6180745490,1294.61185,8558397345,1295414352,8558397521,176,,
6180996065,1294.86243,8558647920,1295664927,8558648076,156,,
6181246349,1295.11271,8558898204,1295915210,8558898359,155,,
6181496480,1295.36284,8559148333,1296165339,8559148488,155,,
6181747060,1295.61342,8559398913,1296415920,8559399068,155,,
6181889119,1295.75548,8559540969,1296557976,8559541124,155,8559540870,
6182014344,1295.88071,8559666196,1296683202,8559666319,123,,
6182264627,1296.13099,8559916477,1296933484,8559916537,60,,
6182514938,1296.38130,8560166787,1297183794,8560166785,-2,,
6182765110,1296.63147,8560416959,1297433965,8560416893,-66,,
6183015230,1296.88159,8560667077,1297684083,8560666979,-98,,
6183265362,1297.13172,8560917208,1297934215,8560917110,-98,,
6183515673,1297.38203,8561167518,1298184525,8561167420,-98,,
6183765786,1297.63215,8561417632,1298434639,8561417534,-98,,
6183907080,1297.77344,8561558923,1298575929,8561558825,-98,8561559164,
6184032165,1297.89853,8561684009,1298701015,8561683953,-56,,
6184282476,1298.14884,8561934319,1298951325,8561934349,30,,
6184532590,1298.39895,8562184433,1299201439,8562184549,116,,
6184783331,1298.64969,8562435173,1299452180,8562435375,202,,
6185033827,1298.90019,8562685667,1299702674,8562685911,244,,
6185284229,1299.15059,8562936069,1299953075,8562936312,243,,
6185534683,1299.40104,8563186521,1300203538,8563186775,254,,
6185784831,1299.65119,8563436669,1300453676,8563436912,243,,
6185927220,1299.79358,8563579056,1300596063,8563579299,243,8563579062,
6186052271,1299.91863,8563704108,1300721115,8563704320,212,,
6186302432,1300.16879,8563954268,1300971275,8563954423,155,,
6186553049,1300.41941,8564204885,1301221892,8564204981,96,,
6186803366,1300.66973,8564455200,1301472206,8564455237,37,,
6187054550,1300.92091,8564706384,1301723391,8564706392,8,,
6187304882,1301.17124,8564956714,1301973721,8564956722,8,,
6187555000,1301.42136,8565206832,1302223838,8565206840,8,,
6187805253,1301.67161,8565457083,1302474090,8565457092,9,,
6187946632,1301.81299,8565598462,1302615468,8565598469,7,8565598682,
6188071712,1301.93807,8565723541,1302740548,8565723575,34,,
6188322086,1302.18845,8565973914,1302990921,8565974002,88,,
6188572705,1302.43907,8566224533,1303241540,8566224675,142,,
6188822853,1302.68921,8566474680,1303491687,8566474877,197,,
6189073034,1302.93940,8566724860,1303741867,8566725082,222,,
6189323363,1303.18972,8566975188,1303992195,8566975411,223,,
6189574076,1303.44044,8567225901,1304242907,8567226123,222,,
6189824402,1303.69076,8567476226,1304493232,8567476448,222,,
6189966277,1303.83264,8567618098,1304635105,8567618320,222,8567618183,
6190091515,1303.95788,8567743337,1304760344,8567743549,212,,
6190342130,1304.20849,8567993951,1305010958,8567994123,172,,
6190592545,1304.45891,8568244366,1305261372,8568244503,137,,
6190842716,1304.70908,8568494535,1305511542,8568494638,103,,
6191093057,1304.95942,8568744875,1305761881,8568744962,87,,
6191343685,1305.21005,8568995504,1306012510,8568995591,87,,
6191595635,1305.46200,8569247452,1306264458,8569247539,87,,
6191846235,1305.71260,8569498052,1306515058,8569498139,87,,
6191987948,1305.85431,8569639763,1306656769,8569639849,86,8569640154,
6192113076,1305.97944,8569764892,1306781898,8569765016,124,,
6192363391,1306.22975,8570015206,1307032213,8570015407,201,,
6192613528,1306.47989,8570265341,1307282348,8570265619,278,,
6192863678,1306.73004,8570515490,1307532496,8570515844,354,,
6193113837,1306.98020,8570765648,1307782654,8570766041,393,,
6193363978,1307.23034,8571015789,1308032795,8571016182,393,,
6193614515,1307.48088,8571266324,1308283330,8571266717,393,,
6193864668,1307.73103,8571516476,1308533483,8571516870,394,,
6194005896,1307.87226,8571657704,1308674710,8571658096,392,8571657993,
6194131142,1307.99750,8571782951,1308799957,8571783340,389,,
6194382060,1308.24842,8572033867,1309050874,8572034221,354,,
6194632618,1308.49898,8572284424,1309301431,8572284753,329,,
6194883312,1308.74967,8572535126,1309552132,8572535429,303,,
6195133957,1309.00032,8572785762,1309802768,8572786053,291,,
6195384354,1309.25071,8573036157,1310053164,8573036448,291,,
6195634767,1309.50113,8573286569,1310303576,8573286860,291,,
6195885623,1309.75198,8573537424,1310554431,8573537715,291,,
6196027405,1309.89377,8573679206,1310696212,8573679496,290,8573679504,
6196152780,1310.01914,8573804581,1310821587,8573804872,291,,
6196402933,1310.26929,8574054733,1311071740,8574055027,294,,
6196653333,1310.51969,8574305133,1311322140,8574305429,296,,
6196903820,1310.77018,8574555618,1311572625,8574555917,299,,
6197154305,1311.02067,8574806102,1311823109,8574806402,300,,
6197404478,1311.27084,8575056275,1312073282,8575056575,300,,
6197654828,1311.52119,8575306623,1312323630,8575306924,301,,
6197904953,1311.77131,8575556747,1312573754,8575557047,300,,
6198046102,1311.91246,8575697896,1312714902,8575698195,299,8575698259,
6198171182,1312.03754,8575822976,1312839982,8575823283,307,,
6198421482,1312.28784,8576073274,1313090281,8576073598,324,,
6198672075,1312.53844,8576323867,1313340874,8576324208,341,,
6198922588,1312.78895,8576574379,1313591386,8576574737,358,,
6199172813,1313.03917,8576824604,1313841611,8576824970,366,,
6199422957,1313.28932,8577074746,1314091753,8577075111,365,,
6199673154,1313.53951,8577324942,1314341949,8577325307,365,,
6199926417,1313.79278,8577578205,1314595211,8577578569,364,,
6200068258,1313.93462,8577720044,1314737050,8577720408,364,8577720401,
6200193289,1314.05965,8577845075,1314862082,8577845439,364,,
6200443661,1314.31002,8578095446,1315112453,8578095809,363,,
6200700217,1314.56658,8578352001,1315369008,8578352363,362,,
6200950727,1314.81709,8578602510,1315619517,8578602870,360,,
6201200932,1315.06729,8578852714,1315869721,8578853073,359,,
6201451474,1315.31784,8579103256,1316120263,8579103615,359,,
6201702328,1315.56869,8579354110,1316371117,8579354469,359,,
6201952855,1315.81922,8579604636,1316621642,8579604995,359,,
6202094492,1315.96085,8579746271,1316763277,8579746629,358,8579746498,
6202219531,1316.08589,8579871311,1316888317,8579871652,341,,
6202470229,1316.33659,8580122006,1317139013,8580122315,309,,
6202720352,1316.58671,8580372129,1317389136,8580372406,277,,
6202970486,1316.83685,8580622262,1317639269,8580622507,245,,
6203220611,1317.08697,8580872387,1317889394,8580872616,229,,
6203471200,1317.33756,8581122975,1318139982,8581123204,229,,
6203722001,1317.58836,8581373776,1318390782,8581374005,229,,
6203972150,1317.83851,8581623923,1318640930,8581624152,229,,
6204113491,1317.97985,8581765262,1318782269,8581765491,229,8581765544,
6204238980,1318.10534,8581890752,1318907758,8581890988,236,,
6204489426,1318.35579,8582141197,1319158204,8582141448,251,,
6204740433,1318.60679,8582392203,1319409210,8582392467,264,,
6204990712,1318.85707,8582642481,1319659488,8582642759,278,,
6205240923,1319.10728,8582892691,1319909697,8582892975,284,,
6205491150,1319.35751,8583142918,1320159924,8583143201,283,,
6205741562,1319.60792,8583393328,1320410335,8583393613,285,,
6205991872,1319.85823,8583643637,1320660643,8583643921,284,,
6206133394,1319.99976,8583785159,1320802165,8583785442,283,8583785364,
6206258811,1320.12517,8583910576,1320927582,8583910849,273,,
6206509634,1320.37600,8584161399,1321178406,8584161653,254,,
6206759989,1320.62635,8584411752,1321428759,8584411988,236,,
6207010497,1320.87686,8584662260,1321679266,8584662476,216,,
6207262596,1321.12896,8584914357,1321931391,8584914592,235,,
6207512986,1321.37935,8585164746,1322181753,8585164954,208,,
6207763538,1321.62990,8585415298,1322432304,8585415505,207,,
6208013881,1321.88024,8585665640,1322682646,8585665847,207,,
6208155226,1322.02159,8585806984,1322823990,8585807190,206,8585807313,
6208280732,1322.14709,8585932489,1322949495,8585932711,222,,
6208531664,1322.39802,8586183420,1323200426,8586183673,253,,
6208782009,1322.64837,8586433765,1323450771,8586434049,284,,
6209032858,1322.89922,8586684613,1323701620,8586684929,316,,
6209283261,1323.14962,8586935015,1323952022,8586935346,331,,
6209533555,1323.39992,8587185308,1324202315,8587185639,331,,
6209783845,1323.65021,8587435597,1324452603,8587435928,331,,
6210034124,1323.90048,8587685875,1324702882,8587686206,331,,
6210175682,1324.04204,8587827432,1324844439,8587827763,331,8587827539,
6210300906,1324.16727,8587952656,1324969663,8587952960,304,,
6210551402,1324.41776,8588203152,1325220158,8588203399,247,,
6210801891,1324.66825,8588453640,1325470646,8588453832,192,,
6211052393,1324.91875,8588704141,1325721147,8588704278,137,,
6211302576,1325.16894,8588954323,1325971329,8588954432,109,,
6211553099,1325.41946,8589204845,1326221851,8589204954,109,,
6211803534,1325.66989,8589455280,1326472286,8589455389,109,,
6212054239,1325.92060,8589705983,1326722990,8589706092,109,,
6212195599,1326.06196,8589847341,1326864348,8589847450,109,8589847661,
6212320899,1326.18726,8589972643,1326989649,8589972778,135,,
6212571443,1326.43780,8590223185,1327240191,8590223373,188,,
6212822136,1326.68850,8590473878,1327490885,8590474120,242,,
6213072272,1326.93863,8590724012,1327741019,8590724308,296,,
6213322974,1327.18934,8590974713,1327991720,8590975035,322,,
6213573174,1327.43953,8591224912,1328241919,8591225233,321,,
6213823931,1327.69029,8591475671,1328492677,8591475992,321,,
6214074888,1327.94125,8591726626,1328743633,8591726947,321,,
6214216724,1328.08308,8591868460,1328885466,8591868781,321,8591868645,
6214341869,1328.20823,8591993606,1329010612,8591993909,303,,
6214592189,1328.45855,8592243924,1329260931,8592244194,270,,
6214842359,1328.70872,8592494094,1329511100,8592494331,237,,
6215092991,1328.95935,8592744724,1329761731,8592744928,204,,
6215343483,1329.20984,8592995215,1330012222,8592995402,187,,
6215593615,1329.45998,8593245347,1330262353,8593245534,187,,
6215843780,1329.71014,8593495511,1330512518,8593495698,187,,
6216094337,1329.96070,8593746066,1330763073,8593746253,187,,
6216237716,1330.10408,8593889444,1330906451,8593889631,187,8593888822,
6216362821,1330.22918,8594014550,1331031556,8594014636,86,,
6216613398,1330.47976,8594265127,1331282133,8594265010,-117,,
6216863474,1330.72984,8594515201,1331532208,8594514883,-318,,
6217114037,1330.98040,8594765764,1331782771,8594765243,-521,,
6217364428,1331.23079,8595016153,1332033160,8595015533,-620,,
6217614980,1331.48134,8595266704,1332283711,8595266083,-621,,
6217865627,1331.73199,8595517351,1332534358,8595516730,-621,,
6218116536,1331.98290,8595768259,1332785265,8595767638,-621,,
6218258280,1332.12464,8595910001,1332927008,8595909380,-621,8595910271,
6218383335,1332.24970,8596035056,1333052063,8596034546,-510,,
6218633455,1332.49982,8596285176,1333302182,8596284889,-287,,
6218883760,1332.75012,8596535481,1333552488,8596535418,-63,,
6219134510,1333.00087,8596786229,1333803236,8596786391,162,,
6219385175,1333.25154,8597036893,1334053900,8597037165,272,,
6219635556,1333.50192,8597287273,1334304280,8597287545,272,,
6219885965,1333.75233,8597537681,1334554688,8597537953,272,,
6220137458,1334.00382,8597789173,1334806180,8597789445,272,,
6220279024,1334.14539,8597930738,1334947745,8597931010,272,8597931092,
6220404460,1334.27082,8598056174,1335073181,8598056455,281,,
6220654843,1334.52120,8598306556,1335323563,8598306859,303,,
6220905076,1334.77144,8598556788,1335573795,8598557111,323,,
6221155481,1335.02184,8598807193,1335824199,8598807536,343,,
6221405729,1335.27209,8599057441,1336074447,8599057796,355,,
6221656594,1335.52295,8599308305,1336325311,8599308660,355,,
6221906731,1335.77309,8599558440,1336575447,8599558795,355,,
6222156918,1336.02328,8599808626,1336825633,8599808981,355,,
6222298074,1336.16443,8599949780,1336966786,8599950134,354,8599950087,
6222423434,1336.28979,8600075141,1337092148,8600075490,349,,
6222674024,1336.54039,8600325730,1337342737,8600326069,339,,
6222924480,1336.79084,8600576186,1337593193,8600576512,326,,
6223175196,1337.04156,8600826900,1337843907,8600827215,315,,
6223425942,1337.29230,8601077645,1338094652,8601077954,309,,
6223676467,1337.54283,8601328169,1338345176,8601328479,310,,
6223926680,1337.79304,8601578383,1338595390,8601578692,309,,
6224176852,1338.04321,8601828554,1338845561,8601828863,309,,
6224318384,1338.18475,8601970083,1338987089,8601970392,309,8601970460,
6224443440,1338.30980,8602095140,1339112147,8602095457,317,,
6224693649,1338.56001,8602345348,1339362355,8602345683,335,,
6224943817,1338.81018,8602595516,1339612523,8602595868,352,,
6225194412,1339.06077,8602846109,1339863116,8602846490,381,,
6225444811,1339.31117,8603096508,1340113515,8603096887,379,,
6225695715,1339.56208,8603347410,1340364417,8603347789,379,,
6225946296,1339.81266,8603597991,1340614998,8603598371,380,,
6226196818,1340.06318,8603848512,1340865518,8603848891,379,,
6226345217,1340.21158,8603996909,1341013916,8603997288,379,8603996919,
6226470329,1340.33669,8604122023,1341139030,8604122356,333,,
6226720918,1340.58728,8604372610,1341389617,8604372851,241,,
6226971635,1340.83800,8604623327,1341640334,8604623475,148,,
6227221764,1341.08812,8604873454,1341890461,8604873510,56,,
6227472365,1341.33873,8605124055,1342141062,8605124066,11,,
6227722549,1341.58891,8605374238,1342391244,8605374249,11,,
6227973126,1341.83949,8605624829,1342641836,8605624840,11,,
6228223397,1342.08976,8605875083,1342892090,8605875094,11,,
6228364834,1342.23120,8606016519,1343033526,8606016530,11,8606016795,
6228490175,1342.35654,8606141861,1343158868,8606141905,44,,
6228740323,1342.60668,8606392007,1343409014,8606392119,112,,
6228991328,1342.85769,8606643012,1343660019,8606643191,179,,
6229241477,1343.10784,8606893161,1343910168,8606893407,246,,
6229491618,1343.35798,8607143300,1344160307,8607143578,278,,
6229741774,1343.60813,8607393455,1344410462,8607393733,278,,
6229992307,1343.85867,8607643988,1344660994,8607644266,278,,
6230242642,1344.10900,8607894321,1344911328,8607894600,279,,
6230384996,1344.25136,8608036674,1345053680,8608036952,278,8608036859,
6230510437,1344.37680,8608162116,1345179122,8608162382,266,,
6230761331,1344.62769,8608413008,1345430014,8608413251,243,,
6231011590,1344.87795,8608663267,1345680274,8608663498,231,,
6231261758,1345.12812,8608913434,1345930440,8608913632,198,,
6231512259,1345.37862,8609163935,1346180942,8609164122,187,,
6231762427,1345.62879,8609414102,1346431109,8609414289,187,,
6232012562,1345.87892,8609664235,1346681242,8609664422,187,,
6232263362,1346.12972,8609915035,1346932042,8609915222,187,,
6232405558,1346.27192,8610057228,1347074235,8610057415,187,8610057583,
6232531109,1346.39747,8610182781,1347199788,8610182988,207,,
6232781283,1346.64764,8610432952,1347449959,8610433202,250,,
6233031762,1346.89812,8610683431,1347700438,8610683723,292,,
6233281924,1347.14828,8610933592,1347950599,8610933927,335,,
6233532558,1347.39892,8611184225,1348201232,8611184581,356,,
6233782859,1347.64922,8611434526,1348451533,8611434882,356,,
6234033804,1347.90017,8611685470,1348702477,8611685826,356,,
6234284677,1348.15104,8611936342,1348953349,8611936698,356,,
6234426092,1348.29245,8612077756,1349094762,8612078112,356,8612078077,
6234551331,1348.41769,8612202995,1349220002,8612203346,351,,
6234801595,1348.66796,8612453258,1349470265,8612453601,343,,
6235051771,1348.91813,8612703433,1349720440,8612703768,335,,
6235302332,1349.16869,8612953994,1349971001,8612954321,327,,
6235552915,1349.41928,8613204576,1350221582,8613204899,323,,
6235803417,1349.66978,8613455076,1350472083,8613455400,324,,
6236054361,1349.92072,8613706019,1350723026,8613706343,324,,
6236304819,1350.17118,8613956477,1350973484,8613956800,323,,
6236446653,1350.31301,8614098309,1351115315,8614098632,323,8614098409,
6236571736,1350.43810,8614223394,1351240401,8614223689,295,,
6236822582,1350.68894,8614474239,1351491245,8614474478,239,,
6237072923,1350.93928,8614724579,1351741597,8614724775,196,,
6237323746,1351.19011,8614975401,1351992407,8614975530,129,,
6237574337,1351.44070,8615225991,1352242998,8615226093,102,,
6237824735,1351.69110,8615476387,1352493394,8615476490,103,,
6238075266,1351.94163,8615726917,1352743924,8615727019,102,,
6238325387,1352.19175,8615977038,1352994044,8615977140,102,,
6238467090,1352.33345,8616118740,1353135746,8616118842,102,8616118945,
6238592177,1352.45854,8616243827,1353260833,8616243942,115,,
6238842264,1352.70862,8616493912,1353510919,8616494053,141,,
6239092374,1352.95873,8616744022,1353761029,8616744190,168,,
6239342795,1353.20916,8616994442,1354011449,8616994636,194,,
6239593663,1353.46002,8617245309,1354262316,8617245517,208,,
6239844280,1353.71064,8617495925,1354512932,8617496132,207,,
6240094683,1353.96104,8617746327,1354763334,8617746535,208,,
6240344811,1354.21117,8617996454,1355013461,8617996661,207,,
6240490505,1354.35687,8618142148,1355159154,8618142355,207,8618142423,
6240615670,1354.48203,8618267312,1355284319,8618267527,215,,
6240866354,1354.73272,8618517996,1355535002,8618518229,233,,
6241124657,1354.99102,8618776298,1355793305,8618776549,251,,
6241374962,1355.24132,8619026602,1356043609,8619026871,269,,
6241625797,1355.49216,8619277436,1356294443,8619277713,277,,
6241876580,1355.74294,8619528218,1356545224,8619528495,277,,
6242127341,1355.99370,8619778978,1356795985,8619779255,277,,
6242377491,1356.24385,8620029128,1357046135,8620029405,277,,
6242524323,1356.39068,8620175958,1357192964,8620176235,277,8620176257,
6242649402,1356.51576,8620301038,1357318045,8620301317,279,,
6242899534,1356.76590,8620551169,1357568185,8620551464,295,,
6243150135,1357.01650,8620801769,1357818776,8620802060,291,,
6243400223,1357.26658,8621051855,1358068862,8621052153,298,,
6243650461,1357.51682,8621302092,1358319099,8621302394,302,,
6243900786,1357.76715,8621552416,1358569423,8621552717,301,,
6244151418,1358.01778,8621803048,1358820055,8621803349,301,,
6244401568,1358.26793,8622053198,1359070204,8622053499,301,,
6244542852,1358.40921,8622194480,1359211486,8622194781,301,8622194798,
6244668275,1358.53464,8622319903,1359336910,8622320206,303,,
6244918813,1358.78517,8622570440,1359587447,8622570748,308,,
6245169559,1359.03592,8622821185,1359838192,8622821499,314,,
6245420166,1359.28653,8623071791,1360088798,8623072109,318,,
6245670410,1359.53677,8623322034,1360339041,8623322354,320,,
6245920798,1359.78716,8623572421,1360589428,8623572741,320,,
6246171655,1360.03802,8623823278,1360840284,8623823598,320,,
6246421788,1360.28815,8624073411,1361090418,8624073732,321,,
6246569483,1360.43584,8624221103,1361238109,8624221423,320,8624221809,
6246694535,1360.56090,8624346156,1361363163,8624346525,369,,
6246944820,1360.81118,8624596440,1361613447,8624596906,466,,
6247195496,1361.06186,8624847115,1361864122,8624847678,563,,
6247445647,1361.31201,8625097266,1362114273,8625097926,660,,
6247696000,1361.56236,8625347617,1362364624,8625348336,719,,
6247946349,1361.81271,8625597966,1362614973,8625598674,708,,
6248196493,1362.06285,8625848108,1362865115,8625848816,708,,
6248446653,1362.31301,8626098268,1363115275,8626098976,708,,
6248588205,1362.45457,8626239818,1363256824,8626240526,708,8626240160,
6248713315,1362.57968,8626364928,1363381935,8626365590,662,,
6248964098,1362.83046,8626615710,1363632717,8626616281,571,,
6249215247,1363.08161,8626866860,1363883867,8626867339,479,,
6249465551,1363.33191,8627117162,1364134169,8627117550,388,,
6249716184,1363.58254,8627367795,1364384801,8627368149,354,,
6249966531,1363.83289,8627618140,1364635146,8627618484,344,,
6250217183,1364.08354,8627868791,1364885798,8627869135,344,,
6250467487,1364.33385,8628119094,1365136102,8628119439,345,,
6250608857,1364.47522,8628260463,1365277470,8628260807,344,8628260743,
6250734027,1364.60039,8628385634,1365402641,8628385970,336,,
6250984223,1364.85058,8628635828,1365652835,8628636149,321,,
6251234357,1365.10072,8628885961,1365902969,8628886267,306,,
6251484945,1365.35131,8629136548,1366153555,8629136837,289,,
6251735078,1365.60144,8629386682,1366403689,8629386965,283,,
6251985647,1365.85201,8629637249,1366654256,8629637532,283,,
6252236258,1366.10262,8629887859,1366904866,8629888142,283,,
6252486407,1366.35277,8630138008,1367155015,8630138290,282,,
6252627932,1366.49429,8630279530,1367296537,8630279812,282,8630279775,
6252753012,1366.61937,8630404612,1367421618,8630404888,276,,
6253003476,1366.86984,8630655075,1367672082,8630655342,267,,
6253254330,1367.12069,8630905927,1367922934,8630906187,260,,
6253505211,1367.37157,8631156807,1368173814,8631157057,250,,
6253755978,1367.62234,8631407574,1368424581,8631407820,246,,
6254006536,1367.87290,8631658131,1368675137,8631658377,246,,
6254256965,1368.12333,8631908559,1368925565,8631908805,246,,
6254507412,1368.37377,8632159005,1369176012,8632159251,246,,
6254648591,1368.51495,8632300182,1369317189,8632300428,246,8632300506,
6254773664,1368.64002,8632425255,1369442262,8632425510,255,,
6255023818,1368.89018,8632675409,1369692415,8632675684,275,,
6255274390,1369.14075,8632925980,1369942987,8632926275,295,,
6255524814,1369.39117,8633176403,1370193410,8633176719,316,,
6255775533,1369.64189,8633427121,1370444128,8633427446,325,,
6256026137,1369.89250,8633677724,1370694731,8633678050,326,,
6256276793,1370.14315,8633928379,1370945386,8633928704,325,,
6256527213,1370.39357,8634178799,1371195806,8634179124,325,,
6256675029,1370.54139,8634326614,1371343620,8634326938,324,8634325861,
6256800216,1370.66658,8634451801,1371468807,8634451990,189,,
6257050529,1370.91689,8634702113,1371719120,8634702033,-80,,
6257301329,1371.16769,8634952912,1371969918,8634952562,-350,,
6257551715,1371.41808,8635203297,1372220303,8635202678,-619,,
6257802099,1371.66846,8635453680,1372470687,8635452930,-750,,
6258052443,1371.91880,8635704023,1372721030,8635703272,-751,,
6258303042,1372.16940,8635954622,1372971629,8635953871,-751,,
6258553208,1372.41957,8636204787,1373221794,8636204036,-751,,
6258694572,1372.56093,8636346149,1373363156,8636345398,-751,8636346420,
6258819662,1372.68602,8636471239,1373488245,8636470616,-623,,
6259069830,1372.93619,8636721406,1373738413,8636721039,-367,,
6259320030,1373.18639,8636971606,1373988613,8636971495,-111,,
6259570396,1373.43676,8637221971,1374238978,8637222117,146,,
6259821020,1373.68738,8637472595,1374489602,8637472869,274,,
6260071655,1373.93802,8637723228,1374740235,8637723501,273,,
6260321814,1374.18818,8637973387,1374990394,8637973661,274,,
6260571959,1374.43832,8638223530,1375240537,8638223803,273,,
6260713572,1374.57993,8638365142,1375382148,8638365415,273,8638365417,
6260838835,1374.70520,8638490404,1375507421,8638490687,283,,
6261089438,1374.95580,8638741007,1375758014,8638741281,274,,
6261339934,1375.20629,8638991502,1376008509,8638991777,275,,
6261590315,1375.45668,8639241883,1376258899,8639242169,286,,
6261841170,1375.70753,8639492738,1376509745,8639493015,277,,
6262091424,1375.95779,8639742990,1376759997,8639743267,277,,
6262341610,1376.20797,8639993175,1377010182,8639993453,278,,
6262592576,1376.45894,8640244140,1377261147,8640244417,277,,
6262733858,1376.60022,8640385420,1377402427,8640385697,277,8640385861,
6262863682,1376.73004,8640515245,1377532252,8640515543,298,,
6263113883,1376.98024,8640765445,1377782452,8640765785,340,,
6263363995,1377.23036,8641015557,1378032563,8641015938,381,,
6263614260,1377.48062,8641265820,1378282827,8641266243,423,,
6263864827,1377.73119,8641516386,1378533393,8641516830,444,,
6264115448,1377.98181,8641767008,1378784015,8641767451,443,,
6264365981,1378.23234,8642017539,1379034545,8642017982,443,,
6264616326,1378.48269,8642267884,1379284891,8642268327,443,,
6264757973,1378.62433,8642409528,1379426535,8642409972,444,8642409882,
6264883071,1378.74943,8642534627,1379551634,8642535060,433,,
6265133554,1378.99992,8642785109,1379802115,8642785519,410,,
6265384890,1379.25125,8643036445,1380053452,8643036833,388,,
6265635421,1379.50178,8643286974,1380303981,8643287341,367,,
6265885549,1379.75191,8643537101,1380554108,8643537458,357,,
6266135806,1380.00217,8643787357,1380804364,8643787714,357,,
6266386221,1380.25258,8644037772,1381054779,8644038129,357,,
6266636308,1380.50267,8644287859,1381304865,8644288215,356,,
6266777521,1380.64388,8644429070,1381446076,8644429426,356,8644429376,
6266902595,1380.76896,8644554145,1381571152,8644554494,349,,
6267152768,1381.01913,8644804317,1381821324,8644804655,338,,
6267403408,1381.26977,8645054955,1382071962,8645055282,327,,
6267654227,1381.52059,8645305773,1382322780,8645306087,314,,
6267904855,1381.77122,8645556400,1382573407,8645556708,308,,
6268155342,1382.02170,8645806887,1382823894,8645807195,308,,
6268405917,1382.27228,8646057461,1383074467,8646057769,308,,
6268656431,1382.52279,8646307973,1383324980,8646308281,308,,
6268797704,1382.66406,8646449245,1383466251,8646449553,308,8646449576,
6268922789,1382.78915,8646574331,1383591337,8646574640,309,,
6269173130,1383.03949,8646824671,1383841678,8646824987,316,,
6269423343,1383.28970,8647074883,1384091890,8647075205,322,,
6269674234,1383.54059,8647325773,1384342780,8647326102,329,,
6269924725,1383.79109,8647576263,1384593270,8647576595,332,,
6270174888,1384.04125,8647826425,1384843431,8647826757,332,,
6270425485,1384.29185,8648077021,1385094028,8648077354,333,,
6270675722,1384.54208,8648327257,1385344264,8648327590,333,,
6270913541,1384.77990,8648565075,1385582081,8648565406,331,8648613526,
6271038612,1384.90497,8648690147,1385707154,8648696497,6350,,
6271289198,1385.15556,8648940731,1385957738,8648959140,18409,,
6271539423,1385.40578,8649190955,1386207961,8649221405,30450,,
6271789529,1385.65589,8649441070,1386458076,8649483556,42486,,
6272040023,1385.90638,8649691553,1386708560,8649740006,48453,,
6272290179,1386.15654,8649941709,1386958716,8649990162,48453,,
6272541240,1386.40760,8650192769,1387209776,8650241223,48454,,
6272791867,1386.65823,8650443396,1387460403,8650491850,48454,,
6272933120,1386.79948,8650584647,1387601653,8650633099,48452,8650584965,
6273058546,1386.92491,8650710074,1387727081,8650752489,42415,,
6273308999,1387.17536,8650960525,1387977532,8650990885,30360,,
6273559613,1387.42597,8651211139,1388228145,8651229436,18297,,
6273810062,1387.67642,8651461586,1388478593,8651467829,6243,,
6274060212,1387.92657,8651711735,1388728742,8651712056,321,,
6274310765,1388.17713,8651962287,1388979294,8651962607,320,,
6274561057,1388.42742,8652212578,1389229584,8652212898,320,,
6274811372,1388.67773,8652462892,1389479898,8652463212,320,,
6274952481,1388.81884,8652604001,1389621007,8652604320,319,8652604316,
6275077595,1388.94396,8652729115,1389746121,8652729434,319,,
6275327802,1389.19416,8652979322,1389996329,8652979640,318,,
6275577971,1389.44433,8653229489,1390246496,8653229807,318,,
6275828095,1389.69446,8653479613,1390496619,8653479930,317,,
6276078509,1389.94487,8653730025,1390747032,8653730343,318,,
6276329160,1390.19552,8653980675,1390997682,8653980992,317,,
6276579505,1390.44587,8654231020,1391248036,8654231347,327,,
6276830420,1390.69678,8654481933,1391498940,8654482251,318,,
6276972461,1390.83882,8654623973,1391640980,8654624290,317,8654623945,
6277097519,1390.96388,8654749031,1391766038,8654749304,273,,
6277348629,1391.21499,8655000141,1392017148,8655000329,188,,
6277599527,1391.46589,8655251038,1392268045,8655251139,101,,
6277850120,1391.71648,8655501630,1392518637,8655501646,16,,
6278100298,1391.96666,8655751807,1392768814,8655751781,-26,,
6278350673,1392.21703,8656002181,1393019188,8656002154,-27,,
6278600845,1392.46721,8656252352,1393269358,8656252325,-27,,
6278851504,1392.71787,8656503010,1393520017,8656502983,-27,,
6278993131,1392.85949,8656644636,1393661643,8656644609,-27,8656645028,
6279118342,1392.98470,8656769848,1393786854,8656769873,25,,
6279368793,1393.23515,8657020298,1394037305,8657020429,131,,
6279619402,1393.48576,8657270905,1394287912,8657271142,237,,
6279869927,1393.73629,8657521429,1394538435,8657521771,342,,
6280120088,1393.98645,8657771590,1394788597,8657771984,394,,
6280370227,1394.23659,8658021729,1395038736,8658022123,394,,
6280620621,1394.48698,8658272122,1395289129,8658272516,394,,
6280871147,1394.73751,8658522647,1395539653,8658523041,394,,
6281012485,1394.87885,8658663982,1395680989,8658664376,394,8658664252,
6281137554,1395.00392,8658789053,1395806060,8658789431,378,,
6281387723,1395.25408,8659039221,1396056228,8659039568,347,,
6281637930,1395.50429,8659289426,1396306433,8659289743,317,,
6281888128,1395.75449,8659539623,1396556629,8659539909,286,,
6282138521,1396.00488,8659790016,1396807023,8659790288,272,,
6282388690,1396.25505,8660040183,1397057190,8660040454,271,,
6282638839,1396.50520,8660290332,1397307339,8660290603,271,,
6282889437,1396.75580,8660540929,1397557936,8660541200,271,,
6283030767,1396.89713,8660682257,1397699263,8660682527,270,8660682594,
6283156126,1397.02249,8660807617,1397824625,8660807897,280,,
6283406540,1397.27290,8661058031,1398075038,8661058328,297,,
6283657168,1397.52353,8661308658,1398325664,8661308970,312,,
6283907425,1397.77379,8661558914,1398575931,8661559255,341,,
6284157605,1398.02397,8661809092,1398826099,8661809432,340,,
6284408074,1398.27444,8662059560,1399076567,8662059899,339,,
6284658459,1398.52482,8662309945,1399326961,8662310294,349,,
6284908598,1398.77496,8662560082,1399577088,8662560421,339,,
6285050285,1398.91665,8662701768,1399718774,8662702107,339,8662702215,
6285175739,1399.04210,8662827224,1399844231,8662827577,353,,
6285425986,1399.29235,8663077470,1400094476,8663077849,379,,
6285676708,1399.54307,8663328191,1400345198,8663328599,408,,
6285927284,1399.79364,8663578765,1400595772,8663579200,435,,
6286177463,1400.04382,8663828943,1400845950,8663829392,449,,
6286428003,1400.29436,8664079482,1401096489,8664079931,449,,
6286678315,1400.54468,8664329793,1401346800,8664330241,448,,
6286928415,1400.79478,8664579893,1401596899,8664580341,448,,
6287111567,1400.97793,8664763044,1401780050,8664763492,448,8664748065,
6287236636,1401.10300,8664888113,1401905119,8664886630,-1483,,
6287486869,1401.35323,8665138344,1402155350,8665133002,-5342,,
6287736983,1401.60334,8665388458,1402405464,8665379258,-9200,,
6287988327,1401.85469,8665639801,1402656808,8665626724,-13077,,
6288239066,1402.10543,8665890539,1402907545,8665875562,-14977,,
6288489374,1402.35574,8666140847,1403157853,8666125870,-14977,,
6288739774,1402.60613,8666391245,1403408252,8666376268,-14977,,
6288990340,1402.85670,8666641811,1403658817,8666626834,-14977,,
6289131579,1402.99794,8666783047,1403800054,8666768070,-14977,8666783375,
6289256723,1403.12308,8666908192,1403925199,8666895130,-13062,,
6289507100,1403.37346,8667158568,1404175575,8667149339,-9229,,
6289757220,1403.62358,8667408687,1404425694,8667403287,-5400,,
6290007341,1403.87370,8667658806,1404675813,8667657235,-1571,,
6290257889,1404.12425,8667909355,1404926362,8667909684,329,,
6290508592,1404.37495,8668160058,1405177065,8668160387,329,,
6290759200,1404.62556,8668410664,1405427671,8668410993,329,,
6291009546,1404.87591,8668661010,1405678016,8668661339,329,,
6291150775,1405.01714,8668802236,1405819243,8668802565,329,8668802674,
6291276030,1405.14239,8668927493,1405944500,8668927836,343,,
6291526328,1405.39269,8669177790,1406194797,8669178161,371,,
6291776520,1405.64288,8669427981,1406444988,8669428378,397,,
6292026950,1405.89331,8669678409,1406695416,8669678834,425,,
6292277184,1406.14354,8669928642,1406945649,8669929082,440,,
6292527437,1406.39380,8670178894,1407195901,8670179333,439,,
6292777571,1406.64393,8670429027,1407446045,8670429477,450,,
6293028129,1406.89449,8670679585,1407696591,8670680024,439,,
6293169483,1407.03584,8670820938,1407837944,8670821376,438,8670821310,
6293294571,1407.16093,8670946026,1407963033,8670946457,431,,
6293545161,1407.41152,8671196616,1408213623,8671197031,415,,
6293795406,1407.66177,8671446859,1408463865,8671447257,398,,
6294045526,1407.91189,8671696978,1408713985,8671697360,382,,
6294295960,1408.16232,8671947412,1408964418,8671947786,374,,
6294546109,1408.41247,8672197559,1409214565,8672197933,374,,
6294796221,1408.66258,8672447670,1409464677,8672448044,374,,
6295046329,1408.91269,8672697778,1409714784,8672698152,374,,
6295188074,1409.05444,8672839522,1409856528,8672839895,373,8672839713,
6295313508,1409.17987,8672964955,1409981963,8672965306,351,,
6295563730,1409.43009,8673215178,1410232184,8673215483,305,,
6295814365,1409.68073,8673465811,1410482818,8673466071,260,,
6296064499,1409.93086,8673715943,1410732950,8673716158,215,,
6296315110,1410.18147,8673966555,1410983561,8673966748,193,,
6296565417,1410.43178,8674216860,1411233866,8674217053,193,,
6296816451,1410.68281,8674467894,1411484900,8674468087,193,,
6297067106,1410.93347,8674718548,1411735555,8674718741,193,,
6297208836,1411.07520,8674860277,1411877283,8674860469,192,8674860385,
6297334122,1411.20048,8674985563,1412002570,8674985746,183,,
6297584771,1411.45113,8675236210,1412253217,8675236376,166,,
6297835197,1411.70156,8675486635,1412503642,8675486783,148,,
6298085912,1411.95227,8675737350,1412754357,8675737479,129,,
6298336116,1412.20248,8675987553,1413004560,8675987674,121,,
6298586260,1412.45262,8676237697,1413254703,8676237818,121,,
6298836805,1412.70317,8676488240,1413505247,8676488361,121,,
6299087257,1412.95362,8676738691,1413755698,8676738813,122,,
6299229208,1413.09557,8676880641,1413897647,8676880762,121,8676881049,
6299354278,1413.22064,8677005712,1414022718,8677005869,157,,
6299604640,1413.47100,8677256073,1414273080,8677256302,229,,
6299854768,1413.72113,8677506200,1414523207,8677506502,302,,
6300104919,1413.97128,8677756349,1414773355,8677756723,374,,
6300355366,1414.22173,8678006794,1415023801,8678007204,410,,
6300605735,1414.47210,8678257164,1415274170,8678257574,410,,
6300855872,1414.72223,8678507300,1415524307,8678507710,410,,
6301106950,1414.97331,8678758378,1415775385,8678758799,421,,
6301248673,1415.11503,8678900098,1415917105,8678900508,410,8678900610,
6301373751,1415.24011,8679025178,1416042184,8679025601,423,,
6301624349,1415.49071,8679275774,1416292781,8679276224,450,,
6301874913,1415.74127,8679526337,1416543344,8679526814,477,,
6302125320,1415.99168,8679776744,1416793751,8679777246,502,,
6302375849,1416.24221,8680027272,1417044279,8680027787,515,,
6302626356,1416.49272,8680277778,1417294795,8680278303,525,,
6302876547,1416.74291,8680527968,1417544975,8680528483,515,,
6303126724,1416.99309,8680778145,1417795152,8680778660,515,,
6303268193,1417.13455,8680919611,1417936618,8680920125,514,8680919969,
6303393685,1417.26005,8681045105,1418062112,8681045599,494,,
6303644034,1417.51040,8681295453,1418312459,8681295908,455,,
6303894556,1417.76092,8681545973,1418562979,8681546390,417,,
6304144751,1418.01111,8681796168,1418813175,8681796547,379,,
6304394912,1418.26127,8682046328,1419063346,8682046700,372,,
6304645397,1418.51176,8682296812,1419313819,8682297172,360,,
6304895598,1418.76196,8682547012,1419564019,8682547383,371,,
6305145983,1419.01234,8682797396,1419814403,8682797756,360,,
6305287261,1419.15362,8682938672,1419955679,8682939032,360,8682939070,
6305412412,1419.27877,8683063823,1420080830,8683064188,365,,
6305662659,1419.52902,8683314071,1420331078,8683314446,375,,
6305913166,1419.77953,8683564577,1420581584,8683564961,384,,
6306163392,1420.02975,8683814801,1420831808,8683815195,394,,
6306413551,1420.27991,8684064960,1421081967,8684065360,400,,
6306663688,1420.53005,8684315095,1421332101,8684315494,399,,
6306913880,1420.78024,8684565290,1421582299,8684565691,401,,
6307164008,1421.03037,8684815413,1421832420,8684815813,400,,
6307305510,1421.17187,8684956914,1421973921,8684957313,399,8684957296,
6307430974,1421.29733,8685082378,1422099385,8685082776,398,,
6307681898,1421.54826,8685333301,1422350308,8685333695,394,,
6307933586,1421.79995,8685584989,1422601996,8685585378,389,,
6308183836,1422.05020,8685835238,1422852245,8685835624,386,,
6308434510,1422.30087,8686085911,1423102918,8686086294,383,,
6308684670,1422.55103,8686336070,1423353077,8686336453,383,,
6308934838,1422.80120,8686586237,1423603244,8686586621,384,,
6309185068,1423.05143,8686836467,1423853474,8686836850,383,,
6309326522,1423.19288,8686977919,1423994926,8686978302,383,8686978343,
6309452037,1423.31840,8687103434,1424120441,8687103821,387,,
6309702139,1423.56850,8687353536,1424370542,8687353934,398,,
6309952453,1423.81881,8687603849,1424620855,8687604258,409,,
6310202629,1424.06899,8687854024,1424871030,8687854444,420,,
6310452925,1424.31929,8688104319,1425121326,8688104746,427,,
6310703060,1424.56942,8688354453,1425371460,8688354879,426,,
6310953704,1424.82007,8688605096,1425622102,8688605522,426,,
6311203865,1425.07023,8688855256,1425872263,8688855682,426,,
6311345345,1425.21171,8688996734,1426013741,8688997160,426,8688997018,
6311470717,1425.33708,8689122108,1426139114,8689122516,408,,
6311720949,1425.58731,8689372338,1426389345,8689372711,373,,
6311971409,1425.83777,8689622798,1426639804,8689623135,337,,
6312222147,1426.08851,8689873534,1426890540,8689873836,302,,
6312472461,1426.33882,8690123848,1427140854,8690124133,285,,
6312722608,1426.58897,8690373993,1427391000,8690374278,285,,
6312972884,1426.83924,8690624270,1427641277,8690624555,285,,
6313223065,1427.08943,8690874449,1427891456,8690874735,286,,
6313364344,1427.23070,8691015727,1428032733,8691016011,284,8691016082,
6313489824,1427.35619,8691141207,1428158214,8691141502,295,,
6313740049,1427.60641,8691391431,1428408438,8691391744,313,,
6313990252,1427.85661,8691641633,1428658640,8691641964,331,,
6314240835,1428.10720,8691892215,1428909222,8691892563,348,,
6314491190,1428.35755,8692142569,1429159576,8692142926,357,,
6314741302,1428.60766,8692392681,1429409688,8692393038,357,,
6314991850,1428.85821,8692643228,1429660234,8692643585,357,,
6315241972,1429.10833,8692893349,1429910356,8692893706,357,,
6315383982,1429.25034,8693035358,1430052365,8693035715,357,8693035568,
6315509054,1429.37541,8693160430,1430177437,8693160768,338,,
6315759368,1429.62573,8693410743,1430427750,8693411046,303,,
6316010143,1429.87650,8693661517,1430678524,8693661783,266,,
6316261236,1430.12760,8693912609,1430929616,8693912839,230,,
6316511836,1430.37820,8694163208,1431180215,8694163420,212,,
6316762307,1430.62867,8694413678,1431430684,8694413890,212,,
6317012423,1430.87878,8694663793,1431680800,8694664006,213,,
6317262845,1431.12921,8694914215,1431931222,8694914427,212,,
6317404656,1431.27102,8695056024,1432073031,8695056236,212,8695056256,
6317529981,1431.39634,8695181349,1432198356,8695181564,215,,
6317780342,1431.64670,8695431709,1432448716,8695431929,220,,
6318030908,1431.89727,8695682275,1432699282,8695682500,225,,
6318281295,1432.14766,8695932662,1432949668,8695932893,231,,
6318531900,1432.39826,8696183265,1433200272,8696183499,234,,
6318782746,1432.64911,8696434110,1433451117,8696434345,235,,
6319033098,1432.89946,8696684461,1433701467,8696684695,234,,
6319283595,1433.14996,8696934957,1433951964,8696935191,234,,
6319425490,1433.29185,8697076851,1434093858,8697077085,234,8697077101,
6319551046,1433.41741,8697202407,1434219414,8697202642,235,,
6319801157,1433.66752,8697452517,1434469524,8697452756,239,,
6320052172,1433.91853,8697703531,1434720538,8697703775,244,,
6320302794,1434.16916,8697954152,1434971159,8697954400,248,,
6320553639,1434.42000,8698204998,1435222005,8698205249,251,,
6320803822,1434.67018,8698455179,1435472186,8698455431,252,,
6321054290,1434.92065,8698705646,1435722652,8698705897,251,,
6321304428,1435.17079,8698955783,1435972790,8698956034,251,,
6321445681,1435.31204,8699097034,1436114041,8699097285,251,8699097335,
6321570885,1435.43725,8699222240,1436239247,8699222497,257,,
6321821041,1435.68740,8699472394,1436489401,8699472665,271,,
6322071389,1435.93775,8699722741,1436739748,8699723025,284,,
6322321969,1436.18833,8699973321,1436990328,8699973617,296,,
6322572136,1436.43850,8700223487,1437240494,8700223790,303,,
6322822699,1436.68906,8700474050,1437491057,8700474353,303,,
6323072842,1436.93920,8700724191,1437741198,8700724494,303,,
6323323395,1437.18976,8700974743,1437991750,8700975046,303,,
6323464919,1437.33128,8701116265,1438133272,8701116568,303,8701116672,
6323590334,1437.45670,8701241682,1438258698,8701242007,325,,
6323840784,1437.70715,8701492130,1438509137,8701492473,343,,
6324091285,1437.95765,8701742631,1438759637,8701743000,369,,
6324341452,1438.20781,8701992797,1439009804,8701993192,395,,
6324592540,1438.45890,8702243883,1439260889,8702244291,408,,
6324843099,1438.70946,8702494441,1439511447,8702494849,408,,
6325093661,1438.96002,8702745003,1439762010,8702745411,408,,
6325344159,1439.21052,8702995500,1440012506,8702995908,408,,
6325485662,1439.35202,8703137002,1440154008,8703137410,408,8703137415,
6325610789,1439.47715,8703262129,1440279136,8703262537,408,,
6325861393,1439.72775,8703512733,1440529740,8703513143,410,,
6326111964,1439.97833,8703763302,1440780309,8703763715,413,,
6326362575,1440.22894,8704013912,1441030919,8704014327,415,,
6326613139,1440.47950,8704264476,1441281483,8704264891,415,,
6326863517,1440.72988,8704514852,1441531859,8704515267,415,,
6327114034,1440.98040,8704765368,1441782375,8704765783,415,,
6327364586,1441.23095,8705015920,1442032926,8705016335,415,,
6327506095,1441.37246,8705157427,1442174434,8705157842,415,8705157613,
6327631558,1441.49792,8705282891,1442299898,8705283269,378,,
6327882213,1441.74857,8705533545,1442550552,8705533869,324,,
6328132471,1441.99883,8705783803,1442800810,8705784072,269,,
6328386015,1442.25238,8706037345,1443054352,8706037559,214,,
6328637695,1442.50406,8706289024,1443306030,8706289212,188,,
6328890037,1442.75640,8706541365,1443558372,8706541553,188,,
6329150408,1443.01677,8706801735,1443818742,8706801923,188,,
6329400755,1443.26712,8707052082,1444069089,8707052270,188,,
6329558674,1443.42503,8707209999,1444227006,8707210187,188,8707216152,
6329683974,1443.55033,8707335300,1444352307,8707336245,945,,
6329934499,1443.80086,8707585823,1444602830,8707588253,2430,,
6330184628,1444.05099,8707835951,1444852958,8707839874,3923,,
6330435341,1444.30170,8708086664,1445103670,8708092083,5419,,
6330686488,1444.55285,8708337810,1445354817,8708343965,6155,,
6330936725,1444.80309,8708588046,1445605053,8708594201,6155,,
6331187232,1445.05359,8708838552,1445855559,8708844707,6155,,
6331437828,1445.30419,8709089147,1446106154,8709095303,6156,,
6331579573,1445.44593,8709230890,1446247896,8709237044,6154,8709231252,
6331704738,1445.57110,8709356057,1446373064,8709361486,5429,,
6331954881,1445.82124,8709606199,1446623216,8709610191,3992,,
6332205192,1446.07155,8709856508,1446873515,8709859039,2531,,
6332455765,1446.32213,8710107080,1447124086,8710108161,1081,,
6332706073,1446.57243,8710357387,1447374393,8710357751,364,,
6332956530,1446.82289,8710607843,1447624850,8710608207,364,,
6333206820,1447.07318,8710858135,1447875145,8710858504,369,,
6333457653,1447.32401,8711108965,1448125972,8711109329,364,,
6333602182,1447.46854,8711253493,1448270499,8711253856,363,8711252519,
6333727427,1447.59379,8711378738,1448395745,8711378934,196,,
6333977520,1447.84388,8711628830,1448645836,8711628692,-138,,
6334228250,1448.09461,8711879559,1448896566,8711879087,-472,,
6334479135,1448.34550,8712130443,1449147450,8712129635,-808,,
6334730245,1448.59661,8712381553,1449398559,8712380581,-972,,
6334980396,1448.84676,8712631703,1449648710,8712630732,-971,,
6335230867,1449.09723,8712882173,1449899180,8712881212,-961,,
6335481455,1449.34782,8713132759,1450149766,8713131788,-971,,
6335623735,1449.49010,8713275039,1450292045,8713274067,-972,8713275340,
6335749016,1449.61538,8713400320,1450417327,8713399506,-814,,
6335999251,1449.86561,8713650554,1450667561,8713650059,-495,,
6336249415,1450.11578,8713900717,1450917723,8713900542,-175,,
6336499666,1450.36603,8714150968,1451167975,8714151114,146,,
6336750170,1450.61653,8714401471,1451418477,8714401774,303,,
6337000302,1450.86666,8714651602,1451668608,8714651905,303,,
6337250447,1451.11681,8714901746,1451918753,8714902049,303,,
6337500601,1451.36696,8715151898,1452168905,8715152201,303,,
6337642143,1451.50850,8715293439,1452310445,8715293742,303,8715293842,
6337767460,1451.63382,8715418756,1452435763,8715419071,315,,
6338017910,1451.88427,8715669205,1452686212,8715669547,342,,
6338268140,1452.13450,8715919436,1452936442,8715919802,366,,
6338518327,1452.38469,8716169622,1453186629,8716170015,393,,
6338768485,1452.63485,8716419778,1453436785,8716420183,405,,
6339018683,1452.88504,8716669976,1453686982,8716670381,405,,
6339268792,1453.13515,8716920083,1453937090,8716920488,405,,
6339519268,1453.38563,8717170559,1454187566,8717170964,405,,
6339660857,1453.52722,8717312146,1454329152,8717312551,405,8717312443,
6339785924,1453.65228,8717437213,1454454220,8717437604,391,,
6340036076,1453.90244,8717687364,1454704371,8717687730,366,,
6340286322,1454.15268,8717937609,1454954616,8717937959,350,,
6340536884,1454.40324,8718188171,1455205178,8718188483,312,,
6340787422,1454.65378,8718438709,1455455715,8718439008,299,,
6341037579,1454.90394,8718688865,1455705872,8718689164,299,,
6341287758,1455.15412,8718939042,1455956049,8718939341,299,,
6341538038,1455.40440,8719189321,1456206328,8719189621,300,,
6341679432,1455.54579,8719330713,1456347719,8719331012,299,8719331084,
6341804487,1455.67085,8719455769,1456472775,8719456077,308,,
6342054636,1455.92100,8719705917,1456722923,8719706243,326,,
6342305158,1456.17152,8719956439,1456973446,8719956784,345,,
6342555511,1456.42187,8720206791,1457223797,8720207155,364,,
6342805952,1456.67231,8720457231,1457474237,8720457604,373,,
6343056557,1456.92292,8720707834,1457724841,8720708207,373,,
6343306782,1457.17314,8720958060,1457975066,8720958433,373,,
6343557418,1457.42378,8721208695,1458225702,8721209069,374,,
6343699397,1457.56576,8721350671,1458367677,8721351044,373,8721350893,
6343824477,1457.69084,8721475752,1458492759,8721476108,356,,
6344074625,1457.94099,8721725899,1458742906,8721726217,318,,
6344325205,1458.19157,8721976478,1458993485,8721976758,280,,
6344575433,1458.44179,8722226705,1459243711,8722226948,243,,
6344826053,1458.69241,8722477324,1459494331,8722477549,225,,
6345076432,1458.94279,8722727702,1459744709,8722727926,224,,
6345326587,1459.19295,8722977856,1459994863,8722978081,225,,
6345576889,1459.44325,8723228159,1460245165,8723228383,224,,
6345718489,1459.58485,8723369757,1460386763,8723369980,223,8723370144,
6345843567,1459.70993,8723494836,1460511843,8723495081,245,,
6346093717,1459.96008,8723744985,1460761992,8723745270,285,,
6346344379,1460.21074,8723995646,1461012653,8723995984,338,,
6346595050,1460.46141,8724246316,1461263323,8724246685,369,,
6346845231,1460.71159,8724496495,1461513502,8724496885,390,,
6347095385,1460.96175,8724746648,1461763655,8724747037,389,,
6347345551,1461.21191,8724996814,1462013821,8724997203,389,,
6347595978,1461.46234,8725247239,1462264246,8725247628,389,,
6347737600,1461.60396,8725388861,1462405867,8725389250,389,8725389023,
6347862640,1461.72900,8725513900,1462530907,8725514260,360,,
6348113202,1461.97956,8725764462,1462781469,8725764777,315,,
6348363699,1462.23006,8726014958,1463031965,8726015207,249,,
6348614255,1462.48062,8726265513,1463282520,8726265705,192,,
6348864724,1462.73108,8726515982,1463532989,8726516146,164,,
6349114989,1462.98135,8726766246,1463783253,8726766410,164,,
6349365531,1463.23189,8727016786,1464033793,8727016951,165,,
6349615812,1463.48217,8727267066,1464284073,8727267231,165,,
6349757160,1463.62352,8727408413,1464425420,8727408577,164,8727408804,
6349882202,1463.74856,8727533455,1464550462,8727533647,192,,
6350132363,1463.99872,8727783616,1464800622,8727783865,249,,
6350382814,1464.24917,8728034065,1465051072,8728034373,308,,
6350633414,1464.49977,8728284666,1465301673,8728285031,365,,
6350883749,1464.75011,8728534999,1465552006,8728535391,392,,
6351134113,1465.00047,8728785362,1465802369,8728785755,393,,
6351384611,1465.25097,8729035859,1466052866,8729036252,393,,
6351635128,1465.50149,8729286376,1466303382,8729286768,392,,
6351776569,1465.64293,8729427814,1466444821,8729428206,392,8729428209,
6351901639,1465.76800,8729552886,1466569893,8729553267,381,,
6352151796,1466.01816,8729803042,1466820049,8729803427,385,,
6352402369,1466.26873,8730053613,1467070620,8730054003,390,,
6352652968,1466.51933,8730304212,1467321219,8730304605,393,,
6352903196,1466.76956,8730554439,1467571445,8730554835,396,,
6353153375,1467.01974,8730804617,1467821623,8730805013,396,,
6353403581,1467.26994,8731054823,1468071829,8731055219,396,,
6353653792,1467.52015,8731305032,1468322039,8731305429,397,,
6353795520,1467.66188,8731446758,1468463765,8731447154,396,8731447141,
6353920839,1467.78720,8731572078,1468589085,8731572473,395,,
6354171374,1468.03774,8731822612,1468839619,8731823004,392,,
6354421451,1468.28781,8732072688,1469089695,8732073077,389,,
6354672002,1468.53836,8732323238,1469340245,8732323625,387,,
6354922616,1468.78898,8732573851,1469590858,8732574237,386,,
6355172876,1469.03924,8732824111,1469841118,8732824496,385,,
6355423345,1469.28971,8733074579,1470091586,8733074964,385,,
6355673532,1469.53989,8733324766,1470341773,8733325151,385,,
6355815016,1469.68138,8733466247,1470483254,8733466632,385,8733466647,
6355940393,1469.80675,8733591626,1470608632,8733592011,385,,
6356190906,1470.05727,8733842137,1470859144,8733842529,392,,
6356441107,1470.30747,8734092338,1471109344,8734092732,394,,
6356691369,1470.55773,8734342598,1471359605,8734342998,400,,
6356941535,1470.80790,8734592764,1471609771,8734593165,401,,
6357191965,1471.05833,8734843193,1471860200,8734843594,401,,
6357442242,1471.30860,8735093469,1472110485,8735093880,411,,
6357692871,1471.55923,8735344096,1472361103,8735344498,402,,
6357834489,1471.70085,8735485714,1472502720,8735486114,400,8735486100,
6357959682,1471.82604,8735610907,1472627914,8735611305,398,,
6358209965,1472.07633,8735861189,1472878196,8735861585,396,,
6358460518,1472.32688,8736111741,1473128748,8736112133,392,,
6358710688,1472.57705,8736361911,1473378918,8736362300,389,,
6358960803,1472.82716,8736612024,1473629031,8736612413,389,,
6359211445,1473.07781,8736862665,1473879672,8736863054,389,,
6359462178,1473.32854,8737113397,1474130404,8737113785,388,,
6359712717,1473.57908,8737363935,1474380942,8737364324,389,,
6359854024,1473.72039,8737505241,1474522248,8737505629,388,8737505631,
6359979551,1473.84591,8737630769,1474647775,8737631157,388,,
6360229847,1474.09621,8737881064,1474898070,8737881452,388,,
6360480577,1474.34694,8738131792,1475148799,8738132182,390,,
6360734128,1474.60049,8738385344,1475402350,8738385734,390,,
6360985092,1474.85145,8738636306,1475653313,8738636697,391,,
6361235803,1475.10216,8738887016,1475904023,8738887407,391,,
6361486177,1475.35254,8739137390,1476154396,8739137781,391,,
6361736954,1475.60332,8739388166,1476405172,8739388556,390,,
6361878513,1475.74487,8739529723,1476546729,8739530113,390,8739530081,
6362003840,1475.87020,8739655050,1476672057,8739655437,387,,
6362254454,1476.12081,8739905663,1476922670,8739906041,378,,
6362505458,1476.37182,8740156666,1477173673,8740157037,371,,
6362757255,1476.62362,8740408462,1477425469,8740408825,363,,
6363007503,1476.87386,8740658709,1477675715,8740659069,360,,
6363257827,1477.12419,8740909033,1477926040,8740909393,360,,
6363508072,1477.37443,8741159277,1478176284,8741159638,361,,
6363758762,1477.62512,8741409966,1478426973,8741410326,360,,
6363900738,1477.76710,8741551941,1478568947,8741552301,360,8741552047,
6364026020,1477.89238,8741677224,1478694230,8741677552,328,,
6364276585,1478.14295,8741927787,1478944794,8741928052,265,,
6364527220,1478.39358,8742178421,1479195428,8742178623,202,,
6364777639,1478.64400,8742428839,1479445846,8742428979,140,,
6365028428,1478.89479,8742679628,1479696634,8742679736,108,,
6365279087,1479.14545,8742930285,1479947292,8742930394,109,,
6365529901,1479.39626,8743181099,1480198105,8743181207,108,,
6365780640,1479.64700,8743431838,1480448845,8743431946,108,,
6365922130,1479.78849,8743573325,1480590332,8743573434,109,8743573728,
6366047633,1479.91399,8743698829,1480715836,8743698973,144,,
6366298232,1480.16459,8743949428,1480966435,8743949648,220,,
6366549051,1480.41541,8744200245,1481217252,8744200539,294,,
6366799611,1480.66597,8744450803,1481467810,8744451172,369,,
6367050643,1480.91700,8744701835,1481718842,8744702240,405,,
6367301239,1481.16760,8744952430,1481969437,8744952835,405,,
6367551798,1481.41816,8745202989,1482219995,8745203394,405,,
6367802612,1481.66897,8745453801,1482470808,8745454207,406,,
6367943879,1481.81024,8745595067,1482612073,8745595472,405,8745595472,
6368069201,1481.93556,8745720389,1482737396,8745720793,404,,
6368319890,1482.18625,8745971087,1482988104,8745971503,416,,
6368570749,1482.43711,8746221936,1483238943,8746222342,406,,
6368821267,1482.68763,8746472453,1483489460,8746472860,407,,
6369072068,1482.93843,8746723253,1483740260,8746723661,408,,
6369322831,1483.18919,8746974015,1483991022,8746974422,407,,
6369573048,1483.43941,8747224232,1484241239,8747224639,407,,
6369823669,1483.69003,8747474852,1484491859,8747475259,407,,
6369965070,1483.83143,8747616269,1484633275,8747616676,407,8747616647,
6370090589,1483.95695,8747741770,1484758777,8747742175,405,,
6370341013,1484.20737,8747992194,1485009201,8747992597,403,,
6370591667,1484.45803,8748242846,1485259853,8748243247,401,,
6370842182,1484.70854,8748493362,1485510368,8748493760,398,,
6371092556,1484.95892,8748743734,1485760741,8748744131,397,,
6371342957,1485.20932,8748994133,1486011140,8748994531,398,,
6371593538,1485.45990,8749244714,1486261721,8749245111,397,,
6371844151,1485.71051,8749495326,1486512333,8749495723,397,,
6371985412,1485.85177,8749636585,1486653592,8749636982,397,8749636974,
6372110753,1485.97711,8749761938,1486778945,8749762333,395,,
6372360865,1486.22723,8750012038,1487029045,8750012432,394,,
6372611560,1486.47792,8750262733,1487279740,8750263125,392,,
6372861678,1486.72804,8750512849,1487529856,8750513240,391,,
6373111906,1486.97827,8750763076,1487780083,8750763466,390,,
6373362013,1487.22837,8751013183,1488030190,8751013573,390,,
6373612408,1487.47877,8751263577,1488280584,8751263967,390,,
6373862544,1487.72890,8751513712,1488530718,8751514102,390,,
6374003955,1487.87032,8751655121,1488672128,8751655511,390,8751655425,
6374129115,1487.99548,8751780282,1488797288,8751780660,378,,
6374379992,1488.24635,8752031158,1489048165,8752031515,357,,
6374630347,1488.49671,8752281512,1489298519,8752281848,336,,
6374880477,1488.74684,8752531641,1489548647,8752531956,315,,
6375131099,1488.99746,8752782262,1489799269,8752782567,305,,
6375381178,1489.24754,8753032341,1490049347,8753032646,305,,
6375631544,1489.49790,8753282707,1490299713,8753283012,305,,
6375882375,1489.74874,8753533536,1490550542,8753533841,305,,
6376025896,1489.89226,8753677056,1490694062,8753677361,305,8753676381,
6376150985,1490.01735,8753802146,1490819152,8753802328,182,,
6376401482,1490.26784,8754052641,1491069648,8754052578,-63,,
6376654961,1490.52132,8754306119,1491323126,8754305808,-311,,
6376905080,1490.77144,8754556237,1491573244,8754555682,-555,,
6377155193,1491.02155,8754806349,1491823356,8754805676,-673,,
6377405373,1491.27173,8755056529,1492073535,8755055856,-673,,
6377656231,1491.52259,8755307385,1492324392,8755306712,-673,,
6377906528,1491.77289,8755557682,1492574689,8755557009,-673,,
6378047822,1491.91418,8755698975,1492715981,8755698302,-673,8755699407,
6378173312,1492.03967,8755824464,1492841471,8755823929,-535,,
6378423440,1492.28980,8756074593,1493091600,8756074335,-258,,
6378673838,1492.54020,8756324989,1493341996,8756325009,20,,
6378924376,1492.79074,8756575527,1493592534,8756575825,298,,
6379174767,1493.04113,8756825916,1493842923,8756826350,434,,
6379425323,1493.29168,8757076471,1494093478,8757076905,434,,
6379675423,1493.54178,8757326576,1494343666,8757327094,518,,
6379925664,1493.79202,8757576810,1494593817,8757577244,434,,
6380067173,1493.93353,8757718318,1494735324,8757718752,434,8757718773,
6380192212,1494.05857,8757843358,1494860364,8757843794,436,,
6380442388,1494.30875,8758093533,1495110540,8758093985,452,,
6380692999,1494.55936,8758344142,1495361149,8758344591,449,,
6380943653,1494.81001,8758594796,1495611803,8758595250,454,,
6381194440,1495.06080,8758845582,1495862589,8758846040,458,,
6381445230,1495.31159,8759096371,1496113378,8759096828,457,,
6381695703,1495.56206,8759346844,1496363850,8759347301,457,,
6381945837,1495.81220,8759596977,1496613984,8759597434,457,,
6382087461,1495.95382,8759738600,1496755606,8759739057,457,8759738821,
6382212988,1496.07935,8759864126,1496881133,8759864553,427,,
6382463699,1496.33006,8760114837,1497131844,8760115206,369,,
6382714439,1496.58080,8760365575,1497382582,8760365885,310,,
6382964692,1496.83105,8760615827,1497632834,8760616080,253,,
6383215264,1497.08163,8760866399,1497883406,8760866622,223,,
6383465824,1497.33218,8761116959,1498133965,8761117182,223,,
6383716618,1497.58298,8761367752,1498384758,8761367975,223,,
6383966754,1497.83311,8761617886,1498634893,8761618109,223,,
6384108449,1497.97481,8761759580,1498776586,8761759803,223,8761759967,
6384233539,1498.09990,8761884671,1498901677,8761884914,243,,
6384484100,1498.35046,8762135231,1499152237,8762135515,284,,
6384734694,1498.60106,8762385823,1499402830,8762386149,326,,
6384984822,1498.85118,8762635950,1499652957,8762636318,368,,
6385235430,1499.10179,8762886558,1499903565,8762886947,389,,
6385485777,1499.35214,8763136903,1500153910,8763137292,389,,
6385736515,1499.60288,8763387641,1500404648,8763388031,390,,
6385986985,1499.85335,8763638110,1500655117,8763638499,389,,
6386128564,1499.99492,8763779687,1500796693,8763780076,389,8763780156,
6386253771,1500.12013,8763904896,1500921905,8763905298,402,,
6386504088,1500.37045,8764155211,1501172218,8764155630,419,,
6386754896,1500.62126,8764406018,1501423025,8764406459,441,,
6387005798,1500.87216,8764656919,1501673926,8764657381,462,,
6387256353,1501.12271,8764907473,1501924479,8764907944,471,,
6387506956,1501.37332,8765158076,1502175082,8765158547,471,,
6387757574,1501.62394,8765408692,1502425699,8765409164,472,,
6388007919,1501.87428,8765659037,1502676044,8765659509,472,,
6388149695,1502.01606,8765800812,1502817818,8765801283,471,8765801113,
6388274780,1502.14114,8765925898,1502942905,8765926359,461,,
6388524909,1502.39127,8766176026,1503193032,8766176434,408,,
6388775217,1502.64158,8766426332,1503443338,8766426698,366,,
6389025868,1502.89223,8766676982,1503693989,8766677306,324,,
6389276005,1503.14237,8766927119,1503944126,8766927423,304,,
6389526306,1503.39267,8767177418,1504194425,8767177721,303,,
6389776427,1503.64279,8767427538,1504444544,8767427841,303,,
6390026553,1503.89291,8767677663,1504694670,8767677967,304,,
6390181572,1504.04793,8767832681,1504849688,8767832984,303,8767830029,
6390306660,1504.17302,8767957770,1504974776,8767957701,-69,,
6390557040,1504.42340,8768208148,1505225155,8768207341,-807,,
6390807284,1504.67365,8768458391,1505475399,8768456846,-1545,,
6391057444,1504.92380,8768708551,1505725558,8768706266,-2285,,
6391307908,1505.17427,8768959014,1505976021,8768956363,-2651,,
6391558332,1505.42469,8769209438,1506226445,8769206787,-2651,,
6391808663,1505.67502,8769459768,1506476774,8769457117,-2651,,
6392058799,1505.92516,8769709903,1506726909,8769707252,-2651,,
6392200177,1506.06654,8769851279,1506868285,8769848628,-2651,8769851701,
6392325248,1506.19161,8769976351,1506993357,8769974086,-2265,,
6392575727,1506.44209,8770226828,1507243835,8770225335,-1493,,
6392825858,1506.69222,8770476959,1507493966,8770476238,-721,,
6393076274,1506.94264,8770727373,1507744380,8770727425,52,,
6393326638,1507.19300,8770977738,1507994745,8770978172,434,,
6393577277,1507.44364,8771228375,1508245381,8771228809,434,,
6393827425,1507.69379,8771478522,1508495529,8771478956,434,,
6394078352,1507.94471,8771729449,1508746456,8771729884,435,,
6394219665,1508.08603,8771870760,1508887766,8771871194,434,8771871211,
6394344963,1508.21132,8771996058,1509013065,8771996494,436,,
6394595324,1508.46168,8772246419,1509263425,8772246859,440,,
6394846332,1508.71269,8772497426,1509514433,8772497872,446,,
6395096790,1508.96315,8772747882,1509764889,8772748333,451,,
6395347355,1509.21372,8772998446,1510015453,8772998900,454,,
6395597481,1509.46384,8773248571,1510265578,8773249024,453,,
6395847913,1509.71427,8773499003,1510516010,8773499456,453,,
6396098336,1509.96470,8773749425,1510766432,8773749878,453,,
6396239566,1510.10593,8773890654,1510907660,8773891106,452,8773891078,
6396364659,1510.23102,8774015747,1511032765,8774016207,460,,
6396614895,1510.48126,8774265982,1511282989,8774266425,443,,
6396865245,1510.73161,8774516331,1511533338,8774516768,437,,
6397115571,1510.98193,8774766656,1511783663,8774767086,430,,
6397366020,1511.23238,8775017104,1512034111,8775017530,426,,
6397616579,1511.48294,8775267663,1512284670,8775268089,426,,
6397866736,1511.73310,8775517819,1512534825,8775518245,426,,
6398116914,1511.98328,8775767995,1512785002,8775768421,426,,
6398258045,1512.12441,8775909126,1512926132,8775909552,426,8775909537,
6398383160,1512.24952,8776034241,1513051248,8776034664,423,,
6398633471,1512.49983,8776284551,1513301557,8776284971,420,,
6398883924,1512.75029,8776535004,1513552011,8776535421,417,,
6399134318,1513.00068,8776785396,1513802402,8776785810,414,,
6399384487,1513.25085,8777035564,1514052571,8777035978,414,,
6399635205,1513.50157,8777286281,1514303288,8777286694,413,,
6399885353,1513.75171,8777536428,1514553435,8777536841,413,,
6400135637,1514.00200,8777786710,1514803717,8777787124,414,,
6400276891,1514.14325,8777927965,1514944971,8777928377,412,8777928364,
6400402257,1514.26862,8778053331,1515070338,8778053741,410,,
6400652441,1514.51880,8778303514,1515320520,8778303921,407,,
6400903279,1514.76964,8778554351,1515571358,8778554757,406,,
6401153425,1515.01979,8778804496,1515821503,8778804898,402,,
6401403834,1515.27020,8779054905,1516071912,8779055306,401,,
6401654475,1515.52084,8779305544,1516322551,8779305945,401,,
6401908686,1515.77505,8779559757,1516576763,8779560157,400,,
6402160723,1516.02708,8779811791,1516828797,8779812192,401,,
6402302050,1516.16841,8779953116,1516970123,8779953517,401,8779953473,
6402427519,1516.29388,8780078585,1517095592,8780078981,396,,
6402677985,1516.54435,8780329050,1517346057,8780329434,384,,
6402928338,1516.79470,8780579402,1517596409,8780579776,374,,
6403178491,1517.04485,8780829554,1517846561,8780829917,363,,
6403428905,1517.29527,8781079968,1518096975,8781080327,359,,
6403679371,1517.54573,8781330433,1518347440,8781330792,359,,
6403929500,1517.79586,8781580561,1518597568,8781580919,358,,
6404180078,1518.04644,8781831139,1518848145,8781831497,358,,
6404321285,1518.18765,8781972343,1518989349,8781972701,358,8781972722,
6404446633,1518.31299,8782097693,1519114700,8782098053,360,,
6404696815,1518.56318,8782347873,1519364880,8782348239,366,,
6404947656,1518.81402,8782598713,1519615720,8782599095,382,,
6405197794,1519.06416,8782848850,1519865857,8782849227,377,,
6405447953,1519.31431,8783099009,1520116016,8783099389,380,,
6405698470,1519.56483,8783349524,1520366531,8783349904,380,,
6405948598,1519.81496,8783599652,1520616659,8783600032,380,,
6406199006,1520.06537,8783850059,1520867066,8783850439,380,,
6406340472,1520.20683,8783991524,1521008530,8783991903,379,8783991850,
6406465550,1520.33191,8784116602,1521133609,8784116975,373,,
6406715874,1520.58224,8784366926,1521383933,8784367286,360,,
6406966364,1520.83272,8784617415,1521634421,8784617761,346,,
6407216731,1521.08309,8784867780,1521884786,8784868114,334,,
6407467330,1521.33369,8785118379,1522135385,8785118707,328,,
6407717981,1521.58434,8785369028,1522386035,8785369356,328,,
6407968101,1521.83446,8785619147,1522636154,8785619475,328,,
6408218234,1522.08460,8785869280,1522886287,8785869609,329,,
6408359829,1522.22619,8786010874,1523027880,8786011202,328,8786011230,
6408485254,1522.35162,8786136299,1523153306,8786136630,331,,
6408735402,1522.60176,8786386447,1523403453,8786386796,349,,
6408985541,1522.85190,8786636584,1523653591,8786636930,346,,
6409235699,1523.10206,8786886741,1523903748,8786887096,355,,
6409485807,1523.35217,8787136848,1524153855,8787137206,358,,
6409736027,1523.60239,8787387067,1524404074,8787387426,359,,
6409986571,1523.85293,8787637610,1524654617,8787637969,359,,
6410236692,1524.10305,8787887730,1524904736,8787888088,358,,
6410383291,1524.24965,8788034328,1525051335,8788034686,358,8788032055,
6410508847,1524.37521,8788159884,1525176891,8788159911,27,,
6410759008,1524.62537,8788410044,1525427051,8788409414,-630,,
6411009883,1524.87624,8788660919,1525677926,8788659629,-1290,,
6411260253,1525.12661,8788911288,1525928295,8788909340,-1948,,
6411510822,1525.37718,8789161856,1526178863,8789159586,-2270,,
6411760979,1525.62734,8789412012,1526429019,8789409741,-2271,,
6412011349,1525.87771,8789662390,1526679397,8789660120,-2270,,
6412261834,1526.12820,8789912865,1526929871,8789910594,-2271,,
6412402915,1526.26928,8790053945,1527070952,8790051674,-2271,8790054429,
6412527971,1526.39433,8790179001,1527196008,8790177073,-1928,,
6412778114,1526.64448,8790429143,1527446150,8790427905,-1238,,
6413029157,1526.89552,8790680186,1527697193,8790679640,-546,,
6413279323,1527.14568,8790930350,1527947357,8790930495,145,,
6413529484,1527.39585,8791180512,1528197519,8791180997,485,,
6413780051,1527.64641,8791431078,1528448084,8791431562,484,,
6414030232,1527.89659,8791681257,1528698264,8791681742,485,,
6414280663,1528.14702,8791931687,1528948694,8791932172,485,,
6414422401,1528.28876,8792073423,1529090430,8792073908,485,8792073742,
6414547490,1528.41385,8792198513,1529215520,8792198977,464,,
6414798087,1528.66445,8792449109,1529466116,8792449532,423,,
6415048242,1528.91460,8792699264,1529716270,8792699646,382,,
6415298368,1529.16473,8792949388,1529966395,8792949729,341,,
6415548548,1529.41491,8793199567,1530216574,8793199888,321,,
6415798909,1529.66527,8793449929,1530466935,8793450249,320,,
6416049093,1529.91545,8793700111,1530717118,8793700431,320,,
6416299868,1530.16623,8793950885,1530967892,8793951206,321,,
6416441021,1530.30738,8794092036,1531109043,8794092356,320,8794092521,
6416566311,1530.43267,8794217327,1531234334,8794217667,340,,
6416816441,1530.68280,8794467456,1531484463,8794467838,382,,
6417066576,1530.93294,8794717590,1531734597,8794718014,424,,
6417316727,1531.18309,8794967740,1531984747,8794968206,466,,
6417566855,1531.43322,8795217868,1532234874,8795218353,485,,
6417816994,1531.68335,8795468005,1532485012,8795468491,486,,
6418067295,1531.93366,8795718305,1532735311,8795718790,485,,
6418317424,1532.18378,8795968435,1532985442,8795968921,486,,
6418459036,1532.32540,8796110044,1533127051,8796110530,486,8796110782,
6418584111,1532.45047,8796235120,1533252127,8796235637,517,,
6418835175,1532.70154,8796486183,1533503190,8796486765,582,,
6419086135,1532.95250,8796737143,1533754150,8796737789,646,,
6419336261,1533.20262,8796987268,1534004275,8796987977,709,,
6419586395,1533.45276,8797237401,1534254407,8797238140,739,,
6419836990,1533.70335,8797487994,1534505001,8797488733,739,,
6420087121,1533.95348,8797738124,1534755131,8797738863,739,,
6420337268,1534.20363,8797988270,1535005277,8797989020,750,,
6420478684,1534.34505,8798129686,1535146692,8798130425,739,8798130110,
6420603756,1534.47012,8798254758,1535271764,8798255457,699,,
6420854332,1534.72069,8798505333,1535522340,8798505955,622,,
6421104920,1534.97128,8798755921,1535772928,8798756464,543,,
6421355388,1535.22175,8799006387,1536023394,8799006853,466,,
6421606041,1535.47240,8799257039,1536274046,8799257465,426,,
6421856177,1535.72254,8799507174,1536524181,8799507601,427,,
6422106430,1535.97279,8799757427,1536774433,8799757852,425,,
6422356541,1536.22290,8800007536,1537024543,8800007962,426,,
6422497970,1536.36433,8800148964,1537165970,8800149389,425,8800149371,
6422623523,1536.48988,8800274517,1537291525,8800274942,425,,
6422873659,1536.74002,8800524652,1537541658,8800525072,420,,
6423123920,1536.99028,8800774912,1537791919,8800775328,416,,
6423374350,1537.24071,8801025343,1538042350,8801025754,411,,
6423624808,1537.49117,8801275799,1538292806,8801276209,410,,
6423875535,1537.74190,8801526525,1538543532,8801526934,409,,
6424125925,1537.99229,8801776914,1538793921,8801777323,409,,
6424376478,1538.24284,8802027466,1539044473,8802027875,409,,
6424518087,1538.38445,8802169073,1539186080,8802169482,409,8802169293,
6424643195,1538.50956,8802294182,1539311188,8802294567,385,,
6424893316,1538.75968,8802544302,1539561309,8802544641,339,,
6425143655,1539.01002,8802794641,1539811648,8802794934,293,,
6425393858,1539.26022,8803044842,1540061849,8803045087,245,,
6425644422,1539.51078,8803295405,1540312412,8803295627,222,,
6425894733,1539.76109,8803545717,1540562724,8803545939,222,,
6426144866,1540.01123,8803795849,1540812855,8803796071,222,,
6426395209,1540.26157,8804046191,1541063197,8804046413,222,,
6426536467,1540.40283,8804187447,1541204453,8804187669,222,8804187857,
6426661835,1540.52820,8804312814,1541329821,8804313059,245,,
6426912114,1540.77848,8804563093,1541580109,8804563396,303,,
6427162292,1541.02865,8804813271,1541830278,8804813612,341,,
6427412459,1541.27882,8805063437,1542080444,8805063825,388,,
6427662633,1541.52899,8805313609,1542330615,8805314021,412,,
6427913120,1541.77948,8805564095,1542581101,8805564517,422,,
6428163408,1542.02977,8805814383,1542831390,8805814795,412,,
6428413910,1542.28027,8806064884,1543081891,8806065296,412,,
6428555083,1542.42144,8806206056,1543223062,8806206468,412,8806206441,
6428680157,1542.54652,8806331131,1543348137,8806331539,408,,
6428930751,1542.79711,8806581723,1543598730,8806582126,403,,
6429181242,1543.04760,8806832213,1543849220,8806832609,396,,
6429431468,1543.29783,8807082438,1544099445,8807082829,391,,
6429681803,1543.54816,8807332772,1544349779,8807333159,387,,
6429932105,1543.79847,8807583074,1544600081,8807583461,387,,
6430182249,1544.04861,8807833216,1544850223,8807833603,387,,
6430432465,1544.29883,8808083431,1545100438,8808083818,387,,
6430573861,1544.44022,8808224826,1545241832,8808225213,387,8808225311,
6430698930,1544.56529,8808349895,1545366902,8808350296,401,,
6430949326,1544.81569,8808600291,1545617297,8808600716,425,,
6431200086,1545.06645,8808851050,1545868057,8808851500,450,,
6431450209,1545.31657,8809101173,1546118180,8809101649,476,,
6431700794,1545.56715,8809351756,1546368763,8809352244,488,,
6431951403,1545.81776,8809602364,1546619371,8809602852,488,,
6432201571,1546.06793,8809852532,1546869538,8809853019,487,,
6432452213,1546.31857,8810103172,1547120179,8810103660,488,,
6432593716,1546.46008,8810244675,1547261681,8810245162,487,8810245177,
6432718770,1546.58513,8810369728,1547386735,8810370216,488,,
6432968911,1546.83527,8810619868,1547636875,8810620360,492,,
6433219410,1547.08577,8810870368,1547887375,8810870865,497,,
6433469970,1547.33633,8811120927,1548137933,8811121428,501,,
6433720090,1547.58645,8811371045,1548388051,8811371549,504,,
6433970417,1547.83678,8811621372,1548638379,8811621876,504,,
6434220568,1548.08693,8811871522,1548888529,8811872027,505,,
6434470736,1548.33710,8812121689,1549138696,8812122193,504,,
6434612463,1548.47882,8812263414,1549280421,8812263918,504,8812263760,
6434737536,1548.60390,8812388488,1549405495,8812388972,484,,
6434987854,1548.85422,8812638805,1549655812,8812639250,445,,
6435238496,1549.10486,8812889445,1549906452,8812889851,406,,
6435488645,1549.35501,8813139594,1550156601,8813139961,367,,
6435738985,1549.60535,8813389933,1550406940,8813390281,348,,
6435989171,1549.85553,8813640119,1550657126,8813640466,347,,
6436239349,1550.10571,8813890295,1550907302,8813890642,347,,
6436489880,1550.35624,8814140826,1551157833,8814141173,347,,
6436631225,1550.49759,8814282169,1551299175,8814282515,346,8814282641,
6436756497,1550.62286,8814407441,1551424448,8814407803,362,,
6437006661,1550.87302,8814657604,1551674611,8814657998,394,,
6437257017,1551.12338,8814907959,1551924965,8814908385,426,,
6437507267,1551.37363,8815158209,1552175216,8815158667,458,,
6437758345,1551.62471,8815409286,1552426293,8815409761,475,,
6438008504,1551.87486,8815659443,1552676450,8815659917,474,,
6438259423,1552.12578,8815910363,1552927369,8815910837,474,,
6438509567,1552.37593,8816160505,1553177512,8816160979,474,,
6438650725,1552.51709,8816301661,1553318668,8816302135,474,8816302107,
6438775867,1552.64223,8816426805,1553443812,8816427274,469,,
6439026005,1552.89237,8816676941,1553693948,8816677405,464,,
6439276177,1553.14254,8816927113,1553944120,8816927569,456,,
6439526352,1553.39271,8817177286,1554194293,8817177737,451,,
6439776875,1553.64324,8817427808,1554444815,8817428255,447,,
6440027087,1553.89345,8817678020,1554695026,8817678466,446,,
6440277235,1554.14360,8817928167,1554945173,8817928614,447,,
6440527403,1554.39376,8818178333,1555195340,8818178781,448,,
6440668552,1554.53491,8818319482,1555336488,8818319928,446,8818319928,
6440793623,1554.65998,8818444553,1555461560,8818445000,447,,
6441043914,1554.91027,8818694844,1555711850,8818695290,446,,
6441294341,1555.16070,8818945270,1555962276,8818945717,447,,
6441544497,1555.41086,8819195424,1556212431,8819195871,447,,
6441794621,1555.66098,8819445547,1556462554,8819445995,448,,
6442045013,1555.91137,8819695939,1556712945,8819696387,448,,
6442295163,1556.16152,8819946087,1556963094,8819946536,449,,
6442545650,1556.41201,8820196573,1557213580,8820197022,449,,
6442686818,1556.55318,8820337740,1557354746,8820338187,447,8820338198,
6442811875,1556.67824,8820462807,1557479814,8820463255,448,,
6443062881,1556.92924,8820713803,1557730810,8820714255,452,,
6443313028,1557.17939,8820963949,1557980955,8820964404,455,,
6443563427,1557.42979,8821214348,1558231354,8821214806,458,,
6443814349,1557.68071,8821465268,1558482275,8821465729,461,,
6444064690,1557.93105,8821715608,1558732615,8821716068,460,,
6444314831,1558.18119,8821965748,1558982755,8821966208,460,,
6444564982,1558.43134,8822215898,1559232905,8822216358,460,,
6444706836,1558.57320,8822357752,1559374758,8822358212,460,8822358018,
6444832288,1558.69865,8822483203,1559500210,8822483640,437,,
6445082857,1558.94922,8822733772,1559750778,8822734163,391,,
6445333737,1559.20010,8822984651,1560001658,8822984999,348,,
6445583888,1559.45025,8823234801,1560251807,8823235103,302,,
6445834418,1559.70078,8823485330,1560502336,8823485610,280,,
6446084744,1559.95111,8823735655,1560752662,8823735935,280,,
6446335350,1560.20171,8823986261,1561003268,8823986541,280,,
6446585741,1560.45210,8824236650,1561253656,8824236930,280,,
6446727354,1560.59371,8824378262,1561395268,8824378541,279,8824378644,
6446852638,1560.71900,8824503546,1561520553,8824503838,292,,
6447102848,1560.96921,8824753755,1561770762,8824754073,318,,
6447352992,1561.21935,8825003898,1562020905,8825004242,344,,
6447603890,1561.47025,8825254796,1562271802,8825255167,371,,
6447854366,1561.72073,8825505270,1562522277,8825505655,385,,
6448104967,1561.97133,8825755871,1562772878,8825756255,384,,
6448355421,1562.22178,8826006325,1563023331,8826006708,383,,
6448606530,1562.47289,8826257432,1563274439,8826257817,385,,
6448747766,1562.61413,8826398667,1563415673,8826399050,383,8826399134,
6448872844,1562.73921,8826523756,1563540763,8826524150,394,,
6449123408,1562.98977,8826774308,1563791315,8826774724,416,,
6449373515,1563.23988,8827024414,1564041421,8827024851,437,,
6449623856,1563.49022,8827274755,1564291762,8827275213,458,,
6449874353,1563.74071,8827525250,1564542257,8827525719,469,,
6450124527,1563.99089,8827775423,1564792430,8827775892,469,,
6450374996,1564.24136,8828025891,1565042898,8828026361,470,,
6450625126,1564.49149,8828276022,1565293028,8828276491,469,,
6450766467,1564.63283,8828417361,1565434367,8828417829,468,8828417883,
6450891537,1564.75790,8828542432,1565559438,8828542908,476,,
6451141678,1565.00804,8828792571,1565809577,8828793061,490,,
6451391825,1565.25819,8829042718,1566059725,8829043221,503,,
6451642146,1565.50851,8829293037,1566310044,8829293554,517,,
6451892235,1565.75860,8829543125,1566560131,8829543649,524,,
6452142351,1566.00871,8829793240,1566810246,8829793764,524,,
6452392531,1566.25889,8830043419,1567060426,8830043943,524,,
6452642954,1566.50932,8830293841,1567310848,8830294365,524,,
6452784152,1566.65051,8830435038,1567452045,8830435562,524,8830435461,
6452909233,1566.77559,8830560120,1567577126,8830560631,511,,
6453159410,1567.02577,8830810297,1567827304,8830810783,486,,
6453409597,1567.27596,8831060482,1568077489,8831060943,461,,
6453660007,1567.52637,8831310891,1568327898,8831311328,437,,
6453910346,1567.77671,8831561230,1568578236,8831561654,424,,
6454160486,1568.02685,8831811368,1568828374,8831811792,424,,
6454410620,1568.27698,8832061501,1569078508,8832061925,424,,
6454660762,1568.52712,8832311642,1569328649,8832312066,424,,
6454801872,1568.66823,8832452751,1569469758,8832453175,424,8832453188,
6454926945,1568.79331,8832577824,1569594831,8832578249,425,,
6455177389,1569.04375,8832828267,1569845273,8832828696,429,,
6455427541,1569.29390,8833078418,1570095425,8833078851,433,,
6455678025,1569.54439,8833328904,1570345911,8833329340,436,,
6455928354,1569.79471,8833579230,1570596237,8833579669,439,,
6456178498,1570.04486,8833829373,1570846380,8833829812,439,,
6456429118,1570.29548,8834079993,1571097000,8834080432,439,,
6456679285,1570.54565,8834330159,1571347166,8834330597,438,,
6456820888,1570.68725,8834471759,1571488765,8834472197,438,8834472013,
6456945965,1570.81233,8834596837,1571613854,8834597262,425,,
6457196485,1571.06285,8834847357,1571864364,8834847726,369,,
6457446844,1571.31320,8835097715,1572114722,8835098038,323,,
6457697252,1571.56361,8835348122,1572365129,8835348400,278,,
6457947610,1571.81397,8835598478,1572615485,8835598735,257,,
6458197796,1572.06416,8835848664,1572865671,8835848921,257,,
6458448100,1572.31446,8836098967,1573115974,8836099223,256,,
6458698629,1572.56499,8836349496,1573366503,8836349763,267,,
6458840212,1572.70657,8836491076,1573508082,8836491332,256,8836491467,
6458965687,1572.83205,8836616552,1573633559,8836616825,273,,
6459216020,1573.08238,8836866885,1573883891,8836867192,307,,
6459466386,1573.33275,8837117250,1574134257,8837117592,342,,
6459716790,1573.58315,8837367652,1574384659,8837368028,376,,
6459967226,1573.83359,8837618087,1574635094,8837618480,393,,
6460217325,1574.08369,8837868186,1574885192,8837868579,393,,
6460467451,1574.33381,8838118310,1575135317,8838118704,394,,
6460717616,1574.58398,8838368475,1575385482,8838368869,394,,
6460858864,1574.72522,8838509721,1575526728,8838510114,393,8838510186,
6460983948,1574.85031,8838634806,1575651813,8838635208,402,,
6461234287,1575.10065,8838885144,1575902151,8838885565,421,,
6461484446,1575.35081,8839135302,1576152309,8839135741,439,,
6461734850,1575.60121,8839385706,1576402713,8839386174,468,,
6461985004,1575.85136,8839635859,1576652866,8839636325,466,,
6462235884,1576.10225,8839886738,1576903745,8839887204,466,,
6462486387,1576.35275,8840137239,1577154245,8840137705,466,,
6462736608,1576.60297,8840387459,1577404465,8840387925,466,,
6462878214,1576.74457,8840529064,1577546070,8840529530,466,8840529645,
6463003287,1576.86965,8840654137,1577671144,8840654618,481,,
6463254019,1577.12038,8840904869,1577921876,8840905379,510,,
6463504199,1577.37056,8841155049,1578172055,8841155588,539,,
6463754819,1577.62118,8841405668,1578422675,8841406237,569,,
6464005330,1577.87169,8841656180,1578673187,8841656763,583,,
6464255672,1578.12203,8841906518,1578923525,8841907101,583,,
6464505917,1578.37228,8842156762,1579173769,8842157345,583,,
6464756355,1578.62272,8842407199,1579424205,8842407782,583,,
6464897612,1578.76397,8842548456,1579565462,8842549038,582,8842548878,
6465022925,1578.88929,8842673768,1579690775,8842674330,562,,
6465273325,1579.13969,8842924168,1579941175,8842924692,524,,
6465524145,1579.39051,8843174987,1580191993,8843175470,483,,
6465774967,1579.64133,8843425817,1580442825,8843426262,445,,
6466025152,1579.89151,8843675993,1580692999,8843676417,424,,
6466275795,1580.14216,8843926634,1580943641,8843927058,424,,
6466526439,1580.39280,8844177278,1581194285,8844177702,424,,
6466776892,1580.64325,8844427729,1581444736,8844428153,424,,
6466918220,1580.78458,8844569057,1581586063,8844569480,423,8844569569,
6467043291,1580.90965,8844694127,1581711134,8844694562,435,,
6467293426,1581.15979,8844944261,1581961268,8844944718,457,,
6467543845,1581.41021,8845194679,1582211685,8845195159,480,,
6467794507,1581.66087,8845445341,1582462347,8845445844,503,,
6468044652,1581.91101,8845695485,1582712491,8845695998,513,,
6468294738,1582.16110,8845945571,1582962577,8845946084,513,,
6468545098,1582.41146,8846195929,1583212936,8846196443,514,,
6468795729,1582.66209,8846446560,1583463566,8846447073,513,,
6468937251,1582.80361,8846588079,1583605085,8846588593,514,8846588571,
6469062346,1582.92871,8846713176,1583730182,8846713686,510,,
6469312581,1583.17894,8846963409,1583980415,8846963915,506,,
6469563342,1583.42970,8847214169,1584231175,8847214670,501,,
6469813869,1583.68023,8847464696,1584481702,8847465192,496,,
6470064446,1583.93081,8847715271,1584732278,8847715765,494,,
6470314613,1584.18097,8847965437,1584982444,8847965932,495,,
6470566033,1584.43239,8848216857,1585233863,8848217351,494,,
6470816565,1584.68293,8848467389,1585484396,8848467883,494,,
6470958284,1584.82464,8848609106,1585626112,8848609600,494,8848609588,
6471083583,1584.94994,8848734405,1585751412,8848734897,492,,
6471334353,1585.20071,8848985174,1586002181,8848985664,490,,
6471584759,1585.45112,8849235579,1586252586,8849236066,487,,
6471835192,1585.70155,8849486012,1586503018,8849486497,485,,
6472085665,1585.95203,8849736482,1586753489,8849736967,485,,
6472335823,1586.20218,8849986640,1587003647,8849987124,484,,
6472586775,1586.45314,8850237591,1587254598,8850238075,484,,
6472837170,1586.70353,8850487985,1587504992,8850488469,484,,
6472978523,1586.84488,8850629337,1587646344,8850629821,484,8850629724,
6473103617,1586.96998,8850754433,1587771439,8850754904,471,,
6473353823,1587.22018,8851004637,1588021643,8851005084,447,,
6473604248,1587.47061,8851255062,1588272068,8851255485,423,,
6473854829,1587.72119,8851505642,1588522648,8851506040,398,,
6474105018,1587.97138,8851755830,1588772836,8851756218,388,,
6474355292,1588.22165,8852006103,1589023110,8852006492,389,,
6474605422,1588.47178,8852256231,1589273238,8852256620,389,,
6474856341,1588.72270,8852507150,1589524156,8852507538,388,,
6474997787,1588.86415,8852648595,1589665601,8852648982,387,8852649058,
6475123003,1588.98936,8852773810,1589790816,8852774209,399,,
6475373141,1589.23950,8853023947,1590040954,8853024371,424,,
6475623312,1589.48967,8853274118,1590291125,8853274566,448,,
6475873547,1589.73991,8853524352,1590541359,8853524824,472,,
6476123699,1589.99006,8853774503,1590791510,8853774986,483,,
6476374260,1590.24062,8854025063,1591042070,8854025546,483,,
6476624737,1590.49110,8854275540,1591292547,8854276024,484,,
6476875539,1590.74190,8854526340,1591543347,8854526823,483,,
6477016613,1590.88297,8854667413,1591684420,8854667896,483,8854667914,
6477141680,1591.00804,8854792480,1591809487,8854792964,484,,
6477391803,1591.25816,8855042602,1592059609,8855043091,489,,
6477642397,1591.50876,8855293194,1592310201,8855293689,495,,
6477892967,1591.75933,8855543764,1592560771,8855544264,500,,
6478143104,1592.00947,8855793902,1592810909,8855794404,502,,
6478393426,1592.25979,8856044222,1593061229,8856044724,502,,
6478643571,1592.50993,8856294367,1593311374,8856294869,502,,
6478893737,1592.76010,8856544531,1593561538,8856545033,502,,
6479034961,1592.90132,8856685753,1593702760,8856686255,502,8856686229,
6479160030,1593.02639,8856810823,1593827830,8856811322,499,,
6479410164,1593.27652,8857060956,1594077963,8857061449,493,,
6479660435,1593.52680,8857311226,1594328233,8857311713,487,,
6479910831,1593.77719,8857561622,1594578628,8857562103,481,,
6480161003,1594.02736,8857811793,1594828799,8857812270,477,,
6480411635,1594.27800,8858062424,1595079430,8858062902,478,,
6480662185,1594.52855,8858312973,1595329980,8858313451,478,,
6480912450,1594.77881,8858563237,1595580243,8858563715,478,,
6481053516,1594.91988,8858704301,1595721308,8858704779,478,8858704799,
6481179055,1595.04542,8858829841,1595846848,8858830322,481,,
6481429210,1595.29557,8859079996,1596097003,8859080481,485,,
6481679372,1595.54573,8859330156,1596347163,8859330647,491,,
6481929552,1595.79591,8859580335,1596597343,8859580832,497,,
6482179711,1596.04607,8859830492,1596847499,8859830991,499,,
6482430143,1596.29650,8860080924,1597097931,8860081423,499,,
6482680703,1596.54706,8860331483,1597348490,8860331983,500,,
6482930873,1596.79723,8860581653,1597598659,8860582152,499,,
6483072029,1596.93839,8860722807,1597739814,8860723306,499,8860723286,
6483197091,1597.06345,8860847870,1597864877,8860848365,495,,
6483447315,1597.31368,8861098093,1598115100,8861098584,491,,
6483697566,1597.56393,8861348343,1598365350,8861348830,487,,
6483947878,1597.81424,8861598654,1598615661,8861599136,482,,
6484198501,1598.06486,8861849277,1598866284,8861849757,480,,
6484448670,1598.31503,8862099444,1599116451,8862099924,480,,
6484699131,1598.56549,8862349904,1599366911,8862350385,481,,
6484949749,1598.81611,8862600521,1599617528,8862601001,480,,
6485091128,1598.95749,8862741899,1599758905,8862742379,480,8862742403,
6485216207,1599.08257,8862866979,1599883986,8862867462,483,,
6485466655,1599.33302,8863117427,1600134434,8863117916,489,,
6485717100,1599.58346,8863367871,1600384878,8863368368,497,,
6485968180,1599.83454,8863618950,1600635957,8863619453,503,,
6486218658,1600.08502,8863869426,1600886433,8863869933,507,,
