Current Real Time,Local Server Time,Hardware Clock Time,Software Clock Time,Error,Remote Est Time,
94832904,7976190482,901194,901195,-7975289287,,
94850868,7976208446,919159,919159,-7975289287,7976208509,
95101164,7976458743,1169455,1997368429,-5979090314,,
95351411,7976708990,1419703,3993410911,-3983298079,,
95601572,7976959151,1669864,5988767431,-1988191720,,
95851949,7977209528,1920241,7977209592,64,,
96102767,7977460347,2171060,7977460411,64,,
96353155,7977710735,2421448,7977710799,64,,
96603917,7977961497,2672210,7977961562,65,,
96854106,7978211686,2922398,7978211750,64,,
96872422,7978230000,2940713,7978230064,64,7978230135,
97122997,7978480577,3191290,7978480658,81,,
97373494,7978731074,3441787,7978731174,100,,
97624332,7978981911,3692624,7978982030,119,,
97875848,7979233427,3944140,7979233563,136,,
98126467,7979484046,4194758,7979484182,136,,
98376991,7979734571,4445284,7979734707,136,,
98627208,7979984787,4695500,7979984924,137,,
98877839,7980235419,4946132,7980235555,136,,
98895989,7980253568,4964280,7980253703,135,7980253630,
99146163,7980503741,5214454,7980503858,117,,
99396746,7980754326,5465039,7980754425,99,,
99647059,7981004648,5715361,7981004729,81,,
99897407,7981254987,5965699,7981255051,64,,
100147858,7981505437,6216150,7981505501,64,,
100398311,7981755890,6466603,7981755954,64,,
100648825,7982006404,6717126,7982006478,74,,
100899235,7982256814,6967527,7982256888,74,,
100917423,7982275001,6985713,7982275065,64,7982275052,
101167598,7982525177,7235889,7982525248,71,,
101417805,7982775384,7486097,7982775444,60,,
101668059,7983025648,7736361,7983025704,56,,
101918262,7983275841,7986554,7983275894,53,,
102168566,7983526155,8236868,7983526208,53,,
102419176,7983776755,8487468,7983776808,53,,
102669574,7984027163,8737875,7984027216,53,,
102919744,7984277322,8988035,7984277375,53,,
102937710,7984295288,9006000,7984295341,53,7984295348,
103188292,7984545870,9256583,7984545924,54,,
103438703,7984796293,9507005,7984796350,57,,
103688989,7985046578,9757290,7985046637,59,,
103939539,7985297119,10007831,7985297180,61,,
104189945,7985547524,10258236,7985547585,61,,
104440485,7985798064,10508777,7985798125,61,,
104690681,7986048260,10758973,7986048322,62,,
104941193,7986298772,11009484,7986298843,71,,
104959116,7986316695,11027407,7986316755,60,7986316759,
105209645,7986567224,11277937,7986567286,62,,
105459838,7986817417,11528130,7986817480,63,,
105710238,7987067817,11778530,7987067883,66,,
105961194,7987318774,12029486,7987318840,66,,
106211650,7987569229,12279952,7987569305,76,,
106462094,7987819674,12530386,7987819740,66,,
106712986,7988070564,12781277,7988070630,66,,
106963571,7988321160,13031873,7988321226,66,,
106981615,7988339194,13049906,7988339259,65,7988339169,
107231848,7988589426,13300138,7988589479,53,,
107482190,7988839770,13550483,7988839791,21,,
107732900,7989090479,13801191,7989090477,-2,,
107983390,7989340969,14051681,7989340946,-23,,
108234174,7989591753,14302465,7989591730,-23,,
108484295,7989841875,14552587,7989841852,-23,,
108734889,7990092467,14803180,7990092444,-23,,
108985274,7990342863,15053575,7990342840,-23,,
109003209,7990360787,15071499,7990360763,-24,7990360840,
109253528,7990611107,15321819,7990611103,-4,,
109503979,7990861558,15572271,7990861575,17,,
109754837,7991112416,15823129,7991112451,35,,
110004956,7991362535,16073248,7991362590,55,,
110255057,7991612635,16323348,7991612690,55,,
110505327,7991862906,16573619,7991862961,55,,
110755830,7992113409,16824122,7992113465,56,,
111005958,7992363537,17074249,7992363592,55,,
111024161,7992381740,17092452,7992381794,54,7992381666,
111274769,7992632357,17343070,7992632381,24,,
111525319,7992882899,17593612,7992882890,-9,,
111775775,7993133354,17844067,7993133314,-40,,
112026205,7993383784,18094497,7993383713,-71,,
112276729,7993634308,18345021,7993634236,-72,,
112527535,7993885115,18595827,7993885043,-72,,
112778039,7994135618,18846331,7994135546,-72,,
113028744,7994386323,19097035,7994386251,-72,,
113046800,7994404378,19115091,7994404306,-72,7994404367,
113297648,7994655227,19365940,7994655171,-56,,
113548287,7994905866,19616579,7994905825,-41,,
113798972,7995156551,19867264,7995156526,-25,,
114049606,7995407185,20117898,7995407175,-10,,
114300399,7995657978,20368691,7995657969,-9,,
114550861,7995908440,20619153,7995908430,-10,,
114801314,7996158893,20869606,7996158883,-10,,
115052069,7996409649,21120361,7996409639,-10,,
115070112,7996427691,21138403,7996427680,-11,7996427724,
115320356,7996677936,21388648,7996677937,1,,
115571087,7996928667,21639380,7996928680,13,,
115821809,7997179388,21890101,7997179412,24,,
116072260,7997429840,22140553,7997429875,35,,
116322928,7997680507,22391219,7997680542,35,,
116573440,7997931019,22641732,7997931054,35,,
116824144,7998181723,22892435,7998181758,35,,
117074578,7998432157,23142869,7998432192,35,,
117092745,7998450323,23161036,7998450358,35,7998450429,
117343418,7998700997,23411710,7998701050,53,,
117593674,7998951254,23661967,7998951325,71,,
117844032,7999201611,23912324,7999201701,90,,
118094635,7999452214,24162927,7999452322,108,,
118344959,7999702539,24413251,7999702647,108,,
118595573,7999953153,24663866,7999953261,108,,
118846277,8000203856,24914569,8000203965,109,,
119096760,8000454354,25165066,8000454461,107,,
119114819,8000472398,25183110,8000472505,107,8000472423,
119365068,8000722647,25433359,8000722733,86,,
119615651,8000973229,25683942,8000973296,67,,
119866073,8001223651,25934374,8001223709,58,,
120116205,8001473783,26184496,8001473810,27,,
120366425,8001724004,26434716,8001724030,26,,
120616752,8001974331,26685044,8001974358,27,,
120867552,8002225130,26935853,8002225167,37,,
121117755,8002475334,27186046,8002475361,27,,
121135873,8002493451,27204164,8002493478,27,8002493435,
121386384,8002743963,27454675,8002743978,15,,
121636798,8002994376,27705089,8002994381,5,,
121887177,8003244756,27955469,8003244752,-4,,
122137371,8003494950,28205662,8003494945,-5,,
122387675,8003745254,28455966,8003745238,-16,,
122637921,8003995511,28706223,8003995496,-15,,
122888481,8004246060,28956782,8004246055,-5,,
123139046,8004496635,29207348,8004496620,-15,,
123157222,8004514800,29225512,8004514785,-15,8004514846,
123407338,8004764916,29475629,8004764917,1,,
123657998,8005015577,29726289,8005015594,17,,
123908231,8005265809,29976532,8005265852,43,,
124158616,8005516196,30226908,8005516244,48,,
124408959,8005766537,30477250,8005766585,48,,
124659259,8006016837,30727549,8006016885,48,,
124909536,8006267125,30977838,8006267173,48,,
125160378,8006517967,31228680,8006518015,48,,
125178356,8006535934,31246647,8006535982,48,8006535947,
125429032,8006786611,31497323,8006786650,39,,
125679223,8007036811,31747524,8007036841,30,,
125929947,8007287526,31998248,8007287558,32,,
126180112,8007537691,32248403,8007537704,13,,
126430696,8007788275,32498987,8007788289,14,,
126681132,8008038710,32749423,8008038724,14,,
126931380,8008288960,32999672,8008288974,14,,
127181649,8008539228,33249940,8008539241,13,,
127199830,8008557408,33268121,8008557422,14,8008557403,
127449989,8008807568,33518280,8008807587,19,,
127700281,8009057860,33768573,8009057865,5,,
127950710,8009308289,34019002,8009308290,1,,
128201086,8009558665,34269378,8009558661,-4,,
128451561,8009809139,34519852,8009809135,-4,,
128701928,8010059517,34770230,8010059513,-4,,
128952074,8010309653,35020365,8010309649,-4,,
129202489,8010560067,35270780,8010560063,-4,,
129220633,8010578212,35288924,8010578207,-5,8010578241,
129470997,8010828576,35539288,8010828579,3,,
129721170,8011078759,35789471,8011078772,13,,
129971990,8011329569,36040282,8011329591,22,,
130222462,8011580040,36290753,8011580071,31,,
130472707,8011830286,36540999,8011830317,31,,
130722882,8012080462,36791175,8012080493,31,,
130973710,8012331289,37042001,8012331319,30,,
131224364,8012581943,37292655,8012581973,30,,
131242512,8012600090,37310803,8012600121,31,8012600066,
131492916,8012850494,37561207,8012850511,17,,
131743726,8013101305,37812018,8013101309,4,,
131994249,8013351828,38062541,8013351818,-10,,
132244518,8013602097,38312810,8013602075,-22,,
132494801,8013852380,38563107,8013852371,-9,,
132745403,8014102991,38813704,8014102968,-23,,
132996122,8014353700,39064413,8014353688,-12,,
133247001,8014604580,39315292,8014604557,-23,,
133265051,8014622630,39333342,8014622606,-24,8014622616,
133515562,8014873141,39583853,8014873130,-11,,
133766135,8015123714,39834437,8015123706,-8,,
134016726,8015374305,40085018,8015374291,-14,,
134267140,8015624719,40335441,8015624717,-2,,
134517774,8015875353,40586076,8015875351,-2,,
134768185,8016125764,40836476,8016125763,-1,,
135019113,8016376692,41087404,8016376679,-13,,
135269266,8016626844,41337557,8016626832,-12,,
135287366,8016644944,41355656,8016644932,-12,8016644929,
135538131,8016895710,41606423,8016895697,-13,,
135788677,8017146256,41856969,8017146243,-13,,
136039665,8017397244,42107956,8017397231,-13,,
136290301,8017647880,42358592,8017647866,-14,,
136540857,8017898435,42609158,8017898433,-2,,
136791551,8018149130,42859843,8018149127,-3,,
137041842,8018399421,43110144,8018399419,-2,,
137292444,8018650023,43360736,8018650010,-13,,
137310496,8018668074,43378787,8018668061,-13,8018668047,
137560741,8018918319,43629031,8018918302,-17,,
137811162,8019168741,43879453,8019168720,-21,,
138061759,8019419338,44130050,8019419315,-23,,
138311932,8019669510,44380223,8019669484,-26,,
138562284,8019919863,44630576,8019919837,-26,,
138812777,8020170357,44881069,8020170331,-26,,
139063307,8020420886,45131598,8020420860,-26,,
139313475,8020671054,45381766,8020671028,-26,,
139331569,8020689147,45399860,8020689121,-26,8020689135,
139581955,8020939533,45650246,8020939510,-23,,
139832434,8021190013,45900725,8021189994,-19,,
140082670,8021440249,46150962,8021440234,-15,,
140332976,8021690565,46401278,8021690554,-11,,
140583435,8021941014,46651726,8021941012,-2,,
140834123,8022191703,46902416,8022191692,-11,,
141084326,8022441904,47152617,8022441893,-11,,
141334674,8022692263,47402976,8022692252,-11,,
141352778,8022710356,47421069,8022710345,-11,8022710375,
141603304,8022960883,47671595,8022960878,-5,,
141853845,8023211423,47922135,8023211428,5,,
142104406,8023461984,48172697,8023461997,13,,
142354634,8023712213,48422926,8023712233,20,,
142604921,8023962500,48673213,8023962520,20,,
142855439,8024213028,48923741,8024213048,20,,
143105911,8024463490,49174203,8024463510,20,,
143356886,8024714464,49425177,8024714484,20,,
143374931,8024732509,49443222,8024732529,20,8024732425,
143625499,8024983078,49693790,8024983071,-7,,
143875670,8025233250,49943963,8025233219,-31,,
144126438,8025484017,50194730,8025483961,-56,,
144376592,8025734171,50444894,8025734099,-72,,
144627097,8025984675,50695388,8025984603,-72,,
144877544,8026235123,50945845,8026235051,-72,,
145127914,8026485492,51196205,8026485410,-82,,
145378382,8026735961,51446673,8026735879,-82,,
145396419,8026753997,51464709,8026753915,-82,8026753942,
145646548,8027004127,51714839,8027004063,-64,,
145896873,8027254452,51965165,8027254385,-67,,
146147253,8027504832,52215545,8027504772,-60,,
146397600,8027755179,52465892,8027755126,-53,,
146648278,8028005858,52716570,8028005805,-53,,
146898782,8028256362,52967074,8028256309,-53,,
147148910,8028506489,53217202,8028506436,-53,,
147399445,8028757024,53467736,8028756971,-53,,
147417447,8028775025,53485738,8028774972,-53,8028774965,
147667961,8029025541,53736253,8029025486,-55,,
147918413,8029275992,53986705,8029275937,-55,,
148169323,8029526902,54237615,8029526845,-57,,
148419451,8029777030,54487742,8029776972,-58,,
148669816,8030027395,54738107,8030027337,-58,,
148920327,8030277906,54988618,8030277848,-58,,
149170524,8030528102,55238825,8030528054,-48,,
149421097,8030778686,55489398,8030778628,-58,,
149439133,8030796711,55507424,8030796653,-58,8030796648,
149689504,8031047084,55757796,8031047025,-59,,
149939664,8031297243,56007956,8031297184,-59,,
150189973,8031547552,56258265,8031547491,-61,,
150440843,8031798422,56509135,8031798360,-62,,
150691169,8032048748,56759460,8032048686,-62,,
150941563,8032299142,57009855,8032299080,-62,,
151192295,8032549874,57260587,8032549812,-62,,
151442780,8032800360,57511073,8032800298,-62,,
151460708,8032818286,57528998,8032818224,-62,8032818243,
151711102,8033068681,57779393,8033068624,-57,,
151961290,8033318870,58029583,8033318819,-51,,
152211554,8033569133,58279846,8033569087,-46,,
152462399,8033819978,58530690,8033819937,-41,,
152713151,8034070731,58781444,8034070690,-41,,
152963417,8034320996,59031709,8034320956,-40,,
153214027,8034571617,59282329,8034571576,-41,,
153464365,8034821943,59532656,8034821912,-31,,
153482473,8034840051,59550763,8034840010,-41,8034839964,
153733059,8035090638,59801351,8035090586,-52,,
153983466,8035341055,60051768,8035340992,-63,,
154234060,8035591639,60302362,8035591575,-64,,
154484369,8035841948,60552660,8035841863,-85,,
154734916,8036092504,60803217,8036092419,-85,,
154985374,8036342952,61053675,8036342877,-75,,
155235631,8036593209,61303921,8036593124,-85,,
155485961,8036843540,61554253,8036843455,-85,,
155503973,8036861551,61572264,8036861466,-85,8036861511,
155754549,8037112128,61822841,8037112055,-73,,
156004804,8037362383,62073106,8037362330,-53,,
156254991,8037612580,62323292,8037612528,-52,,
156505421,8037863000,62573712,8037862960,-40,,
156756112,8038113690,62824403,8038113651,-39,,
157006424,8038364013,63074725,8038363974,-39,,
157256620,8038614198,63324911,8038614159,-39,,
157507195,8038864774,63575486,8038864735,-39,,
157525349,8038882927,63593640,8038882888,-39,8038882889,
157775544,8039133123,63843836,8039133085,-38,,
158026240,8039383819,64094531,8039383780,-39,,
158276782,8039634361,64345073,8039634323,-38,,
158527231,8039884809,64595522,8039884772,-37,,
158777805,8040135384,64846106,8040135357,-27,,
159027980,8040385558,65096271,8040385521,-37,,
159278529,8040636107,65346820,8040636070,-37,,
159528692,8040886271,65596983,8040886233,-38,,
159546798,8040904376,65615088,8040904339,-37,8040904359,
159797006,8041154585,65865298,8041154553,-32,,
160047510,8041405089,66115801,8041405063,-26,,
160297616,8041655195,66365908,8041655174,-21,,
160547811,8041905390,66616102,8041905374,-16,,
160797979,8042155558,66866270,8042155542,-16,,
161048269,8042405848,67116560,8042405833,-15,,
161298462,8042656041,67366754,8042656026,-15,,
161549236,8042906825,67617538,8042906811,-14,,
161567409,8042924987,67635699,8042924972,-15,8042924865,
161818067,8043175646,67886359,8043175604,-42,,
162068216,8043425796,68136508,8043425728,-68,,
162318974,8043676553,68387266,8043676460,-93,,
162569388,8043926967,68637679,8043926847,-120,,
162820173,8044177752,68888465,8044177632,-120,,
163070502,8044428082,69138794,8044427962,-120,,
163320904,8044678483,69389195,8044678363,-120,,
163571662,8044929241,69639954,8044929122,-119,,
163589698,8044947277,69657989,8044947157,-120,8044947252,
163840219,8045197798,69908511,8045197703,-95,,
164090401,8045447980,70158693,8045447910,-70,,
164340836,8045698415,70409128,8045698369,-46,,
164591376,8045948956,70659668,8045948934,-22,,
164841698,8046199277,70909990,8046199256,-21,,
165091927,8046449506,71160219,8046449484,-22,,
165342113,8046699692,71410405,8046699671,-21,,
165592860,8046950439,71661161,8046950426,-13,,
165611056,8046968634,71679347,8046968612,-22,8046968477,
165861962,8047219540,71930253,8047219484,-56,,
166112681,8047470260,72180972,8047470171,-89,,
166363209,8047720788,72431501,8047720666,-122,,
166613694,8047971273,72681985,8047971118,-155,,
166864197,8048221776,72932489,8048221621,-155,,
167115001,8048472580,73183293,8048472425,-155,,
167365303,8048722882,73433595,8048722727,-155,,
167615874,8048973453,73684166,8048973298,-155,,
167633985,8048991564,73702276,8048991408,-156,8048991455,
167884671,8049242250,73952962,8049242107,-143,,
168135627,8049493206,74203919,8049493075,-131,,
168386103,8049743682,74454395,8049743564,-118,,
168636495,8049994083,74704796,8049993976,-107,,
168886784,8050244363,74955076,8050244256,-107,,
169137004,8050494584,75205297,8050494478,-106,,
169387650,8050745229,75455941,8050745121,-108,,
169638194,8050995773,75706486,8050995666,-107,,
169656339,8051013917,75724630,8051013810,-107,8051013794,
169907178,8051264757,75975470,8051264646,-111,,
170157710,8051515289,76226001,8051515175,-114,,
170407883,8051765471,76476184,8051765353,-118,,
170658216,8052015794,76726518,8052015685,-109,,
170908328,8052265907,76976630,8052265797,-110,,
171158591,8052516170,77226883,8052516059,-111,,
171408732,8052766311,77477023,8052766189,-122,,
171659381,8053016959,77727672,8053016838,-121,,
171677623,8053035202,77745914,8053035080,-122,8053035054,
171928310,8053285889,77996601,8053285761,-128,,
172178987,8053536566,78247279,8053536432,-134,,
172429672,8053787252,78497965,8053787112,-140,,
172680237,8054037816,78748529,8054037670,-146,,
172930511,8054288090,78998803,8054287944,-146,,
173180679,8054538259,79248972,8054538114,-145,,
173431258,8054788837,79499550,8054788692,-145,,
173681783,8055039361,79750073,8055039215,-146,,
173699885,8055057463,79768176,8055057317,-146,8055057373,
173950444,8055308024,80018736,8055307892,-132,,
174200938,8055558517,80269239,8055558410,-107,,
174451452,8055809042,80519754,8055808939,-103,,
174702279,8056059858,80770571,8056059770,-88,,
174952736,8056310315,81021028,8056310227,-88,,
175203375,8056560954,81271666,8056560866,-88,,
175453756,8056811335,81522048,8056811248,-87,,
175704184,8057061763,81772475,8057061685,-78,,
175722232,8057079810,81790523,8057079722,-88,8057079744,
175972785,8057330363,82041086,8057330290,-73,,
176222971,8057580549,82291272,8057580483,-66,,
176473764,8057831342,82542055,8057831281,-61,,
176723971,8058081551,82792264,8058081486,-65,,
176974646,8058332225,83042938,8058332161,-64,,
177224843,8058582432,83293145,8058582367,-65,,
177475300,8058832879,83543602,8058832824,-55,,
177725489,8059083068,83793780,8059083003,-65,,
177743600,8059101179,83811891,8059101113,-66,8059101118,
177993996,8059351575,84062288,8059351510,-65,,
178244332,8059601912,84312625,8059601849,-63,,
178494490,8059852069,84562782,8059852008,-61,,
178746659,8060104238,84814950,8060104179,-59,,
178996921,8060354500,85065213,8060354441,-59,,
179247088,8060604667,85315380,8060604608,-59,,
179497648,8060855227,85565940,8060855169,-58,,
179748117,8061105696,85816408,8061105648,-48,,
179766147,8061123725,85834437,8061123666,-59,8061123671,
180016476,8061374064,86084777,8061374006,-58,,
180266703,8061624282,86334994,8061624225,-57,,
180517575,8061875154,86585866,8061875099,-55,,
180767774,8062125353,86836065,8062125300,-53,,
181017997,8062375576,87086299,8062375533,-43,,
181268217,8062625796,87336509,8062625743,-53,,
181518563,8062876152,87586864,8062876098,-54,,
181768955,8063126534,87837247,8063126481,-53,,
181786996,8063144574,87855286,8063144521,-53,8063144449,
182037518,8063395107,88105819,8063395037,-70,,
182288173,8063645751,88356464,8063645663,-88,,
182538272,8063895862,88606574,8063895757,-105,,
182788883,8064146461,88857174,8064146338,-123,,
183039095,8064396684,89107396,8064396561,-123,,
183289576,8064647154,89357867,8064647031,-123,,
183540112,8064897691,89608403,8064897578,-113,,
183790716,8065148295,89859008,8065148173,-122,,
183808749,8065166328,89877040,8065166205,-123,8065166193,
184059045,8065416624,90127336,8065416508,-116,,
184309256,8065666836,90377548,8065666708,-128,,
184559460,8065917039,90627751,8065916907,-132,,
184809576,8066167155,90877867,8066167021,-134,,
185060432,8066418021,91128733,8066417888,-133,,
185310544,8066668123,91378835,8066667990,-133,,
185560750,8066918328,91629041,8066918195,-133,,
185811102,8067168681,91879393,8067168548,-133,,
185829189,8067186767,91897479,8067186634,-133,8067186645,
186079666,8067437244,92147967,8067437124,-120,,
186329839,8067687418,92398130,8067687291,-127,,
186580169,8067937748,92648460,8067937624,-124,,
186830798,8068188377,92899089,8068188257,-120,,
187081497,8068439077,93149789,8068438957,-120,,
187332303,8068689881,93400604,8068689771,-110,,
187582420,8068939998,93650711,8068939878,-120,,
187832961,8069190539,93901252,8069190419,-120,,
187851033,8069208611,93919324,8069208491,-120,8069208536,
188101424,8069459003,94169716,8069458895,-108,,
188351553,8069709132,94419844,8069709034,-98,,
188601889,8069959467,94670180,8069959381,-86,,
188852105,8070209684,94920396,8070209610,-74,,
189102544,8070460123,95170835,8070460049,-74,,
189352649,8070710227,95420950,8070710164,-63,,
189602927,8070960505,95671218,8070960431,-74,,
189853101,8071210679,95921392,8071210605,-74,,
189871245,8071228823,95939536,8071228749,-74,8071228803,
190121511,8071479090,96189803,8071479029,-61,,
190371674,8071729252,96439964,8071729205,-47,,
190621881,8071979459,96690172,8071979426,-33,,
190872231,8072229810,96940522,8072229802,-8,,
191122524,8072480103,97190815,8072480084,-19,,
191372951,8072730529,97441242,8072730521,-8,,
191623140,8072980719,97691431,8072980700,-19,,
191873464,8073231043,97941765,8073231033,-10,,
191891513,8073249092,97959804,8073249073,-19,8073249022,
192141827,8073499406,98210119,8073499375,-31,,
192392210,8073749789,98460502,8073749745,-44,,
192642622,8074000201,98710913,8074000144,-57,,
192892732,8074250321,98961034,8074250254,-67,,
193143557,8074501146,99211859,8074501078,-68,,
193393721,8074751300,99462022,8074751242,-58,,
193644168,8075001747,99712459,8075001689,-58,,
193894745,8075252324,99963037,8075252256,-68,,
193912852,8075270430,99981142,8075270362,-68,8075270293,
194163120,8075520699,100231411,8075520613,-86,,
194413328,8075770907,100481619,8075770816,-91,,
194663632,8076021211,100731923,8076021093,-118,,
194914271,8076271849,100982562,8076271714,-135,,
195164706,8076522295,101233007,8076522160,-135,,
195414926,8076772505,101483217,8076772370,-135,,
195665462,8077023041,101733753,8077022906,-135,,
195915768,8077273357,101984069,8077273222,-135,,
195933870,8077291448,102002160,8077291313,-135,8077291292,
196184314,8077541893,102252605,8077541752,-141,,
196434541,8077792120,102502832,8077791974,-146,,
196685123,8078042702,102753414,8078042552,-150,,
196935923,8078293502,103004215,8078293347,-155,,
197186677,8078544266,103254978,8078544111,-155,,
197436989,8078794579,103505291,8078794424,-155,,
197687852,8079045432,103756144,8079045277,-155,,
197938361,8079295940,104006652,8079295785,-155,,
197956381,8079313959,104024672,8079313804,-155,8079313718,
198207015,8079564595,104275307,8079564418,-177,,
198457460,8079815049,104525761,8079814850,-199,,
198707735,8080065314,104776026,8080065095,-219,,
198958236,8080315814,105026526,8080315574,-240,,
199208406,8080565985,105276698,8080565746,-239,,
199458873,8080816451,105527164,8080816211,-240,,
199708992,8081066571,105777283,8081066331,-240,,
199959503,8081317081,106027794,8081316841,-240,,
199977606,8081335184,106045897,8081334944,-240,8081334994,
200227722,8081585302,106296014,8081585075,-227,,
200477861,8081835440,106546152,8081835225,-215,,
200728508,8082086087,106796800,8082085886,-201,,
200978855,8082336434,107047146,8082336245,-189,,
201229051,8082586630,107297343,8082586442,-188,,
201479219,8082836798,107547510,8082836610,-188,,
201729873,8083087452,107798164,8083087264,-188,,
201980230,8083337809,108048522,8083337621,-188,,
201998213,8083355791,108066504,8083355603,-188,8083355676,
202248593,8083606181,108316894,8083606011,-170,,
202498752,8083856331,108567043,8083856189,-142,,
202749178,8084106757,108817470,8084106624,-133,,
202999747,8084357325,109068037,8084357211,-114,,
203250147,8084607726,109318439,8084607613,-113,,
203500697,8084858276,109568989,8084858162,-114,,
203751320,8085108898,109819611,8085108784,-114,,
204001742,8085359321,110070033,8085359207,-114,,
204019854,8085377432,110088144,8085377318,-114,8085377301,
204270390,8085627968,110338681,8085627859,-109,,
204521040,8085878619,110589331,8085878496,-123,,
204771657,8086129237,110839949,8086129110,-127,,
205021859,8086379437,111090150,8086379307,-130,,
205272317,8086629896,111340609,8086629766,-130,,
205522867,8086880446,111591159,8086880316,-130,,
205773375,8087130954,111841667,8087130824,-130,,
206023619,8087381197,112091910,8087381067,-130,,
206041858,8087399436,112110148,8087399306,-130,8087399244,
206292474,8087650053,112360765,8087649907,-146,,
206542644,8087900223,112610935,8087900062,-161,,
206793235,8088150815,112861528,8088150640,-175,,
207043629,8088401208,113111921,8088401019,-189,,
207294162,8088651741,113362465,8088651562,-179,,
207545160,8088902738,113613451,8088902548,-190,,
207795417,8089152995,113863708,8089152805,-190,,
208045800,8089403378,114114091,8089403188,-190,,
208063856,8089421434,114132147,8089421244,-190,8089421290,
208314116,8089671705,114382418,8089671526,-179,,
208564480,8089922059,114632771,8089921891,-168,,
208814606,8090172184,114882897,8090172029,-155,,
209065246,8090422824,115133537,8090422681,-143,,
209315863,8090673452,115384165,8090673309,-143,,
209566517,8090924096,115634808,8090923953,-143,,
209816801,8091174380,115885092,8091174237,-143,,
210067100,8091424679,116135391,8091424546,-133,,
210085188,8091442766,116153478,8091442623,-143,8091442646,
210335862,8091693441,116404154,8091693303,-138,,
210586596,8091944174,116654887,8091944042,-132,,
210836809,8092194388,116905100,8092194262,-126,,
211087036,8092444625,117155338,8092444506,-119,,
211337546,8092695136,117405849,8092695017,-119,,
211587813,8092945392,117656104,8092945272,-120,,
211838190,8093195769,117906482,8093195651,-118,,
212088730,8093446309,118157021,8093446189,-120,,
212106817,8093464396,118175108,8093464276,-120,8093464253,
212357103,8093714692,118425405,8093714567,-125,,
212607657,8093965235,118675948,8093965105,-130,,
212858251,8094215830,118926543,8094215695,-135,,
213108492,8094466070,119176783,8094465929,-141,,
213358685,8094716265,119426977,8094716123,-142,,
213609123,8094966701,119677414,8094966560,-141,,
213859627,8095217205,119927918,8095217074,-131,,
214109970,8095467549,120178261,8095467407,-142,,
214128070,8095485648,120196361,8095485507,-141,8095485539,
214378481,8095736060,120446772,8095735936,-124,,
214629017,8095986596,120697318,8095986480,-116,,
214879544,8096237122,120947834,8096237005,-117,,
215129848,8096487427,121198140,8096487319,-108,,
215380222,8096737802,121448514,8096737694,-108,,
215630370,8096987949,121698661,8096987841,-108,,
215880584,8097238162,121948875,8097238054,-108,,
216130746,8097488325,122199038,8097488217,-108,,
216148720,8097506298,122217010,8097506190,-108,8097506158,
216399159,8097756738,122467450,8097756623,-115,,
216649638,8098007216,122717929,8098007093,-123,,
216900140,8098257719,122968432,8098257589,-130,,
217150940,8098508519,123219242,8098508391,-128,,
217401262,8098758850,123469563,8098758712,-138,,
217652015,8099009594,123720307,8099009456,-138,,
217902177,8099259756,123970468,8099259628,-128,,
218152580,8099510158,124220871,8099510020,-138,,
218170587,8099528166,124238878,8099528027,-139,8099527973,
218421366,8099778945,124489657,8099778792,-153,,
218671729,8100029308,124740021,8100029143,-165,,
218922096,8100279675,124990388,8100279496,-179,,
219172465,8100530044,125240756,8100529863,-181,,
219422861,8100780440,125491162,8100780259,-181,,
219673401,8101030979,125741702,8101030798,-181,,
219924327,8101281906,125992618,8101281715,-191,,
220174653,8101532232,126242944,8101532040,-192,,
220192651,8101550229,126260941,8101550038,-191,8101550021,
220443247,8101800826,126511539,8101800631,-195,,
220694196,8102051775,126762488,8102051578,-197,,
220944350,8102301928,127012640,8102301726,-202,,
221194779,8102552357,127263070,8102552151,-206,,
221445410,8102802989,127513701,8102802783,-206,,
221696035,8103053614,127764327,8103053418,-196,,
221946137,8103303715,128014428,8103303509,-206,,
222196988,8103554568,128265280,8103554362,-206,,
222215023,8103572602,128283314,8103572395,-207,8103572453,
222465352,8103822931,128533644,8103822739,-192,,
222715713,8104073302,128784014,8104073125,-177,,
222966262,8104323840,129034553,8104323678,-162,,
223216438,8104574017,129284729,8104573870,-147,,
223466908,8104824496,129535209,8104824350,-146,,
223717606,8105075185,129785898,8105075038,-147,,
223967854,8105325432,130036145,8105325285,-147,,
224218061,8105575640,130286352,8105575493,-147,,
224235993,8105593572,130304284,8105593425,-147,8105593362,
224486404,8105843994,130554706,8105843832,-162,,
224736773,8106094353,130805065,8106094176,-177,,
224987130,8106344709,131055421,8106344516,-193,,
225237547,8106595125,131305838,8106594917,-208,,
225488132,8106845711,131556423,8106845502,-209,,
225738514,8107096094,131806807,8107095886,-208,,
225989094,8107346673,132057385,8107346464,-209,,
226239570,8107597149,132307862,8107596941,-208,,
226257686,8107615264,132325977,8107615056,-208,8107615070,
226507843,8107865422,132576134,8107865217,-205,,
226758189,8108115768,132826491,8108115578,-190,,
227008830,8108366409,133077121,8108366212,-197,,
227259521,8108617099,133327812,8108616906,-193,,
227509730,8108867308,133578021,8108867115,-193,,
227760130,8109117709,133828422,8109117517,-192,,
228010452,8109368031,134078743,8109367838,-193,,
228261005,8109618583,134329296,8109618390,-193,,
228279111,8109636689,134347402,8109636496,-193,8109636500,
228529519,8109887098,134597811,8109886907,-191,,
228780392,8110137971,134848683,8110137781,-190,,
229030755,8110388334,135099046,8110388145,-189,,
229281293,8110638872,135349584,8110638684,-188,,
229531458,8110889036,135599749,8110888849,-187,,
229782008,8111139588,135850300,8111139401,-187,,
230032341,8111389920,136100632,8111389732,-188,,
230282702,8111640280,136350993,8111640093,-187,,
230300728,8111658307,136369019,8111658119,-188,8111658153,
230551293,8111908872,136619584,8111908694,-178,,
230801479,8112159058,136869770,8112158887,-171,,
231051996,8112409574,137120287,8112409413,-161,,
231302126,8112659704,137370417,8112659552,-152,,
231552778,8112910356,137621069,8112910204,-152,,
231802889,8113160468,137871180,8113160316,-152,,
232053911,8113411490,138122203,8113411338,-152,,
232304047,8113661626,138372338,8113661484,-142,,
232322018,8113679596,138390308,8113679444,-152,8113679479,
232572117,8113929696,138640408,8113929552,-144,,
232822547,8114180127,138890839,8114179993,-134,,
233072956,8114430534,139141246,8114430409,-125,,
233323392,8114680971,139391683,8114680854,-117,,
233573564,8114931143,139641855,8114931026,-117,,
233824290,8115181868,139892581,8115181752,-116,,
234074549,8115432128,140142840,8115432021,-107,,
234325190,8115682768,140393481,8115682652,-116,,
234343324,8115700903,140411615,8115700786,-117,8115700735,
234594157,8115951736,140662448,8115951607,-129,,
234844495,8116202073,140912796,8116201941,-132,,
235094865,8116452454,141163167,8116452300,-154,,
235345137,8116702716,141413428,8116702549,-167,,
235595608,8116953186,141663899,8116953020,-166,,
235845854,8117203433,141914145,8117203266,-167,,
236096599,8117454188,142164901,8117454023,-165,,
236347174,8117704753,142415465,8117704586,-167,,
236365197,8117722775,142433488,8117722609,-166,8117722586,
236615472,8117973051,142683763,8117972879,-172,,
236865878,8118223457,142934170,8118223290,-167,,
237116562,8118474142,143184865,8118473970,-172,,
237366735,8118724324,143435036,8118724136,-188,,
237616879,8118974457,143685170,8118974270,-187,,
237867022,8119224601,143935314,8119224414,-187,,
238117631,8119475211,144185923,8119475023,-188,,
238367815,8119725404,144436117,8119725217,-187,,
238385839,8119743418,144454130,8119743231,-187,8119743211,
238636224,8119993802,144704515,8119993610,-192,,
238886746,8120244325,144955037,8120244129,-196,,
239136869,8120494448,145205160,8120494258,-190,,
239387563,8120745142,145455854,8120744937,-205,,
239638071,8120995649,145706361,8120995444,-205,,
239888501,8121246079,145956792,8121245874,-205,,
240139039,8121496618,146207330,8121496413,-205,,
240389323,8121746902,146457614,8121746697,-205,,
240407438,8121765016,146475728,8121764810,-206,8121764821,
240658193,8122015772,146726484,8122015570,-202,,
240908733,8122266311,146977034,8122266122,-189,,
241158859,8122516438,147227150,8122516241,-197,,
241408965,8122766543,147477256,8122766350,-193,,
241659214,8123016793,147727505,8123016599,-194,,
241909313,8123266892,147977604,8123266698,-194,,
242159485,8123517064,148227776,8123516870,-194,,
242409648,8123767226,148477949,8123767043,-183,,
242427719,8123785297,148496010,8123785104,-193,8123785176,
242677882,8124035461,148746173,8124035294,-167,,
242928298,8124285877,148996590,8124285720,-157,,
243178478,8124536057,149246769,8124535917,-140,,
243428616,8124786205,149496918,8124786085,-120,,
243678810,8125036389,149747101,8125036268,-121,,
243929325,8125286904,149997616,8125286783,-121,,
244180099,8125537678,150248390,8125537558,-120,,
244430505,8125788094,150498806,8125787974,-120,,
244448656,8125806234,150516947,8125806114,-120,8125806076,
244699407,8126056986,150767698,8126056856,-130,,
244950059,8126307637,151018350,8126307499,-138,,
245200555,8126558134,151268846,8126557997,-137,,
245450982,8126808561,151519274,8126808405,-156,,
245701103,8127058682,151769394,8127058525,-157,,
245951671,8127309250,152019962,8127309094,-156,,
246201792,8127559370,152270083,8127559214,-156,,
246452008,8127809597,152520309,8127809441,-156,,
246470012,8127827591,152538303,8127827435,-156,8127827399,
246720535,8128078115,152788827,8128077950,-165,,
246970692,8128328271,153038984,8128328098,-173,,
247221081,8128578659,153289371,8128578487,-172,,
247471935,8128829525,153540237,8128829334,-191,,
247722208,8129079786,153790499,8129079596,-190,,
247972335,8129329913,154040626,8129329723,-190,,
248222470,8129580049,154290761,8129579859,-190,,
248472961,8129830550,154541263,8129830360,-190,,
248491032,8129848611,154559323,8129848420,-191,8129848369,
248741220,8130098799,154809512,8130098595,-204,,
248991537,8130349116,155059828,8130348899,-217,,
249241961,8130599540,155310252,8130599311,-229,,
249492693,8130850272,155560984,8130850041,-231,,
249742800,8131100379,155811091,8131100139,-240,,
249993207,8131350786,156061498,8131350546,-240,,
250243319,8131600897,156311610,8131600657,-240,,
250493741,8131851320,156562032,8131851079,-241,,
250511810,8131869388,156580101,8131869148,-240,8131869178,
250762396,8132119975,156830688,8132119742,-233,,
251012517,8132370096,157080808,8132369870,-226,,
251262799,8132620378,157331090,8132620161,-217,,
251513270,8132870848,157581561,8132870639,-209,,
251763927,8133121505,157832218,8133121296,-209,,
252014296,8133371875,158082587,8133371665,-210,,
252264441,8133622019,158332732,8133621810,-209,,
252514625,8133872203,158582916,8133872004,-199,,
252532767,8133890345,158601058,8133890136,-209,8133890030,
252783392,8134140972,158851684,8134140736,-236,,
253033670,8134391248,159101961,8134390986,-262,,
253284181,8134641760,159352472,8134641471,-289,,
253534680,8134892258,159602971,8134891944,-314,,
253785169,8135142748,159853460,8135142434,-314,,
254035652,8135393231,160103944,8135392917,-314,,
254285981,8135643559,160354272,8135643245,-314,,
254536172,8135893751,160604464,8135893437,-314,,
254554115,8135911694,160622406,8135911379,-315,8135911496,
254804625,8136162204,160872926,8136161928,-276,,
255054942,8136412521,161123234,8136412266,-255,,
255305388,8136662967,161373680,8136662741,-226,,
255555731,8136913310,161624022,8136913113,-197,,
255806745,8137164324,161875037,8137164128,-196,,
256056978,8137414556,162125269,8137414360,-196,,
256307320,8137664899,162375611,8137664702,-197,,
256557456,8137915035,162625747,8137914839,-196,,
256575459,8137933038,162643750,8137932841,-197,8137932806,
256825838,8138183417,162894129,8138183211,-206,,
257076222,8138433800,163144512,8138433586,-214,,
257326526,8138684105,163394817,8138683883,-222,,
257576896,8138934475,163645187,8138934245,-230,,
257827050,8139184629,163895342,8139184399,-230,,
258077364,8139434942,164145655,8139434712,-230,,
258327789,8139685368,164396080,8139685147,-221,,
258578366,8139935945,164646657,8139935715,-230,,
258596454,8139954032,164664745,8139953802,-230,8139953857,
258847054,8140204632,164915345,8140204415,-217,,
259097608,8140455197,165165909,8140454994,-203,,
259347836,8140705414,165416127,8140705226,-188,,
259598185,8140955764,165666476,8140955590,-174,,
259848454,8141206034,165916746,8141205860,-174,,
260098587,8141456176,166166888,8141456002,-174,,
260348927,8141706506,166417218,8141706331,-175,,
260599108,8141956686,166667399,8141956512,-174,,
260617063,8141974641,166685354,8141974467,-174,8141974409,
260867631,8142225210,166935923,8142225021,-189,,
261118134,8142475713,167186425,8142475510,-203,,
261368705,8142726283,167436996,8142726066,-217,,
261618895,8142976474,167687187,8142976243,-231,,
261869865,8143227445,167938158,8143227214,-231,,
262120068,8143477646,168188358,8143477415,-231,,
262370176,8143727755,168438467,8143727524,-231,,
262620641,8143978220,168688932,8143977989,-231,,
262638593,8143996171,168706883,8143995940,-231,8143995948,
262889413,8144246992,168957705,8144246764,-228,,
263139539,8144497119,169207832,8144496893,-226,,
263389975,8144747554,169458267,8144747331,-223,,
263640544,8144998123,169708836,8144997902,-221,,
263890939,8145248517,169959230,8145248296,-221,,
264141428,8145499007,170209719,8145498786,-221,,
264391909,8145749488,170460200,8145749267,-221,,
264642762,8146000341,170711054,8146000120,-221,,
264661534,8146019112,170729825,8146018891,-221,8146018463,
264912028,8146269608,170980320,8146269278,-330,,
265162862,8146520441,171231153,8146520006,-435,,
265413340,8146770919,171481632,8146770377,-542,,
265664218,8147021798,171732510,8147021149,-649,,
265914663,8147272243,171982955,8147271595,-648,,
266165463,8147523042,172233754,8147522394,-648,,
266415619,8147773198,172483911,8147772550,-648,,
266666095,8148023674,172734387,8148023026,-648,,
266684223,8148041802,172752514,8148041153,-649,8148041497,
266934835,8148292414,173003126,8148291852,-562,,
267185372,8148542951,173253664,8148542476,-475,,
267435856,8148793435,173504148,8148793047,-388,,
267686801,8149044381,173755093,8149044078,-303,,
267937397,8149294977,174005690,8149294674,-303,,
268188096,8149545676,174256389,8149545373,-303,,
268438287,8149795867,174506580,8149795564,-303,,
268688904,8150046484,174757196,8150046181,-303,,
268706853,8150064431,174775143,8150064128,-303,8150064214,
268957821,8150315401,175026113,8150315119,-282,,
269208182,8150565761,175276473,8150565502,-259,,
269459133,8150816712,175527424,8150816475,-237,,
269709928,8151067507,175778220,8151067292,-215,,
269960360,8151317940,176028652,8151317724,-216,,
270211315,8151568894,176279607,8151568679,-215,,
270461778,8151819357,176530070,8151819142,-215,,
270712628,8152070208,176780920,8152069992,-216,,
270730749,8152088327,176799040,8152088112,-215,8152088034,
270981211,8152338790,177049502,8152338554,-236,,
271231324,8152588903,177299615,8152588649,-254,,
271482177,8152839757,177550470,8152839484,-273,,
271733083,8153090662,177801374,8153090370,-292,,
271983932,8153341511,178052223,8153341219,-292,,
272234822,8153592401,178303113,8153592108,-293,,
272485575,8153843154,178553866,8153842862,-292,,
272736396,8154093975,178804688,8154093683,-292,,
272767885,8154125463,178836176,8154125171,-292,8154118482,
273018594,8154376173,179086886,8154374203,-1970,,
273269386,8154626966,179337678,8154623320,-3646,,
273520269,8154877848,179588560,8154872524,-5324,,
273770493,8155128072,179838785,8155121093,-6979,,
274020746,8155378325,180089037,8155371346,-6979,,
274270970,8155628549,180339262,8155621570,-6979,,
274521210,8155878789,180589501,8155871810,-6979,,
274771448,8156129027,180839739,8156122048,-6979,,
274789321,8156146899,180857612,8156139920,-6979,8156146635,
275039788,8156397367,181108080,8156392069,-5298,,
275290704,8156648283,181358995,8156644670,-3613,,
275541269,8156898848,181609561,8156896919,-1929,,
275792117,8157149696,181860408,8157149433,-263,,
276042946,8157400525,182111238,8157400262,-263,,
276293716,8157651295,182362008,8157651033,-262,,
276544579,8157902159,182612871,8157901896,-263,,
276794978,8158152558,182863270,8158152295,-263,,
276813051,8158170629,182881342,8158170366,-263,8158170299,
277063207,8158420786,183131498,8158420506,-280,,
277313849,8158671428,183382141,8158671133,-295,,
277564711,8158922290,183633003,8158921977,-313,,
277815537,8159173117,183883829,8159172789,-328,,
278066004,8159423583,184134296,8159423256,-327,,
278316837,8159674417,184385129,8159674089,-328,,
278567670,8159925249,184635962,8159924921,-328,,
278818133,8160175713,184886425,8160175385,-328,,
278836226,8160193804,184904516,8160193476,-328,8160193479,
279086796,8160444376,185155089,8160444048,-328,,
279337752,8160695331,185406044,8160695004,-327,,
279588233,8160945812,185656525,8160945486,-326,,
279838659,8161196238,185906951,8161195914,-324,,
280089315,8161446895,186157607,8161446571,-324,,
280339996,8161697575,186408287,8161697251,-324,,
280590819,8161948398,186659111,8161948074,-324,,
280841756,8162199335,186910048,8162199011,-324,,
280859833,8162217411,186928123,8162217087,-324,8162217143,
281109997,8162467576,187178289,8162467266,-310,,
281360556,8162718136,187428848,8162717841,-295,,
281610805,8162968385,187679098,8162968104,-281,,
281860995,8163218574,187929296,8163218318,-256,,
282111423,8163469002,188179714,8163468735,-267,,
282361777,8163719356,188430069,8163719091,-265,,
282612016,8163969594,188680317,8163969338,-256,,
282862980,8164220559,188931272,8164220294,-265,,
282881108,8164238686,188949398,8164238420,-266,8164238348,
283131955,8164489534,189200246,8164489248,-286,,
283382439,8164740028,189450740,8164739725,-303,,
283633171,8164990750,189701463,8164990441,-309,,
283883742,8165241331,189952044,8165240994,-337,,
284134125,8165491704,190202416,8165491366,-338,,
284384747,8165742326,190453039,8165741989,-337,,
284634918,8165992497,190703210,8165992161,-336,,
284885231,8166242811,190953523,8166242474,-337,,
284903223,8166260801,190971513,8166260463,-338,8166260519,
285153567,8166511146,191221859,8166510825,-321,,
285403926,8166761505,191472217,8166761197,-308,,
285654417,8167012006,191722719,8167011712,-294,,
285904934,8167262524,191973236,8167262244,-280,,
286155055,8167512634,192223346,8167512353,-281,,
286405772,8167763352,192474064,8167763072,-280,,
286656180,8168013759,192724471,8168013479,-280,,
286906483,8168264062,192974775,8168263782,-280,,
286924482,8168282061,192992773,8168281780,-281,8168281712,
287175015,8168532593,193243306,8168532296,-297,,
287425599,8168783188,193493901,8168782874,-314,,
287676193,8169033771,193744484,8169033452,-319,,
287926824,8169284404,193995116,8169284057,-347,,
288177690,8169535270,194245982,8169534923,-347,,
288428372,8169785951,194496664,8169785605,-346,,
288678932,8170036511,194747224,8170036164,-347,,
288929870,8170287449,194998162,8170287102,-347,,
288947782,8170305360,195016073,8170305013,-347,8170305001,
289198090,8170555669,195266382,8170555318,-351,,
289448688,8170806267,195516980,8170805914,-353,,
289699472,8171057051,195767764,8171056695,-356,,
289950443,8171308022,196018734,8171307664,-358,,
290201093,8171558673,196269385,8171558315,-358,,
290451827,8171809406,196520119,8171809048,-358,,
290702087,8172059666,196770379,8172059308,-358,,
290952825,8172310404,197021116,8172310046,-358,,
290971350,8172328928,197039641,8172328570,-358,8172328298,
291222042,8172579622,197290334,8172579197,-425,,
291472795,8172830374,197541087,8172829881,-493,,
291723566,8173081146,197791858,8173080585,-561,,
291973872,8173331451,198042163,8173330823,-628,,
292224373,8173581952,198292665,8173581324,-628,,
292474985,8173832564,198543277,8173831937,-627,,
292725247,8174082826,198793539,8174082198,-628,,
292975401,8174332980,199043693,8174332352,-628,,
292993322,8174350900,199061612,8174350272,-628,8174350608,
293243640,8174601219,199311931,8174600674,-545,,
293494160,8174851739,199562452,8174851279,-460,,
293744267,8175101846,199812558,8175101471,-375,,
293995108,8175352687,200063400,8175352397,-290,,
294245596,8175603174,200313887,8175602893,-281,,
294496049,8175853638,200564350,8175853347,-291,,
294746220,8176103799,200814511,8176103507,-292,,
294996387,8176353966,201064679,8176353675,-291,,
295014358,8176371937,201082649,8176371646,-291,8176371547,
295264526,8176622105,201332818,8176621789,-316,,
295514713,8176872293,201583005,8176871953,-340,,
295764840,8177122419,201833132,8177122055,-364,,
296015380,8177372969,202083682,8177372581,-388,,
296265568,8177623147,202333859,8177622759,-388,,
296515793,8177873382,202584095,8177872994,-388,,
296765936,8178123515,202834228,8178123127,-388,,
297016143,8178373723,203084436,8178373335,-388,,
297034124,8178391702,203102415,8178391314,-388,8178391333,
297284439,8178642017,203352730,8178641633,-384,,
297534999,8178892578,203603291,8178892200,-378,,
297785414,8179142992,203853705,8179142629,-363,,
298035715,8179393305,204104018,8179392937,-368,,
298286235,8179643814,204354526,8179643445,-369,,
298536588,8179894167,204604879,8179893809,-358,,
298787521,8180145101,204855813,8180144733,-368,,
299037643,8180395232,205105945,8180394864,-368,,
299055664,8180413243,205123955,8180412874,-369,8180412869,
299306075,8180663654,205374367,8180663284,-370,,
299556640,8180914230,205624942,8180913858,-372,,
299807316,8181164905,205875617,8181164533,-372,,
300057831,8181415410,206126123,8181415038,-372,,
300308293,8181665871,206376584,8181665499,-372,,
300558465,8181916044,206626767,8181915682,-362,,
300808886,8182166465,206877177,8182166093,-372,,
301059273,8182416852,207127565,8182416480,-372,,
301077301,8182434879,207145592,8182434507,-372,8182434518,
301327628,8182685207,207395919,8182684838,-369,,
301577999,8182935577,207646290,8182935211,-366,,
301828498,8183186077,207896790,8183185715,-362,,
302079017,8183436596,208147308,8183436237,-359,,
302329464,8183687043,208397755,8183686684,-359,,
302579668,8183937247,208647960,8183936888,-359,,
302829830,8184187420,208898132,8184187061,-359,,
303080555,8184438144,209148857,8184437785,-359,,
303098580,8184456158,209166871,8184455799,-359,8184455774,
303349157,8184706736,209417449,8184706370,-366,,
303599514,8184957093,209667805,8184956721,-372,,
303850062,8185207642,209918355,8185207265,-377,,
304100284,8185457874,210168586,8185457491,-383,,
304350645,8185708224,210418937,8185707841,-383,,
304601384,8185958963,210669676,8185958580,-383,,
304851603,8186209182,210919905,8186208809,-373,,
305101821,8186459400,211170113,8186459017,-383,,
305119870,8186477449,211188161,8186477065,-384,8186477058,
305370573,8186728151,211438864,8186727766,-385,,
305621132,8186978710,211689423,8186978324,-386,,
305871365,8187228945,211939657,8187228557,-388,,
306121881,8187479460,212190172,8187479071,-389,,
306372089,8187729668,212440381,8187729279,-389,,
306622281,8187979859,212690572,8187979470,-389,,
306872462,8188230041,212940754,8188229652,-389,,
307123477,8188481067,213191779,8188480677,-390,,
307141547,8188499126,213209838,8188498736,-390,8188498755,
307392243,8188749821,213460534,8188749437,-384,,
307642897,8189000476,213711188,8189000096,-380,,
307893052,8189250631,213961344,8189250257,-374,,
308143809,8189501387,214212099,8189501018,-369,,
308394057,8189751635,214462348,8189751266,-369,,
308644409,8190001988,214712700,8190001618,-370,,
308894576,8190252155,214962867,8190251795,-360,,
309144743,8190502332,215213044,8190501963,-369,,
309162756,8190520334,215231046,8190519964,-370,8190519960,
309413410,8190770989,215481701,8190770620,-369,,
309663533,8191021111,215731824,8191020752,-359,,
309913846,8191271425,215982137,8191271054,-371,,
310164889,8191522467,216233180,8191522095,-372,,
310415328,8191772907,216483620,8191772535,-372,,
310665880,8192023459,216734171,8192023086,-373,,
310916233,8192273813,216984525,8192273441,-372,,
311166877,8192524456,217235168,8192524084,-372,,
311184914,8192542493,217253205,8192542121,-372,8192542203,
311435402,8192792981,217503693,8192792630,-351,,
311685580,8193043159,217753871,8193042829,-330,,
311936129,8193293707,218004420,8193293409,-298,,
312186682,8193544261,218254973,8193543973,-288,,
312437147,8193794726,218505438,8193794438,-288,,
312687794,8194045372,218756085,8194045094,-278,,
312938130,8194295709,219006421,8194295420,-289,,
313188371,8194545951,219256663,8194545662,-289,,
313206339,8194563917,219274629,8194563629,-288,8194563517,
313456906,8194814485,219525197,8194814169,-316,,
313707407,8195064985,219775698,8195064641,-344,,
313957671,8195315249,220025961,8195314878,-371,,
314207868,8195565457,220276169,8195565059,-398,,
314458609,8195816198,220526910,8195815799,-399,,
314709249,8196066827,220777540,8196066429,-398,,
314959769,8196317348,221028061,8196316950,-398,,
315209924,8196567503,221278216,8196567105,-398,,
315227914,8196585493,221296205,8196585094,-399,8196585046,
315478341,8196835920,221546633,8196835510,-410,,
315728817,8197086395,221797108,8197085973,-422,,
315978934,8197336512,222047225,8197336079,-433,,
316229478,8197587057,222297770,8197586612,-445,,
316479738,8197837317,222548029,8197836872,-445,,
316730170,8198087748,222798461,8198087303,-445,,
316980812,8198338391,223049103,8198337946,-445,,
317231367,8198588946,223299658,8198588501,-445,,
317249319,8198606898,223317610,8198606452,-446,8198606497,
317499443,8198857021,223567734,8198856587,-434,,
317749540,8199107118,223817831,8199106695,-423,,
317999909,8199357487,224068199,8199357076,-411,,
318250304,8199607883,224318596,8199607484,-399,,
318501039,8199858617,224569330,8199858218,-399,,
318751513,8200109092,224819805,8200108693,-399,,
319002295,8200359873,225070586,8200359474,-399,,
319252478,8200610058,225320770,8200609658,-400,,
319270481,8200628059,225338772,8200627660,-399,8200627642,
319521092,8200878670,225589383,8200878266,-404,,
319771379,8201128968,225839681,8201128560,-408,,
320021764,8201379342,226090065,8201378940,-402,,
320271894,8201629483,226340195,8201629067,-416,,
320522702,8201880281,226590993,8201879865,-416,,
320773329,8202130908,226841620,8202130491,-417,,
321023568,8202381146,227091859,8202380730,-416,,
321273719,8202631299,227342011,8202630882,-417,,
321291868,8202649446,227360159,8202649030,-416,8202649035,
321542110,8202899689,227610401,8202899273,-416,,
321792723,8203150302,227861015,8203149888,-414,,
322043031,8203400610,228111322,8203400198,-412,,
322293554,8203651133,228361846,8203650723,-410,,
322544125,8203901704,228612416,8203901293,-411,,
322794487,8204152076,228862788,8204151666,-410,,
323045117,8204402695,229113408,8204402285,-410,,
323295839,8204653418,229364131,8204653008,-410,,
323313910,8204671488,229382200,8204671078,-410,8204671074,
323564194,8204921773,229632485,8204921360,-413,,
323814669,8205172248,229882961,8205171836,-412,,
324065368,8205422947,230133660,8205422535,-412,,
324316090,8205673669,230384382,8205673258,-411,,
324566296,8205923875,230634587,8205923463,-412,,
324817292,8206174871,230885584,8206174459,-412,,
325067862,8206425441,231136153,8206425029,-412,,
325318329,8206675908,231386621,8206675496,-412,,
325336422,8206694000,231404712,8206693588,-412,8206693603,
325586909,8206944488,231655200,8206944080,-408,,
325837243,8207194821,231905533,8207194428,-393,,
326087886,8207445465,232156178,8207445066,-399,,
326337993,8207695572,232406285,8207695177,-395,,
326588435,8207946014,232656727,8207945619,-395,,
326838943,8208196522,232907235,8208196127,-395,,
327089339,8208446918,233157630,8208446523,-395,,
327339476,8208697054,233407767,8208696659,-395,,
327357473,8208715052,233425764,8208714656,-396,8208714625,
327607593,8208965172,233675884,8208964767,-405,,
327857853,8209215432,233926144,8209215020,-412,,
328108168,8209465746,234176459,8209465328,-418,,
328359069,8209716648,234427361,8209716223,-425,,
328609182,8209966761,234677473,8209966335,-426,,
328860022,8210217602,234928315,8210217177,-425,,
329110150,8210467729,235178441,8210467304,-425,,
329360601,8210718189,235428902,8210717764,-425,,
329378651,8210736230,235446942,8210735804,-426,8210735800,
329629142,8210986721,235697433,8210986294,-427,,
329879252,8211236831,235947543,8211236404,-427,,
330129700,8211487279,236197992,8211486851,-428,,
330380538,8211738117,236448830,8211737689,-428,,
330631069,8211988648,236699361,8211988220,-428,,
330881254,8212238834,236949546,8212238406,-428,,
331131647,8212489226,237199939,8212488808,-418,,
331381893,8212739472,237450185,8212739044,-428,,
331399978,8212757556,237468268,8212757128,-428,8212757186,
331650804,8213008382,237719095,8213007968,-414,,
331901414,8213258994,237969706,8213258595,-399,,
332151824,8213509402,238220115,8213509018,-384,,
332402775,8213760364,238471076,8213759996,-368,,
332653343,8214010922,238721634,8214010553,-369,,
332903644,8214261223,238971946,8214260866,-357,,
333153831,8214511410,239222122,8214511052,-358,,
333403993,8214761572,239472284,8214761204,-368,,
333421963,8214779542,239490254,8214779174,-368,8214779105,
333672324,8215029902,239740615,8215029517,-385,,
333922722,8215280300,239991013,8215279900,-400,,
334172928,8215530506,240241219,8215530088,-418,,
334423115,8215780694,240491406,8215780259,-435,,
334673579,8216031157,240741880,8216030732,-425,,
334923858,8216281436,240992149,8216281012,-424,,
335174229,8216531808,241242520,8216531373,-435,,
335424714,8216782292,241493005,8216781857,-435,,
335442839,8216800417,241511130,8216799982,-435,8216800030,
335692959,8217050538,241761250,8217050124,-414,,
335943123,8217300701,242011414,8217300290,-411,,
336193322,8217550901,242261613,8217550502,-399,,
336443805,8217801383,242512096,8217800997,-386,,
336693968,8218051546,242762269,8218051170,-376,,
336944441,8218302020,243012732,8218301633,-387,,
337194595,8218552173,243262886,8218551787,-386,,
337444851,8218802440,243513153,8218802054,-386,,
337462914,8218820492,243531205,8218820106,-386,8218820020,
337713773,8219071352,243782074,8219070953,-399,,
337964024,8219321602,244032315,8219321184,-418,,
338214336,8219571915,244282627,8219571464,-451,,
338464917,8219822495,244533218,8219822034,-461,,
338715260,8220072838,244783551,8220072378,-460,,
338965812,8220323390,245034103,8220322919,-471,,
339216251,8220573829,245284542,8220573358,-471,,
339466433,8220824011,245534724,8220823540,-471,,
339484533,8220842112,245552824,8220841640,-472,8220841686,
339734703,8221092281,245802994,8221091821,-460,,
339985114,8221342693,246053405,8221342244,-449,,
340235668,8221593247,246303959,8221592811,-436,,
340486039,8221843617,246554330,8221843193,-424,,
340736543,8222094133,246804845,8222093709,-424,,
340987172,8222344751,247055463,8222344327,-424,,
341237670,8222595248,247305961,8222594824,-424,,
341488015,8222845593,247556305,8222845169,-424,,
341505984,8222863562,247574284,8222863148,-414,8222863051,
341756338,8223113916,247824639,8223113481,-435,,
342006718,8223364297,248075010,8223363831,-466,,
342256905,8223614483,248325196,8223613995,-488,,
342507296,8223864875,248575587,8223864365,-510,,
342757486,8224115075,248825787,8224114566,-509,,
343007841,8224365420,249076132,8224364911,-509,,
343258009,8224615588,249326300,8224615079,-509,,
343508478,8224866057,249576769,8224865548,-509,,
343526507,8224884085,249594797,8224883576,-509,8224883702,
343776630,8225134220,249844932,8225133741,-479,,
344026730,8225384309,250095021,8225383863,-446,,
344277385,8225634964,250345676,8225634549,-415,,
344528043,8225885622,250596334,8225885240,-382,,
344778366,8226135954,250846667,8226135572,-382,,
345028508,8226386086,251096799,8226385704,-382,,
345278805,8226636383,251347096,8226636001,-382,,
345528920,8226886498,251597210,8226886116,-382,,
345546955,8226904533,251615245,8226904151,-382,8226904090,
345797346,8227154925,251865637,8227154527,-398,,
346047785,8227405363,252116076,8227404951,-412,,
346298203,8227655782,252366494,8227655355,-427,,
346549143,8227906722,252617434,8227906281,-441,,
346799960,8228157539,252868252,8228157098,-441,,
347050630,8228408210,253118922,8228407769,-441,,
347300786,8228658364,253369077,8228657923,-441,,
347551567,8228909146,253619858,8228908705,-441,,
347569574,8228927152,253637864,8228926711,-441,8228926714,
347819975,8229177554,253888277,8229177125,-429,,
348070236,8229427815,254138527,8229427376,-439,,
348320847,8229678426,254389138,8229677988,-438,,
348571317,8229928896,254639609,8229928460,-436,,
348821996,8230179574,254890286,8230179138,-436,,
349072177,8230429765,255140478,8230429329,-436,,
349322456,8230680035,255390747,8230679599,-436,,
349572630,8230930208,255640931,8230929782,-426,,
349590653,8230948231,255658944,8230947795,-436,8230947818,
349841032,8231198611,255909324,8231198181,-430,,
350091489,8231449067,256159780,8231448643,-424,,
350341829,8231699407,256410119,8231698989,-418,,
350592412,8231949990,256660703,8231949578,-412,,
350842612,8232200191,256910903,8232199778,-413,,
351093145,8232450733,257161446,8232450322,-411,,
351343684,8232701263,257411975,8232700851,-412,,
351593823,8232951401,257662114,8232950989,-412,,
351611899,8232969477,257680190,8232969065,-412,8232969005,
351862245,8233219824,257930537,8233219397,-427,,
352112403,8233469982,258180695,8233469541,-441,,
352362635,8233720214,258430926,8233719758,-456,,
352613315,8233970893,258681606,8233970423,-470,,
352863616,8234221194,258931907,8234220724,-470,,
353113741,8234471320,259182032,8234470850,-470,,
353364436,8234722015,259432727,8234721545,-470,,
353614766,8234972345,259683057,8234971874,-471,,
353632955,8234990534,259701246,8234990064,-470,8234990087,
353883237,8235240817,259951529,8235240353,-464,,
354133389,8235490978,260201691,8235490520,-458,,
354383546,8235741124,260451837,8235740672,-452,,
354633879,8235991457,260702169,8235991012,-445,,
354884292,8236241871,260952583,8236241425,-446,,
355134399,8236491988,261202700,8236491543,-445,,
355384605,8236742184,261452897,8236741739,-445,,
355634944,8236992523,261703235,8236992078,-445,,
355653010,8237010589,261721301,8237010143,-446,8237010115,
355903588,8237261167,261971880,8237260715,-452,,
356153743,8237511321,262222033,8237510862,-459,,
356403869,8237761448,262472160,8237760983,-465,,
356654234,8238011812,262722525,8238011340,-472,,
356904869,8238262448,262973160,8238261976,-472,,
357155598,8238513187,263223899,8238512715,-472,,
357405875,8238763454,263474167,8238762982,-472,,
357656247,8239013825,263724538,8239013353,-472,,
357674317,8239031895,263742607,8239031423,-472,8239031411,
357924581,8239282160,263992872,8239281685,-475,,
358174941,8239532520,264243232,8239532043,-477,,
358425472,8239783050,264493763,8239782570,-480,,
358675630,8240033208,264743921,8240032726,-482,,
358925903,8240283482,264994195,8240283000,-482,,
359176054,8240533633,265244346,8240533151,-482,,
359426409,8240783987,265494700,8240783516,-471,,
359676804,8241034383,265745095,8241033900,-483,,
359694739,8241052317,265763029,8241051834,-483,8241051859,
359944838,8241302417,266013129,8241301949,-468,,
360195675,8241553254,266263966,8241552784,-470,,
360446117,8241803706,266514419,8241803243,-463,,
360696597,8242054175,266764888,8242053730,-445,,
360947474,8242305063,267015776,8242304607,-456,,
361198048,8242555627,267266339,8242555171,-456,,
361448477,8242806056,267516769,8242805600,-456,,
361698635,8243056214,267766927,8243055758,-456,,
361716715,8243074294,267785006,8243073837,-457,8243073795,
361967085,8243324663,268035376,8243324196,-467,,
362218025,8243575604,268286316,8243575126,-478,,
362468194,8243825773,268536485,8243825286,-487,,
362718766,8244076345,268787068,8244075859,-486,,
362969125,8244326715,269037427,8244326217,-498,,
363219381,8244576960,269287672,8244576462,-498,,
363469761,8244827350,269538063,8244826853,-497,,
363720124,8245077703,269788415,8245077206,-497,,
363738308,8245095887,269806599,8245095390,-497,8245095404,
363988725,8245346304,270057016,8245345810,-494,,
364238893,8245596471,270307184,8245595981,-490,,
364489162,8245846740,270557453,8245846264,-476,,
364739637,8246097216,270807928,8246096735,-481,,
364989865,8246347444,271058156,8246346962,-482,,
365240050,8246597629,271308341,8246597148,-481,,
365490693,8246848271,271558984,8246847790,-481,,
365741006,8247098585,271809297,8247098103,-482,,
365759168,8247116747,271827459,8247116265,-482,8247116274,
366009667,8247367246,272077958,8247366766,-480,,
366259920,8247617499,272328212,8247617023,-476,,
366510258,8247867846,272578559,8247867373,-473,,
366761231,8248118810,272829523,8248118339,-471,,
367011702,8248369280,273079993,8248368809,-471,,
367261885,8248619464,273330176,8248618992,-472,,
367512190,8248869769,273580482,8248869298,-471,,
367762660,8249120249,273830962,8249119778,-471,,
367780763,8249138342,273849054,8249137871,-471,8249137819,
368031358,8249388937,274099650,8249388453,-484,,
368281726,8249639306,274350018,8249638808,-498,,
368531949,8249889527,274600240,8249889028,-499,,
368782083,8250139662,274850374,8250139141,-521,,
369032275,8250389854,275100566,8250389332,-522,,
369282787,8250640366,275351078,8250639845,-521,,
369533251,8250890829,275601542,8250890308,-521,,
369783377,8251140956,275851679,8251140445,-511,,
369801542,8251159120,275869832,8251158598,-522,8251158621,
370052106,8251409684,276120397,8251409179,-505,,
370302550,8251660128,276370841,8251659618,-510,,
370552662,8251910240,276620953,8251909737,-503,,
370802893,8252160472,276871184,8252159974,-498,,
371053217,8252410796,277121509,8252410309,-487,,
371303574,8252661152,277371865,8252660655,-497,,
371553735,8252911313,277622026,8252910816,-497,,
371803941,8253161530,277872242,8253161033,-497,,
371821925,8253179504,277890216,8253179007,-497,8253179023,
372072263,8253429842,278140554,8253429349,-493,,
372322796,8253680375,278391087,8253679887,-488,,
372573172,8253930750,278641462,8253930267,-483,,
372823725,8254181304,278892017,8254180825,-479,,
373074229,8254431808,279142520,8254431328,-480,,
373324692,8254682271,279392983,8254681801,-470,,
373575253,8254932832,279643544,8254932353,-479,,
373825530,8255183118,279893831,8255182640,-478,,
373843833,8255201412,279912124,8255200932,-480,8255200922,
374094558,8255452136,280162849,8255451654,-482,,
374345331,8255702910,280413622,8255702425,-485,,
374595433,8255953011,280663733,8255952535,-476,,
374846105,8256203684,280914396,8256203196,-488,,
375096233,8256453812,281164524,8256453324,-488,,
375346855,8256704434,281415146,8256703945,-489,,
375597416,8256954995,281665707,8256954507,-488,,
375847917,8257205495,281916219,8257205018,-477,,
375866032,8257223610,281934322,8257223122,-488,8257223081,
376116285,8257473864,282184576,8257473365,-499,,
376366708,8257724287,282434999,8257723778,-509,,
376617077,8257974656,282685368,8257974137,-519,,
376867702,8258225281,282935994,8258224755,-526,,
377118154,8258475733,283186446,8258475206,-527,,
377368516,8258726095,283436807,8258725568,-527,,
377618848,8258976427,283687139,8258975900,-527,,
377869020,8259226599,283937312,8259226072,-527,,
377887155,8259244733,283955445,8259244205,-528,8259244259,
378137262,8259494841,284205563,8259494337,-504,,
378387531,8259745110,284455822,8259744609,-501,,
378637858,8259995436,284706149,8259994961,-475,,
378888790,8260246369,284957081,8260245897,-472,,
379139382,8260496961,285207674,8260496489,-472,,
379389623,8260747202,285457914,8260746729,-473,,
379639791,8260997370,285708082,8260996898,-472,,
379890247,8261247825,285958538,8261247353,-472,,
379908243,8261265821,285976533,8261265349,-472,8261265320,
380158585,8261516163,286226876,8261515684,-479,,
380408748,8261766337,286477049,8261765851,-486,,
380659708,8262017286,286727999,8262016793,-493,,
380910271,8262267849,286978562,8262267350,-499,,
381160885,8262518464,287229176,8262517964,-500,,
381411194,8262768773,287479496,8262768284,-489,,
381661787,8263019366,287730078,8263018867,-499,,
381912136,8263269716,287980429,8263269217,-499,,
381930259,8263287838,287998550,8263287339,-499,8263287379,
382180636,8263538215,288248927,8263537725,-490,,
382431320,8263788899,288499621,8263788430,-469,,
382681493,8264039071,288749783,8264038603,-468,,
382932386,8264289965,289000677,8264289507,-458,,
383182532,8264540111,289250823,8264539654,-457,,
383433070,8264790648,289501361,8264790191,-457,,
383683702,8265041280,289751993,8265040823,-457,,
383934286,8265291866,290002578,8265291409,-457,,
383952380,8265309958,290020670,8265309501,-457,8265309482,
384202675,8265560254,290270967,8265559792,-462,,
384452920,8265810498,290521211,8265810032,-466,,
384703678,8266061267,290771979,8266060796,-471,,
384953937,8266311516,291022228,8266311042,-474,,
385204157,8266561746,291272459,8266561272,-474,,
385454457,8266812036,291522748,8266811562,-474,,
385704910,8267062489,291773202,8267062015,-474,,
385955484,8267313073,292023786,8267312599,-474,,
385973553,8267331132,292041844,8267330657,-475,8267330623,
386223688,8267581267,292291989,8267580794,-473,,
386474096,8267831675,292542388,8267831184,-491,,
386724663,8268082252,292792964,8268081752,-500,,
386975000,8268332579,293043302,8268332082,-497,,
387225194,8268582773,293293485,8268582266,-507,,
387475398,8268832977,293543690,8268832470,-507,,
387725701,8269083290,293794002,8269082783,-507,,
387975908,8269333487,294044199,8269332990,-497,,
387994012,8269351591,294062303,8269351083,-508,8269351036,
388244149,8269601738,294312450,8269601219,-519,,
388494448,8269852027,294562739,8269851497,-530,,
388744794,8270102373,294813096,8270101841,-532,,
388994960,8270352538,295063251,8270351985,-553,,
389245199,8270602778,295313490,8270602234,-544,,
389495677,8270853256,295563969,8270852703,-553,,
389745899,8271103478,295814191,8271102925,-553,,
389996031,8271353609,296064322,8271353056,-553,,
390014163,8271371742,296082454,8271371189,-553,8271371232,
390264494,8271622073,296332795,8271621540,-533,,
390514703,8271872282,296582994,8271871751,-531,,
390765022,8272122601,296833314,8272122081,-520,,
391015540,8272373118,297083831,8272372610,-508,,
391265876,8272623454,297334167,8272622946,-508,,
391516057,8272873635,297584348,8272873127,-508,,
391766169,8273123748,297834471,8273123250,-498,,
392016572,8273374150,298084863,8273373642,-508,,
392034652,8273392230,298102942,8273391722,-508,8273391708,
392284934,8273642513,298353225,8273642001,-512,,
392535419,8273892998,298603710,8273892483,-515,,
392785769,8274143349,298854061,8274142832,-517,,
393036400,8274393979,299104691,8274393459,-520,,
393287001,8274644580,299355292,8274644059,-521,,
393537364,8274894943,299605655,8274894422,-521,,
393787574,8275145163,299855875,8275144643,-520,,
394038292,8275395871,300106583,8275395350,-521,,
394056400,8275413978,300124691,8275413458,-520,8275413448,
394306522,8275664100,300374813,8275663577,-523,,
394556929,8275914507,300625220,8275913982,-525,,
394807322,8276164900,300875613,8276164373,-527,,
395057810,8276415389,301126101,8276414859,-530,,
395307932,8276665511,301376223,8276664982,-529,,
395558120,8276915699,301626411,8276915179,-520,,
395808266,8277165845,301876557,8277165316,-529,,
396058519,8277416098,302126810,8277415568,-530,,
396076509,8277434087,302144799,8277433557,-530,8277433519,
396326830,8277684408,302395121,8277683869,-539,,
396577339,8277934918,302645631,8277934370,-548,,
396827553,8278185132,302895855,8278184585,-547,,
397077673,8278435252,303145964,8278434686,-566,,
397328302,8278685880,303396593,8278685314,-566,,
397578637,8278936216,303646939,8278935661,-555,,
397829295,8279186873,303897586,8279186307,-566,,
398079760,8279437350,304148062,8279436784,-566,,
398097926,8279455505,304166217,8279454939,-566,8279454968,
398348325,8279705904,304416616,8279705345,-559,,
398598487,8279956066,304666788,8279955525,-541,,
398849064,8280206642,304917355,8280206099,-543,,
399099645,8280457223,305167936,8280456688,-535,,
399349834,8280707413,305418125,8280706888,-525,,
399600513,8280958092,305668804,8280957567,-525,,
399851037,8281208617,305919329,8281208082,-535,,
400101552,8281459142,306169854,8281458607,-535,,
400119589,8281477167,306187880,8281476632,-535,8281476620,
400369938,8281727517,306438229,8281726978,-539,,
400620333,8281977911,306688624,8281977370,-541,,
400870600,8282228179,306938892,8282227636,-543,,
401120794,8282478372,307189085,8282477826,-546,,
401371661,8282729239,307439952,8282728693,-546,,
401622218,8282979797,307690509,8282979250,-547,,
401873209,8283230788,307941500,8283230242,-546,,
402123502,8283481080,308191793,8283480534,-546,,
402141510,8283499088,308209801,8283498542,-546,8283498544,
402391603,8283749181,308459894,8283748636,-545,,
402642257,8283999836,308710548,8283999291,-545,,
402892673,8284250252,308960964,8284249708,-544,,
403143085,8284500664,309211376,8284500122,-542,,
403393580,8284751159,309461871,8284750627,-532,,
403643767,8285001345,309712058,8285000803,-542,,
403893902,8285251481,309962193,8285250939,-542,,
404144218,8285501797,310212509,8285501254,-543,,
404162623,8285520202,310230914,8285519659,-543,8285519483,
404413077,8285770656,310481368,8285770078,-578,,
404663196,8286020774,310731487,8286020144,-630,,
404913537,8286271116,310981829,8286270442,-674,,
405164070,8286521649,311232361,8286520932,-717,,
405414545,8286772123,311482836,8286771417,-706,,
405664887,8287022465,311733178,8287021748,-717,,
405915461,8287273039,311983752,8287272322,-717,,
406165885,8287523463,312234176,8287522746,-717,,
406184003,8287541582,312252294,8287540865,-717,8287541040,
406434157,8287791735,312502448,8287791062,-673,,
406684535,8288042113,312752826,8288041484,-629,,
406935550,8288293129,313003842,8288292546,-583,,
407186438,8288544028,313254740,8288543488,-540,,
407436871,8288794449,313505162,8288793909,-540,,
407687283,8289044862,313755574,8289044322,-540,,
407937766,8289295344,314006057,8289294804,-540,,
408187995,8289545574,314256286,8289545034,-540,,
408206126,8289563704,314274417,8289563164,-540,8289563143,
408456323,8289813902,314524614,8289813356,-546,,
408707055,8290064634,314775346,8290064083,-551,,
408957222,8290314801,315025514,8290314246,-555,,
409207724,8290565313,315276026,8290564753,-560,,
409457908,8290815487,315526200,8290814927,-560,,
409708237,8291065816,315776528,8291065256,-560,,
409958873,8291316452,316027165,8291315892,-560,,
410209251,8291566829,316277542,8291566269,-560,,
410227365,8291584943,316295655,8291584382,-561,8291584447,
410477890,8291835469,316546181,8291834925,-544,,
410728060,8292085639,316796351,8292085111,-528,,
410978811,8292336390,317047103,8292335880,-510,,
411229305,8292586883,317297596,8292586389,-494,,
411479907,8292837486,317548199,8292836992,-494,,
411730028,8293087607,317798319,8293087123,-484,,
411980621,8293338210,318048922,8293337716,-494,,
412231075,8293588654,318299366,8293588159,-495,,
412249290,8293606868,318317580,8293606374,-494,8293606320,
412499681,8293857260,318567972,8293856753,-507,,
412750180,8294107759,318818471,8294107239,-520,,
413000874,8294358453,319069166,8294357920,-533,,
413250998,8294608577,319319290,8294608031,-546,,
413501169,8294858748,319569460,8294858201,-547,,
413752096,8295109674,319820386,8295109128,-546,,
414002559,8295360138,320070851,8295359593,-545,,
414253048,8295610627,320321339,8295610081,-546,,
414271140,8295628719,320339431,8295628173,-546,8295628155,
414521324,8295878903,320589615,8295878352,-551,,
414771595,8296129174,320839886,8296128619,-555,,
415021839,8296379418,321090131,8296378860,-558,,
415272114,8296629693,321340405,8296629131,-562,,
415522331,8296879909,321590622,8296879347,-562,,
415772632,8297130210,321840923,8297129648,-562,,
416022825,8297380404,322091117,8297379843,-561,,
416273150,8297630729,322341442,8297630167,-562,,
416291303,8297648882,322359594,8297648320,-562,8297648339,
416541461,8297899039,322609752,8297898492,-547,,
416792035,8298149614,322860326,8298149061,-553,,
417042504,8298400083,323110796,8298399536,-547,,
417292678,8298650257,323360969,8298649715,-542,,
417543033,8298900611,323611324,8298900070,-541,,
417793629,8299151207,323861919,8299150666,-541,,
418044370,8299401958,324112671,8299401417,-541,,
418294965,8299652544,324363256,8299652003,-541,,
418313058,8299670637,324381349,8299670095,-542,8299670025,
418563619,8299921197,324631910,8299920638,-559,,
418814269,8300171847,324882560,8300171271,-576,,
419065168,8300422747,325133460,8300422154,-593,,
419315339,8300672918,325383630,8300672308,-610,,
419565651,8300923229,325633942,8300922619,-610,,
419815847,8301173425,325884138,8301172815,-610,,
420066500,8301424079,326134792,8301423469,-610,,
420316889,8301674468,326385181,8301673858,-610,,
420334921,8301692499,326403211,8301691889,-610,8301691951,
420585022,8301942601,326653314,8301942007,-594,,
420835206,8302192784,326903497,8302192206,-578,,
421085544,8302443132,327153845,8302442570,-562,,
421335750,8302693328,327404041,8302692782,-546,,
421586393,8302943972,327654684,8302943425,-547,,
421837143,8303194721,327905434,8303194175,-546,,
422087672,8303445250,328155963,8303444704,-546,,
422337906,8303695485,328406197,8303694938,-547,,
422356147,8303713725,328424437,8303713179,-546,8303713108,
422606727,8303964306,328675018,8303963741,-565,,
422857200,8304214779,328925492,8304214198,-581,,
423107923,8304465502,329176214,8304464903,-599,,
423358042,8304715621,329426334,8304715006,-615,,
423608595,8304966174,329676886,8304965558,-616,,
423858860,8305216438,329927151,8305215823,-615,,
424109033,8305466612,330177324,8305465997,-615,,
424359848,8305717427,330428139,8305716821,-606,,
424378120,8305735698,330446411,8305735083,-615,8305735057,
424628592,8305986171,330696883,8305985550,-621,,
424879319,8306236898,330947610,8306236271,-627,,
425130089,8306487667,331198380,8306487044,-623,,
425380829,8306738408,331449120,8306737768,-640,,
425630939,8306988518,331699230,8306987879,-639,,
425881252,8307238830,331949543,8307238191,-639,,
426131568,8307489147,332199859,8307488507,-640,,
426382207,8307739796,332450509,8307739157,-639,,
426400395,8307757974,332468686,8307757334,-640,8307757352,
426650960,8308008539,332719251,8308007904,-635,,
426901212,8308258790,332969503,8308258160,-630,,
427151420,8308508999,333219711,8308508374,-625,,
427401732,8308759321,333470033,8308758700,-621,,
427652421,8309010000,333720712,8309009379,-621,,
427902986,8309260565,333971278,8309259946,-619,,
428153183,8309510762,334221474,8309510141,-621,,
428403900,8309761489,334472202,8309760869,-620,,
428421973,8309779552,334490264,8309778931,-621,8309778916,
428672254,8310029833,334740545,8310029208,-625,,
428922431,8310280009,334990722,8310279381,-628,,
429172872,8310530451,335241163,8310529819,-632,,
429423258,8310780837,335491549,8310780203,-634,,
429673485,8311031064,335741776,8311030430,-634,,
429923950,8311281529,335992242,8311280895,-634,,
430174067,8311531646,336242358,8311531011,-635,,
430424767,8311782356,336493069,8311781722,-634,,
430442928,8311800506,336511218,8311799872,-634,8311799909,
430693093,8312050672,336761384,8312050048,-624,,
430943387,8312300965,337011678,8312300350,-615,,
431194359,8312551937,337262650,8312551333,-604,,
431444902,8312802491,337513204,8312801896,-595,,
431695911,8313053490,337764202,8313052904,-586,,
431946221,8313303800,338014513,8313303205,-595,,
432196944,8313554523,338265235,8313553928,-595,,
432447125,8313804704,338515416,8313804120,-584,,
432465182,8313822761,338533473,8313822166,-595,8313822177,
432715298,8314072877,338783600,8314072296,-581,,
432965762,8314323341,339034053,8314322751,-590,,
433216009,8314573588,339284301,8314573003,-585,,
433466867,8314824446,339535168,8314823874,-572,,
433717057,8315074636,339785349,8315074054,-582,,
433967395,8315324974,340035687,8315324392,-582,,
434217993,8315575571,340286283,8315574989,-582,,
434468373,8315825962,340536674,8315825380,-582,,
434486517,8315844095,340554808,8315843513,-582,8315843472,
434736687,8316094266,340804978,8316093674,-592,,
434986864,8316344443,341055155,8316343841,-602,,
435237174,8316594753,341305465,8316594142,-611,,
435487697,8316845276,341555989,8316844655,-621,,
435738528,8317096107,341806819,8317095486,-621,,
435989099,8317346678,342057390,8317346067,-611,,
436239612,8317597191,342307903,8317596569,-622,,
436489826,8317847404,342558117,8317846783,-621,,
436507859,8317865437,342576150,8317864816,-621,8317864836,
436758268,8318115847,342826559,8318115230,-617,,
437009116,8318366706,343077418,8318366094,-612,,
437259386,8318616964,343327677,8318616358,-606,,
437509968,8318867547,343578259,8318866947,-600,,
437760347,8319117926,343828638,8319117325,-601,,
438010656,8319368235,344078947,8319367634,-601,,
438260970,8319618559,344329271,8319617959,-600,,
438511445,8319869024,344579736,8319868424,-600,,
438529402,8319886981,344597693,8319886381,-600,8319886295,
438780092,8320137670,344848383,8320137049,-621,,
439030582,8320388161,345098874,8320387519,-642,,
439280947,8320638526,345349238,8320637862,-664,,
439531071,8320888649,345599362,8320887965,-684,,
439781725,8321139304,345850016,8321138620,-684,,
440031826,8321389404,346100117,8321388720,-684,,
440282220,8321639799,346350511,8321639115,-684,,
440532321,8321889900,346600612,8321889216,-684,,
440550371,8321907950,346618662,8321907266,-684,8321907253,
440800659,8322158237,346868950,8322157549,-688,,
441050916,8322408495,347119207,8322407805,-690,,
441301095,8322658684,347369396,8322657991,-693,,
441551491,8322909069,347619782,8322908374,-695,,
441801695,8323159273,347869986,8323158578,-695,,
442051931,8323409509,348120222,8323408814,-695,,
442302095,8323659674,348370396,8323658989,-685,,
442552274,8323909852,348620564,8323909157,-695,,
442570262,8323927840,348638552,8323927145,-695,8323927203,
442820893,8324178472,348889184,8324177791,-681,,
443071264,8324428853,349139565,8324428188,-665,,
443322334,8324679912,349390635,8324679272,-640,,
443572496,8324930075,349640788,8324929440,-635,,
443823197,8325180775,349891488,8325180140,-635,,
444073737,8325431315,350142028,8325430680,-635,,
444323919,8325681498,350392210,8325680862,-636,,
444574487,8325932066,350642778,8325931430,-636,,
444592538,8325950116,350660829,8325949481,-635,8325949477,
444842663,8326200242,350910954,8326199606,-636,,
445092973,8326450552,351161264,8326449915,-637,,
445343177,8326700756,351411469,8326700119,-637,,
445593937,8326951516,351662228,8326950878,-638,,
445844122,8327201702,351912414,8327201065,-637,,
446094725,8327452303,352163016,8327451666,-637,,
446344958,8327702537,352413249,8327701910,-627,,
446595558,8327953136,352663849,8327952499,-637,,
446613808,8327971387,352682099,8327970749,-638,8327970863,
446864387,8328221976,352932688,8328221367,-609,,
447114731,8328472311,353183023,8328471730,-581,,
447364885,8328722474,353433187,8328721923,-551,,
447615414,8328972993,353683705,8328972471,-522,,
447866044,8329223623,353934345,8329223111,-512,,
448116472,8329474051,354184763,8329473529,-522,,
448366629,8329724207,354434919,8329723685,-522,,
448616820,8329974399,354685111,8329973876,-523,,
448634911,8329992490,354703202,8329991967,-523,8329991843,
448885334,8330242913,354953625,8330242359,-554,,
449135683,8330493261,355203974,8330492677,-584,,
449386050,8330743629,355454342,8330743015,-614,,
449636411,8330993990,355704702,8330993345,-645,,
449886532,8331244111,355954834,8331243476,-635,,
450136721,8331494300,356205012,8331493654,-646,,
450387306,8331744885,356455597,8331744239,-646,,
450637565,8331995144,356705856,8331994498,-646,,
450655657,8332013235,356723948,8332012590,-645,8332012547,
450906054,8332263633,356974346,8332262977,-656,,
451156348,8332513926,357224639,8332513260,-666,,
451406757,8332764336,357475049,8332763670,-666,,
451657514,8333015104,357725817,8333014417,-687,,
451907968,8333265546,357976259,8333264860,-686,,
452158533,8333516112,358226825,8333515425,-687,,
452408955,8333766534,358477246,8333765846,-688,,
452659360,8334016939,358727651,8334016262,-677,,
452677491,8334035069,358745781,8334034382,-687,8334034431,
452927851,8334285430,358996143,8334284756,-674,,
453178567,8334536146,359246858,8334535485,-661,,
453428670,8334786248,359496961,8334785599,-649,,
453679395,8335036973,359747686,8335036337,-636,,
453929709,8335287287,359998000,8335286651,-636,,
454180208,8335537787,360248510,8335537161,-626,,
454430505,8335788084,360498796,8335787447,-637,,
454681290,8336038868,360749581,8336038232,-636,,
454699354,8336056932,360767645,8336056296,-636,8336056258,
454949539,8336307119,361017831,8336306474,-645,,
455200105,8336557685,361268397,8336557031,-654,,
455450714,8336808293,361519005,8336807630,-663,,
455701509,8337059097,361769810,8337058425,-672,,
455952189,8337309767,362020479,8337309095,-672,,
456202738,8337560318,362271030,8337559646,-672,,
456453177,8337810756,362521468,8337810083,-673,,
456703342,8338060920,362771632,8338060248,-672,,
456721484,8338079062,362789774,8338078390,-672,8338078390,
456972234,8338329814,363040527,8338329142,-672,,
457222865,8338580444,363291157,8338579773,-671,,
457473473,8338831052,363541765,8338830381,-671,,
457724031,8339081610,363792322,8339080939,-671,,
457974145,8339331724,364042447,8339331064,-660,,
458224345,8339581924,364292637,8339581254,-670,,
458474517,8339832096,364542808,8339831426,-670,,
458724855,8340082433,364793146,8340081763,-670,,
458742850,8340100428,364811140,8340099758,-670,8340099687,
458993137,8340350715,365061428,8340350028,-687,,
459243655,8340601234,365311947,8340600530,-704,,
459494527,8340852106,365562818,8340851384,-722,,
459745160,8341102738,365813451,8341101999,-739,,
459995734,8341353313,366064026,8341352575,-738,,
460246198,8341603777,366314489,8341603038,-739,,
460496337,8341853916,366564628,8341853176,-740,,
460746713,8342104292,366815004,8342103552,-740,,
460764698,8342122276,366832989,8342121537,-739,8342121560,
461015448,8342373027,367083739,8342372294,-733,,
461265832,8342623411,367334123,8342622684,-727,,
461516863,8342874442,367585154,8342873721,-721,,
461767489,8343125068,367835780,8343124353,-715,,
462017822,8343375401,368086114,8343374687,-714,,
462268136,8343625715,368336427,8343625001,-714,,
462518805,8343876383,368587095,8343875669,-714,,
462768952,8344126531,368837244,8344125817,-714,,
462786910,8344144488,368855201,8344143774,-714,8344143780,
463037602,8344395181,369105893,8344394467,-714,,
463287995,8344645574,369356287,8344644863,-711,,
463538142,8344895722,369606435,8344895013,-709,,
463788671,8345146250,369856962,8345145543,-707,,
464039136,8345396715,370107428,8345396008,-707,,
464289361,8345646940,370357653,8345646234,-706,,
464540216,8345897795,370608507,8345897088,-707,,
464790512,8346148091,370858803,8346147383,-708,,
464808504,8346166082,370876794,8346165375,-707,8346165375,
465058622,8346416201,371126913,8346415494,-707,,
465308746,8346666325,371377037,8346665619,-706,,
465559274,8346916852,371627575,8346916156,-696,,
465809424,8347167003,371877726,8347166308,-695,,
466060229,8347417819,372128531,8347417114,-705,,
466310829,8347668408,372379121,8347667704,-704,,
466561207,8347918786,372629498,8347918091,-695,,
466811725,8348169304,372880016,8348168598,-706,,
466829725,8348187303,372898015,8348186598,-705,8348186559,
467079919,8348437497,373148210,8348436792,-705,,
467330619,8348688199,373398911,8348687475,-724,,
467580922,8348938501,373649224,8348937778,-723,,
467831456,8349189035,373899748,8349188293,-742,,
468082405,8349439984,374150696,8349439242,-742,,
468333182,8349690761,374401474,8349690019,-742,,
468583542,8349941121,374651833,8349940379,-742,,
468833907,8350191486,374902198,8350190744,-742,,
468851990,8350209568,374920281,8350208826,-742,8350208842,
469102690,8350460269,375170981,8350459530,-739,,
469352874,8350710464,375421176,8350709730,-734,,
469603621,8350961200,375671912,8350960469,-731,,
469853803,8351211382,375922094,8351210657,-725,,
470104300,8351461878,376172591,8351461153,-725,,
470354495,8351712073,376422786,8351711348,-725,,
470605104,8351962683,376673395,8351961958,-725,,
470855481,8352213059,376923771,8352212334,-725,,
470873709,8352231287,376942000,8352230562,-725,8352230506,
471124118,8352481697,377192410,8352480958,-739,,
471374443,8352732023,377442735,8352731270,-753,,
471624761,8352982340,377693053,8352981574,-766,,
471875377,8353232955,377943668,8353232175,-780,,
472125855,8353483434,378194146,8353482653,-781,,
472376083,8353733673,378444385,8353732893,-780,,
472626615,8353984204,378694917,8353983424,-780,,
472877006,8354234584,378945297,8354233804,-780,,
472895060,8354252639,378963351,8354251858,-781,8354251932,
473145483,8354503072,379213784,8354502311,-761,,
473395938,8354753517,379464239,8354752785,-732,,
473646117,8355003707,379714419,8355002984,-723,,
473897050,8355254629,379965341,8355253923,-706,,
474147651,8355505230,380215942,8355504534,-696,,
474397724,8355755313,380466026,8355754608,-705,,
474647893,8356005472,380716195,8356004777,-695,,
474898891,8356256470,380967182,8356255765,-705,,
474917030,8356274609,380985321,8356273903,-706,8356273840,
475167237,8356524816,381235528,8356524095,-721,,
475417395,8356774974,381485687,8356774237,-737,,
475667638,8357025217,381735939,8357024475,-742,,
475918255,8357275834,381986547,8357275068,-766,,
476168881,8357526460,382237172,8357525693,-767,,
476419064,8357776643,382487356,8357775876,-767,,
476669448,8358027027,382737739,8358026260,-767,,
476920454,8358278033,382988755,8358277276,-757,,
476938579,8358296157,383006870,8358295390,-767,8358295451,
477188969,8358546547,383257270,8358545805,-742,,
477439302,8358796881,383507594,8358796145,-736,,
477689634,8359047213,383757925,8359046493,-720,,
477940673,8359298252,384008965,8359297547,-705,,
478191392,8359548971,384259683,8359548266,-705,,
478441585,8359799174,384509887,8359798469,-705,,
478692126,8360049715,384760428,8360049010,-705,,
478942277,8360299855,385010583,8360299165,-690,,
478960351,8360317929,385028641,8360317224,-705,8360317127,
479210854,8360568432,385279145,8360567703,-729,,
479461382,8360818961,385529673,8360818208,-753,,
479711492,8361069071,385779783,8361068295,-776,,
479962080,8361319660,386030372,8361318860,-800,,
480212330,8361569909,386280621,8361569109,-800,,
480463118,8361820697,386531409,8361819897,-800,,
480713912,8362071491,386782203,8362070690,-801,,
480964864,8362322443,387033155,8362321642,-801,,
480983026,8362340604,387051316,8362339804,-800,8362339772,
481233597,8362591176,387301888,8362590368,-808,,
481484135,8362841714,387552427,8362840909,-805,,
481734707,8363092286,387802998,8363091464,-822,,
481985155,8363342734,388053446,8363341903,-831,,
482235727,8363593305,388304018,8363592475,-830,,
482486093,8363843672,388554384,8363842841,-831,,
482736244,8364093823,388804535,8364092993,-830,,
482986560,8364344140,389054853,8364343310,-830,,
483004685,8364362263,389072976,8364361433,-830,8364361560,
483254886,8364612465,389323177,8364611666,-799,,
483505418,8364862996,389573709,8364862230,-766,,
483755773,8365113352,389824064,8365112618,-734,,
484005922,8365363500,390074213,8365362798,-702,,
484256144,8365613723,390324435,8365613021,-702,,
484506469,8365864048,390574760,8365863346,-702,,
484757069,8366114647,390825360,8366113945,-702,,
485008060,8366365639,391076352,8366364938,-701,,
485026147,8366383725,391094438,8366383023,-702,8366382973,
485277021,8366634600,391345323,8366633895,-705,,
485527310,8366884888,391595601,8366884161,-727,,
485777818,8367135397,391846109,8367134658,-739,,
486028472,8367386051,392096763,8367385299,-752,,
486278640,8367636219,392346931,8367635477,-742,,
486529174,8367886753,392597465,8367886002,-751,,
486780091,8368137670,392848382,8368136919,-751,,
487030670,8368388249,393098962,8368387498,-751,,
487048743,8368406321,393117033,8368405570,-751,8368405573,
487298987,8368656566,393367278,8368655816,-750,,
487549193,8368906772,393617485,8368906034,-738,,
487799656,8369157235,393867947,8369156487,-748,,
488049944,8369407533,394118245,8369406787,-746,,
488300222,8369657802,394368515,8369657056,-746,,
488550514,8369908093,394618805,8369907346,-747,,
488800699,8370158278,394868990,8370157542,-736,,
489051012,8370408601,395119314,8370407855,-746,,
489069087,8370426666,395137378,8370425920,-746,8370425882,
489319336,8370676915,395387627,8370676158,-757,,
489569535,8370927113,395637825,8370926349,-764,,
489819956,8371177535,395888247,8371176762,-773,,
490070460,8371428039,396138752,8371427257,-782,,
490321048,8371678627,396389340,8371677845,-782,,
490571219,8371928797,396639510,8371928015,-782,,
490822225,8372179803,396890516,8372179021,-782,,
491072594,8372430182,397140895,8372429400,-782,,
491090557,8372448135,397158847,8372447352,-783,8372447342,
491340868,8372698447,397409169,8372697671,-776,,
491591544,8372949123,397659835,8372948335,-788,,
491842060,8373199638,397910351,8373198849,-789,,
492092743,8373450331,398161044,8373449540,-791,,
492342908,8373700487,398411200,8373699696,-791,,
492593526,8373951105,398661817,8373950314,-791,,
492843893,8374201472,398912184,8374200681,-791,,
493094515,8374452094,399162806,8374451302,-792,,
493112626,8374470204,399180917,8374469413,-791,8374469361,
493363020,8374720599,399431311,8374719794,-805,,
493613553,8374971131,399681843,8374970314,-817,,
493864369,8375221948,399932661,8375221118,-830,,
494115075,8375472654,400183366,8375471812,-842,,
494365425,8375723004,400433716,8375722162,-842,,
494615916,8375973495,400684218,8375972664,-831,,
494866409,8376223987,400934700,8376223145,-842,,
495116512,8376474090,401184803,8376473248,-842,,
495134539,8376492118,401202830,8376491275,-843,8376491296,
495385076,8376742654,401453377,8376741826,-828,,
495635647,8376993226,401703939,8376992394,-832,,
495885810,8377243388,401954101,8377242562,-826,,
496136176,8377493755,402204467,8377492935,-820,,
496386357,8377743936,402454648,8377743116,-820,,
496637077,8377994655,402705368,8377993835,-820,,
496887504,8378245083,402955795,8378244262,-821,,
497138007,8378495586,403206309,8378494776,-810,,
497155985,8378513564,403224276,8378512743,-821,8378512811,
497406924,8378764503,403475215,8378763699,-804,,
497657438,8379015017,403725729,8379014230,-787,,
497907970,8379265549,403976261,8379264780,-769,,
498158260,8379515839,404226551,8379515087,-752,,
498408474,8379766052,404476775,8379765312,-740,,
498659009,8380016588,404727301,8380015837,-751,,
498909274,8380266853,404977565,8380266102,-751,,
499160022,8380517600,405228313,8380516849,-751,,
499178145,8380535724,405246436,8380534972,-752,8380534945,
499428738,8380786327,405497040,8380785569,-758,,
499679218,8381036797,405747509,8381036032,-765,,
499929331,8381286909,405997622,8381286138,-771,,
500179802,8381537381,406248093,8381536604,-777,,
500430354,8381787943,406498656,8381787166,-777,,
500680803,8382038381,406749094,8382037604,-777,,
500931267,8382288846,406999559,8382288069,-777,,
501181433,8382539011,407249723,8382538234,-777,,
501199599,8382557177,407267890,8382556400,-777,8382556353,
501450049,8382807628,407518351,8382806850,-778,,
501700536,8383058115,407768827,8383057314,-801,,
501950865,8383308443,408019155,8383307631,-812,,
502201542,8383559120,408269833,8383558297,-823,,
502451664,8383809242,408519955,8383808419,-823,,
502702024,8384059603,408770315,8384058779,-824,,
502952514,8384310093,409020806,8384309270,-823,,
503203388,8384560966,409271679,8384560143,-823,,
503221539,8384579117,409289830,8384578294,-823,8384578316,
503472125,8384829715,409540427,8384828897,-818,,
503722277,8385079855,409790568,8385079043,-812,,
503972427,8385330006,410040718,8385329200,-806,,
504222832,8385580410,410291123,8385579610,-800,,
504473454,8385831033,410541755,8385830243,-790,,
504723575,8386081154,410791867,8386080354,-800,,
504974016,8386331595,411042307,8386330794,-801,,
505224174,8386581753,411292465,8386580953,-800,,
505242231,8386599809,411310521,8386599009,-800,8386599041,
505492701,8386850280,411560992,8386849488,-792,,
505743029,8387100608,411811321,8387099826,-782,,
505993661,8387351240,412061953,8387350466,-774,,
506243792,8387601371,412312083,8387600604,-767,,
506494803,8387852382,412563094,8387851616,-766,,
506744923,8388102502,412813214,8388101735,-767,,
506995492,8388353071,413063784,8388352315,-756,,
507245618,8388603196,413313909,8388602430,-766,,
507263704,8388621282,413331995,8388620516,-766,8388620461,
507513901,8388871480,413582192,8388870701,-779,,
507764451,8389122030,413832742,8389121237,-793,,
508014678,8389372257,414082970,8389371453,-804,,
508265186,8389622765,414333477,8389621945,-820,,
508515676,8389873254,414583967,8389872435,-819,,
508766108,8390123686,414834399,8390122867,-819,,
509016745,8390374323,415085036,8390373504,-819,,
509267112,8390624690,415335403,8390623871,-819,,
509285237,8390642815,415353528,8390641996,-819,8390641993,
509535637,8390893216,415603928,8390892394,-822,,
509786236,8391143814,415854527,8391142993,-821,,
510036629,8391394208,416104921,8391393387,-821,,
510287133,8391644712,416355434,8391643901,-811,,
510537682,8391895261,416605973,8391894440,-821,,
510787814,8392145393,416856106,8392144572,-821,,
511038420,8392395998,417106711,8392395177,-821,,
511288532,8392646111,417356823,8392645290,-821,,
511306612,8392664190,417374903,8392663369,-821,8392663344,
511556723,8392914302,417625015,8392913475,-827,,
511807154,8393164733,417875445,8393163899,-834,,
512057990,8393415569,418126282,8393414730,-839,,
512308631,8393666210,418376922,8393665364,-846,,
512559201,8393916780,418627492,8393915935,-845,,
512809721,8394167300,418878013,8394166456,-844,,
513060216,8394417794,419128507,8394416949,-845,,
513310562,8394668141,419378853,8394667296,-845,,
513328686,8394686265,419396977,8394685419,-846,8394685404,
513578888,8394936467,419647179,8394935618,-849,,
513829212,8395186791,419897504,8395185938,-853,,
514080069,8395437647,420148360,8395436791,-856,,
514330259,8395687838,420398550,8395686978,-860,,
514580489,8395938068,420648781,8395937219,-849,,
514830946,8396188525,420899237,8396187666,-859,,
515081264,8396438843,421149556,8396437984,-859,,
515331748,8396689327,421400039,8396688467,-860,,
515349790,8396707368,421418080,8396706509,-859,8396706538,
515600276,8396957854,421668567,8396957003,-851,,
515850975,8397208565,421919278,8397207721,-844,,
516101182,8397458761,422169473,8397457925,-836,,
516351746,8397709325,422420037,8397708496,-829,,
516602600,8397960179,422670892,8397959351,-828,,
516853173,8398210752,422921475,8398209935,-817,,
517103615,8398461194,423171906,8398460365,-829,,
517353789,8398711367,423422080,8398710539,-828,,
517371831,8398729409,423440122,8398728581,-828,8398728589,
517622162,8398979741,423690454,8398978916,-825,,
517872306,8399229885,423940598,8399229071,-814,,
518122910,8399480489,424191201,8399479668,-821,,
518373408,8399730987,424441699,8399730168,-819,,
518623792,8399981381,424692094,8399980562,-819,,
518873947,8400231526,424942238,8400230707,-819,,
519124185,8400481764,425192476,8400480945,-819,,
519374356,8400731935,425442647,8400731115,-820,,
519392358,8400749936,425460649,8400749117,-819,8400749133,
519642963,8401000552,425711264,8400999737,-815,,
519893135,8401250714,425961426,8401249903,-811,,
520144016,8401501595,426212307,8401500789,-806,,
520394207,8401751786,426462499,8401750984,-802,,
520644843,8402002422,426713134,8402001620,-802,,
520895179,8402252758,426963470,8402251956,-802,,
521145554,8402503132,427213845,8402502330,-802,,
521395703,8402753282,427463994,8402752480,-802,,
521413685,8402771263,427481975,8402770461,-802,8402770440,
521664182,8403021761,427732483,8403020964,-797,,
521914683,8403272262,427982984,8403271459,-803,,
522164966,8403522545,428233258,8403521729,-816,,
522415129,8403772708,428483420,8403771886,-822,,
522665465,8404023054,428733766,8404022233,-821,,
522915567,8404273145,428983858,8404272324,-821,,
523166030,8404523609,429234321,8404522787,-822,,
523416161,8404773740,429484452,8404772919,-821,,
523434151,8404791729,429502441,8404790907,-822,8404790914,
523684374,8405041952,429752665,8405041132,-820,,
523934620,8405292199,430002911,8405291380,-819,,
524185473,8405543051,430253763,8405542235,-816,,
524435639,8405793217,430503930,8405792404,-813,,
524686179,8406043757,430754470,8406042944,-813,,
524936631,8406294210,431004922,8406293397,-813,,
525186837,8406544415,431255128,8406543602,-813,,
525437155,8406794733,431505446,8406793920,-813,,
525455330,8406812908,431523620,8406812095,-813,8406812036,
525705908,8407063487,431774200,8407062661,-826,,
525956510,8407314089,432024802,8407313248,-841,,
526206910,8407564498,432275211,8407563642,-856,,
526457530,8407815108,432525821,8407814238,-870,,
526707907,8408065486,432776198,8408064616,-870,,
526958525,8408316104,433026816,8408315233,-871,,
527208834,8408566413,433277126,8408565544,-869,,
527459156,8408816735,433527447,8408815864,-871,,
527477133,8408834711,433545424,8408833841,-870,8408833805,
527727502,8409085081,433795793,8409084202,-879,,
527977911,8409335490,434046202,8409334602,-888,,
528228563,8409586142,434296854,8409585246,-896,,
528479295,8409836874,434547586,8409835968,-906,,
528729523,8410087112,434797824,8410086207,-905,,
528979960,8410337538,435048251,8410336633,-905,,
529230309,8410587888,435298601,8410586984,-904,,
529480635,8410838213,435548925,8410837308,-905,,
529498704,8410856282,435566994,8410855376,-906,8410855351,
529749232,8411106811,435817523,8411105900,-911,,
529999560,8411357139,436067851,8411356222,-917,,
530250148,8411607727,436318439,8411606804,-923,,
530500892,8411858471,436569183,8411857541,-930,,
530751655,8412109234,436819956,8412108315,-919,,
531002217,8412359796,437070509,8412358867,-929,,
531252346,8412609935,437320648,8412609006,-929,,
531502937,8412860516,437571228,8412859587,-929,,
531520983,8412878561,437589274,8412877632,-929,8412877703,
531771327,8413128906,437839619,8413127994,-912,,
532021840,8413379419,438090132,8413378526,-893,,
532272632,8413630210,438340923,8413629335,-875,,
532522969,8413880548,438591260,8413879691,-857,,
532773297,8414130877,438841589,8414130020,-857,,
533023814,8414381393,439092106,8414380536,-857,,
533274649,8414632228,439342941,8414631371,-857,,
533524940,8414882518,439593231,8414881661,-857,,
533542886,8414900465,439611177,8414899607,-858,8414899540,
533793299,8415150878,439861590,8415150004,-874,,
534043671,8415401250,440111962,8415400360,-890,,
534293947,8415651526,440362239,8415650619,-907,,
534544593,8415902171,440612884,8415901248,-923,,
534795241,8416152820,440863532,8416151897,-923,,
535045848,8416403427,441114139,8416402504,-923,,
535296364,8416653943,441364655,8416653030,-913,,
535547322,8416904901,441615613,8416903977,-924,,
535565437,8416923015,441633728,8416922092,-923,8416922150,
535815667,8417173245,441883968,8417172346,-899,,
536066110,8417423689,442134402,8417422795,-894,,
536317036,8417674615,442385327,8417673736,-879,,
536567618,8417925199,442635911,8417924334,-865,,
536818001,8418175580,442886302,8418174725,-855,,
537068176,8418425754,443136467,8418424890,-864,,
537318679,8418676258,443386970,8418675394,-864,,
537569307,8418926886,443637599,8418926022,-864,,
537587361,8418944939,443655651,8418944075,-864,8418944091,
537837917,8419195505,443906218,8419194645,-860,,
538088454,8419446034,444156746,8419445179,-855,,
538338546,8419696124,444406837,8419695284,-840,,
538588729,8419946307,444657020,8419945461,-846,,
538838862,8420196441,444907154,8420195595,-846,,
539089392,8420446971,445157683,8420446124,-847,,
539339540,8420697119,445407831,8420696283,-836,,
539590175,8420947754,445658466,8420946907,-847,,
539608248,8420965826,445676539,8420964980,-846,8420964983,
539858511,8421216090,445926802,8421215245,-845,,
540109113,8421466692,446177404,8421465848,-844,,
540362274,8421719853,446430565,8421719010,-843,,
540612811,8421970390,446681103,8421969548,-842,,
540863762,8422221341,446932053,8422220499,-842,,
541114188,8422471767,447182479,8422470925,-842,,
541364809,8422722388,447433101,8422721546,-842,,
541615476,8422973054,447683767,8422972212,-842,,
541633495,8422991073,447701786,8422990231,-842,8422990141,
541884011,8423241590,447952303,8423240725,-865,,
542134610,8423492190,448202902,8423491303,-887,,
542384734,8423742313,448453026,8423741404,-909,,
542634905,8423992484,448703196,8423991552,-932,,
542885650,8424243229,448953942,8424242298,-931,,
543135999,8424493578,449204291,8424492647,-931,,
543386776,8424744356,449455068,8424743425,-931,,
543637414,8424995003,449705715,8424994072,-931,,
543655400,8425012978,449723691,8425012047,-931,8425012110,
543905752,8425263330,449974043,8425262416,-914,,
544156131,8425513710,450224422,8425512811,-899,,
544406504,8425764083,450474795,8425763201,-882,,
544656834,8426014413,450725125,8426013546,-867,,
544907685,8426265265,450975977,8426264399,-866,,
545158019,8426515598,451226310,8426514732,-866,,
545408123,8426765702,451476414,8426764836,-866,,
545658745,8427016324,451727037,8427015458,-866,,
545676749,8427034327,451745039,8427033461,-866,8427033440,
545927068,8427284647,451995359,8427283776,-871,,
546178044,8427535622,452246335,8427534746,-876,,
546428416,8427785995,452496707,8427785115,-880,,
546678947,8428036535,452747248,8428035650,-885,,
546929711,8428287290,452998003,8428286406,-884,,
547180000,8428537589,453248302,8428536704,-885,,
547430449,8428788027,453498740,8428787142,-885,,
547680992,8429038571,453749293,8429037696,-875,,
547699008,8429056587,453767299,8429055701,-886,8429055673,
547949348,8429306927,454017640,8429306036,-891,,
548199938,8429557517,454268230,8429556618,-899,,
548450745,8429808325,454519037,8429807420,-905,,
548701369,8430058948,454769660,8430058036,-912,,
548951983,8430309562,455020275,8430308651,-911,,
549202242,8430559821,455270533,8430558908,-913,,
549452744,8430810323,455521035,8430809411,-912,,
549702901,8431060481,455771193,8431059569,-912,,
549721032,8431078610,455789323,8431077698,-912,8431077694,
549971262,8431328841,456039553,8431327928,-913,,
550222226,8431580310,456291094,8431579481,-829,,
550473720,8431831299,456542012,8431830385,-914,,
550724546,8432082124,456792837,8432081210,-914,,
550975200,8432332779,457043492,8432331865,-914,,
551226137,8432583716,457294429,8432582801,-915,,
551476838,8432834417,457545129,8432833502,-915,,
551727684,8433085262,457795985,8433084357,-905,,
551745770,8433103348,457814060,8433102433,-915,8433102423,
551996132,8433353711,458064424,8433352795,-916,,
552246293,8433603872,458314584,8433602953,-919,,
552496753,8433854332,458565044,8433853411,-921,,
552747079,8434104657,458815370,8434103734,-923,,
552997522,8434355101,459065813,8434354188,-913,,
553247947,8434605526,459316238,8434604603,-923,,
553498746,8434856325,459567037,8434855402,-923,,
553748924,8435106502,459817215,8435105579,-923,,
553767020,8435124598,459835311,8435123675,-923,8435123702,
554017387,8435374967,460085680,8435374050,-917,,
554268139,8435625718,460336431,8435624809,-909,,
554518295,8435875874,460586586,8435874972,-902,,
554768931,8436126510,460837222,8436125614,-896,,
555019623,8436377201,461087925,8436376317,-884,,
555270417,8436627996,461338709,8436627101,-895,,
555521185,8436878764,461589476,8436877869,-895,,
555771678,8437129257,461839969,8437128362,-895,,
555789689,8437147267,461857980,8437146372,-895,8437146365,
556040123,8437397702,462108415,8437396805,-897,,
556290638,8437648228,462358940,8437647329,-899,,
556540849,8437898428,462609141,8437897528,-900,,
556790981,8438148560,462859273,8438147670,-890,,
557041268,8438398847,463109569,8438397956,-891,,
557291412,8438648991,463359713,8438648100,-891,,
557542282,8438899861,463610573,8438898960,-901,,
557792694,8439150272,463860985,8439149371,-901,,
557810711,8439168290,463879002,8439167388,-902,8439167388,
558060880,8439418460,464129173,8439417558,-902,,
558311092,8439668671,464379383,8439667770,-901,,
558561316,8439918894,464629607,8439917993,-901,,
558811973,8440169551,464880264,8440168651,-900,,
559062300,8440419889,465130602,8440418989,-900,,
559312877,8440670456,465381168,8440669556,-900,,
559563091,8440920670,465631382,8440919769,-901,,
559813255,8441170834,465881547,8441169934,-900,,
559831352,8441188930,465899643,8441188030,-900,8441188001,
560081703,8441439282,466149995,8441438374,-908,,
560331984,8441689563,466400275,8441688648,-915,,
560582583,8441940162,466650874,8441939240,-922,,
560833114,8442190693,466901406,8442189765,-928,,
561083265,8442440844,467151557,8442439916,-928,,
561333543,8442691123,467401836,8442690195,-928,,
561583875,8442941454,467652167,8442940526,-928,,
561834344,8443191923,467902635,8443190994,-929,,
561852426,8443210004,467920717,8443209076,-928,8443209092,
562103210,8443460788,468171501,8443459864,-924,,
562353867,8443711445,468422158,8443710526,-919,,
562604255,8443961834,468672546,8443960919,-915,,
562854893,8444212472,468923184,8444211562,-910,,
563105425,8444463004,469173717,8444462095,-909,,
563355792,8444713371,469424083,8444712460,-911,,
563606707,8444964286,469674999,8444963376,-910,,
563857638,8445215218,469925930,8445214308,-910,,
563875771,8445233349,469944061,8445232439,-910,8445232379,
564126309,8445483888,470194601,8445482964,-924,,
564376695,8445734274,470444987,8445733335,-939,,
564627133,8445984722,470695435,8445983769,-953,,
564877618,8446235198,470945910,8446234230,-968,,
565128088,8446485667,471196380,8446484699,-968,,
565378237,8446735817,471446529,8446734849,-968,,
565628712,8446986291,471697004,8446985323,-968,,
565879169,8447236759,471947471,8447235791,-968,,
565897281,8447254860,471965572,8447253891,-969,8447253927,
566147454,8447505034,472215746,8447504073,-961,,
566397551,8447755130,472465843,8447754180,-950,,
566648435,8448006017,472716730,8448005077,-940,,
566898793,8448256372,472967085,8448255441,-931,,
567149282,8448506862,473217575,8448505931,-931,,
567399746,8448757326,473468039,8448756395,-931,,
567650095,8449007675,473718387,8449006744,-931,,
567900931,8449258510,473969223,8449257580,-930,,
567919059,8449276637,473987350,8449275706,-931,8449275659,
568169841,8449527421,474238133,8449526477,-944,,
568420214,8449777793,474488506,8449776838,-955,,
568670430,8450028009,474738722,8450027043,-966,,
568921085,8450278663,474989376,8450277686,-977,,
569171423,8450529001,475239714,8450528024,-977,,
569421679,8450779268,475489981,8450778291,-977,,
569672002,8451029581,475740294,8451028604,-977,,
569922096,8451279675,475990387,8451278698,-977,,
569940174,8451297752,476008465,8451296775,-977,8451296841,
570190745,8451548324,476259036,8451547362,-962,,
570441176,8451798755,476509468,8451797811,-944,,
570691479,8452049058,476759771,8452048131,-927,,
570943872,8452301451,477012163,8452300541,-910,,
571194463,8452552042,477262755,8452551132,-910,,
571445057,8452802636,477513349,8452801726,-910,,
571695447,8453053027,477763740,8453052117,-910,,
571945717,8453303296,478014009,8453302387,-909,,
571963738,8453321317,478032029,8453320407,-910,8453320344,
572213834,8453571413,478282125,8453570487,-926,,
572464227,8453821816,478532529,8453820875,-941,,
572714619,8454072198,478782910,8454071242,-956,,
572965295,8454322873,479033586,8454321902,-971,,
573215845,8454573424,479284137,8454572453,-971,,
573466086,8454823665,479534377,8454822694,-971,,
573716316,8455073895,479784607,8455072924,-971,,
573967122,8455324701,480035413,8455323730,-971,,
573985216,8455342795,480053507,8455341823,-972,8455341892,
574235444,8455593023,480303735,8455592069,-954,,
574485630,8455843209,480553922,8455842272,-937,,
574736118,8456093697,480804409,8456092778,-919,,
574986482,8456344061,481054784,8456343171,-890,,
575237183,8456594762,481305474,8456593861,-901,,
575487328,8456844918,481555630,8456844017,-901,,
575737764,8457095342,481806055,8457094441,-901,,
575988399,8457345978,482056701,8457345088,-890,,
576006554,8457364132,482074844,8457363231,-901,8457363160,
576256971,8457614550,482325262,8457613632,-918,,
576507615,8457865194,482575906,8457864258,-936,,
576758286,8458115865,482826578,8458114912,-953,,
577008857,8458366436,483077149,8458365466,-970,,
577259258,8458616837,483327559,8458615877,-960,,
577509665,8458867244,483577957,8458866274,-970,,
577760058,8459117637,483828359,8459116677,-960,,
578010690,8459368268,484078981,8459367298,-970,,
578028662,8459386241,484096953,8459385270,-971,8459385272,
578278947,8459636525,484347237,8459635555,-970,,
578529544,8459887123,484597836,8459886154,-969,,
578780164,8460137743,484848455,8460136775,-968,,
579030489,8460388068,485098781,8460387101,-967,,
579280798,8460638377,485349089,8460637410,-967,,
579531552,8460889131,485599843,8460888164,-967,,
579782151,8461139730,485850443,8461138763,-967,,
580032792,8461390371,486101084,8461389414,-957,,
580050803,8461408381,486119093,8461407414,-967,8461407438,
580300924,8461658503,486369216,8461657553,-950,,
580551369,8461908947,486619659,8461907993,-954,,
580801715,8462159294,486870007,8462158347,-947,,
581052483,8462410062,487120775,8462409122,-940,,
581302681,8462660260,487370973,8462659319,-941,,
581553220,8462910799,487621512,8462909858,-941,,
581803556,8463161134,487871847,8463160193,-941,,
582053907,8463411496,488122209,8463410555,-941,,
582072059,8463429638,488140350,8463428696,-942,8463428694,
582322269,8463679847,488390560,8463678905,-942,,
582572484,8463930063,488640775,8463929121,-942,,
582822834,8464180413,488891125,8464179470,-943,,
583073256,8464430835,489141558,8464429903,-932,,
583323635,8464681215,489391927,8464680273,-942,,
583574137,8464931715,489642428,8464930773,-942,,
583825079,8465182658,489893380,8465181725,-933,,
584075635,8465433215,490143928,8465432273,-942,,
584093796,8465451374,490162087,8465450432,-942,8465450263,
584344394,8465701972,490412685,8465700997,-975,,
584594868,8465952447,490663159,8465951419,-1028,,
584845245,8466202824,490913547,8466201765,-1059,,
585095740,8466453330,491164042,8466452219,-1111,,
585346365,8466703944,491414657,8466702834,-1110,,
585596768,8466954347,491665060,8466953237,-1110,,
585847345,8467204933,491915646,8467203824,-1109,,
586097815,8467455395,492166108,8467454285,-1110,,
586115838,8467473416,492184128,8467472306,-1110,8467472401,
586366387,8467723966,492434678,8467722879,-1087,,
586616941,8467974520,492685232,8467973458,-1062,,
586867237,8468224827,492935539,8468223790,-1037,,
587117334,8468474913,493185625,8468473900,-1013,,
587368072,8468725651,493436363,8468724638,-1013,,
587618420,8468975999,493686712,8468974996,-1003,,
587869369,8469226947,493937670,8469225944,-1003,,
588119963,8469477543,494188255,8469476530,-1013,,
588138003,8469495581,494206294,8469494568,-1013,8469494561,
588388426,8469746005,494456718,8469744990,-1015,,
588638554,8469996133,494706845,8469995115,-1018,,
588888998,8470246576,494957289,8470245558,-1018,,
589139222,8470496801,495207523,8470495792,-1009,,
589389434,8470747013,495457725,8470745994,-1019,,
589640037,8470997616,495708339,8470996607,-1009,,
589890539,8471248118,495958830,8471247098,-1020,,
590140983,8471498562,496209275,8471497543,-1019,,
590159045,8471516623,496227335,8471515604,-1019,8471515711,
590409762,8471767341,496478053,8471766348,-993,,
590660330,8472017919,496728632,8472016954,-965,,
590910394,8472267974,496978686,8472267037,-937,,
591160774,8472518352,497229076,8472517453,-899,,
591410881,8472768459,497479172,8472767549,-910,,
591661616,8473019195,497729907,8473018285,-910,,
591912052,8473269640,497980353,8473268730,-910,,
592162559,8473520138,498230850,8473519228,-910,,
592180729,8473538307,498249019,8473537397,-910,8473537365,
592430905,8473788484,498499196,8473787566,-918,,
592681072,8474038651,498749363,8474037726,-925,,
592931364,8474288943,498999656,8474288010,-933,,
593182328,8474539907,499250619,8474538967,-940,,
593432998,8474790577,499501289,8474789637,-940,,
593683478,8475041057,499751770,8475040117,-940,,
593934338,8475291917,500002640,8475290987,-930,,
594184615,8475542194,500252907,8475541254,-940,,
594202651,8475560229,500270942,8475559289,-940,8475559151,
594453231,8475810810,500521522,8475809835,-975,,
594704074,8476061653,500772366,8476060645,-1008,,
594954679,8476312257,501022970,8476311215,-1042,,
595205231,8476562810,501273523,8476561734,-1076,,
595455364,8476812953,501523666,8476811877,-1076,,
595706088,8477063666,501774379,8477062590,-1076,,
595956376,8477313954,502024667,8477312878,-1076,,
596207211,8477564790,502275503,8477563714,-1076,,
596225280,8477582858,502293571,8477581782,-1076,8477581802,
596475556,8477833135,502543848,8477832064,-1071,,
596725700,8478083278,502793991,8478082222,-1056,,
596976328,8478333907,503044619,8478332847,-1060,,
597226858,8478584437,503295149,8478583381,-1056,,
597477093,8478834672,503545384,8478833617,-1055,,
597727262,8479084840,503795552,8479083785,-1055,,
597977454,8479335033,504045745,8479333978,-1055,,
598228415,8479585994,504296707,8479584939,-1055,,
598246528,8479604106,504314818,8479603051,-1055,8479603028,
598496894,8479854473,504565186,8479853413,-1060,,
598747256,8480104835,504815547,8480103769,-1066,,
598998027,8480355605,505066318,8480354535,-1070,,
599248424,8480606014,505316727,8480604938,-1076,,
599498545,8480856124,505566836,8480855048,-1076,,
599748699,8481106277,505816990,8481105201,-1076,,
599999322,8481356900,506067612,8481355824,-1076,,
600250172,8481607751,506318474,8481606686,-1065,,
600268137,8481625715,506336428,8481624639,-1076,8481624715,
600518516,8481876095,506586807,8481875038,-1057,,
600768752,8482126332,506837044,8482125294,-1038,,
601019207,8482376786,507087498,8482375768,-1018,,
601270305,8482627884,507338606,8482626895,-989,,
601520442,8482878020,507588733,8482877021,-999,,
601770730,8483128309,507839021,8483127309,-1000,,
602021388,8483378967,508089680,8483377968,-999,,
602271816,8483629395,508340108,8483628397,-998,,
602289917,8483647496,508358208,8483646496,-1000,8483646460,
602540034,8483897613,508608325,8483896604,-1009,,
602790491,8484148069,508858782,8484147062,-1007,,
603041084,8484398663,509109375,8484397646,-1017,,
603291518,8484649109,509359821,8484648075,-1034,,
603542334,8484899912,509610635,8484898889,-1023,,
603792892,8485150471,509861183,8485149437,-1034,,
604043413,8485400993,510111705,8485399959,-1034,,
604293899,8485651478,510362191,8485650444,-1034,,
604311826,8485669404,510380117,8485668370,-1034,8485668360,
604562143,8485919721,510630434,8485918695,-1026,,
604812858,8486170437,510881149,8486169398,-1039,,
605063404,8486420983,511131696,8486419942,-1041,,
605313620,8486671208,511381921,8486670166,-1042,,
605563995,8486921574,511632286,8486920531,-1043,,
605814478,8487172057,511882769,8487171014,-1043,,
606064837,8487422416,512133129,8487421373,-1043,,
606315296,8487672884,512383597,8487671841,-1043,,
606333308,8487690887,512401599,8487689844,-1043,8487689810,
606583770,8487941348,512652060,8487940296,-1052,,
606834192,8488191771,512902483,8488190711,-1060,,
607084916,8488442495,513153208,8488441427,-1068,,
607335304,8488692883,513403596,8488691808,-1075,,
607585806,8488943385,513654097,8488942310,-1075,,
607836157,8489193735,513904447,8489192660,-1075,,
608086435,8489444015,514154727,8489442940,-1075,,
608336891,8489694470,514405183,8489693396,-1074,,
608355018,8489712596,514423308,8489711521,-1075,8489711514,
608605695,8489963273,514673986,8489962197,-1076,,
608856077,8490213656,514924368,8490212578,-1078,,
609106641,8490464219,515174932,8490463140,-1079,,
609357488,8490715067,515425780,8490713987,-1080,,
609607661,8490965240,515675952,8490964159,-1081,,
609857927,8491215506,515926219,8491214436,-1070,,
610108244,8491465823,516176535,8491464752,-1071,,
610358755,8491716334,516427047,8491715254,-1080,,
610376750,8491734328,516445040,8491733248,-1080,8491733244,
610627086,8491984665,516695377,8491983585,-1080,,
610877593,8492235171,516945884,8492234090,-1081,,
611128248,8492485827,517196540,8492484746,-1081,,
611378673,8492736253,517446965,8492735171,-1082,,
611629351,8492986930,517697642,8492985847,-1083,,
611879549,8493237128,517947840,8493236045,-1083,,
612130133,8493487712,518198424,8493486630,-1082,,
612380639,8493738218,518448930,8493737136,-1082,,
612398706,8493756284,518466996,8493755201,-1083,8493755195,
612649294,8494006872,518717585,8494005788,-1084,,
612899623,8494257202,518967914,8494256117,-1085,,
613149962,8494507541,519218254,8494506455,-1086,,
613400183,8494757773,519468485,8494756685,-1088,,
613650403,8495007982,519718694,8495006894,-1088,,
613900758,8495258337,519969049,8495257250,-1087,,
614150887,8495508465,520219178,8495507378,-1087,,
614401264,8495758843,520469555,8495757756,-1087,,
614419350,8495776928,520487640,8495775841,-1087,8495775904,
614669628,8496027207,520737920,8496026146,-1061,,
614919970,8496277549,520988262,8496276494,-1055,,
615170545,8496528134,521238846,8496527096,-1038,,
615421019,8496778598,521489310,8496777576,-1022,,
615671545,8497029123,521739836,8497028101,-1022,,
615921947,8497279526,521990238,8497278504,-1022,,
616172168,8497529747,522240459,8497528725,-1022,,
616422521,8497780100,522490812,8497779078,-1022,,
616440614,8497798193,522508905,8497797171,-1022,8497797127,
616690899,8498048478,522759201,8498047456,-1022,,
616941524,8498299103,523009815,8498298060,-1043,,
617191674,8498549253,523259965,8498548199,-1054,,
617441811,8498799400,523510112,8498798336,-1064,,
617692305,8499049884,523760596,8499048820,-1064,,
617943234,8499300812,524011525,8499299748,-1064,,
618193641,8499551219,524261932,8499550155,-1064,,
618444295,8499801884,524512596,8499800820,-1064,,
618462352,8499819930,524530643,8499818866,-1064,8499818826,
618712720,8500070299,524781011,8500069224,-1075,,
618963434,8500321013,525031725,8500319929,-1084,,
619213807,8500571386,525282098,8500570292,-1094,,
619464502,8500822080,525532793,8500820977,-1103,,
619714710,8501072289,525783002,8501071186,-1103,,
619965162,8501322741,526033453,8501321637,-1104,,
620215560,8501573139,526283851,8501572046,-1093,,
620466173,8501823752,526534464,8501822648,-1104,,
620484258,8501841836,526552548,8501840733,-1103,8501840678,
620734535,8502092124,526802837,8502091007,-1117,,
620985076,8502342654,527053367,8502341524,-1130,,
621236068,8502593647,527304359,8502592504,-1143,,
621486401,8502843979,527554692,8502842823,-1156,,
621736729,8503094308,527805020,8503093152,-1156,,
621986872,8503344451,528055163,8503343294,-1157,,
622237674,8503595253,528305965,8503594097,-1156,,
622487869,8503845447,528556170,8503844301,-1146,,
622506030,8503863609,528574321,8503862452,-1157,8503862478,
622756492,8504114071,528824783,8504112931,-1140,,
623007421,8504365000,529075713,8504363857,-1143,,
623257856,8504615446,529326158,8504614310,-1136,,
623508055,8504865634,529576346,8504864504,-1130,,
623758476,8505116055,529826767,8505114925,-1130,,
624008979,8505366568,530077280,8505365439,-1129,,
624259587,8505617166,530327879,8505616037,-1129,,
624510009,8505867588,530578301,8505866459,-1129,,
624527964,8505885543,530596255,8505884413,-1130,8505884446,
624778793,8506136372,530847084,8506135251,-1121,,
625029288,8506386877,531097590,8506385764,-1113,,
625279802,8506637392,531348104,8506636288,-1104,,
625530257,8506887836,531598549,8506886741,-1095,,
625780550,8507138129,531848841,8507137033,-1096,,
626031047,8507388626,532099339,8507387531,-1095,,
626281992,8507639571,532350284,8507638476,-1095,,
626532831,8507890410,532601123,8507889315,-1095,,
626550884,8507908462,532619175,8507907367,-1095,8507907418,
626801065,8508158645,532869358,8508157562,-1083,,
627051960,8508409539,533120252,8508408469,-1070,,
627302186,8508659765,533370477,8508658709,-1056,,
627552824,8508910403,533621116,8508909360,-1043,,
627803795,8509161374,533872086,8509160331,-1043,,
628054663,8509412243,534122955,8509411200,-1043,,
628304846,8509662425,534373138,8509661382,-1043,,
628555908,8509913487,534624200,8509912444,-1043,,
628573917,8509931495,534642208,8509930452,-1043,8509930331,
628824386,8510181965,534892677,8510180891,-1074,,
629075137,8510432717,535143429,8510431613,-1104,,
629325743,8510683322,535394035,8510682188,-1134,,
629576089,8510933668,535644381,8510932505,-1163,,
629826463,8511184042,535894754,8511182879,-1163,,
630076707,8511434287,536144999,8511433124,-1163,,
630326830,8511684409,536395122,8511683246,-1163,,
630577420,8511934999,536645711,8511933836,-1163,,
630595414,8511952993,536663705,8511951829,-1164,8511951892,
630845734,8512203313,536914025,8512202164,-1149,,
631096288,8512453867,537164579,8512452736,-1131,,
631346499,8512704089,537414801,8512702974,-1115,,
631596945,8512954523,537665236,8512953424,-1099,,
631847330,8513204909,537915622,8513203811,-1098,,
632097827,8513455406,538166119,8513454308,-1098,,
632348203,8513705792,538416505,8513704693,-1099,,
632598677,8513956256,538666968,8513955167,-1089,,
632616718,8513974296,538685009,8513973197,-1099,8513973155,
632867490,8514225069,538935782,8514223959,-1110,,
633118107,8514475687,539186399,8514474567,-1120,,
633368272,8514725851,539436564,8514724721,-1130,,
633618609,8514976188,539686900,8514975048,-1140,,
633869058,8515226637,539937349,8515225497,-1140,,
634119658,8515477237,540187949,8515476107,-1130,,
634370185,8515727764,540438477,8515726625,-1139,,
634620669,8515978247,540688960,8515977107,-1140,,
634638681,8515996259,540706971,8515995119,-1140,8515995174,
634889327,8516246905,540957618,8516245780,-1125,,
635139641,8516497220,541207933,8516496109,-1111,,
635389861,8516747440,541458153,8516746344,-1096,,
635639973,8516997552,541708265,8516996469,-1083,,
635890374,8517247952,541958665,8517246869,-1083,,
636140996,8517498575,542209287,8517497491,-1084,,
636391436,8517749014,542459727,8517747931,-1083,,
636641541,8517999120,542709833,8517998037,-1083,,
636659667,8518017246,542727958,8518016162,-1084,8518016108,
636909921,8518267500,542978212,8518266402,-1098,,
637160846,8518518426,543229139,8518517316,-1110,,
637411174,8518768753,543479466,8518767630,-1123,,
637661345,8519018924,543729636,8519017788,-1136,,
637911502,8519269081,543979794,8519267945,-1136,,
638162069,8519519648,544230360,8519518512,-1136,,
638412422,8519770001,544480714,8519768865,-1136,,
638663386,8520020965,544731677,8520019829,-1136,,
638681451,8520039029,544749741,8520037893,-1136,8520037849,
638931738,8520289317,545000029,8520288169,-1148,,
639181925,8520539504,545250216,8520538345,-1159,,
639432353,8520789932,545500644,8520788774,-1158,,
639682504,8521040082,545750795,8521038904,-1178,,
639932972,8521290551,546001264,8521289373,-1178,,
640183223,8521540802,546251515,8521539624,-1178,,
640433968,8521791546,546502259,8521790369,-1177,,
640684068,8522041647,546752359,8522040469,-1178,,
640702169,8522059748,546770460,8522058569,-1179,8522058614,
640952323,8522309901,547020613,8522308734,-1167,,
641202678,8522560256,547270969,8522559101,-1155,,
641453223,8522810812,547521525,8522809669,-1143,,
641703694,8523061273,547771985,8523060141,-1132,,
641954294,8523311873,548022585,8523310740,-1133,,
642204440,8523562019,548272731,8523560897,-1122,,
642455194,8523812784,548523496,8523811652,-1132,,
642705335,8524062914,548773626,8524061782,-1132,,
642723387,8524080965,548791678,8524079833,-1132,8524079826,
642973899,8524331478,549042190,8524330344,-1134,,
643224162,8524581741,549292453,8524580606,-1135,,
643474441,8524832019,549542732,8524830882,-1137,,
643725056,8525082634,549793347,8525081496,-1138,,
643975142,8525332721,550043433,8525331583,-1138,,
644225954,8525583532,550294245,8525582395,-1137,,
644476103,8525833682,550544395,8525832545,-1137,,
644726543,8526084122,550794834,8526082983,-1139,,
644744726,8526102304,550813016,8526101166,-1138,8526101203,
644995375,8526352953,551063666,8526351824,-1129,,
645245972,8526603551,551314263,8526602432,-1119,,
645496569,8526854147,551564870,8526853048,-1099,,
645747431,8527105009,551815722,8527103910,-1099,,
645997562,8527355140,552065853,8527354051,-1089,,
646247789,8527605367,552316080,8527604268,-1099,,
646498208,8527855786,552566499,8527854688,-1098,,
646748556,8528106134,552816847,8528105035,-1099,,
646766794,8528124373,552835085,8528123274,-1099,8528123221,
647017351,8528374930,553085643,8528373818,-1112,,
647268073,8528625663,553336376,8528624538,-1125,,
647518227,8528875806,553586519,8528874669,-1137,,
647768833,8529126412,553837124,8529125262,-1150,,
648019381,8529376960,554087673,8529375810,-1150,,
648270330,8529627909,554338621,8529626759,-1150,,
648520985,8529878564,554589277,8529877414,-1150,,
648771426,8530129005,554839717,8530127855,-1150,,
648789480,8530147058,554857771,8530145908,-1150,8530145929,
649039883,8530397461,555108174,8530396315,-1146,,
649290167,8530647746,555358469,8530646616,-1130,,
649540304,8530897883,555608595,8530896749,-1134,,
649790423,8531148002,555858715,8531146874,-1128,,
650040778,8531398357,556109069,8531397229,-1128,,
650291637,8531649215,556359927,8531648087,-1128,,
650541902,8531899481,556610204,8531898363,-1118,,
650792149,8532149737,556860450,8532148609,-1128,,
650810266,8532167844,556878557,8532166716,-1128,8532166710,
651060955,8532418534,557129247,8532417404,-1130,,
651311320,8532668899,557379621,8532667777,-1122,,
651561664,8532919243,557629956,8532918112,-1131,,
651812076,8533169655,557880367,8533168532,-1123,,
652062242,8533419820,558130533,8533418687,-1133,,
652312949,8533670528,558381240,8533669395,-1133,,
652563568,8533921146,558631859,8533920013,-1133,,
652814286,8534171865,558882577,8534170732,-1133,,
652832386,8534189964,558900676,8534188830,-1134,8534188801,
653082932,8534440512,559151224,8534439372,-1140,,
653333429,8534691007,559401720,8534689860,-1147,,
653583706,8534941285,559651997,8534940131,-1154,,
653834244,8535191823,559902536,8535190672,-1151,,
654084826,8535442404,560153117,8535441243,-1161,,
654335423,8535693001,560403714,8535691840,-1161,,
654586032,8535943611,560654324,8535942450,-1161,,
654836414,8536193992,560904705,8536192831,-1161,,
654854580,8536212158,560922871,8536210997,-1161,8536211021,
655104947,8536462526,561173238,8536461381,-1145,,
655355152,8536712731,561423443,8536711582,-1149,,
655605569,8536963148,561673860,8536962005,-1143,,
655855965,8537213543,561924256,8537212407,-1136,,
656106499,8537464078,562174791,8537462942,-1136,,
656357472,8537715051,562425763,8537713914,-1137,,
656607600,8537965179,562675891,8537964043,-1136,,
656858122,8538215700,562926412,8538214564,-1136,,
656876238,8538233816,562944528,8538232680,-1136,8538232621,
657126886,8538484465,563195177,8538483315,-1150,,
657377667,8538735246,563445970,8538734093,-1153,,
657628316,8538985895,563696607,8538984726,-1169,,
657878466,8539236045,563946757,8539234862,-1183,,
658129165,8539486745,564197458,8539485553,-1192,,
658379400,8539736989,564447702,8539735796,-1193,,
658630043,8539987622,564698345,8539986439,-1183,,
658880384,8540237963,564948686,8540236780,-1183,,
658898451,8540256029,564966741,8540254836,-1193,8540254768,
659148925,8540506504,565217216,8540505294,-1210,,
659399399,8540756977,565467690,8540755751,-1226,,
659649921,8541007500,565718212,8541006257,-1243,,
659900318,8541257897,565968609,8541256648,-1249,,
660150964,8541508543,566219255,8541507284,-1259,,
660401192,8541758781,566469494,8541757522,-1259,,
660651393,8542008972,566719695,8542007723,-1249,,
660901630,8542259209,566969932,8542257961,-1248,,
660919716,8542277294,566988007,8542276035,-1259,8542276121,
661170083,8542527661,567238374,8542526423,-1238,,
661420511,8542778090,567488812,8542776884,-1206,,
661670644,8543028222,567738935,8543027028,-1194,,
661921077,8543278656,567989368,8543277494,-1162,,
662171555,8543529134,568239847,8543527963,-1171,,
662422024,8543779613,568490326,8543778441,-1172,,
662672508,8544030097,568740810,8544028925,-1172,,
662922739,8544280328,568991041,8544279156,-1172,,
662940752,8544298330,569009043,8544297158,-1172,8544297156,
663191268,8544548846,569259559,8544547673,-1173,,
663441745,8544799324,569510036,8544798150,-1174,,
663692228,8545049807,569760519,8545048634,-1173,,
663942575,8545300154,570010866,8545298981,-1173,,
664193047,8545550626,570261338,8545549453,-1173,,
664443502,8545801080,570511793,8545799907,-1173,,
664694176,8546051754,570762467,8546050581,-1173,,
664944347,8546301926,571012639,8546300753,-1173,,
664962391,8546319969,571030681,8546318796,-1173,8546318765,
665212593,8546570173,571280885,8546568992,-1181,,
665462946,8546820525,571531237,8546819348,-1177,,
665713136,8547070715,571781427,8547069529,-1186,,
665964087,8547321665,572032378,8547320463,-1202,,
666214462,8547572041,572282753,8547570839,-1202,,
666464633,8547822212,572532925,8547821010,-1202,,
666714979,8548072558,572783270,8548071356,-1202,,
666965503,8548323082,573033795,8548321880,-1202,,
666983722,8548341300,573052012,8548340098,-1202,8548340111,
667234261,8548591839,573302562,8548590651,-1188,,
667484637,8548842216,573552928,8548841021,-1195,,
667735012,8549092591,573803303,8549091400,-1191,,
667985623,8549343201,574053914,8549342014,-1187,,
668236028,8549593617,574304330,8549592430,-1187,,
668486141,8549843719,574554432,8549842532,-1187,,
668736796,8550094374,574805087,8550093187,-1187,,
668987543,8550345121,575055833,8550343934,-1187,,
669005587,8550363166,575073878,8550361978,-1188,8550361951,
669255708,8550613287,575324010,8550612103,-1184,,
669505903,8550863482,575574194,8550862281,-1201,,
669756119,8551113697,575824410,8551112490,-1207,,
670006550,8551364129,576074841,8551362916,-1213,,
670257134,8551614713,576325435,8551613510,-1203,,
670507493,8551865072,576575784,8551863858,-1214,,
670757840,8552115420,576826132,8552114207,-1213,,
671008380,8552365959,577076671,8552364746,-1213,,
671026538,8552384116,577094829,8552382903,-1213,8552382896,
671276942,8552634530,577345243,8552633314,-1216,,
671527039,8552884618,577595331,8552883401,-1217,,
671777458,8553135037,577845749,8553133819,-1218,,
672027700,8553385278,578095991,8553384059,-1219,,
672278059,8553635637,578346350,8553634428,-1209,,
672528188,8553885767,578596479,8553884548,-1219,,
672778314,8554135893,578846605,8554134674,-1219,,
673028761,8554386339,579097052,8554385120,-1219,,
673046873,8554404452,579115164,8554403232,-1220,8554403262,
673297370,8554654959,579365671,8554653746,-1213,,
673547596,8554905174,579615887,8554903970,-1204,,
673798197,8555155775,579866488,8555154579,-1196,,
674048615,8555406193,580116906,8555405005,-1188,,
674298839,8555656417,580367130,8555655229,-1188,,
674549068,8555906647,580617359,8555905459,-1188,,
674799680,8556157259,580867971,8556156071,-1188,,
675049804,8556407383,581118095,8556406194,-1189,,
675067870,8556425448,581136160,8556424260,-1188,8556424261,
675318247,8556675826,581386538,8556674639,-1187,,
675568621,8556926200,581636913,8556925014,-1186,,
675818784,8557176363,581887075,8557175177,-1186,,
676069283,8557426862,582137574,8557425677,-1185,,
676319834,8557677413,582388126,8557676228,-1185,,
676570915,8557928504,582639217,8557927319,-1185,,
676821332,8558178910,582889623,8558177725,-1185,,
677071771,8558429350,583140062,8558428164,-1186,,
677089830,8558447408,583158121,8558446223,-1185,8558446219,
677340344,8558697923,583408635,8558696747,-1176,,
677590686,8558948265,583658978,8558947078,-1187,,
677840850,8559198429,583909141,8559197241,-1188,,
678091665,8559449244,584159957,8559448056,-1188,,
678342399,8559699978,584410690,8559698800,-1178,,
678592638,8559950227,584660940,8559949039,-1188,,
678842808,8560200387,584911099,8560199199,-1188,,
679093385,8560450964,585161676,8560449775,-1189,,
679111388,8560468966,585179678,8560467778,-1188,8560467717,
679361818,8560719397,585430109,8560718195,-1202,,
679612440,8560970019,585680732,8560968802,-1217,,
679862629,8561220208,585930920,8561218975,-1233,,
680112785,8561470365,586181078,8561469118,-1247,,
680363287,8561720876,586431588,8561719629,-1247,,
680613410,8561970990,586681702,8561969743,-1247,,
680863646,8562221225,586931937,8562219978,-1247,,
681113767,8562471346,587182058,8562470109,-1237,,
681131708,8562489286,587199998,8562488039,-1247,8562488052,
681381942,8562739520,587450233,8562738276,-1244,,
681632465,8562990044,587700756,8562988804,-1240,,
681882960,8563240539,587951252,8563239303,-1236,,
682133165,8563490743,588201456,8563489511,-1232,,
682384067,8563741646,588452358,8563740414,-1232,,
682634557,8563992136,588702849,8563990905,-1231,,
682885046,8564242625,588953337,8564241392,-1233,,
683135394,8564492973,589203686,8564491741,-1232,,
683153369,8564510947,589221660,8564509715,-1232,8564509673,
683403474,8564761053,589471766,8564759810,-1243,,
683654114,8565011694,589722406,8565010441,-1253,,
683904259,8565261838,589972550,8565260574,-1264,,
684155016,8565512595,590223307,8565511322,-1273,,
684405187,8565762765,590473488,8565761502,-1263,,
684655650,8566013230,590723943,8566011957,-1273,,
684905820,8566263398,590974121,8566262135,-1263,,
685156500,8566514080,591224793,8566512807,-1273,,
685174630,8566532208,591242921,8566530935,-1273,8566530996,
685425204,8566782783,591493496,8566781526,-1257,,
685675407,8567032986,591743708,8567031754,-1232,,
685925983,8567283561,591994274,8567282335,-1226,,
686176267,8567533846,592244558,8567532635,-1211,,
686426436,8567784014,592494727,8567782803,-1211,,
686676561,8568034141,592744853,8568032930,-1211,,
686927098,8568284676,592995389,8568283465,-1211,,
687177417,8568534996,593245709,8568533785,-1211,,
687195512,8568553090,593263803,8568551879,-1211,8568551722,
687445745,8568803335,593514048,8568802084,-1251,,
687696558,8569054137,593764860,8569052858,-1279,,
687946939,8569304517,594015230,8569303189,-1328,,
688197431,8569555010,594265722,8569553643,-1367,,
688447769,8569805348,594516060,8569803981,-1367,,
688698108,8570055687,594766400,8570054320,-1367,,
688948386,8570305965,595016677,8570304598,-1367,,
689198532,8570556112,595266825,8570554745,-1367,,
689216612,8570574191,595284903,8570572823,-1368,8570572905,
689467171,8570824749,595535462,8570823402,-1347,,
689717315,8571074894,595785616,8571073578,-1316,,
689967659,8571325238,596035960,8571323942,-1296,,
690217768,8571575347,596286070,8571574074,-1273,,
690468210,8571825789,596536501,8571824505,-1284,,
690719002,8572076591,596787303,8572075307,-1284,,
690969582,8572327171,597037884,8572325887,-1284,,
691219890,8572577468,597288181,8572576184,-1284,,
691238395,8572595973,597306685,8572594689,-1284,8572594867,
691488948,8572846527,597557239,8572845288,-1239,,
691739272,8573096862,597807574,8573095668,-1194,,
691989449,8573347038,598057750,8573345889,-1149,,
692239956,8573597536,598308248,8573596431,-1105,,
692490507,8573848096,598558809,8573846992,-1104,,
692741142,8574098731,598809444,8574097627,-1104,,
692991738,8574349317,599060030,8574348213,-1104,,
693242328,8574599907,599310619,8574598802,-1105,,
693260400,8574617978,599328690,8574616874,-1104,8574616716,
693510754,8574868332,599579044,8574867188,-1144,,
693761315,8575118904,599829616,8575117721,-1183,,
694011776,8575369354,600080077,8575368142,-1212,,
694262335,8575619924,600330636,8575618663,-1261,,
694512724,8575870303,600581015,8575869053,-1250,,
694763353,8576120932,600831655,8576119682,-1250,,
695014220,8576371809,601082522,8576370548,-1261,,
695264371,8576621949,601332661,8576620688,-1261,,
695282383,8576639961,601350674,8576638700,-1261,8576638616,
695532471,8576890049,601600762,8576888769,-1280,,
695782616,8577140195,601850907,8577138897,-1298,,
696032973,8577390552,602101275,8577389247,-1305,,
696283541,8577641120,602351833,8577639786,-1334,,
696534115,8577891694,602602406,8577890370,-1324,,
696784342,8578141921,602852633,8578140587,-1334,,
697034621,8578392200,603102922,8578390876,-1324,,
697285381,8578642960,603353682,8578641636,-1324,,
697303401,8578660979,603371691,8578659645,-1334,8578659717,
697554403,8578911982,603622695,8578910666,-1316,,
697804519,8579162098,603872821,8579160811,-1287,,
698054737,8579412315,604123038,8579411047,-1268,,
698305373,8579662962,604373675,8579661702,-1260,,
698555615,8579913194,604623916,8579911944,-1250,,
698806025,8580163603,604874316,8580162343,-1260,,
699056442,8580414031,605124744,8580412771,-1260,,
699307046,8580664624,605375337,8580663364,-1260,,
699325219,8580682797,605393510,8580681537,-1260,8580681556,
699575436,8580933015,605643727,8580931759,-1256,,
699825616,8581183195,605893907,8581181945,-1250,,
700075848,8581433426,606144139,8581432181,-1245,,
700326830,8581684409,606395122,8581683169,-1240,,
700577818,8581935397,606646109,8581934167,-1230,,
700828194,8582185773,606896496,8582184543,-1230,,
701078620,8582436199,607146912,8582434959,-1240,,
701329212,8582686791,607397514,8582685561,-1230,,
701347192,8582704770,607415482,8582703530,-1240,8582703465,
701597303,8582954882,607665594,8582953625,-1257,,
701847429,8583205008,607915720,8583203746,-1262,,
702098021,8583455600,608166312,8583454312,-1288,,
702348504,8583706083,608416796,8583704791,-1292,,
702598865,8583956444,608667157,8583955141,-1303,,
702849241,8584206820,608917533,8584205517,-1303,,
703099824,8584457403,609168115,8584456100,-1303,,
703350007,8584707596,609418309,8584706293,-1303,,
703368111,8584725689,609436401,8584724386,-1303,8584724483,
703618300,8584975879,609686591,8584974600,-1279,,
703869007,8585226586,609937298,8585225343,-1243,,
704119599,8585477177,610187890,8585475949,-1228,,
704370147,8585727726,610438439,8585726533,-1193,,
704620658,8585978237,610688949,8585977033,-1204,,
704871299,8586228878,610939600,8586227684,-1194,,
705122217,8586479796,611190509,8586478592,-1204,,
705372584,8586730164,611440877,8586728960,-1204,,
705390694,8586748272,611458985,8586747068,-1204,8586746858,
705641325,8586998904,611709616,8586997646,-1258,,
705891836,8587249425,611960138,8587248115,-1310,,
706142255,8587499844,612210556,8587498482,-1362,,
706392739,8587750318,612461031,8587748905,-1413,,
706643578,8588001156,612711868,8587999743,-1413,,
706894167,8588251756,612962468,8588250343,-1413,,
707144427,8588502006,613212719,8588500593,-1413,,
707394863,8588752443,613463155,8588751030,-1413,,
707412908,8588770487,613481199,8588769074,-1413,8588769218,
707663101,8589020679,613731392,8589019302,-1377,,
707913405,8589270984,613981707,8589269653,-1331,,
708163973,8589521551,614232263,8589520247,-1304,,
708414266,8589771846,614482559,8589770579,-1267,,
708664461,8590022039,614732752,8590020772,-1267,,
708914857,8590272436,614983158,8590271179,-1257,,
709165173,8590522751,615233464,8590521494,-1257,,
709415576,8590773166,615483878,8590771899,-1267,,
709433593,8590791172,615501884,8590789904,-1268,8590789865,
709683899,8591041478,615752190,8591040200,-1278,,
709934391,8591291970,616002683,8591290684,-1286,,
710185061,8591542641,616253354,8591541346,-1295,,
710435823,8591793402,616504115,8591792097,-1305,,
710686412,8592043990,616754703,8592042685,-1305,,
710936527,8592294106,617004818,8592292801,-1305,,
711186950,8592544528,617255241,8592543223,-1305,,
711437455,8592795034,617505746,8592793729,-1305,,
711455476,8592813054,617523766,8592811748,-1306,8592811789,
711705848,8593063437,617774149,8593062143,-1294,,
711956499,8593314088,618024801,8593312804,-1284,,
712207083,8593564663,618275375,8593563390,-1273,,
712457492,8593815071,618525794,8593813818,-1253,,
712707854,8594065433,618776145,8594064170,-1263,,
712958203,8594315781,619026494,8594314529,-1252,,
713208427,8594566006,619276729,8594564754,-1252,,
713458902,8594816481,619527193,8594815218,-1263,,
713477181,8594834759,619545472,8594833496,-1263,8594833446,
713727760,8595085339,619796051,8595084062,-1277,,
713978023,8595335612,620046324,8595334324,-1288,,
714228402,8595585982,620296694,8595584682,-1300,,
714478773,8595836352,620547064,8595835040,-1312,,
714728984,8596086573,620797286,8596085261,-1312,,
714979292,8596336871,621047583,8596335570,-1301,,
715229880,8596587459,621298171,8596586158,-1301,,
715480264,8596837843,621548556,8596836531,-1312,,
715498453,8596856031,621566743,8596854719,-1312,8596854831,
715748596,8597106174,621816887,8597104890,-1284,,
715999019,8597356598,622067311,8597355354,-1244,,
716249587,8597607166,622317879,8597605939,-1227,,
716500227,8597857805,622568528,8597856617,-1188,,
716750576,8598108155,622818867,8598106957,-1198,,
717000930,8598358519,623069231,8598357321,-1198,,
717251508,8598609097,623319810,8598607899,-1198,,
717502270,8598859849,623570572,8598858661,-1188,,
717520329,8598877907,623588620,8598876709,-1198,8598876551,
717770875,8599128454,623839167,8599127216,-1238,,
718021065,8599378644,624089367,8599377378,-1266,,
718271580,8599629159,624339872,8599627843,-1316,,
718521780,8599879359,624590071,8599878004,-1355,,
718772603,8600130181,624840894,8600128836,-1345,,
719022754,8600380333,625091046,8600378979,-1354,,
719273076,8600630655,625341367,8600629310,-1345,,
719523443,8600881022,625591734,8600879677,-1345,,
719541359,8600898937,625609649,8600897582,-1355,8600897648,
719791554,8601149133,625859845,8601147794,-1339,,
720042147,8601399727,626110440,8601398406,-1321,,
720292631,8601650220,626360932,8601648916,-1304,,
720543444,8601901023,626611735,8601899745,-1278,,
720793839,8602151418,626862130,8602150141,-1277,,
721044030,8602401620,627112332,8602400333,-1287,,
721294655,8602652234,627362947,8602650948,-1286,,
721545037,8602902616,627613328,8602901328,-1288,,
721563051,8602920629,627631342,8602919342,-1287,8602919260,
721813340,8603170919,627881632,8603169611,-1308,,
722063533,8603421123,628131836,8603419795,-1328,,
722313720,8603671299,628382011,8603669951,-1348,,
722563892,8603921471,628632183,8603920103,-1368,,
722814316,8604171895,628882607,8604170537,-1358,,
723064710,8604422299,629133012,8604420931,-1368,,
723315103,8604672682,629383395,8604671314,-1368,,
723565577,8604923155,629633868,8604921787,-1368,,
723583581,8604941160,629651872,8604939791,-1369,8604939771,
723833870,8605191449,629902162,8605190076,-1373,,
724084700,8605442289,630153002,8605440911,-1378,,
724335077,8605692655,630403368,8605691284,-1371,,
724585703,8605943282,630653994,8605941905,-1377,,
724836239,8606193818,630904531,8606192441,-1377,,
725086439,8606444028,631154740,8606442641,-1387,,
725336715,8606694294,631405006,8606692907,-1387,,
725586922,8606944501,631655213,8606943113,-1388,,
725604915,8606962493,631673206,8606961106,-1387,8606961168,
725855669,8607213248,631923960,8607211886,-1362,,
726105795,8607463374,632174086,8607462018,-1356,,
726356410,8607713989,632424711,8607712659,-1330,,
726606866,8607964444,632675157,8607963120,-1324,,
726857241,8608214819,632925532,8608213495,-1324,,
727107403,8608464993,633175705,8608463669,-1324,,
727358019,8608715598,633426320,8608714284,-1314,,
727608357,8608965936,633676648,8608964621,-1315,,
727626378,8608983956,633694668,8608982632,-1324,8608982569,
727876850,8609234428,633945140,8609233088,-1340,,
728127381,8609484960,634195673,8609483606,-1354,,
728377556,8609735134,634445847,8609733764,-1370,,
728628042,8609985621,634696333,8609984236,-1385,,
728878240,8610235819,634946532,8610234434,-1385,,
729129241,8610486819,635197543,8610485445,-1374,,
729379682,8610737271,635447984,8610735886,-1385,,
729630259,8610987838,635698550,8610986453,-1385,,
729648283,8611005861,635716574,8611004476,-1385,8611004527,
729899054,8611256632,635967345,8611255259,-1373,,
730149214,8611506793,636217506,8611505434,-1359,,
730399914,8611757493,636468206,8611756148,-1345,,
730650061,8612007640,636718352,8612006307,-1333,,
730900196,8612257775,636968487,8612256442,-1333,,
731150411,8612507990,637218713,8612506668,-1322,,
731400677,8612758255,637468968,8612756933,-1322,,
731651189,8613008768,637719480,8613007445,-1323,,
731669236,8613026815,637737527,8613025482,-1333,8613025527,
731919813,8613277392,637988104,8613276070,-1322,,
732170107,8613527687,638238400,8613526377,-1310,,
732420701,8613778291,638489003,8613776992,-1299,,
732670829,8614028407,638739120,8614027121,-1286,,
732921341,8614278920,638989632,8614277633,-1287,,
733172141,8614529729,639240442,8614528443,-1286,,
733422238,8614779817,639490529,8614778530,-1287,,
733673016,8615030595,639741307,8615029308,-1287,,
733690977,8615048556,639759268,8615047269,-1287,8615047172,
733941642,8615299220,640009933,8615297909,-1311,,
734192170,8615549750,640260462,8615548415,-1335,,
734442636,8615800215,640510928,8615798856,-1359,,
734692883,8616050461,640761174,8616049079,-1382,,
734943244,8616300822,641011535,8616299440,-1382,,
735193562,8616551152,641261865,8616549770,-1382,,
735443906,8616801495,641512208,8616800113,-1382,,
735694272,8617051851,641762563,8617050469,-1382,,
735712175,8617069753,641780465,8617068371,-1382,8617068357,
735963066,8617320645,642031357,8617319260,-1385,,
736213639,8617571219,642281931,8617569831,-1388,,
736463983,8617821562,642532275,8617820171,-1391,,
736714754,8618072332,642783045,8618070938,-1394,,
736964947,8618322526,643033238,8618321131,-1395,,
737215904,8618573482,643284195,8618572088,-1394,,
737466014,8618823593,643534305,8618822198,-1395,,
737716894,8619074472,643785184,8619073078,-1394,,
737734927,8619092505,643803218,8619091111,-1394,8619091084,
737985215,8619342793,644053506,8619341392,-1401,,
738235302,8619592881,644303593,8619591483,-1398,,
738485998,8619843588,644554301,8619842174,-1414,,
738736140,8620093718,644804431,8620092308,-1410,,
738986849,8620344428,645055140,8620343007,-1421,,
739237002,8620594581,645305294,8620593162,-1419,,
739487203,8620844781,645555493,8620843361,-1420,,
739737559,8621095138,645805851,8621093718,-1420,,
739755619,8621113197,645823910,8621111777,-1420,8621111834,
740005761,8621363340,646074052,8621361933,-1407,,
740255868,8621613447,646324160,8621612055,-1392,,
740506128,8621863707,646574420,8621862330,-1377,,
740756861,8622114439,646825152,8622113087,-1352,,
741007350,8622364929,647075652,8622363577,-1352,,
741257901,8622615480,647326192,8622614118,-1362,,
741508133,8622865712,647576424,8622864349,-1363,,
741758618,8623116197,647826909,8623114835,-1362,,
741776677,8623134256,647844968,8623132893,-1363,8623132845,
742027116,8623384695,648095407,8623383322,-1373,,
742277600,8623635178,648345891,8623633793,-1385,,
742528433,8623886023,648596736,8623884626,-1397,,
742778832,8624136411,648847133,8624135012,-1399,,
743029044,8624386622,649097335,8624385213,-1409,,
743279659,8624637237,649347950,8624635828,-1409,,
743529905,8624887484,649598207,8624886085,-1399,,
743780394,8625137973,649848685,8625136563,-1410,,
743798525,8625156104,649866816,8625154694,-1410,8625154688,
744048934,8625406512,650117224,8625405101,-1411,,
744299518,8625657097,650367809,8625655684,-1413,,
744549635,8625907224,650617936,8625905811,-1413,,
744800043,8626157622,650868334,8626156208,-1414,,
745050640,8626408219,651118931,8626406804,-1415,,
745301132,8626658711,651369423,8626657308,-1403,,
745551758,8626909347,651620060,8626907933,-1414,,
745802318,8627159897,651870609,8627158483,-1414,,
745820554,8627178132,651888844,8627176717,-1415,8627176741,
746071019,8627428608,652139321,8627427200,-1408,,
746321736,8627679325,652390037,8627677923,-1402,,
746572116,8627929695,652640417,8627928310,-1385,,
746822231,8628179809,652890522,8628178431,-1378,,
747073049,8628430627,653141350,8628429248,-1379,,
747323238,8628680816,653391529,8628679427,-1389,,
747573441,8628931030,653641743,8628929641,-1389,,
747823754,8629181344,653892056,8629179955,-1389,,
747841866,8629199444,653910157,8629198055,-1389,8629198087,
748092421,8629449999,654160712,8629448629,-1370,,
748342900,8629700479,654411192,8629699108,-1371,,
748593592,8629951171,654661883,8629949808,-1363,,
748843890,8630201469,654912181,8630200113,-1356,,
749094063,8630451641,655162364,8630450296,-1345,,
749344545,8630702135,655412847,8630700780,-1355,,
749595276,8630952855,655663578,8630951510,-1345,,
749845474,8631203053,655913765,8631201698,-1355,,
749863614,8631221192,655931905,8631219837,-1355,8631219849,
750113725,8631471304,656182026,8631469962,-1342,,
750364200,8631721779,656432492,8631720441,-1338,,
750614811,8631972389,656683102,8631971054,-1335,,
750865548,8632223127,656933839,8632221794,-1333,,
751115806,8632473395,657184108,8632472054,-1341,,
751366041,8632723619,657434342,8632722288,-1331,,
751616159,8632973738,657684451,8632972396,-1342,,
751866575,8633224155,657934868,8633222813,-1342,,
751884682,8633242260,657952973,8633240918,-1342,8633240858,
752135231,8633492809,658203522,8633491461,-1348,,
752385559,8633743148,658453860,8633741776,-1372,,
752636043,8633993622,658704334,8633992235,-1387,,
752886203,8634243782,658954495,8634242381,-1401,,
753136761,8634494340,659205062,8634492949,-1391,,
753387146,8634744735,659455448,8634743334,-1401,,
753637294,8634994872,659705585,8634993471,-1401,,
753887821,8635245400,659956112,8635243998,-1402,,
753905709,8635263288,659974000,8635261886,-1402,8635261894,
754156343,8635513922,660224635,8635512522,-1400,,
754406591,8635764170,660474882,8635762783,-1387,,
754656747,8636014326,660725038,8636012931,-1395,,
754906925,8636264504,660975216,8636263122,-1382,,
755157263,8636514841,661225564,8636513459,-1382,,
755407758,8636765336,661476058,8636763954,-1382,,
755658098,8637015677,661726390,8637014285,-1392,,
755908286,8637265864,661976577,8637264483,-1381,,
755926382,8637283960,661994673,8637282568,-1392,8637282564,
756176878,8637534457,662245169,8637533075,-1382,,
756427288,8637784867,662495579,8637783473,-1394,,
756677668,8638035246,662745959,8638033853,-1393,,
756928130,8638285709,662996421,8638284315,-1394,,
757178694,8638536273,663246986,8638534879,-1394,,
757429091,8638786670,663497383,8638785276,-1394,,
757679325,8639036903,663747616,8639035509,-1394,,
757929693,8639287271,663997984,8639285877,-1394,,
757947743,8639305321,664016033,8639303926,-1395,8639303886,
758198083,8639555661,664266385,8639554269,-1392,,
758448736,8639806314,664517027,8639804901,-1413,,
758699173,8640056751,664767464,8640055328,-1423,,
758949832,8640307411,665018124,8640305978,-1433,,
759200590,8640558170,665268882,8640556737,-1433,,
759451320,8640808898,665519611,8640807465,-1433,,
759701678,8641059256,665769968,8641057823,-1433,,
759952300,8641309890,666020602,8641308457,-1433,,
759970463,8641328042,666038754,8641326608,-1434,8641326654,
760220913,8641578492,666289205,8641577080,-1412,,
760471112,8641828691,666539403,8641827280,-1411,,
760721430,8642079009,666789721,8642077610,-1399,,
760971624,8642329203,667039916,8642327817,-1386,,
761222326,8642579905,667290618,8642578520,-1385,,
761472444,8642830023,667540736,8642828647,-1376,,
761722996,8643080575,667791287,8643079188,-1387,,
761973311,8643330890,668041602,8643329504,-1386,,
761991427,8643349005,668059717,8643347619,-1386,8643347556,
762241579,8643599158,668309870,8643597757,-1401,,
762491997,8643849575,668560288,8643848170,-1405,,
762742221,8644099800,668810512,8644098368,-1432,,
762992428,8644350007,669060729,8644348570,-1437,,
763242964,8644600553,669311265,8644599106,-1447,,
763493976,8644851554,669562267,8644850107,-1447,,
763744128,8645101707,669812419,8645100260,-1447,,
763994328,8645351906,670062629,8645350470,-1436,,
764012672,8645370251,670080963,8645368804,-1447,8645368953,
764263143,8645620722,670331435,8645619312,-1410,,
764513692,8645871271,670581983,8645869909,-1362,,
764764226,8646121805,670832517,8646120471,-1334,,
765014753,8646372331,671083044,8646371045,-1286,,
765265000,8646622589,671333302,8646621293,-1296,,
765515533,8646873112,671583825,8646871816,-1296,,
765766432,8647124011,671834724,8647122715,-1296,,
766016983,8647374563,672085275,8647373266,-1297,,
766034976,8647392554,672103266,8647391257,-1297,8647391162,
766285553,8647643132,672353845,8647641812,-1320,,
766536459,8647894038,672604751,8647892695,-1343,,
766786955,8648144534,672855247,8648143167,-1367,,
767037193,8648394773,673105486,8648393383,-1390,,
767287470,8648645050,673355762,8648643659,-1391,,
767538188,8648895767,673606479,8648894377,-1390,,
767788514,8649146093,673856805,8649144702,-1391,,
768038701,8649396279,674106992,8649394889,-1390,,
768056852,8649414431,674125143,8649413040,-1391,8649413015,
768307439,8649665019,674375731,8649663622,-1397,,
768557843,8649915433,674626146,8649914031,-1402,,
768808041,8650165620,674876332,8650164211,-1409,,
769058286,8650415865,675126577,8650414451,-1414,,
769308912,8650666491,675377204,8650665077,-1414,,
769559223,8650916813,675627525,8650915399,-1414,,
769810188,8651167766,675878479,8651166352,-1414,,
770060306,8651417885,676128597,8651416470,-1415,,
770078510,8651436088,676146800,8651434673,-1415,8651434712,
770329096,8651686675,676397388,8651685272,-1403,,
770579471,8651937066,676647779,8651935672,-1394,,
770829751,8652187329,676898041,8652185945,-1384,,
771080022,8652437601,677148314,8652436227,-1374,,
771330125,8652687704,677398416,8652686330,-1374,,
771580786,8652938364,677649076,8652937000,-1364,,
771831345,8653188924,677899636,8653187549,-1375,,
772081496,8653439075,678149787,8653437701,-1374,,
772099637,8653457215,678167928,8653455841,-1374,8653455799,
772350070,8653707649,678418361,8653706263,-1386,,
772600525,8653958104,678668817,8653956709,-1395,,
772851140,8654208719,678919431,8654207314,-1405,,
773101478,8654459056,679169769,8654457641,-1415,,
773351947,8654709526,679420238,8654708110,-1416,,
773602059,8654959638,679670351,8654958223,-1415,,
773852656,8655210234,679920947,8655208819,-1415,,
774103090,8655460669,680171381,8655459254,-1415,,
774121190,8655478768,680189481,8655477353,-1415,8655477312,
774371427,8655729016,680439729,8655727591,-1425,,
774621822,8655979401,680690123,8655977976,-1425,,
774872586,8656230165,680940877,8656228720,-1445,,
775122794,8656480373,681191085,8656478919,-1454,,
775373459,8656731038,681441751,8656729585,-1453,,
775623909,8656981488,681692201,8656980044,-1444,,
775874122,8657231701,681942414,8657230247,-1454,,
776124285,8657481863,682192576,8657480409,-1454,,
776142366,8657499945,682210657,8657498490,-1455,8657498521,
776392842,8657750421,682461134,8657748974,-1447,,
776643117,8658000695,682711408,8657999256,-1439,,
776893343,8658250921,682961634,8658249491,-1430,,
777143921,8658501499,683212212,8658500077,-1422,,
777394368,8658751948,683462660,8658750526,-1422,,
777644764,8659002343,683713055,8659000921,-1422,,
777895178,8659252756,683963468,8659251334,-1422,,
778145310,8659502889,684213601,8659501466,-1423,,
778163552,8659521131,684231843,8659519709,-1422,8659519692,
778413929,8659771509,684482221,8659770083,-1426,,
778664067,8660021645,684732358,8660020215,-1430,,
778914269,8660271847,684982560,8660270413,-1434,,
779165042,8660522621,685233334,8660521184,-1437,,
779415512,8660773092,685483804,8660771655,-1437,,
779665817,8661023396,685734108,8661021958,-1438,,
779916164,8661273743,685984455,8661272306,-1437,,
780166773,8661524351,686235063,8661522914,-1437,,
780184804,8661542382,686253094,8661540945,-1437,8661540900,
780435151,8661792730,686503443,8661791282,-1448,,
780685536,8662043115,686753827,8662041657,-1458,,
780935711,8662293290,687004002,8662291830,-1460,,
781186548,8662544127,687254839,8662542647,-1480,,
781436759,8662794338,687505051,8662792858,-1480,,
781687259,8663044837,687755550,8663043357,-1480,,
781937602,8663295181,688005893,8663293701,-1480,,
782188060,8663545639,688256351,8663544159,-1480,,
782206182,8663563760,688274472,8663562280,-1480,8663562265,
782456694,8663814273,688524985,8663812790,-1483,,
782707038,8664064617,688775329,8664063131,-1486,,
782957671,8664315250,689025962,8664313761,-1489,,
783207807,8664565385,689276098,8664563892,-1493,,
783458683,8664816273,689526985,8664814780,-1493,,
783708958,8665066546,689777258,8665065053,-1493,,
783959067,8665316646,690027359,8665315153,-1493,,
784209357,8665566936,690277649,8665565444,-1492,,
784227495,8665585074,690295786,8665583580,-1494,8665583592,
784478109,8665835688,690546401,8665834208,-1480,,
784728437,8666086016,690796729,8666084529,-1487,,
784978831,8666336410,691047122,8666334927,-1483,,
785229153,8666586731,691297444,8666585251,-1480,,
785479247,8666836826,691547539,8666835346,-1480,,
785729606,8667087184,691797897,8667085704,-1480,,
785980199,8667337778,692048490,8667336298,-1480,,
786230693,8667588272,692298985,8667586792,-1480,,
786248960,8667606538,692317251,8667605058,-1480,8667605063,
786499400,8667856989,692567702,8667855511,-1478,,
786749938,8668107517,692818229,8668106041,-1476,,
787000041,8668357619,693068332,8668356144,-1475,,
787250357,8668607935,693318648,8668606472,-1463,,
787500703,8668858283,693568995,8668856809,-1474,,
787751536,8669109115,693819837,8669107652,-1463,,
788001726,8669359305,694070017,8669357831,-1474,,
788251861,8669609440,694320153,8669607968,-1472,,
788269931,8669627509,694338222,8669626036,-1473,8669625990,
788520189,8669877779,694588491,8669876293,-1486,,
788770883,8670128462,694839184,8670126976,-1486,,
789021204,8670378783,695089495,8670377276,-1507,,
789271360,8670628939,695339651,8670627420,-1519,,
789521781,8670879360,695590082,8670877852,-1508,,
789771980,8671129559,695840272,8671128041,-1518,,
790022388,8671379966,696090679,8671378448,-1518,,
790272740,8671630319,696341032,8671628801,-1518,,
790290818,8671648396,696359109,8671646878,-1518,8671646899,
790541202,8671898781,696609504,8671897278,-1503,,
790791632,8672149221,696859933,8672147714,-1507,,
791041838,8672399416,697110128,8672397915,-1501,,
791292296,8672649876,697360589,8672648380,-1496,,
791542880,8672900468,697611181,8672898972,-1496,,
791793611,8673151191,697861913,8673149705,-1486,,
792043771,8673401350,698112062,8673399854,-1496,,
792294284,8673651862,698362575,8673650366,-1496,,
792312394,8673669972,698380684,8673668476,-1496,8673668517,
792563011,8673920590,698631312,8673919115,-1475,,
792813196,8674170775,698881487,8674169301,-1474,,
793063924,8674421503,699132215,8674420039,-1464,,
793314592,8674672171,699382884,8674670719,-1452,,
793565389,8674922967,699633680,8674921515,-1452,,
793815513,8675173102,699883814,8675171649,-1453,,
794066354,8675423932,700134644,8675422479,-1453,,
794316539,8675674127,700384839,8675672674,-1453,,
794334526,8675692105,700402817,8675690651,-1454,8675690618,
794584660,8675942238,700652951,8675940776,-1462,,
794835194,8676192773,700903485,8676191302,-1471,,
795085359,8676442938,701153650,8676441459,-1479,,
795335932,8676693510,701404234,8676692036,-1474,,
795586137,8676943716,701654429,8676942231,-1485,,
795837175,8677194753,701905466,8677193268,-1485,,
796087365,8677444953,702155666,8677443468,-1485,,
796338178,8677695757,702406469,8677694272,-1485,,
796356294,8677713873,702424585,8677712387,-1486,8677712367,
796606502,8677964081,702674804,8677962602,-1479,,
796856714,8678214292,702925005,8678212797,-1495,,
797106882,8678464461,703175174,8678462962,-1499,,
797357223,8678714801,703425514,8678713297,-1504,,
797607690,8678965268,703675981,8678963774,-1494,,
797857861,8679215440,703926152,8679213935,-1505,,
798107963,8679465542,704176254,8679464037,-1505,,
798358480,8679716058,704426771,8679714554,-1504,,
798376596,8679734174,704444887,8679732670,-1504,8679732742,
798627229,8679984807,704695520,8679983331,-1476,,
798877386,8680234965,704945677,8680233497,-1468,,
799128005,8680485584,705196297,8680484136,-1448,,
799379049,8680736628,705447340,8680735207,-1421,,
799629559,8680987138,705697850,8680985708,-1430,,
799880152,8681237731,705948443,8681236300,-1431,,
800130761,8681488339,706199052,8681486909,-1430,,
800381111,8681738689,706449402,8681737259,-1430,,
800399155,8681756734,706467446,8681755303,-1431,8681755257,
800649783,8682007362,706718074,8682005930,-1432,,
800899979,8682257558,706968270,8682256104,-1454,,
801150325,8682507903,707218616,8682506450,-1453,,
801400811,8682758390,707469103,8682756915,-1475,,
801651286,8683008864,707719577,8683007389,-1475,,
801901475,8683259054,707969767,8683257590,-1464,,
802151864,8683509443,708220155,8683507978,-1465,,
802402049,8683759628,708470341,8683758153,-1475,,
802420127,8683777705,708488417,8683776230,-1475,8683776128,
802670602,8684028181,708738893,8684026680,-1501,,
802921039,8684278618,708989330,8684277091,-1527,,
803171641,8684529220,709239932,8684527669,-1551,,
803421764,8684779343,709490055,8684777767,-1576,,
803671981,8685029559,709740272,8685027994,-1565,,
803922107,8685279685,709990398,8685278121,-1564,,
804172315,8685529894,710240607,8685528330,-1564,,
804422422,8685780011,710490724,8685778436,-1575,,
804440481,8685798059,710508771,8685796484,-1575,8685796531,
804690756,8686048335,710759048,8686046772,-1563,,
804940872,8686298451,711009174,8686296911,-1540,,
805191133,8686548711,711259424,8686547173,-1538,,
805441462,8686799041,711509753,8686797515,-1526,,
805691692,8687049281,711759994,8687047755,-1526,,
805942019,8687299598,712010310,8687298071,-1527,,
806192436,8687550016,712260728,8687548490,-1526,,
806443163,8687800742,712511455,8687799216,-1526,,
806461314,8687818892,712529605,8687817366,-1526,8687817400,
806711609,8688069188,712779900,8688067670,-1518,,
806962452,8688320031,713030743,8688318521,-1510,,
807212693,8688570271,713280984,8688568771,-1500,,
807462925,8688820505,713531218,8688819014,-1491,,
807713201,8689070780,713781502,8689069299,-1481,,
807963567,8689321146,714031858,8689319654,-1492,,
808213884,8689571463,714282175,8689569971,-1492,,
808464587,8689822166,714532888,8689820684,-1482,,
808482821,8689840400,714551112,8689838909,-1491,8689838879,
808732929,8690090508,714801220,8690089009,-1499,,
808983790,8690341369,715052081,8690339863,-1506,,
809234474,8690592053,715302766,8690590541,-1512,,
809484628,8690842206,715552919,8690840687,-1519,,
809734816,8691092395,715803107,8691090876,-1519,,
809985149,8691342727,716053440,8691341208,-1519,,
810235501,8691593080,716303803,8691591572,-1508,,
810485698,8691843276,716553989,8691841757,-1519,,
810503795,8691861373,716572085,8691859854,-1519,8691859736,
810754424,8692112003,716822715,8692110454,-1549,,
811004954,8692362532,717073245,8692360955,-1577,,
811255868,8692613448,717324160,8692611841,-1607,,
811506150,8692863739,717574451,8692862104,-1635,,
811756438,8693114016,717824739,8693112392,-1624,,
812006577,8693364155,718074868,8693362520,-1635,,
812256949,8693614528,718325240,8693612892,-1636,,
812507423,8693865001,718575714,8693863366,-1635,,
812525617,8693883195,718593907,8693881560,-1635,8693881606,
812776215,8694133793,718844505,8694132170,-1623,,
813026428,8694384007,719094719,8694382395,-1612,,
813276524,8694634103,719344816,8694632504,-1599,,
813527053,8694884631,719595344,8694883044,-1587,,
813777616,8695135195,719845907,8695133607,-1588,,
814027814,8695385393,720096105,8695383806,-1587,,
814278169,8695635748,720346460,8695634161,-1587,,
814528379,8695885958,720596670,8695884370,-1588,,
814546502,8695904081,720614793,8695902494,-1587,8695902493,
814796766,8696154345,720865058,8696152758,-1587,,
815047684,8696405263,721115975,8696403675,-1588,,
815298078,8696655658,721366370,8696654071,-1587,,
815548403,8696905981,721616694,8696904395,-1586,,
815798611,8697156189,721866901,8697154614,-1575,,
816049381,8697406960,722117672,8697405384,-1576,,
816300036,8697657615,722368327,8697656028,-1587,,
816550218,8697907797,722618509,8697906210,-1587,,
816568302,8697925880,722636592,8697924294,-1586,8697924339,
816818622,8698176201,722886913,8698174627,-1574,,
817069188,8698426767,723137479,8698425203,-1564,,
817319677,8698677256,723387968,8698675705,-1551,,
817570587,8698928167,723638880,8698926628,-1539,,
817821164,8699178753,723889465,8699177214,-1539,,
818071585,8699429163,724139876,8699427624,-1539,,
818321759,8699679337,724390050,8699677798,-1539,,
818572590,8699930169,724640881,8699928630,-1539,,
818590763,8699948341,724659053,8699946802,-1539,8699946715,
818841272,8700198851,724909563,8700197290,-1561,,
819091782,8700449361,725160073,8700447777,-1584,,
819342204,8700699783,725410495,8700698178,-1605,,
819592330,8700949909,725660622,8700948294,-1615,,
819843003,8701200582,725911294,8701198967,-1615,,
820093133,8701450711,726161423,8701449086,-1625,,
820343342,8701700931,726411644,8701699306,-1625,,
820593466,8701951045,726661767,8701949430,-1615,,
820611689,8701969267,726679980,8701967642,-1625,8701967713,
820862306,8702219885,726930597,8702218277,-1608,,
821112623,8702470201,727180914,8702468611,-1590,,
821363184,8702720763,727431475,8702719191,-1572,,
821613746,8702971324,727682037,8702969771,-1553,,
821864095,8703221673,727932386,8703220131,-1542,,
822114841,8703472420,728183132,8703470866,-1554,,
822365027,8703722606,728433318,8703721053,-1553,,
822615241,8703972820,728683533,8703971268,-1552,,
822633535,8703991113,728701826,8703989560,-1553,8703989674,
822884040,8704241629,728952342,8704240104,-1525,,
823134138,8704491717,729202430,8704490221,-1496,,
823384300,8704741879,729452591,8704740412,-1467,,
823634623,8704992202,729702914,8704990764,-1438,,
823884816,8705242405,729953117,8705240967,-1438,,
824135342,8705492921,730203633,8705491483,-1438,,
824385691,8705743279,730453992,8705741841,-1438,,
824636121,8705993700,730704412,8705992262,-1438,,
824654183,8706011762,730722474,8706010323,-1439,8706010170,
824904373,8706261952,730972674,8706260486,-1466,,
825154589,8706512168,731222880,8706510654,-1514,,
825404925,8706762504,731473216,8706760952,-1552,,
825655572,8707013151,731723863,8707011560,-1591,,
825906183,8707263761,731974474,8707262171,-1590,,
826156702,8707514281,732224993,8707512690,-1591,,
826407057,8707764635,732475347,8707763045,-1590,,
826657446,8708015024,732725737,8708013434,-1590,,
826675528,8708033106,732743818,8708031516,-1590,8708031500,
826925891,8708283469,732994182,8708281875,-1594,,
827176274,8708533852,733244565,8708532255,-1597,,
827426702,8708784281,733494994,8708782680,-1601,,
827677263,8709034842,733745554,8709033238,-1604,,
827927898,8709285477,733996189,8709283873,-1604,,
828178282,8709535860,734246573,8709534256,-1604,,
828428511,8709786090,734496802,8709784486,-1604,,
828678737,8710036315,734747028,8710034711,-1604,,
828696879,8710054458,734765170,8710052853,-1605,8710052884,
828947258,8710304837,735015550,8710303241,-1596,,
829197633,8710555211,735265923,8710553623,-1588,,
829448196,8710805774,735516487,8710804194,-1580,,
829698460,8711056038,735766751,8711054466,-1572,,
829948727,8711306306,736017018,8711304734,-1572,,
830198901,8711556480,736267192,8711554907,-1573,,
830449405,8711806983,736517696,8711805411,-1572,,
830699880,8712057458,736768171,8712055886,-1572,,
830718067,8712075645,736786358,8712074073,-1572,8712074020,
830968493,8712326082,737036794,8712324497,-1585,,
831218631,8712576210,737286923,8712574612,-1598,,
831469072,8712826651,737537363,8712825041,-1610,,
831719620,8713077199,737787911,8713075575,-1624,,
831969801,8713327380,738038092,8713325757,-1623,,
832220312,8713577891,738288603,8713576267,-1624,,
832470870,8713828449,738539162,8713826826,-1623,,
832721047,8714078626,738789338,8714077003,-1623,,
832739170,8714096749,738807461,8714095125,-1624,8714095147,
832989314,8714346893,739057616,8714345285,-1608,,
833239852,8714597431,739308144,8714595819,-1612,,
833490197,8714847775,739558488,8714846169,-1606,,
833740301,8715097880,739808592,8715096280,-1600,,
833991069,8715348658,740059371,8715347058,-1600,,
834241522,8715599100,740309813,8715597500,-1600,,
834492054,8715849633,740560346,8715848033,-1600,,
834742561,8716100139,740810852,8716098539,-1600,,
834760606,8716118184,740828896,8716116584,-1600,8716116607,
835011032,8716368611,741079324,8716367017,-1594,,
835261394,8716618973,741329686,8716617386,-1587,,
835511932,8716869510,741580233,8716867939,-1571,,
835762803,8717120382,741831104,8717118817,-1565,,
836013134,8717370713,742081435,8717369147,-1566,,
836263780,8717621359,742332071,8717619783,-1576,,
836514123,8717871701,742582413,8717870126,-1575,,
836764438,8718122017,742832729,8718120451,-1566,,
836782590,8718140168,742850881,8718138593,-1575,8718138525,
837032779,8718390357,743101070,8718388764,-1593,,
837283245,8718640824,743351536,8718639215,-1609,,
837534052,8718891630,743602343,8718890014,-1616,,
837784171,8719141760,743852472,8719140117,-1643,,
838034857,8719392435,744103148,8719390793,-1642,,
838285639,8719643219,744353931,8719641577,-1642,,
838536413,8719893991,744604704,8719892349,-1642,,
838786840,8720144419,744855142,8720142787,-1632,,
838804860,8720162438,744873150,8720160796,-1642,8720160763,
839055469,8720413048,745123760,8720411397,-1651,,
839305693,8720663272,745373984,8720661614,-1658,,
839555809,8720913388,745624100,8720911723,-1665,,
839806044,8721163622,745874334,8721161959,-1663,,
840056629,8721414208,746124921,8721412535,-1673,,
840307049,8721664628,746375341,8721662955,-1673,,
840557216,8721914794,746625507,8721913121,-1673,,
840807940,8722165519,746876242,8722163857,-1662,,
840826011,8722183589,746894301,8722181916,-1673,8722181896,
841076906,8722434485,747145197,8722432806,-1679,,
841327481,8722685059,747395772,8722683376,-1683,,
841578196,8722935775,747646487,8722934087,-1688,,
841828720,8723186299,747897011,8723184606,-1693,,
842079356,8723436934,748147646,8723435242,-1692,,
842329697,8723687277,748397989,8723685585,-1692,,
842580190,8723937768,748648481,8723936076,-1692,,
842830345,8724187934,748898646,8724186242,-1692,,
842848389,8724205968,748916680,8724204275,-1693,8724204307,
843098644,8724456223,749166935,8724454539,-1684,,
843349002,8724706581,749417294,8724704905,-1676,,
843599120,8724956698,749667420,8724955041,-1657,,
843850039,8725207618,749918330,8725205959,-1659,,
844100159,8725457738,750168450,8725456078,-1660,,
844350546,8725708126,750418838,8725706467,-1659,,
844600716,8725958294,750669007,8725956635,-1659,,
844851448,8726209037,750919750,8726207378,-1659,,
844869536,8726227114,750937826,8726225455,-1659,8726225432,
845119727,8726477306,751188018,8726475641,-1665,,
845369845,8726727424,751438137,8726725755,-1669,,
845620341,8726977929,751688642,8726976255,-1674,,
845870474,8727228063,751938776,8727226384,-1679,,
846121067,8727478645,752189357,8727476965,-1680,,
846371292,8727728871,752439583,8727727191,-1680,,
846621531,8727979110,752689822,8727977430,-1680,,
846871812,8728229400,752940113,8728227721,-1679,,
846889844,8728247422,752958135,8728245742,-1680,8728245812,
847140149,8728497727,753208440,8728496064,-1663,,
847390489,8728748068,753458780,8728746432,-1636,,
847640674,8728998253,753708965,8728996625,-1628,,
847890823,8729248401,753959124,8729246803,-1598,,
848141138,8729498716,754209429,8729497107,-1609,,
848391413,8729748991,754459704,8729747382,-1609,,
848641676,8729999255,754709967,8729997645,-1610,,
848891951,8730249530,754960253,8730247931,-1599,,
848909908,8730267486,754978199,8730265877,-1609,8730265832,
849160483,8730518061,755228774,8730516441,-1620,,
849410788,8730768367,755479079,8730766736,-1631,,
849661330,8731018909,755729622,8731017268,-1641,,
849911857,8731269436,755980149,8731267785,-1651,,
850162565,8731520144,756230856,8731518492,-1652,,
850413142,8731770720,756481433,8731769068,-1652,,
850663726,8732021304,756732017,8732019652,-1652,,
850914490,8732272068,756982781,8732270417,-1651,,
850932534,8732290112,757000824,8732288459,-1653,8732288446,
851182653,8732540242,757250955,8732538587,-1655,,
851433356,8732790936,757501648,8732789278,-1658,,
851683840,8733041420,757752132,8733039758,-1662,,
851934080,8733291660,758002372,8733289996,-1664,,
852184347,8733541925,758252638,8733540261,-1664,,
852434867,8733792446,758503158,8733790782,-1664,,
852685198,8734042776,758753489,8734041112,-1664,,
852935434,8734293013,759003726,8734291349,-1664,,
852953506,8734311084,759021797,8734309420,-1664,8734309420,
853203677,8734561255,759271968,8734559591,-1664,,
853453941,8734811520,759522233,8734809866,-1654,,
853704760,8735062339,759773061,8735060686,-1653,,
853955312,8735312901,760023614,8735311238,-1663,,
854205679,8735563257,760273970,8735561594,-1663,,
854455993,8735813572,760524284,8735811908,-1664,,
854706371,8736063950,760774662,8736062297,-1653,,
854956863,8736314453,761025166,8736312790,-1663,,
854975346,8736332924,761043637,8736331261,-1663,8736331134,
855225878,8736583456,761294169,8736581760,-1696,,
855476641,8736834220,761544932,8736832492,-1728,,
855726772,8737084361,761795074,8737082603,-1758,,
855977304,8737334883,762045595,8737333104,-1779,,
856227439,8737585018,762295730,8737583228,-1790,,
856477644,8737835222,762545935,8737833433,-1789,,
856728045,8738085623,762796336,8738083844,-1779,,
856978216,8738335795,763046508,8738334006,-1789,,
856996290,8738353868,763064580,8738352079,-1789,8738352164,
857246596,8738604174,763314887,8738602406,-1768,,
857497406,8738854984,763565697,8738853249,-1735,,
857747620,8739105198,763815921,8739103484,-1714,,
857997892,8739355481,764066194,8739353779,-1702,,
858248515,8739606093,764316806,8739604391,-1702,,
858498942,8739856520,764567244,8739854829,-1691,,
858749528,8740107107,764817819,8740105405,-1702,,
858999817,8740357406,765068118,8740355704,-1702,,
859018062,8740375640,765086352,8740373938,-1702,8740373987,
859268273,8740625852,765336564,8740624162,-1690,,
859518725,8740876304,765587016,8740874628,-1676,,
859768879,8741126457,765837169,8741124794,-1663,,
860019096,8741376685,766087398,8741375034,-1651,,
860269232,8741626812,766337524,8741625161,-1651,,
860519873,8741877452,766588164,8741875801,-1651,,
860770385,8742127964,766838676,8742126313,-1651,,
861021251,8742378840,767089552,8742377189,-1651,,
861039308,8742396886,767107599,8742395235,-1651,8742395238,
861289562,8742647140,767357853,8742645489,-1651,,
861540149,8742897727,767608440,8742896077,-1650,,
861790552,8743148131,767858843,8743146482,-1649,,
862041270,8743398860,768109572,8743397213,-1647,,
862291690,8743649269,768359982,8743647622,-1647,,
862542257,8743899835,768610548,8743898188,-1647,,
862792487,8744150066,768860779,8744148419,-1647,,
863043264,8744400843,769111555,8744399205,-1638,,
863061387,8744418965,769129677,8744417318,-1647,8744417248,
863311715,8744669293,769380006,8744667628,-1665,,
863562054,8744919632,769630345,8744917950,-1682,,
863812463,8745170042,769880755,8745168343,-1699,,
864062691,8745420270,770130982,8745418564,-1706,,
864312878,8745670457,770381169,8745668741,-1716,,
864563402,8745920981,770631694,8745919265,-1716,,
864813992,8746171570,770882283,8746169854,-1716,,
865064546,8746422125,771132847,8746420419,-1706,,
865082700,8746440278,771150990,8746438561,-1717,8746438573,
865333157,8746690736,771401448,8746689023,-1713,,
865583757,8746941336,771652048,8746939625,-1711,,
865834170,8747191749,771902462,8747190043,-1706,,
866084331,8747441910,772152622,8747440206,-1704,,
866335000,8747692588,772403301,8747690885,-1703,,
866585148,8747942727,772653439,8747941023,-1704,,
866835458,8748193037,772903749,8748191334,-1703,,
867085658,8748443237,773153950,8748441534,-1703,,
867103756,8748461335,773172047,8748459631,-1704,8748459606,
867354542,8748712122,773422834,8748710412,-1710,,
867604991,8748962570,773673292,8748960865,-1705,,
867855185,8749212764,773923476,8749211042,-1722,,
868105390,8749462979,774173692,8749461252,-1727,,
868355709,8749713287,774424000,8749711560,-1727,,
868606750,8749964329,774675041,8749962602,-1727,,
868856853,8750214432,774925144,8750212705,-1727,,
869107542,8750465131,775175843,8750463404,-1727,,
869125700,8750483279,775193991,8750481552,-1727,8750481596,
869376049,8750733628,775444340,8750731921,-1707,,
869626171,8750983749,775694461,8750982045,-1704,,
869876628,8751234207,775944919,8751232514,-1693,,
870126793,8751484373,776195085,8751482692,-1681,,
870377184,8751734762,776445475,8751733081,-1681,,
870627357,8751984935,776695648,8751983254,-1681,,
870877713,8752235291,776946004,8752233610,-1681,,
871128099,8752485688,777196400,8752484007,-1681,,
871146341,8752503919,777214631,8752502238,-1681,8752502274,
871396909,8752754488,777465200,8752752816,-1672,,
871647799,8753005378,777716091,8753003715,-1663,,
871897930,8753255509,777966222,8753253856,-1653,,
872148398,8753505977,778216690,8753504333,-1644,,
872398959,8753756537,778467249,8753754893,-1644,,
872649109,8754006688,778717400,8754005044,-1644,,
872899362,8754256942,778967654,8754255298,-1644,,
873149524,8754507113,779217825,8754505468,-1645,,
873167644,8754525222,779235934,8754523578,-1644,8754523562,
873418237,8754775816,779486529,8754774168,-1648,,
873668582,8755026161,779736873,8755024509,-1652,,
873919077,8755276656,779987369,8755275001,-1655,,
874169563,8755527152,780237865,8755525494,-1658,,
874419692,8755777270,780487983,8755775612,-1658,,
874670214,8756027793,780738505,8756026135,-1658,,
874920524,8756278103,780988815,8756276445,-1658,,
875171491,8756529070,781239782,8756527411,-1659,,
875189516,8756547094,781257806,8756545436,-1658,8756545412,
875439791,8756797369,781508082,8756795706,-1663,,
875690143,8757047721,781758434,8757046052,-1669,,
875940266,8757297845,782008557,8757296170,-1675,,
876190633,8757548213,782258925,8757546533,-1680,,
876441050,8757798629,782509341,8757796948,-1681,,
876691175,8758048754,782759467,8758047074,-1680,,
876941506,8758299084,783009796,8758297404,-1680,,
877191651,8758549239,783259952,8758547559,-1680,,
877209769,8758567347,783278060,8758565667,-1680,8758565557,
877460199,8758817778,783528490,8758816070,-1708,,
877711009,8759068587,783779300,8759066852,-1735,,
877961152,8759318731,784029443,8759316968,-1763,,
878212146,8759569725,784280437,8759567936,-1789,,
878462463,8759820042,784530754,8759818253,-1789,,
878713031,8760070609,784781322,8760068820,-1789,,
878963596,8760321174,785031887,8760319385,-1789,,
879214300,8760571878,785282591,8760570089,-1789,,
879232273,8760589851,785300563,8760588062,-1789,8760588098,
879482799,8760840378,785551090,8760838599,-1779,,
879733167,8761090745,785801458,8761088975,-1770,,
879983556,8761341135,786051847,8761339374,-1761,,
880234187,8761591765,786302478,8761590014,-1751,,
880484689,8761842268,786552980,8761840517,-1751,,
880735211,8762092790,786803502,8762091039,-1751,,
880985809,8762343388,787054101,8762341637,-1751,,
881236418,8762593996,787304709,8762592245,-1751,,
881254558,8762612136,787322848,8762610385,-1751,8762610405,
881504978,8762862557,787573269,8762860812,-1745,,
881755106,8763112685,787823397,8763110944,-1741,,
882005359,8763362938,788073650,8763361203,-1735,,
882255755,8763613333,788324046,8763611604,-1729,,
882505912,8763863490,788574213,8763861771,-1719,,
882756272,8764113851,788824563,8764112121,-1730,,
883006835,8764364414,789075126,8764362684,-1730,,
883257231,8764614810,789325523,8764613081,-1729,,
883275394,8764632973,789343685,8764631243,-1730,8764631158,
883526138,8764883717,789594429,8764881966,-1751,,
883776581,8765134160,789844872,8765132389,-1771,,
884027232,8765384812,790095524,8765383020,-1792,,
884277379,8765634958,790345670,8765633145,-1813,,
884528013,8765885593,790596305,8765883779,-1814,,
884778619,8766136198,790846911,8766134385,-1813,,
885029255,8766386835,791097547,8766385022,-1813,,
885279868,8766637447,791348160,8766635634,-1813,,
885311725,8766669304,791380016,8766667490,-1814,8766660617,
885562179,8766919759,791630471,8766916224,-3535,,
885812745,8767170325,791881037,8767165068,-5257,,
886063395,8767420974,792131687,8767413995,-6979,,
886313917,8767671496,792382208,8767662811,-8685,,
886564137,8767921716,792632429,8767913031,-8685,,
886814340,8768171919,792882631,8768163244,-8675,,
887064769,8768422348,793133060,8768413663,-8685,,
887315137,8768672716,793383429,8768664031,-8685,,
887333287,8768690866,793401578,8768682180,-8686,8768689093,
887583539,8768941118,793651831,8768934162,-6956,,
887834196,8769191775,793902487,8769186552,-5223,,
888084579,8769442158,794152880,8769438677,-3481,,
888334801,8769692380,794403092,8769690608,-1772,,
888585012,8769942591,794653303,8769940819,-1772,,
888835498,8770193076,794903789,8770191305,-1771,,
889085647,8770443236,795153949,8770441465,-1771,,
889336276,8770693854,795404567,8770692083,-1771,,
889354315,8770711894,795422606,8770710122,-1772,8770710168,
889604797,8770962376,795673088,8770960615,-1761,,
889855240,8771212818,795923531,8771211070,-1748,,
890105547,8771463126,796173838,8771461390,-1736,,
890356015,8771713595,796424308,8771711871,-1724,,
890606492,8771964071,796674784,8771962347,-1724,,
890856800,8772214389,796925101,8772212664,-1725,,
891107309,8772464897,797175610,8772463174,-1723,,
891357470,8772715048,797425761,8772713324,-1724,,
891375502,8772733080,797443793,8772731356,-1724,8772731298,
891625929,8772983508,797694220,8772981769,-1739,,
891876110,8773233688,797944401,8773231936,-1752,,
892126324,8773483912,798194625,8773482146,-1766,,
892376587,8773734166,798444879,8773732386,-1780,,
892626966,8773984545,798695257,8773982765,-1780,,
892877152,8774234731,798945443,8774232951,-1780,,
893127271,8774484850,799195563,8774483070,-1780,,
893377730,8774735308,799446021,8774733528,-1780,,
893395749,8774753327,799464040,8774751547,-1780,8774751577,
893646044,8775003623,799714335,8775001850,-1773,,
893896171,8775253749,799964462,8775251984,-1765,,
894146338,8775503917,800214639,8775502170,-1747,,
894396531,8775754111,800464823,8775752362,-1749,,
894646783,8776004362,800715075,8776002613,-1749,,
894897726,8776255305,800966018,8776253556,-1749,,
895147925,8776505505,801216217,8776503756,-1749,,
895398228,8776755806,801466519,8776754057,-1749,,
895416192,8776773770,801484483,8776772021,-1749,8776772056,
895666677,8777024255,801734968,8777022525,-1730,,
895916967,8777274545,801985258,8777272814,-1731,,
896167390,8777524969,802235681,8777523248,-1721,,
896418044,8777775623,802486345,8777773921,-1702,,
896668174,8778025752,802736465,8778024040,-1712,,
896918758,8778276336,802987049,8778274624,-1712,,
897169347,8778526926,803237639,8778525214,-1712,,
897419461,8778777040,803487752,8778775327,-1713,,
897437558,8778795136,803505849,8778793424,-1712,8778793375,
897688169,8779045748,803756460,8779044023,-1725,,
897938328,8779295907,804006619,8779294172,-1735,,
898188639,8779546218,804256931,8779544471,-1747,,
898439131,8779796710,804507423,8779794961,-1749,,
898689630,8780047209,804757921,8780045449,-1760,,
898940242,8780297821,805008533,8780296072,-1749,,
899190807,8780548386,805259099,8780546627,-1759,,
899441413,8780798992,805509704,8780797233,-1759,,
899459460,8780817038,805527750,8780815278,-1760,8780815219,
899709926,8781067504,805778217,8781065731,-1773,,
899960265,8781317843,806028556,8781316055,-1788,,
900210599,8781568179,806278891,8781566376,-1803,,
900461221,8781818801,806529513,8781816984,-1817,,
900712161,8782069740,806780453,8782067924,-1816,,
900962292,8782319871,807030583,8782318054,-1817,,
901212696,8782570275,807280988,8782568458,-1817,,
901463329,8782820909,807531621,8782819092,-1817,,
901481493,8782839071,807549783,8782837253,-1818,8782837272,
901732193,8783089772,807800484,8783087959,-1813,,
901982993,8783340572,808051284,8783338765,-1807,,
902233199,8783590778,808301490,8783588976,-1802,,
902483317,8783840896,808551609,8783839099,-1797,,
902733512,8784091091,808801803,8784089294,-1797,,
902983956,8784341535,809052247,8784339737,-1798,,
903234145,8784591724,809302437,8784589927,-1797,,
903484338,8784841917,809552629,8784840130,-1787,,
903502456,8784860034,809570746,8784858236,-1798,8784858228,
903752683,8785110261,809820973,8785108462,-1799,,
904003329,8785360908,810071621,8785359107,-1801,,
904253694,8785611273,810321986,8785609472,-1801,,
904504210,8785861789,810572501,8785859985,-1804,,
904755180,8786112759,810823471,8786110954,-1805,,
905005674,8786363253,811073965,8786361460,-1793,,
905256167,8786613746,811324458,8786611942,-1804,,
905506621,8786864200,811574912,8786862396,-1804,,
905524800,8786882378,811593090,8786880574,-1804,8786880591,
905775063,8787132641,811843354,8787130842,-1799,,
906025176,8787382755,812093467,8787380960,-1795,,
906275347,8787632935,812343648,8787631146,-1789,,
906525467,8787883046,812593759,8787881261,-1785,,
906776049,8788133628,812844340,8788131842,-1786,,
907026236,8788383815,813094528,8788382030,-1785,,
907276864,8788634453,813345166,8788632668,-1785,,
907527370,8788884948,813595661,8788883163,-1785,,
907545538,8788903117,813613829,8788901331,-1786,8788901401,
907796005,8789153584,813864296,8789151816,-1768,,
908046525,8789404103,814114816,8789402353,-1750,,
908297094,8789654673,814365386,8789652941,-1732,,
908547619,8789905197,814615910,8789903483,-1714,,
908797833,8790155412,814866124,8790153697,-1715,,
909048148,8790405727,815116440,8790404013,-1714,,
909298437,8790656026,815366739,8790654312,-1714,,
909549068,8790906647,815617359,8790904933,-1714,,
909567276,8790924854,815635567,8790923140,-1714,8790923081,
909817640,8791175219,815885931,8791173491,-1728,,
910068374,8791425953,816136665,8791424210,-1743,,
910318674,8791676253,816386966,8791674497,-1756,,
910569656,8791927246,816637958,8791925475,-1771,,
910819958,8792177537,816888249,8792175766,-1771,,
911070112,8792427690,817138403,8792425919,-1771,,
911320614,8792678193,817388906,8792676422,-1771,,
911571425,8792929004,817639716,8792927243,-1761,,
911589619,8792947197,817657909,8792945426,-1771,8792945382,
911840098,8793197676,817908389,8793195895,-1781,,
912090298,8793447877,818158589,8793446085,-1792,,
912341019,8793698599,818409311,8793696797,-1802,,
912591379,8793948958,818659670,8793947155,-1803,,
912841647,8794199226,818909938,8794197412,-1814,,
913091973,8794449552,819160264,8794447739,-1813,,
913342359,8794699938,819410650,8794698125,-1813,,
913592510,8794950089,819660801,8794948286,-1803,,
913610652,8794968231,819678943,8794966417,-1814,8794966422,
913861226,8795218805,819929517,8795216993,-1812,,
914112083,8795469662,820180374,8795467850,-1812,,
914362581,8795720161,820430873,8795718352,-1809,,
914613149,8795970728,820681440,8795968920,-1808,,
914863755,8796221334,820932046,8796219527,-1807,,
915114370,8796471949,821182661,8796470142,-1807,,
915365081,8796722661,821433373,8796720854,-1807,,
915615631,8796973210,821683922,8796971402,-1808,,
915633732,8796991310,821702023,8796989503,-1807,8796989469,
915883955,8797241533,821952245,8797239717,-1816,,
916134102,8797491681,822202393,8797489857,-1824,,
916384629,8797742208,822452921,8797740377,-1831,,
916635099,8797992678,822703390,8797990838,-1840,,
916885725,8798243304,822954017,8798241464,-1840,,
917136034,8798493613,823204325,8798491772,-1841,,
917386590,8798744169,823454882,8798742329,-1840,,
917636756,8798994335,823705047,8798992495,-1840,,
917654837,8799012415,823723128,8799010575,-1840,8799010582,
917905061,8799262639,823973352,8799260800,-1839,,
918155361,8799512940,824223653,8799511103,-1837,,
918406161,8799763740,824474453,8799761915,-1825,,
918656831,8800014409,824725122,8800012577,-1832,,
918907312,8800264891,824975603,8800263059,-1832,,
919157501,8800515089,825225802,8800513257,-1832,,
919407991,8800765571,825476283,8800763739,-1832,,
919658133,8801015712,825726424,8801013880,-1832,,
919676171,8801033749,825744462,8801031917,-1832,8801031930,
919926468,8801284046,825994769,8801282227,-1819,,
920176592,8801534171,826244884,8801532346,-1825,,
920427024,8801784602,826495324,8801782790,-1812,,
920677133,8802034712,826745424,8802032893,-1819,,
920927686,8802285264,826995977,8802283446,-1818,,
921178322,8802535900,827246613,8802534082,-1818,,
921428702,8802786281,827496993,8802784463,-1818,,
921678817,8803036396,827747108,8803034578,-1818,,
921697052,8803054631,827765343,8803052813,-1818,8803052778,
921947487,8803305066,828015778,8803303239,-1827,,
922197725,8803555304,828266016,8803553468,-1836,,
922448011,8803805590,828516302,8803803756,-1834,,
922698135,8804055714,828766426,8804053863,-1851,,
922948255,8804305833,829016545,8804303982,-1851,,
923198429,8804556008,829266721,8804554157,-1851,,
923448775,8804806364,829517077,8804804513,-1851,,
923699171,8805056749,829767462,8805054898,-1851,,
923717391,8805074969,829785682,8805073118,-1851,8805073086,
923967508,8805325087,830035799,8805323228,-1859,,
924217755,8805575333,830286046,8805573466,-1867,,
924468270,8805825849,830536571,8805823985,-1864,,
924718485,8806076064,830786776,8806074182,-1882,,
924968686,8806326265,831036977,8806324383,-1882,,
925219024,8806576602,831287315,8806574720,-1882,,
925469384,8806826963,831537676,8806825082,-1881,,
925719691,8807077281,831787993,8807075399,-1882,,
925737916,8807095495,831806207,8807093612,-1883,8807093763,
925988678,8807346256,832056969,8807344412,-1844,,
926239177,8807596756,832307468,8807594949,-1807,,
926489603,8807847182,832557905,8807845424,-1758,,
926739738,8808097317,832808029,8808095587,-1730,,
926990026,8808347605,833058318,8808345875,-1730,,
927240757,8808598335,833309048,8808596605,-1730,,
927491040,8808848618,833559341,8808846899,-1719,,
927741421,8809099000,833809712,8809097269,-1731,,
927759585,8809117163,833827875,8809115433,-1730,8809115277,
928010086,8809367664,834078377,8809365894,-1770,,
928260586,8809618164,834328877,8809616355,-1809,,
928511019,8809868608,834579321,8809866761,-1847,,
928761607,8810119186,834829909,8810117311,-1875,,
929012217,8810369795,835080508,8810367910,-1885,,
929262624,8810620202,835330915,8810618317,-1885,,
929513378,8810870967,835581679,8810869082,-1885,,
929763646,8811121225,835831947,8811119350,-1875,,
929781794,8811139372,835850085,8811137487,-1885,8811137507,
930032585,8811390164,836100876,8811388283,-1881,,
930283024,8811640602,836351326,8811638738,-1864,,
930533140,8811890719,836601432,8811888849,-1870,,
930783503,8812141082,836851805,8812139228,-1854,,
931033656,8812391234,837101947,8812389370,-1864,,
931283820,8812641399,837352111,8812639535,-1864,,
931534159,8812891739,837602451,8812889875,-1864,,
931784303,8813141881,837852594,8813140017,-1864,,
931802466,8813160044,837870756,8813158180,-1864,8813158180,
932052657,8813410236,838120948,8813408371,-1865,,
932303228,8813660807,838371519,8813658944,-1863,,
932553523,8813911112,838621825,8813909249,-1863,,
932803859,8814161438,838872150,8814159576,-1862,,
933054092,8814411671,839122384,8814409809,-1862,,
933304249,8814661828,839372540,8814659976,-1852,,
933554437,8814912016,839622729,8814910155,-1861,,
933804920,8815162499,839873211,8815160636,-1863,,
933822973,8815180552,839891264,8815178689,-1863,8815178667,
934073254,8815430832,840141545,8815428964,-1868,,
934323845,8815681424,840392137,8815679551,-1873,,
934574207,8815931786,840642498,8815929908,-1878,,
934824800,8816182379,840893091,8816180496,-1883,,
935074929,8816432508,841143220,8816430634,-1874,,
935325382,8816682961,841393673,8816681078,-1883,,
935575710,8816933288,841644000,8816931405,-1883,,
935826052,8817183631,841894344,8817181748,-1883,,
935844307,8817201885,841912598,8817200002,-1883,8817200035,
936094914,8817452493,842163205,8817450627,-1866,,
936345550,8817703129,842413841,8817701262,-1867,,
936595785,8817953364,842664076,8817951505,-1859,,
936846239,8818203818,842914530,8818201969,-1849,,
937096889,8818454479,843165191,8818452629,-1850,,
937347463,8818705043,843415755,8818703194,-1849,,
937597921,8818955511,843666224,8818953662,-1849,,
937848092,8819205671,843916383,8819203822,-1849,,
937866227,8819223805,843934517,8819221956,-1849,8819221964,
938116324,8819473902,844184615,8819472056,-1846,,
938367032,8819724610,844435322,8819722766,-1844,,
938617488,8819975077,844685790,8819973236,-1841,,
938867747,8820225325,844936038,8820223486,-1839,,
939117864,8820475442,845186155,8820473613,-1829,,
939368114,8820725693,845436406,8820723854,-1839,,
939618504,8820976083,845686796,8820974244,-1839,,
939868934,8821226513,845937225,8821224674,-1839,,
939886999,8821244577,845955290,8821242738,-1839,8821242702,
940137254,8821494833,846205556,8821492994,-1839,,
940387614,8821745192,846455905,8821743334,-1858,,
940638094,8821995672,846706385,8821993806,-1866,,
940888252,8822245831,846956543,8822243957,-1874,,
941138566,8822496145,847206868,8822494281,-1864,,
941389145,8822746725,847457437,8822744851,-1874,,
941639493,8822997071,847707784,8822995197,-1874,,
941889668,8823247247,847957959,8823245373,-1874,,
941907697,8823265275,847975987,8823263400,-1875,8823263386,
942158423,8823516002,848226714,8823514135,-1867,,
942408594,8823766173,848476885,8823764303,-1870,,
942658941,8824016519,848727232,8824014636,-1883,,
942909140,8824266719,848977431,8824264832,-1887,,
943159461,8824517039,849227752,8824515163,-1876,,
943409652,8824767232,849477944,8824765344,-1888,,
943659979,8825017558,849728270,8825015670,-1888,,
943910172,8825267750,849978462,8825265863,-1887,,
943928215,8825285794,849996506,8825283906,-1888,8825283932,
944178846,8825536425,850247137,8825534544,-1881,,
944429212,8825786790,850497502,8825784916,-1874,,
944679454,8826037033,850747745,8826035166,-1867,,
944929699,8826287278,850997991,8826285418,-1860,,
945179919,8826537497,851248210,8826535637,-1860,,
945430061,8826787640,851498352,8826785790,-1850,,
945680407,8827037986,851748698,8827036126,-1860,,
945930706,8827288284,851998997,8827286424,-1860,,
945948768,8827306347,852017059,8827304486,-1861,8827304476,
946199569,8827557148,852267860,8827555284,-1864,,
946449864,8827807443,852518155,8827805578,-1865,,
946700076,8828057654,852768367,8828055787,-1867,,
946950299,8828307878,853018590,8828306009,-1869,,
947200848,8828558426,853269139,8828556557,-1869,,
947451493,8828809072,853519785,8828807213,-1859,,
947701830,8829059418,853770131,8829057549,-1869,,
947951999,8829309578,854020290,8829307708,-1870,,
947970121,8829327700,854038412,8829325830,-1870,8829325765,
948220610,8829578189,854288902,8829576303,-1886,,
948470987,8829828566,854539289,8829826674,-1892,,
948721173,8830078752,854789464,8830076833,-1919,,
948971954,8830329533,855040245,8830327600,-1933,,
949222129,8830579708,855290420,8830577775,-1933,,
949472606,8830830184,855540907,8830828262,-1922,,
949723172,8831080750,855791463,8831078817,-1933,,
949973291,8831330870,856041582,8831328936,-1934,,
949991359,8831348937,856059650,8831347004,-1933,8831346977,
950241532,8831599110,856309822,8831597170,-1940,,
950491854,8831849432,856560155,8831847496,-1936,,
950741993,8832099571,856810284,8832097619,-1952,,
950992539,8832350118,857060831,8832348160,-1958,,
951243342,8832600931,857311644,8832598973,-1958,,
951493700,8832851288,857562001,8832849331,-1957,,
951743796,8833101374,857812087,8833099416,-1958,,
951994440,8833352018,858062730,8833350060,-1958,,
952012426,8833370005,858080717,8833368046,-1959,8833368101,
952262650,8833620229,858330941,8833618284,-1945,,
952513036,8833870615,858581338,8833868695,-1920,,
952763570,8834121149,858831861,8834119232,-1917,,
953013884,8834371463,859082175,8834369560,-1903,,
953264069,8834621647,859332360,8834619745,-1902,,
953514379,8834871957,859582670,8834870055,-1902,,
953764581,8835122159,859832872,8835120257,-1902,,
954014920,8835372499,860083211,8835370597,-1902,,
954032931,8835390509,860101222,8835388607,-1902,8835388550,
954283467,8835641045,860351758,8835639129,-1916,,
954533659,8835891238,860601951,8835889308,-1930,,
954784049,8836141628,860852340,8836139684,-1944,,
955034243,8836391821,861102534,8836389863,-1958,,
955284862,8836642441,861353153,8836640483,-1958,,
955535201,8836892780,861603493,8836890822,-1958,,
955785303,8837142881,861853594,8837140923,-1958,,
956035438,8837393016,862103729,8837391058,-1958,,
956053398,8837410976,862121689,8837409018,-1958,8837409051,
956303537,8837661115,862371828,8837659165,-1950,,
956553917,8837911496,862622208,8837909555,-1941,,
956804046,8838161624,862872337,8838159692,-1932,,
957054599,8838412177,863122890,8838410253,-1924,,
957304798,8838662377,863373089,8838660453,-1924,,
957555584,8838913162,863623874,8838911238,-1924,,
957805984,8839163563,863874275,8839161639,-1924,,
958056642,8839414221,864124933,8839412296,-1925,,
958074736,8839432314,864143026,8839430390,-1924,8839430353,
958325162,8839682741,864393453,8839680808,-1933,,
958575909,8839933487,864644200,8839931545,-1942,,
958826292,8840183871,864894583,8840181921,-1950,,
959076787,8840434366,865145078,8840432406,-1960,,
959327074,8840684653,865395366,8840682694,-1959,,
959577626,8840935204,865645917,8840933245,-1959,,
959828043,8841185621,865896334,8841183662,-1959,,
960078170,8841435749,866146461,8841433790,-1959,,
960096284,8841453862,866164575,8841451903,-1959,8841451947,
960346884,8841704462,866415175,8841702513,-1949,,
960597461,8841955040,866665753,8841953103,-1937,,
960848020,8842205598,866916311,8842203672,-1926,,
961098603,8842456182,867166894,8842454268,-1914,,
961349227,8842706806,867417518,8842704892,-1914,,
961599606,8842957185,867667897,8842955271,-1914,,
961849790,8843207368,867918081,8843205454,-1914,,
962100081,8843457659,868168372,8843455745,-1914,,
962118406,8843475984,868186697,8843474070,-1914,8843474150,
962369031,8843726610,868437322,8843724716,-1894,,
962619375,8843976953,868687666,8843975079,-1874,,
962870010,8844227588,868938300,8844225735,-1853,,
963120402,8844477981,869188694,8844476148,-1833,,
963370925,8844728504,869439216,8844726671,-1833,,
963621145,8844978724,869689436,8844976890,-1834,,
963871497,8845229076,869939788,8845227253,-1823,,
964121667,8845479246,870189958,8845477413,-1833,,
964139785,8845497363,870208076,8845495530,-1833,8845495411,
964390296,8845747875,870458588,8845746011,-1864,,
964640531,8845998110,870708822,8845996217,-1893,,
964890689,8846248279,870958991,8846246357,-1922,,
965141116,8846498695,871209407,8846496744,-1951,,
965391794,8846749373,871460086,8846747422,-1951,,
965642057,8846999635,871710348,8846997684,-1951,,
965892224,8847249803,871960515,8847247852,-1951,,
966142982,8847500560,872211272,8847498609,-1951,,
966161154,8847518732,872229445,8847516781,-1951,8847516770,
966411669,8847769248,872479961,8847767294,-1954,,
966661908,8848019487,872730200,8848017530,-1957,,
966912361,8848269941,872980653,8848267982,-1959,,
967163307,8848520886,873231598,8848518925,-1961,,
967413898,8848771477,873482189,8848769516,-1961,,
967664354,8849021933,873732645,8849019972,-1961,,
967914978,8849272557,873983280,8849270607,-1950,,
968165486,8849523065,874233777,8849521103,-1962,,
968183612,8849541190,874251902,8849539229,-1961,8849539185,
968434122,8849791701,874502414,8849789731,-1970,,
968684638,8850042217,874752930,8850040235,-1982,,
968934737,8850292316,875003039,8850290335,-1981,,
969184976,8850542555,875253267,8850540551,-2004,,
969435862,8850793441,875504153,8850791437,-2004,,
969686444,8851044022,875754735,8851042019,-2003,,
969936877,8851294456,876005169,8851292453,-2003,,
970187383,8851544962,876255674,8851542958,-2004,,
970205599,8851563178,876273890,8851561175,-2003,8851561218,
970455840,8851813419,876524132,8851811428,-1991,,
970706302,8852063881,876774604,8852061912,-1969,,
970956831,8852314410,877025122,8852312441,-1969,,
971207250,8852564829,877275541,8852562871,-1958,,
971457856,8852815435,877526148,8852813477,-1958,,
971708376,8853065955,877776667,8853063997,-1958,,
971958828,8853316407,878027119,8853314449,-1958,,
972209014,8853566593,878277305,8853564634,-1959,,
972227050,8853584628,878295341,8853582670,-1958,8853582653,
972477647,8853835226,878545938,8853833263,-1963,,
972728093,8854085672,878796395,8854083716,-1956,,
972978731,8854336309,879047022,8854334339,-1970,,
973229004,8854586582,879297295,8854584609,-1973,,
973479627,8854837205,879547918,8854835232,-1973,,
973729842,8855087420,879798133,8855085458,-1962,,
973980375,8855337954,880048666,8855335980,-1974,,
974231201,8855588780,880299492,8855586807,-1973,,
974249275,8855606853,880317566,8855604880,-1973,8855604843,
974499362,8855856941,880567653,8855854958,-1983,,
974749947,8856107525,880818238,8856105533,-1992,,
975000251,8856357830,881068542,8856355829,-2001,,
975250935,8856608514,881319226,8856606504,-2010,,
975501081,8856858671,881569383,8856856662,-2009,,
975751489,8857109067,881819780,8857107058,-2009,,
976001966,8857359555,882070267,8857357546,-2009,,
976252443,8857610022,882320735,8857608024,-1998,,
976270428,8857628006,882338718,8857625997,-2009,8857626048,
976520836,8857878415,882589127,8857876419,-1996,,
976771042,8858128621,882839344,8858126649,-1972,,
977021381,8858378959,883089672,8858377000,-1959,,
977271955,8858629534,883340246,8858627578,-1956,,
977522496,8858880075,883590787,8858878118,-1957,,
977772721,8859130310,883841022,8859128354,-1956,,
978022908,8859380487,884091199,8859378530,-1957,,
978273083,8859630662,884341374,8859628715,-1947,,
978291263,8859648841,884359554,8859646885,-1956,8859646917,
978541379,8859898957,884609670,8859897010,-1947,,
978791953,8860149532,884860245,8860147593,-1939,,
979042342,8860399920,885110633,8860397990,-1930,,
979292929,8860650508,885361220,8860648586,-1922,,
979543550,8860901128,885611841,8860899206,-1922,,
979794045,8861151634,885862346,8861149711,-1923,,
980044183,8861401761,886112473,8861399839,-1922,,
980294379,8861651958,886362670,8861650036,-1922,,
980312341,8861669919,886380631,8861667997,-1922,8861667929,
980563067,8861920645,886631357,8861918705,-1940,,
980813505,8862171083,886881796,8862169138,-1945,,
981063786,8862421365,887132077,8862419392,-1973,,
981314037,8862671617,887382329,8862669628,-1989,,
981564818,8862922397,887633109,8862920408,-1989,,
981815042,8863172621,887883344,8863170642,-1979,,
982065657,8863423235,888133948,8863421246,-1989,,
982316061,8863673639,888384352,8863671660,-1979,,
982334281,8863691859,888402571,8863689870,-1989,8863689812,
982584746,8863942325,888653037,8863940321,-2004,,
982834876,8864192455,888903167,8864190437,-2018,,
983085607,8864443186,889153898,8864441154,-2032,,
983335847,8864693426,889404138,8864691389,-2037,,
983586193,8864943771,889654484,8864941725,-2046,,
983836400,8865193989,889904702,8865191943,-2046,,
984086895,8865444474,890155186,8865442428,-2046,,
984337411,8865694990,890405702,8865692944,-2046,,
984355496,8865713074,890423787,8865711028,-2046,8865711077,
984605958,8865963537,890674249,8865961502,-2035,,
984856072,8866213651,890924364,8866211629,-2022,,
985106248,8866463827,891174539,8866461817,-2010,,
985356383,8866713961,891424673,8866711965,-1996,,
985606943,8866964521,891675234,8866962525,-1996,,
985857227,8867214806,891925519,8867212820,-1986,,
986107759,8867465338,892176051,8867463342,-1996,,
986358240,8867715819,892426532,8867713823,-1996,,
986376293,8867733871,892444593,8867731885,-1986,8867731872,
986626512,8867984091,892694803,8867982094,-1997,,
986877344,8868234933,892945646,8868232936,-1997,,
987127476,8868485054,893195767,8868483057,-1997,,
987377952,8868735531,893446244,8868733534,-1997,,
987628921,8868986500,893697213,8868984503,-1997,,
987879064,8869236653,893947366,8869234656,-1997,,
988129437,8869487016,894197728,8869485019,-1997,,
988380047,8869737626,894448338,8869735629,-1997,,
988398085,8869755664,894466376,8869753667,-1997,8869753677,
988648299,8870005877,894716590,8870003883,-1994,,
988898650,8870256228,894966951,8870254248,-1980,,
989149024,8870506603,895217315,8870504614,-1989,,
989399305,8870756883,895467596,8870754898,-1985,,
989649530,8871007108,895717821,8871005123,-1985,,
989899707,8871257286,895968008,8871255311,-1975,,
990150061,8871507639,896218352,8871505654,-1985,,
990400670,8871758249,896468961,8871756263,-1986,,
990418841,8871776419,896487132,8871774434,-1985,8871774420,
990669009,8872026587,896737299,8872024598,-1989,,
990919562,8872277141,896987863,8872275159,-1982,,
991169704,8872527283,897237995,8872525297,-1986,,
991420419,8872777999,897488712,8872776001,-1998,,
991670639,8873028218,897738930,8873026220,-1998,,
991921378,8873278958,897989671,8873276960,-1998,,
992171539,8873529118,898239830,8873527119,-1999,,
992422349,8873779928,898490640,8873777929,-1999,,
992440410,8873797988,898508701,8873795990,-1998,8873796018,
992690533,8874048121,898758834,8874046131,-1990,,
992941575,8874299154,899009866,8874297170,-1984,,
993191697,8874549276,899259988,8874547299,-1977,,
993442033,8874799612,899510325,8874797644,-1968,,
993692216,8875049805,899760517,8875047836,-1969,,
993942579,8875300168,900010881,8875298199,-1969,,
994192703,8875550282,900260994,8875548313,-1969,,
994442896,8875800475,900511187,8875798505,-1970,,
994461140,8875818719,900529431,8875816749,-1970,8875816674,
994711609,8876069187,900779910,8876067209,-1978,,
994962091,8876319679,901030392,8876317673,-2006,,
995212255,8876569834,901280546,8876567809,-2025,,
995462874,8876820453,901531166,8876818410,-2043,,
995713012,8877070590,901781313,8877068557,-2033,,
995963335,8877320924,902031637,8877318882,-2042,,
996213859,8877571438,902282150,8877569395,-2043,,
996464491,8877822070,902532782,8877820027,-2043,,
996482577,8877840155,902550867,8877838111,-2044,8877838111,
996732866,8878090444,902801157,8878088401,-2043,,
996983242,8878340821,903051534,8878338778,-2043,,
997234254,8878591833,903302545,8878589791,-2042,,
997484433,8878842012,903552725,8878839971,-2041,,
997734630,8879092220,903802932,8879090178,-2042,,
997985216,8879342805,904053517,8879340763,-2042,,
998235656,8879593235,904303947,8879591193,-2042,,
998486011,8879843590,904554302,8879841547,-2043,,
998504011,8879861589,904572301,8879859546,-2043,8879859537,
998754631,8880112209,904822921,8880110165,-2044,,
999005378,8880362957,905073670,8880360911,-2046,,
999255828,8880613406,905324119,8880611358,-2048,,
999506219,8880863808,905574521,8880861758,-2050,,
999756570,8881114148,905824861,8881112098,-2050,,
1000006892,8881364481,906075193,8881362431,-2050,,
1000257247,8881614825,906325537,8881612775,-2050,,
1000507839,8881865417,906576130,8881863367,-2050,,
1000525997,8881883575,906594288,8881881525,-2050,8881881520,
1000776324,8882133903,906844615,8882131852,-2051,,
1001026600,8882384190,907094902,8882382139,-2051,,
1001276752,8882634330,907345043,8882632288,-2042,,
1001527673,8882885251,907595964,8882883198,-2053,,
1001777856,8883135435,907846147,8883133381,-2054,,
1002028051,8883385630,908096343,8883383577,-2053,,
1002278182,8883635761,908346473,8883633718,-2043,,
1002529048,8883886626,908597339,8883884573,-2053,,
1002547023,8883904601,908615313,8883902548,-2053,8883902554,
1002797155,8884154734,908865446,8884152682,-2052,,
1003047404,8884404983,909115696,8884402934,-2049,,
1003297522,8884655101,909365814,8884653054,-2047,,
1003548008,8884905587,909616299,8884903542,-2045,,
1003798414,8885155993,909866706,8885153948,-2045,,
1004048862,8885406441,910117154,8885404396,-2045,,
1004299416,8885656994,910367707,8885654949,-2045,,
1004550079,8885907658,910618370,8885905613,-2045,,
1004568166,8885925744,910636457,8885923699,-2045,8885923676,
1004818790,8886176369,910887082,8886174318,-2051,,
1005069303,8886426883,911137595,8886424827,-2056,,
1005320105,8886677684,911388396,8886675623,-2061,,
1005570466,8886928045,911638757,8886925979,-2066,,
1005821391,8887178970,911889683,8887176904,-2066,,
1006072281,8887429870,912140583,8887427804,-2066,,
1006322726,8887680304,912391017,8887678238,-2066,,
1006573346,8887930925,912641637,8887928859,-2066,,
1006591392,8887948970,912659683,8887946904,-2066,8887946935,
1006842249,8888199827,912910540,8888197769,-2058,,
1007092479,8888450068,913160781,8888448018,-2050,,
1007342978,8888700556,913411269,8888698515,-2041,,
1007593474,8888951053,913661765,8888949020,-2033,,
1007843796,8889201375,913912088,8889199342,-2033,,
1008094215,8889451794,914162506,8889449760,-2034,,
1008344969,8889702548,914413260,8889700515,-2033,,
1008595139,8889952718,914663430,8889950684,-2034,,
1008613110,8889970688,914681401,8889968655,-2033,8889968644,
1008863569,8890221148,914931860,8890219111,-2037,,
1009114082,8890471661,915182373,8890469621,-2040,,
1009364724,8890722303,915433015,8890720262,-2041,,
1009614963,8890972541,915683254,8890970498,-2043,,
1009865115,8891222693,915933406,8891220650,-2043,,
1010115663,8891473242,916183955,8891471199,-2043,,
1010365879,8891723458,916434170,8891721414,-2044,,
1010616295,8891973874,916684586,8891971831,-2043,,
1010634397,8891991975,916702687,8891989932,-2043,8891989871,
1010884625,8892242204,916952916,8892240144,-2060,,
1011134733,8892492312,917203024,8892490237,-2075,,
1011385667,8892743246,917453959,8892741157,-2089,,
1011635805,8892993383,917704096,8892991280,-2103,,
1011886335,8893243913,917954626,8893241810,-2103,,
1012136463,8893494042,918204754,8893491939,-2103,,
1012387129,8893744707,918455420,8893742604,-2103,,
1012637685,8893995264,918705976,8893993161,-2103,,
1012655751,8894013329,918724042,8894011226,-2103,8894011235,
1012906094,8894263672,918974385,8894261571,-2101,,
1013156318,8894513896,919224609,8894511797,-2099,,
1013406465,8894764044,919474757,8894761948,-2096,,
1013656961,8895014540,919725252,8895012447,-2093,,
1013907111,8895264690,919975402,8895262606,-2084,,
1014157302,8895514881,920225594,8895512788,-2093,,
1014407631,8895765221,920475934,8895763128,-2093,,
1014657792,8896015371,920726083,8896013277,-2094,,
1014675964,8896033542,920744255,8896031449,-2093,8896031427,
1014926433,8896284012,920994724,8896281913,-2099,,
1015176551,8896534130,921244842,8896532026,-2104,,
1015426659,8896784238,921494951,8896782129,-2109,,
1015676953,8897034532,921745244,8897032429,-2103,,
1015927242,8897284820,921995533,8897282706,-2114,,
1016177696,8897535275,922245987,8897533160,-2115,,
1016428428,8897786007,922496719,8897783893,-2114,,
1016678576,8898036155,922746867,8898034040,-2115,,
1016696655,8898054233,922764945,8898052118,-2115,8898052081,
1016946819,8898304398,923015111,8898302274,-2124,,
1017197105,8898554684,923265396,8898552552,-2132,,
1017447320,8898804899,923515612,8898802758,-2141,,
1017697504,8899055093,923765805,8899052943,-2150,,
1017947740,8899305319,924016031,8899303168,-2151,,
1018198419,8899555998,924266711,8899553848,-2150,,
1018448996,8899806575,924517287,8899804425,-2150,,
1018699586,8900057164,924767877,8900055014,-2150,,
1018717669,8900075247,924785960,8900073097,-2150,8900073153,
1018968007,8900325585,925036298,8900323448,-2137,,
1019218651,8900576230,925286942,8900574108,-2122,,
1019469022,8900826601,925537314,8900824493,-2108,,
1019719226,8901076805,925787517,8901074712,-2093,,
1019969409,8901326988,926037700,8901324894,-2094,,
1020220366,8901577944,926288657,8901575851,-2093,,
1020470688,8901828266,926538979,8901826173,-2093,,
1020720946,8902078524,926789237,8902076431,-2093,,
1020738994,8902096572,926807284,8902094479,-2093,8902094476,
1020989268,8902346847,927057560,8902344753,-2094,,
1021239465,8902597043,927307756,8902594949,-2094,,
1021490125,8902847704,927558416,8902845609,-2095,,
1021740498,8903098088,927808800,8903095993,-2095,,
1021991116,8903348694,928059407,8903346599,-2095,,
1022241310,8903598888,928309601,8903596793,-2095,,
1022491718,8903849298,928560011,8903847203,-2095,,
1022742049,8904099627,928810340,8904097532,-2095,,
1022760185,8904117764,928828476,8904115668,-2096,8904115628,
1023010691,8904368269,929078982,8904366163,-2106,,
1023261233,8904618812,929329524,8904616696,-2116,,
1023511383,8904868961,929579674,8904866836,-2125,,
1023761871,8905119449,929830162,8905117315,-2134,,
1024011995,8905369584,930080296,8905367449,-2135,,
1024262608,8905620187,930330900,8905618053,-2134,,
1024513012,8905870591,930581304,8905868457,-2134,,
1024763305,8906120884,930831606,8906118760,-2124,,
1024781434,8906139012,930849725,8906136878,-2134,8906136925,
1025031760,8906389338,931100051,8906387216,-2122,,
1025282225,8906639803,931350516,8906637693,-2110,,
1025532740,8906890319,931601031,8906888220,-2099,,
1025783243,8907140822,931851535,8907138748,-2074,,
1026033740,8907391318,932102031,8907389233,-2085,,
1026284263,8907641842,932352554,8907639757,-2085,,
1026534652,8907892230,932602942,8907890156,-2074,,
1026784781,8908142360,932853073,8908140286,-2074,,
1026802899,8908160477,932871190,8908158392,-2085,8908158313,
1027052997,8908410576,933121288,8908408472,-2104,,
1027303259,8908660848,933371561,8908658724,-2124,,
1027553999,8908911578,933622291,8908909435,-2143,,
1027804366,8909161955,933872667,8909159793,-2162,,
1028054984,8909412563,934123275,8909410401,-2162,,
1028305637,8909663216,934373928,8909661064,-2152,,
1028556021,8909913610,934624323,8909911448,-2162,,
1028806213,8910163792,934874505,8910161631,-2161,,
1028824280,8910181858,934892570,8910179696,-2162,8910179771,
1029074804,8910432382,935143095,8910430239,-2143,,
1029325643,8910683221,935393933,8910681097,-2124,,
1029576213,8910933792,935644505,8910931688,-2104,,
1029826723,8911184302,935895025,8911182227,-2075,,
1030077679,8911435258,936145970,8911433173,-2085,,
1030328613,8911686192,936396904,8911684107,-2085,,
1030578771,8911936350,936647062,8911934264,-2086,,
1030829132,8912186711,936897423,8912184625,-2086,,
1030847120,8912204698,936915411,8912202613,-2085,8912202615,
1031097235,8912454813,937165526,8912452729,-2084,,
1031347428,8912705007,937415730,8912702934,-2073,,
1031597820,8912955399,937666112,8912953327,-2072,,
1031848203,8913205782,937916504,8913203711,-2071,,
1032098336,8913455915,938166627,8913453833,-2082,,
1032348919,8913706497,938417209,8913704416,-2081,,
1032599356,8913956934,938667647,8913954853,-2081,,
1032849750,8914207329,938918041,8914205247,-2082,,
1032867888,8914225467,938936179,8914223386,-2081,8914223415,
1033118038,8914475617,939186329,8914473543,-2074,,
1033368146,8914725725,939436437,8914723658,-2067,,
1033618618,8914976197,939686909,8914974139,-2058,,
1033868808,8915226386,939937099,8915224336,-2050,,
1034119656,8915477235,940187947,8915475184,-2051,,
1034370007,8915727586,940438299,8915725536,-2050,,
1034620149,8915977728,940688450,8915975688,-2040,,
1034870252,8916227831,940938543,8916225780,-2051,,
1034888291,8916245870,940956582,8916243819,-2051,8916243672,
1035139156,8916496735,941207447,8916494648,-2087,,
1035389621,8916747199,941457911,8916745076,-2123,,
1035639770,8916997348,941708061,8916995188,-2160,,
1035890389,8917247967,941958680,8917245771,-2196,,
1036140887,8917498466,942209178,8917496270,-2196,,
1036391567,8917749146,942459858,8917746950,-2196,,
1036642155,8917999734,942710446,8917997538,-2196,,
1036892328,8918249907,942960620,8918247711,-2196,,
1036910357,8918267935,942978647,8918265739,-2196,8918265804,
1037160671,8918518261,943228974,8918516081,-2180,,
1037411086,8918768666,943479378,8918766503,-2163,,
1037661386,8919018966,943729678,8919016819,-2147,,
1037911524,8919269102,943979815,8919266973,-2129,,
1038162462,8919520040,944230753,8919517911,-2129,,
1038412919,8919770498,944481210,8919768368,-2130,,
1038663104,8920020683,944731395,8920018554,-2129,,
1038913234,8920270813,944981525,8920268684,-2129,,
1038931218,8920288797,944999509,8920286667,-2130,8920286664,
1039181395,8920538974,945249687,8920536845,-2129,,
1039431863,8920789442,945500155,8920787311,-2131,,
1039681972,8921039550,945750263,8921037419,-2131,,
1039932297,8921289875,946000588,8921287744,-2131,,
1040182501,8921540080,946250793,8921537950,-2130,,
1040432601,8921790179,946500892,8921788048,-2131,,
1040682922,8922040501,946751213,8922038369,-2132,,
1040933171,8922290749,947001462,8922288618,-2131,,
1040951262,8922308840,947019552,8922306708,-2132,8922306686,
1041201490,8922559069,947269782,8922556932,-2137,,
1041452191,8922809770,947520483,8922807628,-2142,,
1041702337,8923059916,947770628,8923057769,-2147,,
1041953039,8923310618,948021330,8923308466,-2152,,
1042203425,8923561014,948271726,8923558861,-2153,,
1042453578,8923811157,948521870,8923809005,-2152,,
1042704021,8924061600,948772312,8924059447,-2153,,
1042954243,8924311822,949022535,8924309670,-2152,,
1042972419,8924329997,949040710,8924327845,-2152,8924327916,
1043222627,8924580216,949290929,8924578081,-2135,,
1043472948,8924830527,949541239,8924828410,-2117,,
1043723405,8925080984,949791696,8925078885,-2099,,
1043973957,8925331536,950042248,8925329456,-2080,,
1044224300,8925581879,950292592,8925579799,-2080,,
1044475105,8925832684,950543397,8925830605,-2079,,
1044725681,8926083260,950793972,8926081179,-2081,,
1044975935,8926333514,951044226,8926331434,-2080,,
1044994045,8926351623,951062335,8926349543,-2080,8926349454,
1045244383,8926601972,951312684,8926599870,-2102,,
1045494685,8926852264,951562977,8926850141,-2123,,
1045744856,8927102434,951813157,8927100299,-2135,,
1045995055,8927352634,952063346,8927350467,-2167,,
1046245375,8927602964,952313677,8927600797,-2167,,
1046495710,8927853290,952564002,8927851123,-2167,,
1046745891,8928103470,952814182,8928101303,-2167,,
1046996079,8928353658,953064370,8928351491,-2167,,
1047014140,8928371718,953082430,8928369551,-2167,8928369466,
1047264518,8928622097,953332820,8928619919,-2178,,
1047515074,8928872653,953583365,8928870444,-2209,,
1047765402,8929122982,953833694,8929120752,-2230,,
1048015741,8929373320,954084032,8929371070,-2250,,
1048266551,8929624140,954334852,8929621890,-2250,,
1048516850,8929874429,954585142,8929872180,-2249,,
1048767570,8930125149,954835861,8930122899,-2250,,
1049017745,8930375324,955086036,8930373074,-2250,,
1049035837,8930393416,955104128,8930391165,-2251,8930391209,
1049286537,8930644116,955354828,8930641886,-2230,,
1049537358,8930894937,955605650,8930892720,-2217,,
1049788206,8931145785,955856497,8931143567,-2218,,
1050038453,8931396031,956106744,8931393826,-2205,,
1050288725,8931646304,956357016,8931644099,-2205,,
1050539098,8931896677,956607390,8931894472,-2205,,
1050789243,8932146822,956857534,8932144617,-2205,,
1051039660,8932397238,957107951,8932395033,-2205,,
1051057697,8932415275,957125987,8932413070,-2205,8932413125,
1051307978,8932665557,957376269,8932663375,-2182,,
1051558492,8932916071,957626784,8932913895,-2176,,
1051808953,8933166531,957877244,8933164369,-2162,,
1052059168,8933416747,958127459,8933414599,-2148,,
1052309334,8933666912,958377625,8933664764,-2148,,
1052559567,8933917146,958627858,8933914998,-2148,,
1052810074,8934167652,958878365,8934165504,-2148,,
1053060930,8934418509,959129221,8934416360,-2149,,
1053078933,8934436511,959147223,8934434363,-2148,8934434287,
1053329318,8934686896,959397609,8934684741,-2155,,
1053579679,8934937258,959647970,8934935072,-2186,,
1053830217,8935187795,959898508,8935185592,-2203,,
1054080604,8935438183,960148895,8935435960,-2223,,
1054330864,8935688443,960399155,8935686221,-2222,,
1054581284,8935938863,960649585,8935936650,-2213,,
1054831424,8936189003,960899715,8936186781,-2222,,
1055081896,8936439474,961150187,8936437252,-2222,,
1055099961,8936457539,961168252,8936455317,-2222,8936455336,
1055350519,8936708108,961418821,8936705890,-2218,,
1055601149,8936958728,961669440,8936956515,-2213,,
1055851939,8937209518,961920230,8937207310,-2208,,
1056102321,8937459900,962170612,8937457698,-2202,,
1056352650,8937710239,962420952,8937708037,-2202,,
1056602818,8937960397,962671109,8937958195,-2202,,
1056853214,8938210793,962921505,8938208591,-2202,,
1057103708,8938461287,963171999,8938459084,-2203,,
1057121767,8938479346,963190058,8938477143,-2203,8938477182,
1057372011,8938729589,963440302,8938727396,-2193,,
1057622536,8938980114,963690827,8938977931,-2183,,
1057872992,8939230571,963941283,8939228399,-2172,,
1058123200,8939480779,964191491,8939478617,-2162,,
1058373563,8939731142,964441855,8939728980,-2162,,
1058624221,8939981799,964692512,8939979637,-2162,,
1058875012,8940232591,964943303,8940230429,-2162,,
1059125811,8940483389,965194102,8940481227,-2162,,
1059143956,8940501535,965212247,8940499373,-2162,8940499352,
1059394060,8940751639,965462362,8940749482,-2157,,
1059644375,8941001954,965712666,8940999782,-2172,,
1059894568,8941252147,965962859,8941249971,-2176,,
1060144972,8941502551,966213264,8941500370,-2181,,
1060395453,8941753032,966463744,8941750860,-2172,,
1060645534,8942003113,966713825,8942000932,-2181,,
1060895881,8942253459,966964172,8942251278,-2181,,
1061146002,8942503581,967214294,8942501400,-2181,,
1061164122,8942521700,967232412,8942519519,-2181,8942519481,
1061414640,8942772219,967482931,8942770028,-2191,,
1061664788,8943022367,967733079,8943020168,-2199,,
1061914944,8943272522,967983235,8943270314,-2208,,
1062165617,8943523195,968233908,8943520978,-2217,,
1062416230,8943773808,968484521,8943771591,-2217,,
1062666876,8944024454,968735167,8944022237,-2217,,
1062917125,8944274704,968985417,8944272497,-2207,,
1063167310,8944524888,969235600,8944522671,-2217,,
1063185384,8944542962,969253675,8944540745,-2217,8944540816,
1063435735,8944793314,969504027,8944791115,-2199,,
1063686548,8945044137,969754850,8945041956,-2181,,
1063937011,8945294590,970005313,8945292438,-2152,,
1064187755,8945545334,970256046,8945543190,-2144,,
1064437898,8945795477,970506190,8945793333,-2144,,
1064688080,8946045658,970756370,8946043514,-2144,,
1064938449,8946296027,971006740,8946293883,-2144,,
1065189065,8946546643,971257356,8946544499,-2144,,
1065207102,8946564680,971275393,8946562536,-2144,8946562458,
1065457815,8946815394,971526106,8946813231,-2163,,
1065708182,8947065761,971776473,8947063579,-2182,,
1065958287,8947315876,972026589,8947313676,-2200,,
1066208946,8947566525,972277248,8947564315,-2210,,
1066459806,8947817386,972528099,8947815166,-2220,,
1066710173,8948067762,972778475,8948065542,-2220,,
1066960282,8948317871,973028583,8948315650,-2221,,
1067210446,8948568025,973278738,8948565805,-2220,,
1067228744,8948586323,973297035,8948584102,-2221,8948584033,
1067479274,8948836853,973547576,8948834625,-2228,,
1067729501,8949087080,973797792,8949084826,-2254,,
1067980121,8949337700,974048412,8949335429,-2271,,
1068230582,8949588161,974298873,8949585872,-2289,,
1068480900,8949838480,974549192,8949836192,-2288,,
1068731105,8950088684,974799397,8950086396,-2288,,
1068981465,8950339044,975049756,8950336756,-2288,,
1069231830,8950589408,975300121,8950587120,-2288,,
1069249986,8950607564,975318277,8950605276,-2288,8950605355,
1069500515,8950858094,975568806,8950855835,-2259,,
1069751284,8951108873,975819585,8951106624,-2249,,
1070001640,8951359219,976069931,8951356991,-2228,,
1070252238,8951609817,976320530,8951607609,-2208,,
1070502644,8951860223,976570936,8951858016,-2207,,
1070753016,8952110605,976821318,8952108397,-2208,,
1071003160,8952360739,977071451,8952358530,-2209,,
1071253479,8952611058,977321770,8952608849,-2209,,
1071271555,8952629133,977339846,8952626925,-2208,8952626899,
1071522300,8952879879,977590602,8952877674,-2205,,
1071772851,8953130429,977841142,8953128218,-2211,,
1072023830,8953381409,978092121,8953379181,-2228,,
1072274363,8953631942,978342654,8953629708,-2234,,
1072525029,8953882609,978593321,8953880376,-2233,,
1072775160,8954132738,978843450,8954130505,-2233,,
1073025538,8954383117,979093829,8954380883,-2234,,
1073275797,8954633375,979344088,8954631142,-2233,,
1073293780,8954651358,979362071,8954649125,-2233,8954649167,
1073544057,8954901636,979612348,8954899412,-2224,,
1073794366,8955151944,979862657,8955149732,-2212,,
1074044944,8955402523,980113236,8955400322,-2201,,
1074295132,8955652710,980363423,8955650520,-2190,,
1074545503,8955903082,980613795,8955900893,-2189,,
1074795637,8956153216,980863929,8956151026,-2190,,
1075046004,8956403583,981114296,8956401393,-2190,,
1075296436,8956654015,981364727,8956651824,-2191,,
1075314510,8956672088,981382801,8956669898,-2190,8956669898,
1075564649,8956922227,981632950,8956920046,-2181,,
1075815319,8957172897,981883610,8957170707,-2190,,
1076065476,8957423054,982133767,8957420864,-2190,,
1076316112,8957673690,982384403,8957671501,-2189,,
1076567084,8957924662,982635385,8957922483,-2179,,
1076817351,8958174930,982885643,8958172741,-2189,,
1077067685,8958425263,983135976,8958423074,-2189,,
1077318277,8958675856,983386579,8958673677,-2179,,
1077336365,8958693943,983404656,8958691754,-2189,8958691726,
1077586830,8958944409,983655122,8958942213,-2196,,
1077837361,8959194940,983905652,8959192736,-2204,,
1078087716,8959445295,984156007,8959443086,-2209,,
1078338303,8959695882,984406594,8959693666,-2216,,
1078588513,8959946092,984656804,8959943876,-2216,,
1078838701,8960196280,984906993,8960194064,-2216,,
1079089338,8960446917,985157630,8960444701,-2216,,
1079339811,8960697401,985408114,8960695185,-2216,,
1079357896,8960715474,985426187,8960713258,-2216,8960713242,
1079608299,8960965889,985676601,8960963668,-2221,,
1079858764,8961216343,985927055,8961214118,-2225,,
1080109344,8961466923,986177635,8961464706,-2217,,
1080359777,8961717366,986428078,8961715135,-2231,,
1080609897,8961967475,986678198,8961965255,-2220,,
1080860850,8962218428,986929141,8962216197,-2231,,
1081111436,8962469014,987179727,8962466783,-2231,,
1081361883,8962719471,987430184,8962717240,-2231,,
1081379967,8962737545,987448258,8962735314,-2231,8962735273,
1081630501,8962988080,987698793,8962985838,-2242,,
1081880635,8963238213,987948926,8963235971,-2242,,
1082130801,8963488379,988199092,8963486117,-2262,,
1082380973,8963738552,988449264,8963736280,-2272,,
1082631619,8963989207,988699920,8963986936,-2271,,
1082881750,8964239328,988950041,8964237057,-2271,,
1083132239,8964489818,989200530,8964487547,-2271,,
1083382445,8964740023,989450736,8964737762,-2261,,
1083400492,8964758070,989468783,8964755799,-2271,8964755809,
1083650787,8965008366,989719078,8965006097,-2269,,
1083901391,8965258969,989969682,8965256703,-2266,,
1084151611,8965509189,990219902,8965506926,-2263,,
1084402077,8965759656,990470368,8965757395,-2261,,
1084652182,8966009760,990720472,8966007500,-2260,,
1084902293,8966259872,990970584,8966257612,-2260,,
1085152390,8966509969,991220681,8966507708,-2261,,
1085402765,8966760343,991471056,8966758083,-2260,,
1085420840,8966778418,991489130,8966776158,-2260,8966776188,
1085671220,8967028799,991739511,8967026555,-2244,,
1085921672,8967279251,991989963,8967277005,-2246,,
1086172384,8967529963,992240675,8967527726,-2237,,
1086422532,8967780110,992490823,8967777892,-2218,,
1086673020,8968030599,992741311,8968028370,-2229,,
1086923234,8968280812,992991525,8968278583,-2229,,
1087173415,8968531003,993241716,8968528774,-2229,,
1087423964,8968781542,993492255,8968779313,-2229,,
1087442089,8968799668,993510380,8968797438,-2230,8968797412,
1087692219,8969049798,993760520,8969047572,-2226,,
1087942588,8969300167,994010879,8969297924,-2243,,
1088192794,8969550373,994261085,8969548125,-2248,,
1088443243,8969800823,994511535,8969798569,-2254,,
1088693696,8970051275,994761988,8970049021,-2254,,
1088943998,8970301577,995012289,8970299323,-2254,,
1089194120,8970551698,995262411,8970549444,-2254,,
1089444562,8970802140,995512853,8970799886,-2254,,
1089462743,8970820321,995531033,8970818067,-2254,8970818025,
1089713095,8971070684,995781396,8971068420,-2264,,
1089963256,8971320834,996031547,8971318560,-2274,,
1090213769,8971571347,996282060,8971569063,-2284,,
1090464126,8971821705,996532418,8971819411,-2294,,
1090714440,8972072018,996782731,8972069724,-2294,,
1090964753,8972322332,997033054,8972320047,-2285,,
1091215090,8972572669,997283381,8972570375,-2294,,
1091465397,8972822976,997533689,8972820682,-2294,,
1091483623,8972841201,997551914,8972838907,-2294,8972838894,
1091734258,8973091836,997802559,8973089548,-2288,,
1091984434,8973342012,998052725,8973339711,-2301,,
1092234930,8973592508,998303221,8973590205,-2303,,
1092485680,8973843259,998553972,8973840954,-2305,,
1092736301,8974093880,998804603,8974091584,-2296,,
1092986427,8974344005,999054718,8974341699,-2306,,
1093236897,8974594475,999305188,8974592169,-2306,,
1093487091,8974844669,999555382,8974842363,-2306,,
1093505244,8974862823,999573535,8974860516,-2307,8974860544,
1093756201,8975113780,999824492,8975111490,-2290,,
1094006375,8975363954,1000074666,8975361662,-2292,,
1094256521,8975614100,1000324812,8975611815,-2285,,
1094507347,8975864927,1000575639,8975862650,-2277,,
1094757511,8976115090,1000825802,8976112822,-2268,,
1095007843,8976365421,1001076134,8976363144,-2277,,
1095258022,8976615601,1001326314,8976613324,-2277,,
1095508347,8976865926,1001576638,8976863649,-2277,,
1095526364,8976883942,1001594654,8976881665,-2277,8976881678,
1095776684,8977134263,1001844976,8977131990,-2273,,
1096027116,8977384694,1002095407,8977382435,-2259,,
1096277557,8977635136,1002345848,8977632870,-2266,,
1096527877,8977885456,1002596169,8977883195,-2261,,
1096778241,8978135819,1002846532,8978133557,-2262,,
1097028815,8978386394,1003097107,8978384132,-2262,,
1097279068,8978636647,1003347359,8978634384,-2263,,
1097529238,8978886816,1003597529,8978884554,-2262,,
1097547187,8978904766,1003615478,8978902503,-2263,8978902537,
1097797473,8979155052,1003865765,8979152798,-2254,,
1098048329,8979405908,1004116620,8979403663,-2245,,
1098298821,8979656399,1004367112,8979654163,-2236,,
1098549382,8979906960,1004617673,8979904733,-2227,,
1098799834,8980157413,1004868125,8980155185,-2228,,
1099050192,8980407770,1005118483,8980405543,-2227,,
1099300812,8980658391,1005369104,8980656164,-2227,,
1099551398,8980908978,1005619691,8980906751,-2227,,
1099569505,8980927084,1005637796,8980924857,-2227,8980924818,
1099819908,8981177487,1005888199,8981175250,-2237,,
1100070596,8981428175,1006138897,8981425939,-2236,,
1100320713,8981678291,1006389004,8981676036,-2255,,
1100571068,8981928647,1006639360,8981926383,-2264,,
1100821180,8982178759,1006889472,8982176495,-2264,,
1101071872,8982429451,1007140179,8982427202,-2249,,
1101322524,8982680102,1007390815,8982677838,-2264,,
1101573561,8982931141,1007641854,8982928877,-2264,,
1101591527,8982949106,1007659818,8982946841,-2265,8982946867,
1101841870,8983199460,1007910172,8983197201,-2259,,
1102092150,8983449743,1008160456,8983447492,-2251,,
1102342578,8983700167,1008410880,8983697924,-2243,,
1102592948,8983950526,1008661239,8983948289,-2237,,
1102843582,8984201161,1008911873,8984198933,-2228,,
1103093718,8984451297,1009162009,8984449060,-2237,,
1103344497,8984702076,1009412788,8984699839,-2237,,
1103594720,8984952309,1009663021,8984950071,-2238,,
1103612865,8984970443,1009681156,8984968206,-2237,8984968203,
1103863196,8985220775,1009931487,8985218538,-2237,,
1104113708,8985471287,1010181999,8985469059,-2228,,
1104364082,8985721660,1010432373,8985719423,-2237,,
1104614326,8985971905,1010682617,8985969666,-2239,,
1104865334,8986222913,1010933626,8986220675,-2238,,
1105115921,8986473500,1011184212,8986471261,-2239,,
1105366080,8986723659,1011434371,8986721420,-2239,,
1105616226,8986973805,1011684517,8986971567,-2238,,
1105634286,8986991865,1011702577,8986989626,-2239,8986989568,
1105884430,8987242008,1011952720,8987239755,-2253,,
1106134779,8987492358,1012203070,8987490091,-2267,,
1106385367,8987742945,1012453658,8987740664,-2281,,
1106635624,8987993203,1012703915,8987990908,-2295,,
1106886087,8988243665,1012954378,8988241370,-2295,,
1107136247,8988493825,1013204538,8988491530,-2295,,
1107386518,8988744096,1013454809,8988741811,-2285,,
1107637347,8988994925,1013705638,8988992630,-2295,,
1107655402,8989012981,1013723693,8989010686,-2295,8989010731,
1107905502,8989263080,1013973793,8989260796,-2284,,
1108155645,8989513223,1014223936,8989510951,-2272,,
1108405814,8989763392,1014474104,8989761132,-2260,,
1108655946,8990013525,1014724247,8990011286,-2239,,
1108906117,8990263695,1014974408,8990261447,-2248,,
1109156671,8990514250,1015224962,8990512002,-2248,,
1109407024,8990764603,1015475315,8990762365,-2238,,
1109657576,8991015155,1015725868,8991012907,-2248,,
1109676607,8991034185,1015744897,8991031937,-2248,8991031407,
1109926950,8991284529,1015995242,8991282149,-2380,,
1110177344,8991534923,1016245635,8991532411,-2512,,
1110427895,8991785474,1016496186,8991782830,-2644,,
1110678198,8992035777,1016746489,8992033001,-2776,,
1110928581,8992286159,1016996872,8992283383,-2776,,
1111178960,8992536538,1017247251,8992533762,-2776,,
1111429435,8992787014,1017497726,8992784238,-2776,,
1111679986,8993037565,1017748277,8993034789,-2776,,
1111698910,8993056489,1017767201,8993053712,-2777,8993053757,
1111949190,8993306770,1018017482,8993304005,-2765,,
1112199388,8993556967,1018267679,8993554214,-2753,,
1112449957,8993807536,1018518249,8993804794,-2742,,
1112700812,8994058391,1018769119,8994055676,-2715,,
1112951690,8994309269,1019019982,8994306539,-2730,,
1113202119,8994559698,1019270410,8994556968,-2730,,
1113452414,8994809993,1019520705,8994807263,-2730,,
1113702881,8995060460,1019771173,8995057730,-2730,,
1113721028,8995078607,1019789319,8995075876,-2731,8995076236,
1113971582,8995329161,1020039874,8995326520,-2641,,
1114221744,8995579323,1020290035,8995576772,-2551,,
1114472616,8995830196,1020540908,8995827737,-2459,,
1114722751,8996080330,1020791043,8996077961,-2369,,
1114973041,8996330620,1021041333,8996328251,-2369,,
1115223393,8996580972,1021291684,8996578614,-2358,,
1115474198,8996831776,1021542500,8996829418,-2358,,
1115724594,8997082173,1021792886,8997079814,-2359,,
1115742646,8997100225,1021810937,8997097855,-2370,8997097894,
1115993082,8997350661,1022061374,8997348312,-2349,,
1116243342,8997600921,1022311633,8997598572,-2349,,
1116493940,8997851519,1022562232,8997849180,-2339,,
1116744146,8998101725,1022812437,8998099396,-2329,,
1116994684,8998352262,1023062975,8998349933,-2329,,
1117245011,8998602590,1023313302,8998600261,-2329,,
1117495585,8998853164,1023563876,8998850835,-2329,,
1117745915,8999103493,1023814206,8999101175,-2318,,
1117763877,8999121455,1023832168,8999119126,-2329,8999119134,
1118014529,8999372107,1024082820,8999369780,-2327,,
1118264670,8999622249,1024332961,8999619923,-2326,,
1118514878,8999872458,1024583171,8999870136,-2322,,
1118765391,9000122969,1024833682,9000120649,-2320,,
1119015613,9000373191,1025083904,9000370881,-2310,,
1119265736,9000623315,1025334027,9000620994,-2321,,
1119516298,9000873877,1025584589,9000871566,-2311,,
1119766417,9001123996,1025834708,9001121676,-2320,,
1119784457,9001142036,1025852748,9001139716,-2320,9001139692,
1120034558,9001392136,1026102848,9001389811,-2325,,
1120284777,9001642356,1026353068,9001640024,-2332,,
1120534876,9001892454,1026603167,9001890119,-2335,,
1120785399,9002142978,1026853690,9002140636,-2342,,
1121035949,9002393528,1027104240,9002391186,-2342,,
1121286558,9002644136,1027354849,9002641794,-2342,,
1121536904,9002894483,1027605195,9002892140,-2343,,
1121787131,9003144710,1027855422,9003142368,-2342,,
1121805162,9003162741,1027873453,9003160398,-2343,9003160507,
1122055732,9003413311,1028124023,9003410996,-2315,,
1122306019,9003663598,1028374310,9003661311,-2287,,
1122556617,9003914197,1028624910,9003911937,-2260,,
1122807316,9004164894,1028875607,9004162662,-2232,,
1123058024,9004415602,1029126315,9004413370,-2232,,
1123308534,9004666113,1029376825,9004663880,-2233,,
1123558647,9004916226,1029626938,9004913994,-2232,,
1123809035,9005166613,1029877326,9005164381,-2232,,
1123827017,9005184595,1029895308,9005182363,-2232,9005182326,
1124077278,9005434856,1030145569,9005432615,-2241,,
1124327877,9005685456,1030396168,9005683205,-2251,,
1124578266,9005935845,1030646557,9005933586,-2259,,
1124828764,9006186353,1030897065,9006184086,-2267,,
1125079765,9006437344,1031148057,9006435077,-2267,,
1125330179,9006687757,1031398469,9006685490,-2267,,
1125580720,9006938299,1031649012,9006936033,-2266,,
1125830979,9007188557,1031899270,9007186290,-2267,,
1125849156,9007206734,1031917447,9007204467,-2267,9007204356,
1126099670,9007457248,1032167961,9007454955,-2293,,
1126349785,9007707364,1032418076,9007705047,-2317,,
1126599907,9007957485,1032668197,9007955143,-2342,,
1126850047,9008207636,1032918349,9008205269,-2367,,
1127100388,9008457967,1033168679,9008455600,-2367,,
1127351080,9008708659,1033419372,9008706292,-2367,,
1127601912,9008959491,1033670204,9008957124,-2367,,
1127852129,9009209718,1033920431,9009207351,-2367,,
1127870188,9009227766,1033938478,9009225399,-2367,9009225399,
1128120503,9009478082,1034188794,9009475715,-2367,,
1128371002,9009728580,1034439293,9009726214,-2366,,
1128621102,9009978680,1034689393,9009976314,-2366,,
1128871595,9010229174,1034939887,9010226809,-2365,,
1129122043,9010479622,1035190334,9010477256,-2366,,
1129372143,9010729722,1035440434,9010727357,-2365,,
1129622258,9010979837,1035690549,9010977472,-2365,,
1129872842,9011230421,1035941134,9011228056,-2365,,
1129890950,9011248529,1035959241,9011246163,-2366,9011246125,
1130141121,9011498699,1036209412,9011496324,-2375,,
1130391289,9011748868,1036459580,9011746484,-2384,,
1130641582,9011999161,1036709873,9011996767,-2394,,
1130892088,9012249668,1036960381,9012247266,-2402,,
1131142375,9012499954,1037210666,9012497552,-2402,,
1131392602,9012750181,1037460893,9012747789,-2392,,
1131643091,9013000669,1037711382,9012998267,-2402,,
1131893756,9013251336,1037962049,9013248935,-2401,,
1131911841,9013269420,1037980132,9013267017,-2403,9013267027,
1132162106,9013519685,1038230397,9013517285,-2400,,
1132412715,9013770294,1038481006,9013767897,-2397,,
1132663293,9014020872,1038731585,9014018478,-2394,,
1132913646,9014271225,1038981937,9014268834,-2391,,
1133164005,9014521584,1039232296,9014519193,-2391,,
1133414152,9014771730,1039482443,9014769339,-2391,,
1133664370,9015021949,1039732661,9015019558,-2391,,
1133914658,9015272237,1039982950,9015269846,-2391,,
1133932659,9015290238,1040000950,9015287846,-2392,9015287901,
1134182956,9015540534,1040251247,9015538157,-2377,,
1134433116,9015790694,1040501407,9015788331,-2363,,
1134683597,9016041176,1040751888,9016038827,-2349,,
1134934491,9016292070,1041002783,9016289736,-2334,,
1135184691,9016542270,1041252983,9016539935,-2335,,
1135435224,9016792802,1041503515,9016790467,-2335,,
1135685685,9017043263,1041753976,9017040928,-2335,,
1135935850,9017293429,1042004152,9017291104,-2325,,
1135954066,9017311644,1042022356,9017309309,-2335,9017309258,
1136204661,9017562240,1042272953,9017559893,-2347,,
1136455136,9017812715,1042523428,9017810355,-2360,,
1136705742,9018063320,1042774033,9018060948,-2372,,
1136956031,9018313610,1043024332,9018311236,-2374,,
1137206495,9018564073,1043274786,9018561689,-2384,,
1137456881,9018814459,1043525172,9018812075,-2384,,
1137706997,9019064575,1043775288,9019062191,-2384,,
1137957484,9019315072,1044025785,9019312688,-2384,,
1137975595,9019333173,1044043886,9019330789,-2384,9019330794,
1138225957,9019583536,1044294248,9019581152,-2384,,
1138476737,9019834316,1044545039,9019831945,-2371,,
1138727033,9020084611,1044795324,9020082232,-2379,,
1138977467,9020335045,1045045768,9020332678,-2367,,
1139227984,9020585563,1045296275,9020583185,-2378,,
1139478159,9020835738,1045546450,9020833360,-2378,,
1139728276,9021085854,1045796567,9021083476,-2378,,
1139978803,9021336382,1046047104,9021334014,-2368,,
1139996956,9021354534,1046065246,9021352156,-2378,9021352156,
1140247338,9021604916,1046315629,9021602548,-2368,,
1140497655,9021855235,1046565947,9021852857,-2378,,
1140747978,9022105556,1046816268,9022103179,-2377,,
1140998213,9022355792,1047066504,9022353426,-2366,,
1141248393,9022605972,1047316684,9022603594,-2378,,
1141498881,9022856459,1047567172,9022854082,-2377,,
1141749010,9023106588,1047817301,9023104211,-2377,,
1141999695,9023357274,1048067987,9023354908,-2366,,
1142017849,9023375427,1048086140,9023373050,-2377,9023372960,
1142268016,9023625595,1048336307,9023623204,-2391,,
1142518884,9023876464,1048587176,9023874042,-2422,,
1142769291,9024126869,1048837582,9024124425,-2444,,
1143019447,9024377025,1049087738,9024374559,-2466,,
1143269669,9024627258,1049337971,9024624792,-2466,,
1143519900,9024877479,1049588191,9024875016,-2463,,
1143770415,9025127994,1049838707,9025125528,-2466,,
1144021194,9025378773,1050089486,9025376307,-2466,,
1144039194,9025396773,1050107485,9025394306,-2467,9025394320,
1144289465,9025647055,1050357768,9025644592,-2463,,
1144540414,9025897993,1050608705,9025895534,-2459,,
1144790556,9026148134,1050858847,9026145690,-2444,,
1145041351,9026398940,1051109652,9026396489,-2451,,
1145291855,9026649433,1051360146,9026646992,-2441,,
1145542234,9026899813,1051610525,9026897361,-2452,,
1145792748,9027150326,1051861039,9027147875,-2451,,
1146043141,9027400720,1052111442,9027398278,-2442,,
1146061155,9027418733,1052129446,9027416282,-2451,9027416379,
1146311524,9027669103,1052379815,9027666676,-2427,,
1146562082,9027919662,1052630374,9027917260,-2402,,
1146812662,9028170240,1052880953,9028167863,-2377,,
1147063175,9028420764,1053131476,9028418412,-2352,,
1147313992,9028671580,1053382293,9028669228,-2352,,
1147564554,9028922132,1053632845,9028919790,-2342,,
1147815093,9029172672,1053883384,9029170320,-2352,,
1148065195,9029422773,1054133486,9029420421,-2352,,
1148083205,9029440783,1054151495,9029438431,-2352,9029438359,
1148333609,9029691188,1054401900,9029688819,-2369,,
1148583923,9029941502,1054652214,9029939115,-2387,,
1148834070,9030191649,1054902361,9030189245,-2404,,
1149084716,9030442306,1055153018,9030439884,-2422,,
1149335350,9030692929,1055403641,9030690507,-2422,,
1149585790,9030943369,1055654092,9030940958,-2411,,
1149836244,9031193833,1055904546,9031191411,-2422,,
1150086987,9031444566,1056155289,9031442154,-2412,,
1150105053,9031462631,1056173344,9031460209,-2422,9031460198,
1150355304,9031712882,1056423595,9031710457,-2425,,
1150605673,9031963253,1056673966,9031960826,-2427,,
1150856309,9032213887,1056924600,9032211458,-2429,,
1151106576,9032464165,1057174878,9032461733,-2432,,
1151356701,9032714279,1057424992,9032711847,-2432,,
1151606867,9032964446,1057675158,9032962023,-2423,,
1151857179,9033214757,1057925469,9033212325,-2432,,
1152108193,9033465783,1058176495,9033463351,-2432,,
1152126228,9033483806,1058194519,9033481374,-2432,9033481395,
1152376939,9033734518,1058445230,9033732090,-2428,,
1152627342,9033984921,1058695633,9033982500,-2421,,
1152877546,9034235124,1058945837,9034232709,-2415,,
1153127662,9034485240,1059195953,9034482841,-2399,,
1153377988,9034735566,1059446279,9034733156,-2410,,
1153628223,9034985802,1059696514,9034983392,-2410,,
1153878298,9035235877,1059946589,9035233466,-2411,,
1154129280,9035486859,1060197571,9035484458,-2401,,
1154147269,9035504848,1060215560,9035502437,-2411,9035502434,
1154397784,9035755362,1060466075,9035752951,-2411,,
1154647989,9036005568,1060716291,9036003167,-2401,,
1154898707,9036256286,1060966998,9036253874,-2412,,
1155149033,9036506622,1061217335,9036504210,-2412,,
1155399752,9036757331,1061468043,9036754919,-2412,,
1155650017,9037007596,1061718309,9037005184,-2412,,
1155901006,9037258585,1061969297,9037256172,-2413,,
1156151553,9037509132,1062219855,9037506731,-2401,,
1156169571,9037527149,1062237862,9037524737,-2412,9037524696,
1156419813,9037777403,1062488115,9037774979,-2424,,
1156670073,9038027652,1062738364,9038025229,-2423,,
1156920403,9038277982,1062988694,9038275549,-2433,,
1157171093,9038528671,1063239394,9038526229,-2442,,
1157421205,9038778783,1063489496,9038776331,-2452,,
1157671453,9039029033,1063739746,9039026581,-2452,,
1157921906,9039279495,1063990207,9039277043,-2452,,
1158172110,9039529689,1064240402,9039527237,-2452,,
1158190026,9039547604,1064258316,9039545152,-2452,9039545149,
1158440452,9039798031,1064508743,9039795578,-2453,,
1158690877,9040048455,1064759168,9040046012,-2443,,
1158941256,9040298835,1065009547,9040296382,-2453,,
1159191570,9040549148,1065259871,9040546705,-2443,,
1159441782,9040799361,1065510074,9040796908,-2453,,
1159691921,9041049511,1065760223,9041047058,-2453,,
1159942277,9041299856,1066010568,9041297402,-2454,,
1160192856,9041550434,1066261147,9041547981,-2453,,
1160211039,9041568618,1066279330,9041566165,-2453,9041566254,
1160461395,9041818973,1066529686,9041816542,-2431,,
1160712029,9042069618,1066780330,9042067209,-2409,,
1160962241,9042319820,1067030532,9042317434,-2386,,
1161212411,9042570000,1067280713,9042567638,-2362,,
1161462504,9042820082,1067530795,9042817720,-2362,,
1161713470,9043071049,1067781761,9043068687,-2362,,
1161963849,9043321438,1068032150,9043319076,-2362,,
1162214028,9043571606,1068282319,9043569244,-2362,,
1162232015,9043589593,1068300305,9043587231,-2362,9043587123,
1162482772,9043840351,1068551063,9043837962,-2389,,
1162732955,9044090534,1068801246,9044088118,-2416,,
1162983277,9044340856,1069051569,9044338415,-2441,,
1163233659,9044591238,1069301950,9044588770,-2468,,
1163484164,9044841743,1069552455,9044839275,-2468,,
1163734544,9045092123,1069802836,9045089655,-2468,,
1163984785,9045342364,1070053077,9045339896,-2468,,
1164234959,9045592538,1070303250,9045590070,-2468,,
1164252983,9045610562,1070321274,9045608093,-2469,9045608080,
1164503292,9045860870,1070571583,9045858399,-2471,,
1164753779,9046111358,1070822070,9046108883,-2475,,
1165003975,9046361553,1071072266,9046359086,-2467,,
1165254396,9046611975,1071322688,9046609495,-2480,,
1165504916,9046862495,1071573208,9046860015,-2480,,
1165755329,9047112908,1071823620,9047110427,-2481,,
1166005907,9047363496,1072074209,9047361016,-2480,,
1166256428,9047614007,1072324719,9047611527,-2480,,
1166274530,9047632109,1072342821,9047629628,-2481,9047629675,
1166524935,9047882514,1072593227,9047880045,-2469,,
1166775100,9048132679,1072843391,9048130222,-2457,,
1167025296,9048382876,1073093589,9048380432,-2444,,
1167275402,9048632981,1073343693,9048630549,-2432,,
1167525798,9048883376,1073594088,9048880944,-2432,,
1167775978,9049133556,1073844269,9049131124,-2432,,
1168026155,9049383734,1074094446,9049381302,-2432,,
1168276754,9049634332,1074345045,9049631900,-2432,,
1168294769,9049652348,1074363060,9049649916,-2432,9049649931,
1168544888,9049902467,1074613179,9049900038,-2429,,
1168795516,9050153094,1074863817,9050150680,-2414,,
1169045695,9050403273,1075113986,9050400853,-2420,,
1169296376,9050653955,1075364668,9050651540,-2415,,
1169546520,9050904099,1075614811,9050901683,-2416,,
1169796670,9051154248,1075864961,9051151833,-2415,,
1170046776,9051404355,1076115067,9051401940,-2415,,
1170297588,9051655167,1076365880,9051652752,-2415,,
1170315976,9051673554,1076384266,9051671139,-2415,9051670976,
1170566091,9051923670,1076634383,9051921216,-2454,,
1170816224,9052173803,1076884515,9052171308,-2495,,
1171066307,9052423885,1077134598,9052421360,-2525,,
1171316483,9052674072,1077384785,9052671496,-2576,,
1171566907,9052924486,1077635198,9052921909,-2577,,
1171817151,9053174729,1077885442,9053172153,-2576,,
1172067405,9053424994,1078135707,9053422418,-2576,,
1172317730,9053675319,1078386032,9053672743,-2576,,
1172335906,9053693485,1078404197,9053690908,-2577,9053690905,
1172586325,9053943905,1078654617,9053941327,-2578,,
1172836654,9054194233,1078904945,9054191655,-2578,,
1173086867,9054444446,1079155168,9054441878,-2568,,
1173337162,9054694751,1079405464,9054692173,-2578,,
1173587861,9054945440,1079656153,9054942862,-2578,,
1173838148,9055195726,1079906439,9055193148,-2578,,
1174088929,9055446508,1080157231,9055443940,-2568,,
1174339151,9055696741,1080407453,9055694162,-2579,,
1174357183,9055714762,1080425474,9055712183,-2579,9055712276,
1174607671,9055965250,1080675963,9055962696,-2554,,
1174858208,9056215787,1080926499,9056213256,-2531,,
1175109193,9056466771,1081177484,9056464264,-2507,,
1175359919,9056717509,1081428221,9056715025,-2484,,
1175610490,9056968068,1081678781,9056965584,-2484,,
1175860920,9057218499,1081929212,9057216015,-2484,,
1176111429,9057469008,1082179720,9057466523,-2485,,
1176361783,9057719372,1082430085,9057716888,-2484,,
1176379831,9057737410,1082448122,9057734925,-2485,9057734909,
1176630065,9057987645,1082698357,9057985156,-2489,,
1176880942,9058238521,1082949234,9058236029,-2492,,
1177131550,9058489140,1083199852,9058486644,-2496,,
1177381860,9058739439,1083450152,9058736940,-2499,,
1177632584,9058990163,1083700875,9058987674,-2489,,
1177882934,9059240512,1083951225,9059238013,-2499,,
1178133181,9059490760,1084201473,9059488261,-2499,,
1178383656,9059741235,1084451948,9059738737,-2498,,
1178401700,9059759279,1084469991,9059756779,-2500,9059756812,
1178652076,9060009654,1084720367,9060007163,-2491,,
1178902516,9060260094,1084970807,9060257612,-2482,,
1179153095,9060510674,1085221386,9060508200,-2474,,
1179403575,9060761164,1085471877,9060758699,-2465,,
1179654018,9061011608,1085722320,9061009143,-2465,,
1179904440,9061262019,1085972731,9061259553,-2466,,
1180154744,9061512323,1086223035,9061509858,-2465,,
1180405437,9061763016,1086473729,9061760551,-2465,,
1180423550,9061781129,1086491841,9061778664,-2465,9061778599,
1180674135,9062031714,1086742426,9062029231,-2483,,
1180924309,9062281888,1086992600,9062279390,-2498,,
1181174984,9062532562,1087243275,9062530049,-2513,,
1181425638,9062783217,1087493930,9062780690,-2527,,
1181676013,9063033592,1087744304,9063031073,-2519,,
1181926411,9063283990,1087994702,9063281462,-2528,,
1182177015,9063534594,1088245306,9063532065,-2529,,
1182427466,9063785055,1088495767,9063782527,-2528,,
1182445630,9063803208,1088513921,9063800680,-2528,9063800655,
1182696592,9064054171,1088764883,9064051646,-2525,,
1182946958,9064304537,1089015249,9064301996,-2541,,
1183197141,9064554719,1089265432,9064552173,-2546,,
1183447502,9064805091,1089515803,9064802539,-2552,,
1183697977,9065055567,1089766279,9065053015,-2552,,
1183948501,9065306080,1090016792,9065303527,-2553,,
1184198633,9065556212,1090266924,9065553659,-2553,,
1184449450,9065807029,1090517742,9065804477,-2552,,
1184467467,9065825045,1090535757,9065822493,-2552,9065822502,
1184717952,9066075530,1090786243,9066072981,-2549,,
1184968574,9066326153,1091036865,9066323605,-2548,,
1185219014,9066576592,1091287305,9066574048,-2544,,
1185469232,9066826811,1091537523,9066824270,-2541,,
1185719540,9067077119,1091787831,9067074577,-2542,,
1185969742,9067327321,1092038033,9067324790,-2531,,
1186220142,9067577720,1092288433,9067575179,-2541,,
1186470299,9067827878,1092538591,9067825337,-2541,,
1186488262,9067845840,1092556552,9067843299,-2541,9067843346,
1186738561,9068096140,1092806852,9068093612,-2528,,
1186989090,9068346668,1093057381,9068344152,-2516,,
1187239218,9068596796,1093307509,9068594292,-2504,,
1187489766,9068847344,1093558057,9068844852,-2492,,
1187740070,9069097648,1093808361,9069095156,-2492,,
1187990764,9069348343,1094059055,9069345850,-2493,,
1188241012,9069598591,1094309303,9069596098,-2493,,
1188491300,9069848878,1094559591,9069846386,-2492,,
1188509360,9069866939,1094577661,9069864456,-2483,9069864385,
1188760030,9070117608,1094828321,9070115100,-2508,,
1189010323,9070367902,1095078615,9070365379,-2523,,
1189260554,9070618133,1095328845,9070615596,-2537,,
1189510780,9070868359,1095579071,9070865807,-2552,,
1189761436,9071119014,1095829726,9071116462,-2552,,
1190012156,9071369734,1096080447,9071367182,-2552,,
1190262533,9071620111,1096330824,9071617559,-2552,,
1190513255,9071870833,1096581546,9071868281,-2552,,
1190531299,9071888877,1096599590,9071886325,-2552,9071886333,
1190781767,9072139346,1096850058,9072136796,-2550,,
1191032167,9072389746,1097100458,9072387197,-2549,,
1191282361,9072639940,1097350652,9072637395,-2545,,
1191532884,9072890463,1097601175,9072887919,-2544,,
1191783428,9073141006,1097851719,9073138463,-2543,,
1192033969,9073391547,1098102260,9073389004,-2543,,
1192284475,9073642053,1098352766,9073639520,-2533,,
1192534901,9073892480,1098603192,9073889937,-2543,,
1192553016,9073910595,1098621307,9073908051,-2544,9073908073,
1192803730,9074161309,1098872022,9074158771,-2538,,
1193054005,9074411583,1099122296,9074409051,-2532,,
1193304848,9074662437,1099373149,9074659911,-2526,,
1193555018,9074912597,1099623309,9074910077,-2520,,
1193805257,9075162835,1099873548,9075160315,-2520,,
1194055869,9075413448,1100124161,9075410928,-2520,,
1194306532,9075664111,1100374823,9075661590,-2521,,
1194557031,9075914610,1100625323,9075912090,-2520,,
1194575115,9075932693,1100643405,9075930173,-2520,9075930135,
1194825786,9076183364,1100894076,9076180835,-2529,,
1195076663,9076434242,1101144954,9076431704,-2538,,
1195326821,9076684400,1101395113,9076681853,-2547,,
1195577175,9076934754,1101645466,9076932198,-2556,,
1195827822,9077185401,1101896113,9077182844,-2557,,
1196078178,9077435756,1102146469,9077433200,-2556,,
1196328344,9077685933,1102396646,9077683377,-2556,,
1196578715,9077936294,1102647007,9077933738,-2556,,
1196596726,9077954304,1102665017,9077951748,-2556,9077951765,
1196847044,9078204623,1102915336,9078202070,-2553,,
1197097213,9078454791,1103165503,9078452243,-2548,,
1197347392,9078704971,1103415684,9078702428,-2543,,
1197597574,9078955152,1103665865,9078952614,-2538,,
1197848068,9079205656,1103916369,9079203118,-2538,,
1198098570,9079456149,1104166861,9079453611,-2538,,
1198349017,9079706606,1104417319,9079704068,-2538,,
1198599175,9079956754,1104667467,9079954216,-2538,,
1198617308,9079974886,1104685599,9079972348,-2538,9079972311,
1198867528,9080225106,1104935819,9080222558,-2548,,
1199118364,9080475943,1105186655,9080473386,-2557,,
1199368580,9080726159,1105436883,9080723605,-2554,,
1199618849,9080976428,1105687140,9080973854,-2574,,
1199869060,9081226639,1105937351,9081224075,-2564,,
1200119698,9081477276,1106187989,9081474702,-2574,,
1200369845,9081727424,1106438137,9081724850,-2574,,
1200620445,9081978025,1106688737,9081975451,-2574,,
1200638606,9081996184,1106706897,9081993610,-2574,9081993660,
1200889078,9082246667,1106957379,9082244106,-2561,,
1201139377,9082496956,1107207668,9082494408,-2548,,
1201389788,9082747367,1107458079,9082744832,-2535,,
1201640213,9082997792,1107708504,9082995269,-2523,,
1201891071,9083248650,1107959363,9083246138,-2512,,
1202141374,9083498952,1108209665,9083496430,-2522,,
1202391510,9083749100,1108459812,9083746578,-2522,,
1202641935,9083999513,1108710226,9083996991,-2522,,
1202660014,9084017593,1108728305,9084015070,-2523,9084015041,
1202910425,9084268004,1108978727,9084265485,-2519,,
1203160606,9084518185,1109228897,9084515649,-2536,,
1203411108,9084768697,1109479409,9084766154,-2543,,
1203661635,9085019214,1109729927,9085016664,-2550,,
1203912143,9085269723,1109980435,9085267173,-2550,,
1204162337,9085519916,1110230638,9085517376,-2540,,
1204412757,9085770345,1110481058,9085767795,-2550,,
1204663224,9086020803,1110731515,9086018253,-2550,,
1204681359,9086038938,1110749650,9086036388,-2550,9086036409,
1204931881,9086289460,1111000173,9086286916,-2544,,
1205182391,9086539971,1111250684,9086537433,-2538,,
1205432638,9086790218,1111500930,9086787686,-2532,,
1205683513,9087041092,1111751805,9087038565,-2527,,
1205933833,9087291412,1112002125,9087288885,-2527,,
1206183941,9087541520,1112252232,9087539003,-2517,,
1206434386,9087791975,1112502688,9087789448,-2527,,
1206684781,9088042359,1112753072,9088039832,-2527,,
1206702935,9088060513,1112771225,9088057986,-2527,9088057985,
1206953414,9088310993,1113021706,9088308466,-2527,,
1207204002,9088561581,1113272293,9088559054,-2527,,
1207454284,9088811863,1113522576,9088809337,-2526,,
1207705115,9089062704,1113773417,9089060178,-2526,,
1207955270,9089312849,1114023561,9089310333,-2516,,
1208205598,9089563177,1114273889,9089560650,-2527,,
1208455781,9089813360,1114524072,9089810833,-2527,,
1208706182,9090063761,1114774473,9090061234,-2527,,
1208724258,9090081836,1114792548,9090079310,-2526,9090079245,
1208974577,9090332155,1115042868,9090329613,-2542,,
1209225168,9090582746,1115293469,9090580199,-2547,,
1209475613,9090833191,1115543904,9090830618,-2573,,
1209726157,9091083736,1115794448,9091081146,-2590,,
1209976309,9091333888,1116044600,9091331309,-2579,,
1210226648,9091584227,1116294939,9091581638,-2589,,
1210476846,9091834425,1116545137,9091831836,-2589,,
1210727197,9092084776,1116795488,9092082187,-2589,,
1210745338,9092102917,1116813629,9092100328,-2589,9092100326,
1210995440,9092353019,1117063731,9092350428,-2591,,
1211246188,9092603766,1117314479,9092601176,-2590,,
1211496278,9092853867,1117564579,9092851278,-2589,,
1211746407,9093103985,1117814698,9093101396,-2589,,
1211996509,9093354087,1118064800,9093351498,-2589,,
1212246901,9093604479,1118315192,9093601890,-2589,,
1212497367,9093854946,1118565658,9093852356,-2590,,
1212747992,9094105570,1118816283,9094102981,-2589,,
1212766169,9094123747,1118834459,9094121158,-2589,9094121184,
1213016340,9094373919,1119084631,9094371336,-2583,,
1213266931,9094624510,1119335223,9094621934,-2576,,
1213517616,9094875206,1119585918,9094872637,-2569,,
1213767911,9095125490,1119836202,9095122928,-2562,,
1214018439,9095376018,1120086730,9095373455,-2563,,
1214269403,9095626981,1120337694,9095624419,-2562,,
1214519673,9095877261,1120587974,9095874699,-2562,,
1214770271,9096127850,1120838562,9096125287,-2563,,
1214788427,9096146005,1120856717,9096143443,-2562,9096143420,
1215039175,9096396754,1121107467,9096394186,-2568,,
1215289527,9096647117,1121357830,9096644545,-2572,,
1215539632,9096897211,1121607924,9096894643,-2568,,
1215790122,9097147700,1121858413,9097145117,-2583,,
1216040608,9097398186,1122108899,9097395603,-2583,,
1216291166,9097648745,1122359457,9097646172,-2573,,
1216541753,9097899331,1122610044,9097896748,-2583,,
1216791930,9098149508,1122860221,9098146926,-2582,,
1216809980,9098167558,1122878271,9098164975,-2583,9098164972,
1217060211,9098417790,1123128502,9098415206,-2584,,
1217310338,9098667917,1123378630,9098665333,-2584,,
1217560545,9098918124,1123628836,9098915539,-2585,,
1217811159,9099168738,1123879451,9099166153,-2585,,
1218061303,9099418882,1124129594,9099416297,-2585,,
1218311478,9099669057,1124379769,9099666471,-2586,,
1218561621,9099919200,1124629912,9099916615,-2585,,
1218812250,9100169829,1124880541,9100167244,-2585,,
1218830402,9100187981,1124898693,9100185395,-2586,9100185419,
1219080723,9100438302,1125149014,9100435723,-2579,,
1219331357,9100688936,1125399649,9100686373,-2563,,
1219581861,9100939439,1125650162,9100936883,-2556,,
1219832181,9101189759,1125900472,9101187199,-2560,,
1220082319,9101439898,1126150610,9101437338,-2560,,
1220332804,9101690383,1126401095,9101687822,-2561,,
1220583409,9101940989,1126651701,9101938429,-2560,,
1220833869,9102191448,1126902161,9102188888,-2560,,
1220852045,9102209623,1126920335,9102207063,-2560,9102207024,
1221102246,9102459825,1127170537,9102457256,-2569,,
1221352682,9102710261,1127420974,9102707682,-2579,,
1221603029,9102960607,1127671320,9102958019,-2588,,
1221853409,9103210988,1127921700,9103208391,-2597,,
1222103959,9103461537,1128172250,9103458940,-2597,,
1222354609,9103712188,1128422910,9103709601,-2587,,
1222604887,9103962467,1128673180,9103959870,-2597,,
1222855163,9104212741,1128923454,9104210144,-2597,,
1222873273,9104230851,1128941564,9104228254,-2597,9104228220,
1223123771,9104481350,1129192062,9104478744,-2606,,
1223374551,9104732130,1129442842,9104729516,-2614,,
1223625018,9104982597,1129693309,9104979975,-2622,,
1223875668,9105233247,1129943960,9105230617,-2630,,
1224125800,9105483379,1130194091,9105480749,-2630,,
1224376614,9105734193,1130444905,9105731562,-2631,,
1224627069,9105984648,1130695361,9105982019,-2629,,
1224877686,9106235274,1130945987,9106232645,-2629,,
1224895843,9106253421,1130964133,9106250791,-2630,9106250784,
1225146469,9106504047,1131214760,9106501415,-2632,,
1225396761,9106754340,1131465052,9106751707,-2633,,
1225647333,9107004921,1131715634,9107002286,-2635,,
1225897528,9107255107,1131965830,9107252482,-2625,,
1226147780,9107505359,1132216071,9107502723,-2636,,
1226397952,9107755531,1132466243,9107752894,-2637,,
1226648973,9108006553,1132717266,9108003917,-2636,,
1226899288,9108256877,1132967589,9108254240,-2637,,
1226917375,9108274953,1132985665,9108272317,-2636,9108272329,
1227167655,9108525234,1133235946,9108522611,-2623,,
1227418342,9108775920,1133486633,9108773291,-2629,,
1227668549,9109026137,1133736850,9109023512,-2625,,
1227919087,9109276665,1133987378,9109274043,-2622,,
1228169508,9109527087,1134237799,9109524465,-2622,,
1228420239,9109777818,1134488530,9109775195,-2623,,
1228670401,9110027980,1134738692,9110025358,-2622,,
1228920590,9110278168,1134988881,9110275546,-2622,,
1228938851,9110296430,1135007142,9110293807,-2623,9110293748,
1229189671,9110547250,1135257962,9110544611,-2639,,
1229440077,9110797655,1135508368,9110795003,-2652,,
1229690457,9111048036,1135758749,9111045370,-2666,,
1229940596,9111298175,1136008887,9111295495,-2680,,
1230191008,9111548586,1136259299,9111545906,-2680,,
1230441615,9111799194,1136509906,9111796513,-2681,,
1230692518,9112050107,1136760819,9112047427,-2680,,
1230943128,9112300707,1137011419,9112298038,-2669,,
1230961264,9112318842,1137029555,9112316162,-2680,9112316203,
1231211741,9112569320,1137280032,9112566650,-2670,,
1231462187,9112819766,1137530478,9112817106,-2660,,
1231712611,9113070190,1137780903,9113067542,-2648,,
1231963564,9113321143,1138031856,9113318505,-2638,,
1232214253,9113571831,1138282544,9113569193,-2638,,
1232464497,9113822076,1138532788,9113819437,-2639,,
1232715330,9114072909,1138783633,9114070282,-2627,,
1232965675,9114323253,1139033966,9114320615,-2638,,
1232983813,9114341391,1139052104,9114338753,-2638,9114338758,
1233234058,9114591636,1139302349,9114588999,-2637,,
1233484491,9114842070,1139552782,9114839435,-2635,,
1233734760,9115092339,1139803051,9115089705,-2634,,
1233984887,9115342466,1140053178,9115339844,-2622,,
1234235123,9115592702,1140303414,9115590070,-2632,,
1234485566,9115843145,1140553857,9115840522,-2623,,
1234736142,9116093721,1140804433,9116091089,-2632,,
1234986485,9116344064,1141054776,9116341432,-2632,,
1235004530,9116362109,1141072821,9116359477,-2632,9116359503,
1235255063,9116612642,1141323354,9116610016,-2626,,
1235505453,9116863032,1141573744,9116860414,-2618,,
1235756118,9117113697,1141824409,9117111086,-2611,,
1236006362,9117363940,1142074653,9117361336,-2604,,
1236256565,9117614144,1142324856,9117611540,-2604,,
1236506796,9117864374,1142575087,9117861770,-2604,,
1236757155,9118114733,1142825446,9118112129,-2604,,
1237007316,9118364895,1143075607,9118362290,-2605,,
1237025408,9118382986,1143093699,9118380382,-2604,9118380302,
1237275648,9118633226,1143343939,9118630601,-2625,,
1237525778,9118883357,1143594069,9118880713,-2644,,
1237776425,9119134003,1143844716,9119131339,-2664,,
1238027298,9119384877,1144095589,9119382193,-2684,,
1238277826,9119635405,1144346118,9119632722,-2683,,
1238528321,9119885900,1144596612,9119883217,-2683,,
1238778565,9120136144,1144846856,9120133470,-2674,,
1239028705,9120386283,1145096996,9120383600,-2683,,
1239046846,9120404425,1145115137,9120401741,-2684,9120401759,
1239297080,9120654658,1145365371,9120651979,-2679,,
1239547464,9120905042,1145615754,9120902368,-2674,,
1239797945,9121155535,1145866247,9121152866,-2669,,
1240048115,9121405694,1146116406,9121403029,-2665,,
1240298487,9121656065,1146366778,9121653401,-2664,,
1240549098,9121906676,1146617399,9121904022,-2654,,
1240799627,9122157206,1146867918,9122154542,-2664,,
1241049994,9122407573,1147118295,9122404919,-2654,,
1241068109,9122425688,1147136400,9122423023,-2665,9122423016,
1241318382,9122675960,1147386673,9122673294,-2666,,
1241569083,9122926662,1147637374,9122923995,-2667,,
1241819886,9123177464,1147888176,9123174796,-2668,,
1242070027,9123427606,1148138318,9123424936,-2670,,
1242320520,9123678099,1148388811,9123675429,-2670,,
1242571085,9123928663,1148639376,9123925993,-2670,,
1242821437,9124179016,1148889728,9124176346,-2670,,
1243071564,9124429143,1149139866,9124426483,-2660,,
1243089801,9124447380,1149158092,9124444709,-2671,9124444818,
1243340302,9124697881,1149408593,9124695237,-2644,,
1243590869,9124948448,1149659161,9124945832,-2616,,
1243841819,9125199398,1149910110,9125196809,-2589,,
1244092336,9125449915,1150160627,9125447365,-2550,,
1244342607,9125700185,1150410898,9125697625,-2560,,
1244593482,9125951062,1150661775,9125948502,-2560,,
1244843859,9126201437,1150912149,9126198877,-2560,,
1245094150,9126451729,1151162441,9126449169,-2560,,
1245112247,9126469825,1151180538,9126467265,-2560,9126467187,
1245362409,9126719988,1151430700,9126717408,-2580,,
1245612546,9126970125,1151680838,9126967526,-2599,,
1245863050,9127220629,1151931341,9127218011,-2618,,
1246113852,9127471431,1152182144,9127468795,-2636,,
1246364076,9127721655,1152432367,9127719017,-2638,,
1246614315,9127971895,1152682607,9127969258,-2637,,
1246864503,9128222082,1152932795,9128219445,-2637,,
1247115114,9128472703,1153183416,9128470066,-2637,,
1247133097,9128490675,1153201388,9128488038,-2637,9128488036,
1247383825,9128741403,1153452116,9128738766,-2637,,
1247634304,9128991883,1153702595,9128989245,-2638,,
1247884587,9129242177,1153952889,9129239540,-2637,,
1248135038,9129492617,1154203330,9129489980,-2637,,
1248385378,9129742957,1154453669,9129740319,-2638,,
1248635814,9129993394,1154704107,9129990757,-2637,,
1248886334,9130243912,1154954625,9130241275,-2637,,
1249136675,9130494254,1155204966,9130491616,-2638,,
1249154708,9130512287,1155222999,9130509649,-2638,9130509553,
1249405394,9130762973,1155473685,9130760311,-2662,,
1249655719,9131013309,1155724021,9131010624,-2685,,
1249906363,9131263942,1155974654,9131261233,-2709,,
1250156484,9131514063,1156224775,9131511331,-2732,,
1250407152,9131764741,1156475453,9131762008,-2733,,
1250657760,9132015340,1156726052,9132012608,-2732,,
1250907988,9132265567,1156976280,9132262835,-2732,,
1251158592,9132516170,1157226883,9132513448,-2722,,
1251176707,9132534286,1157244998,9132531554,-2732,9132531564,
1251427147,9132784726,1157495448,9132782007,-2719,,
1251677629,9133035207,1157745920,9133032481,-2726,,
1251928064,9133285643,1157996356,9133282921,-2722,,
1252179064,9133536642,1158247355,9133533932,-2710,,
1252429623,9133787213,1158497925,9133784493,-2720,,
1252680543,9134038123,1158748835,9134035403,-2720,,
1252930670,9134288249,1158998961,9134285529,-2720,,
1253180985,9134538564,1159249276,9134535843,-2721,,
1253198928,9134556506,1159267218,9134553786,-2720,9134553815,
1253449518,9134807097,1159517809,9134804385,-2712,,
1253699784,9135057363,1159768075,9135054658,-2705,,
1253950160,9135307738,1160018451,9135305042,-2696,,
1254200828,9135558407,1160269119,9135555717,-2690,,
1254451194,9135808773,1160519485,9135806083,-2690,,
1254701563,9136059142,1160769855,9136056454,-2688,,
1254951780,9136309358,1161020071,9136306669,-2689,,
1255201891,9136559470,1161270182,9136556781,-2689,,
1255220015,9136577593,1161288306,9136574904,-2689,9136574837,
1255470395,9136827974,1161538687,9136825269,-2705,,
1255720804,9137078383,1161789095,9137075662,-2721,,
1255971565,9137329144,1162039856,9137326405,-2739,,
1256222054,9137579633,1162290345,9137576878,-2755,,
1256472598,9137830177,1162540889,9137827422,-2755,,
1256722708,9138080287,1162790999,9138077533,-2754,,
1256972911,9138330490,1163041202,9138327736,-2754,,
1257223085,9138580664,1163291376,9138577910,-2754,,
1257241136,9138598715,1163309427,9138595960,-2755,9138595999,
1257491630,9138849209,1163559921,9138846463,-2746,,
1257742092,9139099671,1163810383,9139096936,-2735,,
1257992497,9139350075,1164060788,9139347350,-2725,,
1258242659,9139600237,1164310950,9139597523,-2714,,
1258493412,9139851000,1164561713,9139848286,-2714,,
1258744024,9140101603,1164812315,9140098889,-2714,,
1258994791,9140352369,1165063082,9140349655,-2714,,
1259245150,9140602729,1165313441,9140600014,-2715,,
1259263293,9140620872,1165331584,9140618157,-2715,9140618114,
1259513621,9140871200,1165581913,9140868475,-2725,,
1259764023,9141121602,1165832315,9141118867,-2735,,
1260014277,9141371856,1166082568,9141369110,-2746,,
1260264941,9141622520,1166333232,9141619763,-2757,,
1260515292,9141872870,1166583593,9141870124,-2746,,
1260765937,9142123516,1166834239,9142120770,-2746,,
1261016067,9142373646,1167084358,9142370890,-2756,,
1261266944,9142624523,1167335235,9142621767,-2756,,
1261285044,9142642622,1167353334,9142639866,-2756,9142639927,
1261535674,9142893253,1167603976,9142890522,-2731,,
1261786228,9143143808,1167854520,9143141083,-2725,,
1262036720,9143394299,1168105022,9143391600,-2699,,
1262287021,9143644599,1168355312,9143641905,-2694,,
1262537202,9143894792,1168605505,9143892098,-2694,,
1262787395,9144144974,1168855686,9144142280,-2694,,
1263037676,9144395255,1169105967,9144392560,-2695,,
1263288095,9144645674,1169356386,9144642980,-2694,,
1263306262,9144663840,1169374552,9144661146,-2694,9144661058,
1263556838,9144914416,1169625129,9144911700,-2716,,
1263807204,9145164784,1169875497,9145162047,-2737,,
1264057367,9145414957,1170125669,9145412197,-2760,,
1264307596,9145665174,1170375887,9145662394,-2780,,
1264558211,9145915790,1170626502,9145913020,-2770,,
1264808428,9146166017,1170876730,9146163237,-2780,,
1265059002,9146416581,1171127294,9146413801,-2780,,
1265309427,9146667006,1171377718,9146664225,-2781,,
1265327542,9146685120,1171395833,9146682340,-2780,9146682414,
1265578050,9146935628,1171646341,9146932866,-2762,,
1265828571,9147186149,1171896862,9147183406,-2743,,
1266079022,9147436601,1172147314,9147433877,-2724,,
1266329593,9147687172,1172397884,9147684467,-2705,,
1266580181,9147937760,1172648472,9147935055,-2705,,
1266831036,9148188615,1172899328,9148185911,-2704,,
1267081494,9148439073,1173149785,9148436378,-2695,,
1267331983,9148689561,1173400273,9148686856,-2705,,
1267350175,9148707753,1173418466,9148705048,-2705,9148705030,
1267600642,9148958221,1173668943,9148955520,-2701,,
1267851052,9149208631,1173919344,9149205918,-2713,,
1268101446,9149459025,1174169748,9149456318,-2707,,
1268351868,9149709447,1174420159,9149706724,-2723,,
1268602536,9149960114,1174670838,9149957403,-2711,,
1268853090,9150210670,1174921383,9150207948,-2722,,
1269103212,9150460791,1175171503,9150458079,-2712,,
1269353854,9150711432,1175422145,9150708710,-2722,,
1269371882,9150729461,1175440173,9150726738,-2723,9150726798,
1269622390,9150979968,1175690681,9150977261,-2707,,
1269872794,9151230373,1175941086,9151227682,-2691,,
1270123376,9151480965,1176191678,9151478289,-2676,,
1270373702,9151731281,1176441993,9151728619,-2662,,
1270623897,9151981476,1176692188,9151978815,-2661,,
1270874368,9152231947,1176942660,9152229286,-2661,,
1271124532,9152482111,1177192823,9152479461,-2650,,
1271374853,9152732432,1177443144,9152729771,-2661,,
1271392985,9152750563,1177461276,9152747902,-2661,9152747803,
1271643447,9153001025,1177711738,9152998339,-2686,,
1271893905,9153251495,1177962208,9153248786,-2709,,
1272144251,9153501830,1178212552,9153499105,-2725,,
1272394375,9153751954,1178462666,9153749194,-2760,,
1272644857,9154002436,1178713149,9153999678,-2758,,
1272895367,9154252946,1178963659,9154250187,-2759,,
1273145480,9154503058,1179213771,9154500309,-2749,,
1273395872,9154753451,1179464164,9154750702,-2749,,
1273413893,9154771471,1179482183,9154768712,-2759,9154768786,
1273664048,9155021627,1179732340,9155018886,-2741,,
1273914642,9155272221,1179982934,9155269500,-2721,,
1274165070,9155522649,1180233361,9155519945,-2704,,
1274415664,9155773242,1180483954,9155770558,-2684,,
1274665798,9156023377,1180734090,9156020693,-2684,,
1274915908,9156273487,1180984200,9156270804,-2683,,
1275166073,9156523652,1181234364,9156520967,-2685,,
1275416450,9156774028,1181484740,9156771344,-2684,,
1275434544,9156792122,1181502835,9156789438,-2684,9156789345,
1275684958,9157042536,1181753249,9157039828,-2708,,
1275935730,9157293320,1182004032,9157290590,-2730,,
1276185870,9157543449,1182254161,9157540696,-2753,,
1276436403,9157793982,1182504694,9157791205,-2777,,
1276686589,9158044168,1182754881,9158041392,-2776,,
1276936768,9158294358,1183005070,9158291582,-2776,,
1277187409,9158544987,1183255709,9158542221,-2766,,
1277437981,9158795560,1183506272,9158792783,-2777,,
1277456077,9158813656,1183524368,9158810879,-2777,9158810890,
1277706490,9159064069,1183774781,9159061295,-2774,,
1277957024,9159314603,1184025315,9159311832,-2771,,
1278207150,9159564729,1184275442,9159561962,-2767,,
1278457758,9159815337,1184526049,9159812573,-2764,,
1278708385,9160065965,1184776677,9160063201,-2764,,
1278958607,9160316186,1185026898,9160313422,-2764,,
1279208847,9160566426,1185277138,9160563662,-2764,,
1279459016,9160816595,1185527308,9160813831,-2764,,
1279477207,9160834785,1185545497,9160832021,-2764,9160832099,
1279727316,9161084895,1185795607,9161082151,-2744,,
1279978371,9161335950,1186046662,9161333225,-2725,,
1280228729,9161586308,1186297020,9161583603,-2705,,
1280478884,9161836462,1186547175,9161833788,-2674,,
1280729206,9162086785,1186797497,9162084101,-2684,,
1280979315,9162336905,1187047618,9162334221,-2684,,
1281229865,9162587453,1187298166,9162584769,-2684,,
1281479986,9162837565,1187548277,9162834880,-2685,,
1281498072,9162855650,1187566362,9162852966,-2684,9162852893,
1281748217,9163105795,1187816508,9163103093,-2702,,
1281999085,9163356663,1188067387,9163353954,-2709,,
1282249621,9163607200,1188317913,9163604463,-2737,,
1282499970,9163857548,1188568261,9163854793,-2755,,
1282750663,9164108241,1188818954,9164105486,-2755,,
1283000791,9164358370,1189069082,9164355615,-2755,,
1283251202,9164608781,1189319494,9164606026,-2755,,
1283501394,9164858973,1189569685,9164856218,-2755,,
1283519366,9164876945,1189587657,9164874189,-2756,9164874205,
1283769966,9165127545,1189838258,9165124794,-2751,,
1284020762,9165378341,1190089054,9165375595,-2746,,
1284270984,9165628573,1190339285,9165625831,-2742,,
1284521237,9165878816,1190589529,9165876088,-2728,,
1284771628,9166129206,1190839919,9166126468,-2738,,
1285021753,9166379343,1191090055,9166376605,-2738,,
1285271914,9166629492,1191340205,9166626765,-2727,,
1285522264,9166879843,1191590556,9166877106,-2737,,
1285540382,9166897961,1191608673,9166895223,-2738,9166895187,
1285790845,9167148434,1191859146,9167145686,-2748,,
1286041379,9167398958,1192109681,9167396212,-2746,,
1286291584,9167649163,1192359875,9167646399,-2764,,
1286542014,9167899603,1192610316,9167896832,-2771,,
1286792141,9168149720,1192860432,9168146948,-2772,,
1287042611,9168400190,1193110912,9168397427,-2763,,
1287293241,9168650820,1193361532,9168648047,-2773,,
1287543688,9168901266,1193611979,9168898494,-2772,,
1287562092,9168919671,1193630383,9168916898,-2773,9168917042,
1287812483,9169170072,1193880784,9169167336,-2736,,
1288062723,9169420302,1194131015,9169417602,-2700,,
1288313221,9169670799,1194381512,9169668136,-2663,,
1288563400,9169920979,1194631701,9169918362,-2617,,
1288813562,9170171141,1194881853,9170168524,-2617,,
1289063803,9170421392,1195132104,9170418765,-2627,,
1289314125,9170671704,1195382416,9170669077,-2627,,
1289564671,9170922250,1195632973,9170919634,-2616,,
1289582741,9170940320,1195651032,9170937693,-2627,9170937562,
1289833342,9171190921,1195901644,9171188271,-2650,,
1290083702,9171441281,1196152004,9171438599,-2682,,
1290334115,9171691694,1196402407,9171688980,-2714,,
1290584490,9171942079,1196652792,9171939323,-2756,,
1290834914,9172192493,1196903205,9172189736,-2757,,
1291085485,9172443064,1197153787,9172440318,-2746,,
1291336153,9172693732,1197404444,9172690986,-2746,,
1291586708,9172944296,1197655009,9172941540,-2756,,
1291604848,9172962427,1197673139,9172959670,-2757,9172959702,
1291855225,9173212805,1197923518,9173210056,-2749,,
1292105919,9173463498,1198174210,9173460758,-2740,,
1292356875,9173714454,1198425166,9173711731,-2723,,
1292607442,9173965021,1198675733,9173962297,-2724,,
1292857797,9174215376,1198926088,9174212652,-2724,,
1293108273,9174465861,1199176574,9174463138,-2723,,
1293358824,9174716403,1199427115,9174713680,-2723,,
1293609169,9174966747,1199677460,9174964024,-2723,,
1293627230,9174984808,1199695520,9174982085,-2723,9174982046,
1293878145,9175235724,1199946446,9175233002,-2722,,
1294128471,9175486050,1200196772,9175483319,-2731,,
1294378664,9175736242,1200446954,9175733491,-2751,,
1294628973,9175986552,1200697265,9175983793,-2759,,
1294879923,9176237502,1200948214,9176234751,-2751,,
1295130529,9176488119,1201198832,9176485359,-2760,,
1295380960,9176738550,1201449262,9176735789,-2761,,
1295631666,9176989245,1201699957,9176986484,-2761,,
1295649929,9177007507,1201718219,9177004747,-2760,9177004692,
1295900495,9177258074,1201968786,9177255301,-2773,,
1296151458,9177509037,1202219750,9177506260,-2777,,
1296401874,9177759453,1202470165,9177756653,-2800,,
1296652279,9178009859,1202720572,9178007046,-2813,,
1296902860,9178260439,1202971161,9178257636,-2803,,
1297153269,9178510847,1203221560,9178508034,-2813,,
1297403868,9178761447,1203472159,9178758633,-2814,,
1297654505,9179012084,1203722796,9179009270,-2814,,
1297672618,9179030196,1203740909,9179027383,-2813,9179027391,
1297923002,9179280581,1203991293,9179277781,-2800,,
1298173223,9179530801,1204241514,9179527992,-2809,,
1298423654,9179781232,1204491945,9179778426,-2806,,
1298674283,9180031862,1204742575,9180029059,-2803,,
1298925086,9180282664,1204993387,9180279870,-2794,,
1299175613,9180533202,1205243915,9180530398,-2804,,
1299425853,9180783432,1205494144,9180780628,-2804,,
1299676151,9181033730,1205744442,9181030926,-2804,,
1299694335,9181051913,1205762626,9181049109,-2804,9181049060,
1299944462,9181302040,1206012753,9181299223,-2817,,
1300195036,9181552615,1206263327,9181549797,-2818,,
1300445668,9181803247,1206513970,9181800417,-2830,,
1300695825,9182053405,1206764118,9182050553,-2852,,
1300945945,9182303534,1207014246,9182300682,-2852,,
1301196066,9182553655,1207264368,9182550803,-2852,,
1301446505,9182804084,1207514796,9182801232,-2852,,
1301696906,9183054484,1207765197,9183051632,-2852,,
1301715133,9183072712,1207783424,9183069859,-2853,9183069889,
1301965779,9183323358,1208034071,9183320514,-2844,,
1302216329,9183573908,1208284631,9183571083,-2825,,
1302466683,9183824261,1208534974,9183821433,-2828,,
1302716911,9184074491,1208785203,9184071670,-2821,,
1302967450,9184325039,1209035751,9184322218,-2821,,
1303217866,9184575445,1209286168,9184572634,-2811,,
1303468128,9184825707,1209536419,9184822885,-2822,,
1303718248,9185075827,1209786539,9185073006,-2821,,
1303736509,9185094088,1209804800,9185091266,-2822,9185091301,
1303986707,9185344286,1210054999,9185341473,-2813,,
1304236957,9185594546,1210305258,9185591742,-2804,,
1304487618,9185845197,1210555909,9185842402,-2795,,
1304737968,9186095547,1210806260,9186092762,-2785,,
1304988497,9186346075,1211056788,9186343291,-2784,,
1305239536,9186597125,1211307837,9186594340,-2785,,
1305490131,9186847709,1211558422,9186844924,-2785,,
1305740693,9187098272,1211808985,9187095487,-2785,,
1305758794,9187116373,1211827085,9187113587,-2786,9187113591,
1306009098,9187366677,1212077389,9187363892,-2785,,
1306259249,9187616837,1212327550,9187614054,-2783,,
1306509868,9187867447,1212578159,9187864665,-2782,,
1306760582,9188118162,1212828875,9188115382,-2780,,
1307010773,9188368363,1213079075,9188365583,-2780,,
1307260898,9188618477,1213329189,9188615697,-2780,,
1307511421,9188869000,1213579712,9188866219,-2781,,
1307761993,9189119572,1213830285,9189116792,-2780,,
1307780058,9189137636,1213848349,9189134856,-2780,9189134773,
1308030650,9189388239,1214098951,9189385438,-2801,,
1308281059,9189638648,1214349360,9189635827,-2821,,
1308531263,9189888852,1214599564,9189886009,-2843,,
1308782009,9190139599,1214850312,9190136737,-2862,,
1309032261,9190389840,1215100552,9190386988,-2852,,
1309282620,9190640209,1215350922,9190637348,-2861,,
1309532772,9190890350,1215601063,9190887488,-2862,,
1309783568,9191141146,1215851859,9191138284,-2862,,
1309801609,9191159187,1215869900,9191156325,-2862,9191156379,
1310051941,9191409519,1216120232,9191406670,-2849,,
1310302328,9191659907,1216370630,9191657083,-2824,,
1310552738,9191910316,1216621029,9191907495,-2821,,
1310803025,9192160603,1216871316,9192157796,-2807,,
1311053256,9192410834,1217121547,9192408027,-2807,,
1311303561,9192661140,1217371852,9192658333,-2807,,
1311553921,9192911500,1217622212,9192908693,-2807,,
1311804334,9193161923,1217872636,9193159116,-2807,,
1311822449,9193180027,1217890740,9193177220,-2807,9193177192,
1312072763,9193430341,1218141054,9193427536,-2805,,
1312322849,9193680428,1218391140,9193677607,-2821,,
1312572950,9193930539,1218641251,9193927711,-2828,,
1312823556,9194181134,1218891847,9194178311,-2823,,
1313073662,9194431240,1219141953,9194428406,-2834,,
1313324081,9194681670,1219392383,9194678837,-2833,,
1313574245,9194931823,1219642536,9194928989,-2834,,
1313824582,9195182171,1219892884,9195179337,-2834,,
1313842669,9195200247,1219910959,9195197413,-2834,9195197402,
1314093045,9195450623,1220161336,9195447787,-2836,,
1314343473,9195701051,1220411764,9195698213,-2838,,
1314593906,9195951484,1220662197,9195948643,-2841,,
1314844530,9196202109,1220912821,9196199266,-2843,,
1315094964,9196452543,1221163255,9196449700,-2843,,
1315345994,9196703574,1221414287,9196700731,-2843,,
1315596212,9196953791,1221664503,9196950947,-2844,,
1315846589,9197204177,1221914890,9197201334,-2843,,
1315864734,9197222312,1221933025,9197219469,-2843,9197219498,
1316115258,9197472837,1222183549,9197470000,-2837,,
1316365807,9197723386,1222434099,9197720557,-2829,,
1316616565,9197974144,1222684856,9197971333,-2811,,
1316866696,9198224285,1222934997,9198221472,-2813,,
1317116861,9198474440,1223185152,9198471627,-2813,,
1317367002,9198724581,1223435294,9198721769,-2812,,
1317617198,9198974776,1223685489,9198971963,-2813,,
1317867681,9199225260,1223935973,9199222447,-2813,,
1317885683,9199243262,1223953974,9199240448,-2814,9199240366,
1318136020,9199493599,1224204311,9199490765,-2834,,
1318386808,9199744397,1224455110,9199741544,-2853,,
1318637130,9199994709,1224705421,9199991834,-2875,,
1318887358,9200244937,1224955649,9200242042,-2895,,
1319137840,9200495418,1225206130,9200492524,-2894,,
1319388460,9200746049,1225456762,9200743155,-2894,,
1319638913,9200996492,1225707204,9200993597,-2895,,
1319889126,9201246705,1225957427,9201243821,-2884,,
1319907131,9201264709,1225975422,9201261815,-2894,9201261800,
1320157515,9201515093,1226225806,9201512196,-2897,,
1320408276,9201765855,1226476577,9201762964,-2891,,
1320658839,9202016418,1226727130,9202013515,-2903,,
1320909294,9202266872,1226977585,9202263965,-2907,,
1321159676,9202517254,1227227967,9202514347,-2907,,
1321410059,9202767638,1227478360,9202764740,-2898,,
1321660437,9203018016,1227728728,9203015109,-2907,,
1321910541,9203268120,1227978833,9203265213,-2907,,
1321928569,9203286148,1227996860,9203283240,-2908,9203283227,
1322179007,9203536586,1228247298,9203533676,-2910,,
1322429537,9203787115,1228497828,9203784213,-2902,,
1322680038,9204037617,1228748330,9204034702,-2915,,
1322930248,9204287836,1228998549,9204284917,-2919,,
1323180708,9204538287,1229248999,9204535378,-2909,,
1323431536,9204789115,1229499837,9204786206,-2909,,
1323682080,9205039659,1229750371,9205036739,-2920,,
1323932682,9205290260,1230000973,9205287341,-2919,,
1323950912,9205308490,1230019203,9205305571,-2919,9205305608,
1324201529,9205559107,1230269819,9205556197,-2910,,
1324452179,9205809757,1230520470,9205806856,-2901,,
1324702900,9206060479,1230771192,9206057588,-2891,,
1324953296,9206310875,1231021587,9206308003,-2872,,
1325203551,9206561129,1231271842,9206558248,-2881,,
1325453762,9206811341,1231522054,9206808460,-2881,,
1325704373,9207061952,1231772664,9207059081,-2871,,
1325954712,9207312290,1232023003,9207309409,-2881,,
1325972897,9207330476,1232041188,9207327594,-2882,9207327579,
1326223503,9207581082,1232291794,9207578197,-2885,,
1326474107,9207831686,1232542398,9207828809,-2877,,
1326724398,9208081977,1232792689,9208079086,-2891,,
1326974977,9208332556,1233043268,9208329661,-2895,,
1327225370,9208582958,1233293671,9208580063,-2895,,
1327475951,9208833540,1233544253,9208830645,-2895,,
1327726710,9209084289,1233795002,9209081394,-2895,,
1327976981,9209334560,1234045272,9209331665,-2895,,
1327995122,9209352700,1234063412,9209349805,-2895,9209349809,
1328245744,9209603323,1234314035,9209600429,-2894,,
1328496343,9209853921,1234564634,9209851029,-2892,,
1328746801,9210104380,1234815093,9210101491,-2889,,
1328996932,9210354521,1235065234,9210351632,-2889,,
1329247140,9210604719,1235315431,9210601829,-2890,,
1329497580,9210855158,1235565871,9210852279,-2879,,
1329748169,9211105747,1235816460,9211102868,-2879,,
1329998701,9211356280,1236066992,9211353391,-2889,,
1330016907,9211374485,1236085197,9211371596,-2889,9211371506,
1330267242,9211624820,1236335533,9211621907,-2913,,
1330518100,9211875679,1236586391,9211872743,-2936,,
1330768346,9212125926,1236836638,9212122969,-2957,,
1331018540,9212376118,1237086831,9212373140,-2978,,
1331268645,9212626223,1237336936,9212623255,-2968,,
1331519222,9212876801,1237587513,9212873822,-2979,,
1331769741,9213127319,1237838032,9213124341,-2978,,
1332020445,9213378024,1238088737,9213375046,-2978,,
1332038483,9213396062,1238106774,9213393084,-2978,9213393222,
1332288694,9213646273,1238356996,9213643339,-2934,,
1332539147,9213896725,1238607437,9213893817,-2908,,
1332789906,9214147495,1238858208,9214144622,-2873,,
1333040162,9214397741,1239108453,9214394913,-2828,,
1333290906,9214648485,1239359198,9214645647,-2838,,
1333541708,9214899287,1239609999,9214896449,-2838,,
1333792383,9215149961,1239860674,9215147123,-2838,,
1334042473,9215400052,1240110764,9215397214,-2838,,
1334060417,9215417996,1240128708,9215415157,-2839,9215415050,
1334310818,9215668397,1240379109,9215665532,-2865,,
1334561213,9215918792,1240629504,9215915900,-2892,,
1334811986,9216169566,1240880278,9216166648,-2918,,
1335062318,9216419896,1241130609,9216416962,-2934,,
1335312506,9216670084,1241380797,9216667141,-2943,,
1335562750,9216920329,1241631041,9216917384,-2945,,
1335812872,9217170450,1241881163,9217167516,-2934,,
1336063421,9217420999,1242131712,9217418055,-2944,,
1336081499,9217439078,1242149790,9217436133,-2945,9217436094,
1336331804,9217689382,1242400095,9217686438,-2944,,
1336581980,9217939559,1242650271,9217936596,-2963,,
1336832508,9218190086,1242900799,9218187114,-2972,,
1337082726,9218440304,1243151017,9218437322,-2982,,
1337333152,9218690741,1243401453,9218687759,-2982,,
1337583616,9218941195,1243651907,9218938222,-2973,,
1337833903,9219191482,1243902195,9219188500,-2982,,
1338084075,9219441654,1244152366,9219438672,-2982,,
1338102114,9219459692,1244170404,9219456709,-2983,9219456776,
1338352381,9219709969,1244420682,9219707003,-2966,,
1338602907,9219960486,1244671199,9219957537,-2949,,
1338853278,9220210857,1244921569,9220207926,-2931,,
1339103879,9220461458,1245172171,9220458554,-2904,,
1339354609,9220712188,1245422900,9220709274,-2914,,
1339604906,9220962485,1245673198,9220959571,-2914,,
1339855752,9221213341,1245924054,9221210427,-2914,,
1340106372,9221463962,1246174674,9221461048,-2914,,
1340124461,9221482039,1246192752,9221479125,-2914,9221479141,
1340374696,9221732275,1246442987,9221729366,-2909,,
1340625028,9221982607,1246693319,9221979701,-2906,,
1340875239,9222232818,1246943530,9222229918,-2900,,
1341125425,9222483003,1247193715,9222480107,-2896,,
1341375892,9222733471,1247444183,9222730575,-2896,,
1341626572,9222984151,1247694864,9222981255,-2896,,
1341876716,9223234295,1247945008,9223231399,-2896,,
1342127044,9223484623,1248195345,9223481737,-2886,,
1342145223,9223502801,1248213514,9223499905,-2896,9223499788,
1342395767,9223753346,1248464058,9223750421,-2925,,
1342645898,9224003477,1248714189,9224000523,-2954,,
1342896672,9224254251,1248964963,9224251277,-2974,,
1343147074,9224504652,1249215375,9224501650,-3002,,
1343397244,9224754833,1249465545,9224751821,-3012,,
1343647395,9225004974,1249715686,9225001961,-3013,,
1343897510,9225255099,1249965812,9225252087,-3012,,
1344147729,9225505308,1250216020,9225502295,-3013,,
1344165758,9225523336,1250234048,9225520324,-3012,9225520439,
1344415893,9225773472,1250484185,9225770490,-2982,,
1344666300,9226023879,1250734591,9226020926,-2953,,
1344916919,9226274498,1250985210,9226271573,-2925,,
1345167356,9226524935,1251235647,9226522050,-2885,,
1345417639,9226775218,1251485931,9226772323,-2895,,
1345667903,9227025483,1251736196,9227022588,-2895,,
1345918080,9227275658,1251986371,9227272763,-2895,,
1346168541,9227526120,1252236832,9227523224,-2896,,
1346186599,9227544177,1252254889,9227541282,-2895,9227541213,
1346437017,9227794606,1252505319,9227791694,-2912,,
1346687652,9228045230,1252755943,9228042301,-2929,,
1346938254,9228295833,1253006545,9228292887,-2946,,
1347188863,9228546441,1253257154,9228543479,-2962,,
1347439172,9228796760,1253507473,9228793798,-2962,,
1347689825,9229047404,1253758126,9229044452,-2952,,
1347940498,9229298076,1254008789,9229295114,-2962,,
1348191263,9229548842,1254259554,9229545880,-2962,,
1348209377,9229566956,1254277668,9229563993,-2963,9229564001,
1348459964,9229817553,1254528265,9229814594,-2959,,
1348710461,9230068040,1254778753,9230065083,-2957,,
1348960883,9230318461,1255029174,9230315506,-2955,,
1349211362,9230568940,1255279653,9230565987,-2953,,
1349461764,9230819343,1255530055,9230816390,-2953,,
1349712754,9231070333,1255781045,9231067379,-2954,,
1349963250,9231320829,1256031541,9231317876,-2953,,
1350214029,9231571608,1256282320,9231568655,-2953,,
1350232194,9231589772,1256300484,9231586819,-2953,9231586840,
1350482636,9231840226,1256550938,9231837279,-2947,,
1350732855,9232090434,1256801147,9232087492,-2942,,
1350983247,9232340826,1257051549,9232337900,-2926,,
1351233828,9232591406,1257302119,9232588476,-2930,,
1351484241,9232841830,1257552543,9232838900,-2930,,
1351734357,9233091936,1257802648,9233089006,-2930,,
1351985132,9233342711,1258053424,9233339782,-2929,,
1352235405,9233592984,1258303696,9233590053,-2931,,
1352253614,9233611192,1258321904,9233608262,-2930,9233608225,
1352503767,9233861346,1258572059,9233858408,-2938,,
1352754339,9234111918,1258822631,9234108970,-2948,,
1353004577,9234362156,1259072879,9234359209,-2947,,
1353254902,9234612481,1259323193,9234609515,-2966,,
1353505091,9234862670,1259573382,9234859705,-2965,,
1353755816,9235113395,1259824107,9235110429,-2966,,
1354005993,9235363572,1260074294,9235360617,-2955,,
1354256109,9235613688,1260324400,9235610722,-2966,,
1354274285,9235631863,1260342575,9235628898,-2965,9235628904,
1354524412,9235882002,1260592714,9235879039,-2963,,
1354775003,9236132583,1260843296,9236129623,-2960,,
1355025746,9236383325,1261094048,9236380376,-2949,,
1355275947,9236633525,1261344248,9236630578,-2947,,
1355526418,9236883997,1261594710,9236881041,-2956,,
1355776651,9237134230,1261844952,9237131283,-2947,,
1356027168,9237384746,1262095459,9237381789,-2957,,
1356277261,9237634840,1262345552,9237631883,-2957,,
1356295410,9237652988,1262363700,9237650031,-2957,9237650046,
1356546362,9237903941,1262614653,9237900988,-2953,,
1356797120,9238154700,1262865412,9238151752,-2948,,
1357047372,9238404961,1263115674,9238402017,-2944,,
1357297531,9238655110,1263365822,9238652169,-2941,,
1357547798,9238905377,1263616090,9238902437,-2940,,
1357798066,9239155644,1263866357,9239152704,-2940,,
1358048465,9239406053,1264116766,9239403113,-2940,,
1358298871,9239656450,1264367163,9239653510,-2940,,
1358316978,9239674556,1264385268,9239671616,-2940,9239671638,
1358567324,9239924903,1264635616,9239921969,-2934,,
1358817648,9240175226,1264885939,9240172298,-2928,,
1359068001,9240425580,1265136292,9240422668,-2912,,
1359318618,9240676197,1265386909,9240673280,-2917,,
1359568844,9240926423,1265637135,9240923507,-2916,,
1359819149,9241176738,1265887451,9241173822,-2916,,
1360069797,9241427376,1266138088,9241424460,-2916,,
1360320004,9241677583,1266388295,9241674666,-2917,,
1360337990,9241695568,1266406280,9241692652,-2916,9241692589,
1360588737,9241946316,1266657029,9241943385,-2931,,
1360839114,9242196703,1266907416,9242193757,-2946,,
1361089751,9242447329,1267158052,9242444377,-2952,,
1361340238,9242697816,1267408529,9242694839,-2977,,
1361590848,9242948437,1267659150,9242945460,-2977,,
1361841035,9243198614,1267909326,9243195636,-2978,,
1362091256,9243448835,1268159547,9243445857,-2978,,
1362341932,9243699510,1268410223,9243696533,-2977,,
1362360062,9243717640,1268428353,9243714663,-2977,9243714685,
1362610650,9243968229,1268678941,9243965267,-2962,,
1362861010,9244218589,1268929302,9244215623,-2966,,
1363111731,9244469310,1269180032,9244466360,-2950,,
1363362330,9244719919,1269430631,9244716965,-2954,,
1363612993,9244970582,1269681294,9244967628,-2954,,
1363863328,9245220906,1269931630,9245217963,-2943,,
1364114054,9245471633,1270182345,9245468678,-2955,,
1364364425,9245722004,1270432716,9245719050,-2954,,
1364382455,9245740033,1270450746,9245737079,-2954,9245737056,
1364632705,9245990283,1270700996,9245987332,-2951,,
1364883012,9246240590,1270951303,9246237634,-2956,,
1365133366,9246490945,1271201658,9246487975,-2970,,
1365384159,9246741738,1271452460,9246738772,-2966,,
1365634698,9246992278,1271702990,9246989302,-2976,,
1365884911,9247242500,1271953213,9247239524,-2976,,
1366135214,9247492793,1272203505,9247489816,-2977,,
1366385836,9247743414,1272454127,9247740438,-2976,,
1366403954,9247761532,1272472245,9247758556,-2976,9247758585,
1366654424,9248012004,1272722716,9248009034,-2970,,
1366904533,9248262112,1272972824,9248259149,-2963,,
1367155165,9248512744,1273223456,9248509789,-2955,,
1367405537,9248763116,1273473838,9248760180,-2936,,
1367655639,9249013218,1273723940,9249010282,-2936,,
1367906233,9249263822,1273974535,9249260876,-2946,,
1368156365,9249513954,1274224667,9249511009,-2945,,
1368406529,9249764107,1274474820,9249761161,-2946,,
1368424616,9249782194,1274492907,9249779248,-2946,9249779157,
1368674721,9250032299,1274743012,9250029330,-2969,,
1368925242,9250282821,1274993533,9250279830,-2991,,
1369175605,9250533184,1275243896,9250530170,-3014,,
1369425730,9250783308,1275494021,9250780272,-3036,,
1369676317,9251033895,1275744618,9251030869,-3026,,
1369927012,9251284591,1275995304,9251281556,-3035,,
1370177322,9251534901,1276245613,9251531875,-3026,,
1370427574,9251785153,1276495866,9251782117,-3036,,
1370445550,9251803129,1276513841,9251800092,-3037,9251800130,
1370696260,9252053839,1276764551,9252050811,-3028,,
1370946764,9252304344,1277015056,9252301327,-3017,,
1371196935,9252554513,1277265226,9252551506,-3007,,
1371447126,9252804705,1277515417,9252801708,-2997,,
1371697498,9253055077,1277765790,9253052080,-2997,,
1371947676,9253305255,1278015968,9253302258,-2997,,
1372197994,9253555573,1278266285,9253552585,-2988,,
1372448171,9253805749,1278516462,9253802762,-2987,,
1372466286,9253823864,1278534576,9253820867,-2997,9253820858,
1372716386,9254073965,1278784677,9254070966,-2999,,
1372967207,9254324796,1279035508,9254321796,-3000,,
1373217854,9254575433,1279286145,9254572440,-2993,,
1373468456,9254826035,1279536747,9254823031,-3004,,
1373718736,9255076315,1279787027,9255073311,-3004,,
1373969060,9255326639,1280037352,9255323635,-3004,,
1374219707,9255577286,1280287999,9255574293,-2993,,
1374469834,9255827413,1280538125,9255824409,-3004,,
1374487950,9255845528,1280556240,9255842524,-3004,9255842485,
1374738039,9256095618,1280806330,9256092605,-3013,,
1374988424,9256346002,1281056715,9256342980,-3022,,
1375238842,9256596420,1281307133,9256593389,-3031,,
1375489021,9256846599,1281557312,9256843558,-3041,,
1375739603,9257097182,1281807894,9257094151,-3031,,
1375990270,9257347849,1282058561,9257344807,-3042,,
1376240433,9257598012,1282308724,9257594971,-3041,,
1376490628,9257848206,1282558919,9257845165,-3041,,
1376508863,9257866441,1282577153,9257863400,-3041,9257863494,
1376759370,9258116949,1282827662,9258113932,-3017,,
1377009512,9258367091,1283077804,9258364098,-2993,,
1377259672,9258617260,1283327973,9258614291,-2969,,
1377509963,9258867541,1283578254,9258864596,-2945,,
1377760150,9259117729,1283828441,9259114784,-2945,,
1378010660,9259368239,1284078961,9259365304,-2935,,
1378260808,9259618386,1284329099,9259615441,-2945,,
1378511398,9259868977,1284579689,9259866032,-2945,,
1378529510,9259887088,1284597800,9259884143,-2945,9259884083,
1378779705,9260137285,1284847998,9260134325,-2960,,
1379029949,9260387538,1285098250,9260384562,-2976,,
1379280167,9260637746,1285348458,9260634767,-2979,,
1379530295,9260887874,1285598586,9260884879,-2995,,
1379780832,9261138411,1285849123,9261135406,-3005,,
1380031030,9261388608,1286099320,9261385604,-3004,,
1380281629,9261639208,1286349920,9261636204,-3004,,
1380532109,9261889688,1286600400,9261886694,-2994,,
1380550267,9261907845,1286618557,9261904841,-3004,9261904878,
1380800437,9262158016,1286868729,9262155023,-2993,,
1381051035,9262408624,1287119337,9262405641,-2983,,
1381301186,9262658764,1287369477,9262655789,-2975,,
1381551532,9262909111,1287619823,9262906146,-2965,,
1381801876,9263159454,1287870167,9263156489,-2965,,
1382052053,9263409632,1288120344,9263406667,-2965,,
1382302260,9263659838,1288370551,9263656873,-2965,,
1382552552,9263910130,1288620842,9263907165,-2965,,
1382570630,9263928209,1288638921,9263925243,-2966,9263925150,
1382821545,9264179125,1288889837,9264176136,-2989,,
1383071697,9264429275,1289139988,9264426263,-3012,,
1383322074,9264679652,1289390365,9264676617,-3035,,
1383572263,9264929841,1289640553,9264926784,-3057,,
1383823208,9265180786,1289891498,9265177729,-3057,,
1384073540,9265431118,1290141831,9265428061,-3057,,
1384324021,9265681599,1290392312,9265678542,-3057,,
1384574677,9265932256,1290642968,9265929198,-3058,,
1384592779,9265950357,1290661070,9265947300,-3057,9265947319,
1384843124,9266200703,1290911415,9266197651,-3052,,
1385093652,9266451231,1291161944,9266448194,-3037,,
1385343840,9266701419,1291412131,9266698378,-3041,,
1385594200,9266951778,1291662491,9266948742,-3036,,
1385844767,9267202345,1291913058,9267199309,-3036,,
1386095232,9267452811,1292163523,9267449775,-3036,,
1386345355,9267702934,1292413646,9267699898,-3036,,
1386595518,9267953097,1292663809,9267950061,-3036,,
1386613572,9267971151,1292681863,9267968114,-3037,9267968065,
1386863898,9268221487,1292932200,9268218438,-3049,,
1387114051,9268471630,1293182342,9268468568,-3062,,
1387364272,9268721862,1293432574,9268718790,-3072,,
1387614644,9268972223,1293682946,9268969150,-3073,,
1387864962,9269222540,1293933253,9269219456,-3084,,
1388115100,9269472678,1294183391,9269469594,-3084,,
1388365445,9269723023,1294433736,9269719950,-3073,,
1388615800,9269973390,1294684102,9269970306,-3084,,
1388633911,9269991489,1294702202,9269988405,-3084,9269988463,
1388884087,9270241676,1294952388,9270238606,-3070,,
1389134676,9270492254,1295202977,9270489209,-3045,,
1389385026,9270742604,1295453317,9270739564,-3040,,
1389635190,9270992768,1295703491,9270989753,-3015,,
1389885783,9271243372,1295954084,9271240347,-3025,,
1390136361,9271493940,1296204653,9271490915,-3025,,
1390386882,9271744461,1296455183,9271741445,-3016,,
1390637048,9271994627,1296705339,9271991602,-3025,,
1390655329,9272012907,1296723620,9272009882,-3025,9272009839,
1390905955,9272263544,1296974257,9272260508,-3036,,
1391156080,9272513659,1297224371,9272510612,-3047,,
1391406338,9272763917,1297474629,9272760870,-3047,,
1391656485,9273014064,1297724777,9273010997,-3067,,
1391907390,9273264969,1297975681,9273261902,-3067,,
1392157477,9273515056,1298225769,9273511989,-3067,,
1392408311,9273765889,1298476602,9273762822,-3067,,
1392659006,9274016585,1298727297,9274013518,-3067,,
1392677263,9274034841,1298745554,9274031774,-3067,9274031795,
1392927819,9274285398,1298996110,9274282346,-3052,,
1393178770,9274536348,1299247061,9274533292,-3056,,
1393428889,9274786468,1299497180,9274783417,-3051,,
1393679300,9275036878,1299747591,9275033833,-3045,,
1393929894,9275287483,1299998195,9275284438,-3045,,
1394180708,9275538287,1300248999,9275535252,-3035,,
1394431229,9275788808,1300499520,9275785763,-3045,,
1394681642,9276039221,1300749944,9276036186,-3035,,
1394699804,9276057382,1300768095,9276054337,-3045,9276054330,
1394950098,9276307676,1301018389,9276304629,-3047,,
1395200434,9276558013,1301268725,9276554965,-3048,,
1395450843,9276808422,1301519134,9276805383,-3039,,
1395700980,9277058558,1301769271,9277055507,-3051,,
1395951174,9277308753,1302019475,9277305712,-3041,,
1396201498,9277559077,1302269789,9277556026,-3051,,
1396452178,9277809757,1302520469,9277806705,-3052,,
1396702441,9278060019,1302770732,9278056968,-3051,,
1396720431,9278078010,1302788722,9278074958,-3052,9278074974,
1396970546,9278328125,1303038837,9278325078,-3047,,
1397220758,9278578337,1303289060,9278575305,-3032,,
1397471501,9278829080,1303539792,9278826041,-3039,,
1397722338,9279079917,1303790630,9279076884,-3033,,
1397972565,9279330154,1304040867,9279327120,-3034,,
1398222920,9279580499,1304291212,9279577465,-3034,,
1398473257,9279830836,1304541548,9279827802,-3034,,
1398723869,9280081449,1304792161,9280078415,-3034,,
1398741956,9280099534,1304810246,9280096500,-3034,9280096470,
1398992367,9280349946,1305060658,9280346904,-3042,,
1399242537,9280600115,1305310827,9280597066,-3049,,
1399492746,9280850324,1305561037,9280847268,-3056,,
1399743281,9281100861,1305811573,9281097798,-3063,,
1399993484,9281351062,1306061775,9281348010,-3052,,
1400243858,9281601437,1306312150,9281598374,-3063,,
1400494179,9281851757,1306562470,9281848694,-3063,,
1400744351,9282101929,1306812642,9282098866,-3063,,
1400762567,9282120145,1306830857,9282117082,-3063,9282117061,
1401013182,9282370761,1307081473,9282367693,-3068,,
1401263793,9282621371,1307332083,9282618299,-3072,,
1401514806,9282872384,1307583096,9282869307,-3077,,
1401765047,9283122635,1307833348,9283119553,-3082,,
1402015279,9283372857,1308083570,9283369775,-3082,,
1402265407,9283622985,1308333698,9283619903,-3082,,
1402515620,9283873198,1308583911,9283870116,-3082,,
1402765769,9284123348,1308834061,9284120267,-3081,,
1402783869,9284141448,1308852160,9284138365,-3083,9284138338,
1403033997,9284391586,1309102299,9284388496,-3090,,
1403284148,9284641737,1309352450,9284638641,-3096,,
1403534477,9284892055,1309602767,9284888953,-3102,,
1403784594,9285142174,1309852886,9285139066,-3108,,
1404035485,9285393064,1310103777,9285389966,-3098,,
1404285603,9285643182,1310353895,9285640074,-3108,,
1404536002,9285893580,1310604293,9285890472,-3108,,
1404786452,9286144032,1310854745,9286140925,-3107,,
1404804430,9286162009,1310872721,9286158900,-3109,9286158886,
1405054761,9286412340,1311123052,9286409227,-3113,,
1405305362,9286662941,1311373653,9286659825,-3116,,
1405555663,9286913252,1311623964,9286910134,-3118,,
1405805938,9287163517,1311874230,9287160396,-3121,,
1406056131,9287413710,1312124422,9287410599,-3111,,
1406306728,9287664307,1312375019,9287661185,-3122,,
1406556944,9287914523,1312625235,9287911402,-3121,,
1406807260,9288164840,1312875552,9288161719,-3121,,
1406825396,9288182974,1312893687,9288179853,-3121,9288179836,
1407075913,9288433492,1313144204,9288430366,-3126,,
1407326491,9288684069,1313394782,9288680939,-3130,,
1407576737,9288934316,1313645028,9288931182,-3134,,
1407827191,9289184771,1313895483,9289181634,-3137,,
1408077683,9289435272,1314145985,9289432135,-3137,,
1408328104,9289685682,1314396395,9289682555,-3127,,
1408578432,9289936011,1314646723,9289932874,-3137,,
1408828694,9290186274,1314896986,9290183137,-3137,,
1408846774,9290204352,1314915065,9290201215,-3137,9290201224,
1409097011,9290454589,1315165302,9290451454,-3135,,
1409347540,9290705118,1315415831,9290701986,-3132,,
1409598065,9290955643,1315666356,9290952513,-3130,,
1409848560,9291206150,1315916863,9291203023,-3127,,
1410098950,9291456529,1316167241,9291453402,-3127,,
1410349577,9291707156,1316417868,9291704028,-3128,,
1410599788,9291957366,1316668079,9291954239,-3127,,
1410850343,9292207922,1316918635,9292204796,-3126,,
1410868375,9292225953,1316936666,9292222826,-3127,9292222791,
1411118483,9292476062,1317186774,9292472926,-3136,,
1411369114,9292726693,1317437405,9292723549,-3144,,
1411619283,9292976862,1317687574,9292973709,-3153,,
1411869880,9293227460,1317938172,9293224299,-3161,,
1412120303,9293477882,1318188604,9293474731,-3151,,
1412370961,9293728540,1318439262,9293725389,-3151,,
1412621322,9293978901,1318689624,9293975750,-3151,,
1412871794,9294229373,1318940086,9294226212,-3161,,
1412889901,9294247479,1318958191,9294244318,-3161,9294244363,
1413140486,9294498065,1319208777,9294494915,-3150,,
1413391178,9294748757,1319459469,9294745619,-3138,,
1413641397,9294998976,1319709688,9294995849,-3127,,
1413891847,9295249426,1319960149,9295246323,-3103,,
1414142417,9295499996,1320210708,9295496882,-3114,,
1414392992,9295750571,1320461283,9295747456,-3115,,
1414643420,9296000999,1320711711,9295997884,-3115,,
1414894170,9296251749,1320962461,9296248645,-3104,,
1414912261,9296269839,1320980551,9296266725,-3114,9296266674,
1415163153,9296520732,1321231445,9296517606,-3126,,
1415413382,9296770960,1321481673,9296767821,-3139,,
1415663880,9297021459,1321732171,9297018307,-3152,,
1415914436,9297272015,1321982727,9297268852,-3163,,
1416164610,9297522189,1322232902,9297519026,-3163,,
1416415184,9297772763,1322483475,9297769610,-3153,,
1416665674,9298023253,1322733975,9298020100,-3153,,
1416915813,9298273402,1322984114,9298270239,-3163,,
1416933854,9298291432,1323002145,9298288269,-3163,9298288298,
1417184333,9298541912,1323252624,9298538755,-3157,,
1417434662,9298792240,1323502953,9298789102,-3138,,
1417685272,9299042851,1323753563,9299039709,-3142,,
1417935638,9299293218,1324003930,9299290085,-3133,,
1418186047,9299543626,1324254348,9299540503,-3123,,
1418436642,9299794220,1324504933,9299791087,-3133,,
1418687042,9300044620,1324755333,9300041487,-3133,,
1418937174,9300294763,1325005476,9300291630,-3133,,
1418955198,9300312777,1325023489,9300309643,-3134,9300309634,
1419205885,9300563463,1325274176,9300560339,-3124,,
1419456381,9300813960,1325524672,9300810823,-3137,,
1419706924,9301064503,1325775215,9301061364,-3139,,
1419957464,9301315054,1326025766,9301311913,-3141,,
1420207927,9301565506,1326276228,9301562374,-3132,,
1420458542,9301816120,1326526833,9301812979,-3141,,
1420709087,9302066665,1326777378,9302063524,-3141,,
1420959922,9302317500,1327028223,9302314369,-3131,,
1420977967,9302335545,1327046258,9302332404,-3141,9302332448,
1421228230,9302585809,1327296532,9302582689,-3120,,
1421478625,9302836203,1327546916,9302833084,-3119,,
1421729022,9303086602,1327797314,9303083495,-3107,,
1421979333,9303336912,1328047625,9303333816,-3096,,
1422229438,9303587016,1328297729,9303583920,-3096,,
1422479557,9303837146,1328547858,9303834050,-3096,,
1422730569,9304088148,1328798860,9304085052,-3096,,
1422980989,9304338578,1329049291,9304335482,-3096,,
1422998970,9304356549,1329067261,9304353453,-3096,9304353480,
1423249574,9304607153,1329317865,9304604063,-3090,,
1423500101,9304857679,1329568392,9304854597,-3082,,
1423750971,9305108550,1329819262,9305105476,-3074,,
1424001430,9305359009,1330069722,9305355942,-3067,,
1424251919,9305609498,1330320210,9305606442,-3056,,
1424502420,9305859999,1330570711,9305856931,-3068,,
1424752779,9306110358,1330821070,9306107291,-3067,,
1425002941,9306360530,1331071242,9306357463,-3067,,
1425021153,9306378732,1331089444,9306375665,-3067,9306375628,
1425271251,9306628830,1331339543,9306625754,-3076,,
1425521592,9306879170,1331589883,9306876085,-3085,,
1425771821,9307129400,1331840113,9307126307,-3093,,
1426022228,9307379807,1332090519,9307376705,-3102,,
1426272788,9307630367,1332341079,9307627264,-3103,,
1426523299,9307880877,1332591590,9307877775,-3102,,
1426773675,9308131254,1332841967,9308128162,-3092,,
1427023789,9308381368,1333092081,9308378266,-3102,,
1427041792,9308399370,1333110083,9308396268,-3102,9308396212,
1427292310,9308649888,1333360601,9308646773,-3115,,
1427542599,9308900178,1333610890,9308897048,-3130,,
1427793016,9309150595,1333861308,9309147452,-3143,,
1428043543,9309401122,1334111835,9309397966,-3156,,
1428294000,9309651589,1334362302,9309648433,-3156,,
1428544501,9309902080,1334612792,9309898924,-3156,,
1428794914,9310152492,1334863205,9310149336,-3156,,
1429045077,9310402656,1335113378,9310399510,-3146,,
1429063150,9310420729,1335131441,9310417572,-3157,9310417613,
1429313769,9310671347,1335382060,9310668200,-3147,,
1429564744,9310922323,1335633035,9310919187,-3136,,
1429815338,9311172916,1335883629,9311169791,-3125,,
1430065451,9311423029,1336133742,9311419925,-3104,,
1430316348,9311673927,1336384639,9311670812,-3115,,
1430566515,9311924094,1336634806,9311920980,-3114,,
1430817193,9312174773,1336885486,9312171659,-3114,,
1431068297,9312425877,1337136589,9312422763,-3114,,
1431086271,9312443849,1337154562,9312440735,-3114,9312440706,
1431336643,9312694221,1337404934,9312691099,-3122,,
1431587346,9312944925,1337655637,9312941795,-3130,,
1431837668,9313195247,1337905960,9313192112,-3135,,
1432088150,9313445728,1338156441,9313442586,-3142,,
1432338476,9313696055,1338406767,9313692912,-3143,,
1432588859,9313946437,1338657150,9313943305,-3132,,
1432839429,9314197008,1338907721,9314193866,-3142,,
1433090248,9314447828,1339158541,9314444686,-3142,,
1433108306,9314465884,1339176597,9314462742,-3142,9314462724,
1433358747,9314716325,1339427037,9314713178,-3147,,
1433608911,9314966500,1339677212,9314963349,-3151,,
1433859441,9315217020,1339927732,9315213865,-3155,,
1434109625,9315467215,1340177927,9315464056,-3159,,
1434359818,9315717396,1340428109,9315714237,-3159,,
1434610147,9315967725,1340678438,9315964576,-3149,,
1434861037,9316218616,1340929329,9316215458,-3158,,
1435111197,9316468775,1341179488,9316465616,-3159,,
1435129278,9316486857,1341197569,9316483697,-3160,9316483673,
1435379564,9316737143,1341447855,9316733977,-3166,,
1435630268,9316987846,1341698559,9316984685,-3161,,
1435880378,9317237956,1341948669,9317234779,-3177,,
1436130597,9317488176,1342198898,9317485003,-3173,,
1436380781,9317738360,1342449072,9317735178,-3182,,
1436631407,9317988986,1342699698,9317985804,-3182,,
1436881987,9318239566,1342950279,9318236385,-3181,,
1437132573,9318490152,1343200865,9318486970,-3182,,
1437150709,9318508287,1343218999,9318505105,-3182,9318505133,
1437401078,9318758656,1343469369,9318755481,-3175,,
1437651197,9319008776,1343719488,9319005608,-3168,,
1437901570,9319259149,1343969861,9319255989,-3160,,
1438151825,9319509404,1344220117,9319506252,-3152,,
1438402446,9319760025,1344470737,9319756883,-3142,,
1438652595,9320010173,1344720896,9320007031,-3142,,
1438903231,9320260820,1344971533,9320257668,-3152,,
1439153416,9320510995,1345221708,9320507843,-3152,,
1439171314,9320528893,1345239605,9320525740,-3153,9320525718,
1439421712,9320779290,1345490003,9320776132,-3158,,
1439671918,9321029496,1345740208,9321026333,-3163,,
1439922228,9321279806,1345990519,9321276638,-3168,,
1440172448,9321530027,1346240739,9321526864,-3163,,
1440422765,9321780343,1346491056,9321777170,-3173,,
1440673393,9322030972,1346741684,9322027799,-3173,,
1440923789,9322281379,1346992091,9322278206,-3173,,
1441174339,9322531917,1347242640,9322528754,-3163,,
1441192404,9322549982,1347260694,9322546809,-3173,9322546769,
1441442998,9322800576,1347511289,9322797394,-3182,,
1441693125,9323050704,1347761416,9323047512,-3192,,
1441943704,9323301282,1348011994,9323298081,-3201,,
1442194103,9323551682,1348262394,9323548481,-3201,,
1442444297,9323801876,1348512588,9323798665,-3211,,
1442694461,9324052039,1348762761,9324048838,-3201,,
1442945175,9324302754,1349013466,9324299543,-3211,,
1443195535,9324553114,1349263827,9324549903,-3211,,
1443213642,9324571220,1349281932,9324568009,-3211,9324568064,
1443463756,9324821334,1349532047,9324818137,-3197,,
1443714372,9325071950,1349782663,9325068768,-3182,,
1443964929,9325322508,1350033221,9325319340,-3168,,
1444215559,9325573148,1350283861,9325569994,-3154,,
1444465758,9325823337,1350534049,9325820182,-3155,,
1444716172,9326073751,1350784463,9326070608,-3143,,
1444966319,9326323898,1351034610,9326320753,-3145,,
1445217131,9326574709,1351285422,9326571566,-3143,,
1445235548,9326593126,1351303838,9326589972,-3154,9326589787,
1445486254,9326843833,1351554545,9326840634,-3199,,
1445736776,9327094355,1351805067,9327091109,-3246,,
1445987201,9327344780,1352055493,9327341489,-3291,,
1446237592,9327595181,1352305894,9327591844,-3337,,
1446488461,9327846039,1352556751,9327842702,-3337,,
1446738648,9328096227,1352806939,9328092890,-3337,,
1446989142,9328346721,1353057434,9328343385,-3336,,
1447239690,9328597279,1353307992,9328593942,-3337,,
1447257842,9328615421,1353326133,9328612083,-3338,9328612248,
1447507985,9328865564,1353576277,9328862268,-3296,,
1447758307,9329115886,1353826599,9329112633,-3253,,
1448008776,9329366355,1354077068,9329363143,-3212,,
1448259176,9329616754,1354327477,9329613594,-3160,,
1448509483,9329867061,1354577774,9329863890,-3171,,
1448759955,9330117534,1354828246,9330114362,-3172,,
1449010098,9330367676,1355078389,9330364505,-3171,,
1449260447,9330618026,1355328738,9330614855,-3171,,
1449278535,9330636113,1355346825,9330632942,-3171,9330632972,
1449528719,9330886298,1355597010,9330883133,-3165,,
1449779546,9331137125,1355847837,9331133969,-3156,,
1450029713,9331387291,1356098004,9331384144,-3147,,
1450280111,9331637699,1356348412,9331634559,-3140,,
1450530431,9331888010,1356598723,9331884870,-3140,,
1450780913,9332138491,1356849204,9332135351,-3140,,
1451031252,9332388830,1357099543,9332385690,-3140,,
1451281606,9332639184,1357349897,9332636044,-3140,,
1451299746,9332657324,1357368036,9332654184,-3140,9332654182,
1451550057,9332907635,1357618348,9332904495,-3140,,
1451800373,9333157953,1357868665,9333154813,-3140,,
1452051009,9333408588,1358119300,9333405448,-3140,,
1452301268,9333658847,1358369570,9333655718,-3129,,
1452551531,9333909110,1358619822,9333905980,-3130,,
1452801648,9334159227,1358869939,9334156087,-3140,,
1453052014,9334409592,1359120305,9334406452,-3140,,
1453302229,9334659808,1359370520,9334656668,-3140,,
1453320268,9334677847,1359388559,9334674706,-3141,9334674623,
1453570786,9334928365,1359639077,9334925202,-3163,,
1453821297,9335178876,1359889589,9335175695,-3181,,
1454071412,9335429001,1360139714,9335425799,-3202,,
1454322107,9335679687,1360390399,9335676464,-3223,,
1454572582,9335930161,1360640873,9335926939,-3222,,
1454822957,9336180536,1360891248,9336177314,-3222,,
1455073135,9336430713,1361141426,9336427491,-3222,,
1455323298,9336680887,1361391600,9336677665,-3222,,
1455341428,9336699006,1361409718,9336695784,-3222,9336695799,
1455591872,9336949451,1361660163,9336946232,-3219,,
1455842192,9337199770,1361910482,9337196556,-3214,,
1456092750,9337450329,1362161042,9337447120,-3209,,
1456343068,9337700647,1362411369,9337697452,-3195,,
1456593399,9337950977,1362661690,9337947772,-3205,,
1456843739,9338201318,1362912031,9338198114,-3204,,
1457094112,9338451691,1363162403,9338448485,-3206,,
1457344492,9338702082,1363412794,9338698877,-3205,,
1457362473,9338720051,1363430763,9338716846,-3205,9338716806,
1457612630,9338970209,1363680922,9338966994,-3215,,
1457863607,9339221185,1363931898,9339217961,-3224,,
1458114149,9339471728,1364182441,9339468504,-3224,,
1458364381,9339721971,1364432683,9339718728,-3243,,
1458614552,9339972141,1364682853,9339968898,-3243,,
1458865267,9340222846,1364933559,9340219604,-3242,,
1459115513,9340473091,1365183804,9340469858,-3233,,
1459365910,9340723489,1365434202,9340720247,-3242,,
1459384033,9340741611,1365452323,9340738367,-3244,9340738407,
1459634123,9340991702,1365702414,9340988469,-3233,,
1459884411,9341241989,1365952702,9341238766,-3223,,
1460134623,9341492201,1366202914,9341488988,-3213,,
1460385176,9341742765,1366453478,9341739563,-3202,,
1460635658,9341993237,1366703949,9341990035,-3202,,
1460886144,9342243724,1366954436,9342240522,-3202,,
1461136673,9342494251,1367204964,9342491049,-3202,,
1461386868,9342744456,1367455169,9342741254,-3202,,
1461404854,9342762432,1367473144,9342759230,-3202,9342759151,
1461655288,9343012866,1367723578,9343009644,-3222,,
1461905766,9343263345,1367974057,9343260103,-3242,,
1462156176,9343513754,1368224467,9343510494,-3260,,
1462406435,9343764013,1368474725,9343760745,-3268,,
1462656637,9344014215,1368724928,9344010937,-3278,,
1462906948,9344264527,1368975240,9344261248,-3279,,
1463157308,9344514887,1369225599,9344511608,-3279,,
1463407819,9344765397,1369476110,9344762118,-3279,,
1463425757,9344783336,1369494048,9344780057,-3279,9344780115,
1463676134,9345033723,1369744436,9345030459,-3264,,
1463926456,9345284034,1369994747,9345280785,-3249,,
1464177268,9345534847,1370245559,9345531612,-3235,,
1464427859,9345785437,1370496150,9345782218,-3219,,
1464678669,9346036248,1370746961,9346033029,-3219,,
1464929074,9346286652,1370997365,9346283433,-3219,,
1465179867,9346537446,1371248158,9346534227,-3219,,
1465430018,9346787597,1371498310,9346784378,-3219,,
1465448034,9346805613,1371516325,9346802393,-3220,9346802384,
1465698584,9347056163,1371766875,9347052941,-3222,,
1465949321,9347306900,1372017612,9347303677,-3223,,
1466199618,9347557196,1372267909,9347553971,-3225,,
1466450340,9347807919,1372518631,9347804691,-3228,,
1466700529,9348058108,1372768820,9348054880,-3228,,
1466950934,9348308512,1373019225,9348305296,-3216,,
1467201119,9348558698,1373269410,9348555471,-3227,,
1467451378,9348808957,1373519669,9348805730,-3227,,
1467469518,9348827096,1373537809,9348823869,-3227,9348823839,
1467719803,9349077382,1373788094,9349074146,-3236,,
1467970158,9349327736,1374038449,9349324494,-3242,,
1468220269,9349577848,1374288560,9349574599,-3249,,
1468470804,9349828382,1374539095,9349825126,-3256,,
1468721615,9350079194,1374789907,9350075938,-3256,,
1468972074,9350329653,1375040365,9350326397,-3256,,
1469222376,9350579954,1375290667,9350576698,-3256,,
1469473082,9350830661,1375541373,9350827404,-3257,,
1469491019,9350848598,1375559310,9350845342,-3256,9350845351,
1469741468,9351099047,1375809759,9351095792,-3255,,
1469991673,9351349252,1376059964,9351346000,-3252,,
1470242203,9351599781,1376310494,9351596544,-3237,,
1470493191,9351850769,1376561482,9351847524,-3245,,
1470743345,9352100934,1376811647,9352097689,-3245,,
1470993893,9352351472,1377062185,9352348227,-3245,,
1471244472,9352602050,1377312763,9352598816,-3234,,
1471494744,9352852323,1377563035,9352849078,-3245,,
1471512888,9352870466,1377581179,9352867221,-3245,9352867241,
1471763238,9353120816,1377831529,9353117575,-3241,,
1472013679,9353371259,1378081971,9353368024,-3235,,
1472263887,9353621465,1378332178,9353618245,-3220,,
1472514318,9353871897,1378582609,9353868672,-3225,,
1472765134,9354122723,1378833436,9354119499,-3224,,
1473015724,9354373302,1379084015,9354370078,-3224,,
1473265931,9354623521,1379334233,9354620297,-3224,,
1473516228,9354873807,1379584519,9354870583,-3224,,
1473534423,9354892001,1379602714,9354888777,-3224,9354888736,
1473785165,9355142744,1379853456,9355139510,-3234,,
1474035596,9355393174,1380103887,9355389930,-3244,,
1474285957,9355643536,1380354249,9355640283,-3253,,
1474536550,9355894128,1380604841,9355890864,-3264,,
1474786964,9356144543,1380855255,9356141278,-3265,,
1475037433,9356395012,1381105724,9356391748,-3264,,
1475287724,9356645303,1381356016,9356642039,-3264,,
1475538126,9356895704,1381606417,9356892440,-3264,,
1475556248,9356913826,1381624538,9356910562,-3264,9356910535,
1475806553,9357164132,1381874845,9357160862,-3270,,
1476056683,9357414262,1382124974,9357410985,-3277,,
1476307538,9357665127,1382375840,9357661844,-3283,,
1476557663,9357915241,1382625954,9357911951,-3290,,
1476808448,9358166026,1382876739,9358162736,-3290,,
1477058680,9358416270,1383126982,9358412980,-3290,,
1477309182,9358666771,1383377484,9358663481,-3290,,
1477559570,9358917149,1383627862,9358913859,-3290,,
1477577586,9358935164,1383645876,9358931874,-3290,9358931891,
1477828144,9359185723,1383896436,9359182437,-3286,,
1478078732,9359436311,1384147034,9359433040,-3271,,
1478329229,9359686818,1384397530,9359683542,-3276,,
1478579793,9359937372,1384648084,9359934099,-3273,,
1478830405,9360187983,1384898696,9360184711,-3272,,
1479080680,9360438258,1385148970,9360434986,-3272,,
1479330846,9360688426,1385399138,9360685154,-3272,,
1479581496,9360939074,1385649787,9360935802,-3272,,
1479599666,9360957244,1385667957,9360953972,-3272,9360954021,
1479849800,9361207379,1385918092,9361204120,-3259,,
1480100347,9361457925,1386168637,9361454678,-3247,,
1480350692,9361708280,1386418993,9361705045,-3235,,
1480600840,9361958418,1386669131,9361955196,-3222,,
1480851073,9362208651,1386919364,9362205429,-3222,,
1481101574,9362459152,1387169876,9362455941,-3211,,
1481352110,9362709699,1387420411,9362706477,-3222,,
1481602975,9362960553,1387671266,9362957331,-3222,,
1481621027,9362978606,1387689318,9362975384,-3222,9362975306,
1481871548,9363229127,1387939840,9363225886,-3241,,
1482122222,9363479801,1388190514,9363476541,-3260,,
1482372334,9363729923,1388440636,9363726644,-3279,,
1482622834,9363980413,1388691125,9363977115,-3298,,
1482873158,9364230736,1388941449,9364227438,-3298,,
1483123424,9364481003,1389191726,9364477715,-3288,,
1483373615,9364731194,1389441906,9364727896,-3298,,
1483623851,9364981430,1389692143,9364978132,-3298,,
1483642052,9364999630,1389710342,9364996331,-3299,9364996364,
1483892796,9365250374,1389961087,9365247084,-3290,,
1484143423,9365501013,1390211725,9365497731,-3282,,
1484394201,9365751789,1390462502,9365748516,-3273,,
1484644366,9366001945,1390712658,9365998681,-3264,,
1484895038,9366252617,1390963330,9366249354,-3263,,
1485145707,9366503287,1391214000,9366500023,-3264,,
1485396293,9366753871,1391464584,9366750608,-3263,,
1485646611,9367004190,1391714902,9367000926,-3264,,
1485664706,9367022284,1391732996,9367019020,-3264,9367019012,
1485914795,9367272374,1391983086,9367269108,-3266,,
1486165499,9367523078,1392233790,9367519811,-3267,,
1486416107,9367773686,1392484398,9367770417,-3269,,
1486666553,9368024131,1392734844,9368020861,-3270,,
1486916991,9368274570,1392985283,9368271300,-3270,,
1487167069,9368524648,1393235360,9368521377,-3271,,
1487417509,9368775089,1393485801,9368771819,-3270,,
1487667676,9369025255,1393735978,9369021995,-3260,,
1487685655,9369043233,1393753945,9369039963,-3270,9369039951,
1487936330,9369293909,1394004621,9369290637,-3272,,
1488186452,9369544031,1394254743,9369540756,-3275,,
1488436641,9369794220,1394504932,9369790943,-3277,,
1488686923,9370044502,1394755214,9370041222,-3280,,
1488937805,9370295384,1395006096,9370292114,-3270,,
1489188321,9370545900,1395256612,9370542620,-3280,,
1489438550,9370796129,1395506841,9370792849,-3280,,
1489688799,9371046378,1395757090,9371043098,-3280,,
1489707006,9371064584,1395775297,9371061304,-3280,9371061237,
1489957471,9371315050,1396025762,9371311753,-3297,,
1490207738,9371565316,1396276028,9371562003,-3313,,
1490458315,9371815904,1396526617,9371812576,-3328,,
1490709095,9372066674,1396777386,9372063328,-3346,,
1490959450,9372317039,1397027751,9372313694,-3345,,
1491209863,9372567442,1397278154,9372564107,-3335,,
1491460064,9372817643,1397528356,9372814299,-3344,,
1491710410,9373067989,1397778701,9373064644,-3345,,
1491728411,9373085989,1397796702,9373082644,-3345,9373082642,
1491978739,9373336318,1398047030,9373332971,-3347,,
1492229034,9373586613,1398297325,9373583266,-3347,,
1492479272,9373836862,1398547575,9373833516,-3346,,
1492729554,9374087144,1398797856,9374083798,-3346,,
1492979785,9374337375,1399048087,9374334029,-3346,,
1493230071,9374587649,1399298362,9374584303,-3346,,
1493480186,9374837765,1399548478,9374834419,-3346,,
1493730590,9375088168,1399798881,9375084822,-3346,,
1493748983,9375106561,1399817274,9375103215,-3346,9375103042,
1493999369,9375356947,1400067660,9375353557,-3390,,
1494249959,9375607538,1400318250,9375604106,-3432,,
1494500540,9375858119,1400568832,9375854645,-3474,,
1494750942,9376108521,1400819234,9376105003,-3518,,
1495001312,9376358891,1401069604,9376355373,-3518,,
1495251518,9376609096,1401319809,9376605578,-3518,,
1495501707,9376859286,1401569999,9376855768,-3518,,
1495752232,9377109810,1401820523,9377106292,-3518,,
1495770214,9377127792,1401838505,9377124274,-3518,9377124461,
1496020674,9377378253,1402088965,9377374782,-3471,,
1496271339,9377628917,1402339630,9377625494,-3423,,
1496521870,9377879459,1402590172,9377876084,-3375,,
1496772388,9378129966,1402840679,9378126637,-3329,,
1497022500,9378380079,1403090792,9378376750,-3329,,
1497273116,9378630695,1403341407,9378627366,-3329,,
1497523393,9378880982,1403591695,9378877654,-3328,,
1497773528,9379131107,1403841819,9379127778,-3329,,
1497791652,9379149230,1403859942,9379145901,-3329,9379145990,
1498042039,9379399618,1404110330,9379396312,-3306,,
1498292579,9379650158,1404360870,9379646884,-3274,,
1498542723,9379900303,1404611015,9379897042,-3261,,
1498793482,9380151060,1404861773,9380147822,-3238,,
1499043599,9380401177,1405111890,9380397939,-3238,,
1499294059,9380651637,1405362350,9380648399,-3238,,
1499544533,9380902112,1405612825,9380898874,-3238,,
1499794879,9381152458,1405863170,9381149219,-3239,,
1499813034,9381170612,1405881324,9381167374,-3238,9381167297,
1500063422,9381421001,1406131713,9381417746,-3255,,
1500313729,9381671308,1406382020,9381668037,-3271,,
1500564437,9381922015,1406632728,9381918738,-3277,,
1500815368,9382172947,1406883659,9382169643,-3304,,
1501066303,9382423882,1407134594,9382420578,-3304,,
1501316900,9382674478,1407385191,9382671175,-3303,,
1501567427,9382925006,1407635718,9382921702,-3304,,
1501818131,9383175710,1407886423,9383172407,-3303,,
1501836291,9383193869,1407904581,9383190566,-3303,9383190478,
1502086452,9383444031,1408154743,9383440707,-3324,,
1502336800,9383694378,1408405090,9383691032,-3346,,
1502587135,9383944713,1408655426,9383941346,-3367,,
1502837325,9384194903,1408905616,9384191514,-3389,,
1503087819,9384445398,1409156110,9384442019,-3379,,
1503338168,9384695747,1409406460,9384692358,-3389,,
1503588309,9384945888,1409656600,9384942498,-3390,,
1503839137,9385196716,1409907429,9385193327,-3389,,
1503857196,9385214775,1409925487,9385211386,-3389,9385211407,
1504107749,9385465328,1410176040,9385461943,-3385,,
1504357889,9385715468,1410426180,9385712090,-3378,,
1504608383,9385965962,1410676674,9385962590,-3372,,
1504858806,9386216384,1410927097,9386213018,-3366,,
1505109408,9386466987,1411177699,9386463621,-3366,,
1505359523,9386717102,1411427814,9386713746,-3356,,
1505609797,9386967375,1411678088,9386964020,-3355,,
1505860339,9387217918,1411928630,9387214552,-3366,,
1505878589,9387236167,1411946879,9387232801,-3366,9387232668,
1506129027,9387486605,1412197318,9387483206,-3399,,
1506379293,9387736872,1412447584,9387733439,-3433,,
1506629868,9387987446,1412698159,9387983982,-3464,,
1506880270,9388237849,1412948562,9388234352,-3497,,
1507130482,9388488061,1413198773,9388484564,-3497,,
1507381464,9388739043,1413449755,9388735546,-3497,,
1507631584,9388989162,1413699885,9388985676,-3486,,
1507881987,9389239565,1413950278,9389236068,-3497,,
1507899968,9389257546,1413968259,9389254049,-3497,9389254150,
1508150070,9389507659,1414218371,9389504187,-3472,,
1508400501,9389758079,1414468792,9389754633,-3446,,
1508650845,9390008424,1414719136,9390005014,-3410,,
1508901580,9390259160,1414969873,9390255766,-3394,,
1509152577,9390510155,1415220868,9390506761,-3394,,
1509403039,9390760617,1415471330,9390757223,-3394,,
1509653657,9391011236,1415721949,9391007842,-3394,,
1509904175,9391261753,1415972476,9391258369,-3384,,
1509922214,9391279792,1415990505,9391276398,-3394,9391276397,
1510172616,9391530195,1416240907,9391526799,-3396,,
1510423213,9391780792,1416491504,9391777396,-3396,,
1510673722,9392031300,1416742013,9392027906,-3394,,
1510924332,9392281911,1416992624,9392278517,-3394,,
1511175356,9392532935,1417243647,9392529541,-3394,,
1511425525,9392783103,1417493816,9392779709,-3394,,
1511675774,9393033352,1417744065,9393029958,-3394,,
1511925939,9393283528,1417994240,9393280133,-3395,,
1511943998,9393301577,1418012289,9393298183,-3394,9393298223,
1512194371,9393551950,1418262662,9393548564,-3386,,
1512444959,9393802537,1418513250,9393799163,-3374,,
1512695537,9394053115,1418763828,9394049752,-3363,,
1512945726,9394303305,1419014018,9394299953,-3352,,
1513196139,9394553717,1419264430,9394550365,-3352,,
1513446255,9394803834,1419514546,9394800482,-3352,,
1513697141,9395054720,1419765432,9395051368,-3352,,
1513947316,9395304895,1420015607,9395301553,-3342,,
1513965407,9395322985,1420033697,9395319632,-3353,9395319621,
1514215840,9395573418,1420284131,9395570055,-3363,,
1514466570,9395824149,1420534861,9395820786,-3363,,
1514717126,9396074705,1420785417,9396071343,-3362,,
1514967431,9396325010,1421035723,9396321648,-3362,,
1515218096,9396575675,1421286388,9396572313,-3362,,
1515468278,9396825857,1421536569,9396822494,-3363,,
1515718621,9397076200,1421786913,9397072838,-3362,,
1515968879,9397326457,1422037170,9397323095,-3362,,
1515987188,9397344766,1422055478,9397341404,-3362,9397341463,
1516237297,9397594876,1422305588,9397591530,-3346,,
1516487472,9397845050,1422555763,9397841719,-3331,,
1516737806,9398095385,1422806097,9398092068,-3317,,
1516988167,9398345746,1423056458,9398342445,-3301,,
1517238333,9398595912,1423306624,9398592621,-3291,,
1517489031,9398846609,1423557322,9398843308,-3301,,
1517739231,9399096809,1423807521,9399093519,-3290,,
1517989716,9399347294,1424058006,9399343993,-3301,,
1518007810,9399365388,1424076100,9399362086,-3302,9399361997,
1518257933,9399615512,1424326224,9399612188,-3324,,
1518508048,9399865627,1424576340,9399862282,-3345,,
1518758165,9400115744,1424826456,9400112377,-3367,,
1519008495,9400366084,1425076796,9400362695,-3389,,
1519258841,9400616420,1425327143,9400613041,-3379,,
1519509237,9400866816,1425577528,9400863427,-3389,,
1519759492,9401117070,1425827783,9401113681,-3389,,
1520009900,9401367479,1426078191,9401364090,-3389,,
1520027941,9401385519,1426096232,9401382130,-3389,9401382127,
1520278429,9401636008,1426346721,9401632619,-3389,,
1520528843,9401886422,1426597135,9401883032,-3390,,
1520779004,9402136593,1426847305,9402133202,-3391,,
1521029599,9402387178,1427097891,9402383788,-3390,,
1521279948,9402637527,1427348239,9402634136,-3391,,
1521530246,9402887825,1427598537,9402884444,-3381,,
1521780379,9403137958,1427848681,9403134578,-3380,,
1522031065,9403388643,1428099356,9403385253,-3390,,
1522049120,9403406699,1428117411,9403403308,-3391,9403403281,
1522299595,9403657174,1428367886,9403653777,-3397,,
1522550077,9403907656,1428618368,9403904253,-3403,,
1522800710,9404158289,1428869001,9404154889,-3400,,
1523051590,9404409169,1429119881,9404405752,-3417,,
1523302412,9404659990,1429370713,9404656584,-3406,,
1523552588,9404910167,1429620879,9404906751,-3416,,
1523803582,9405161161,1429871873,9405157745,-3416,,
1524053755,9405411345,1430122057,9405407929,-3416,,
1524071774,9405429353,1430140065,9405425936,-3417,9405425918,
1524321992,9405679571,1430390283,9405676150,-3421,,
1524572570,9405930149,1430640861,9405926724,-3425,,
1524822718,9406180297,1430891010,9406176868,-3429,,
1525073084,9406430662,1431141374,9406427229,-3433,,
1525323268,9406680857,1431391569,9406677424,-3433,,
1525573951,9406931530,1431642242,9406928096,-3434,,
1525824702,9407182282,1431892994,9407178849,-3433,,
1526075094,9407432682,1432143395,9407429250,-3432,,
1526093080,9407450659,1432161371,9407447225,-3434,9407447214,
1526343461,9407701040,1432411763,9407697613,-3427,,
1526593995,9407951574,1432662286,9407948135,-3439,,
1526844196,9408201774,1432912487,9408198344,-3430,,
1527094531,9408452109,1433162822,9408448666,-3443,,
1527345331,9408702910,1433413622,9408699467,-3443,,
1527595718,9408953297,1433664010,9408949854,-3443,,
1527846214,9409203794,1433914506,9409200351,-3443,,
1528096598,9409454177,1434164890,9409450735,-3442,,
1528114650,9409472228,1434182940,9409468785,-3443,9409468788,
1528364877,9409722455,1434433168,9409719013,-3442,,
1528615255,9409972844,1434683556,9409969402,-3442,,
1528865808,9410223386,1434934098,9410219957,-3429,,
1529115992,9410473571,1435184283,9410470133,-3438,,
1529366374,9410723953,1435434665,9410720515,-3438,,
1529616941,9410974530,1435685242,9410971092,-3438,,
1529867581,9411225160,1435935873,9411221722,-3438,,
1530118312,9411475891,1436186603,9411472452,-3439,,
1530136390,9411493968,1436204681,9411490530,-3438,9411490524,
1530386617,9411744196,1436454908,9411740755,-3441,,
1530637186,9411994775,1436705488,9411991335,-3440,,
1530887992,9412245570,1436956282,9412242138,-3432,,
1531138157,9412495736,1437206449,9412492293,-3443,,
1531388478,9412746057,1437456769,9412742614,-3443,,
1531639058,9412996647,1437707359,9412993204,-3443,,
1531889570,9413247149,1437957862,9413243706,-3443,,
1532140015,9413497594,1438208306,9413494151,-3443,,
1532158011,9413515590,1438226302,9413512147,-3443,9413512220,
1532408116,9413765695,1438476407,9413762270,-3425,,
1532658307,9414015896,1438726608,9414012490,-3406,,
1532908429,9414266008,1438976720,9414262620,-3388,,
1533158655,9414516234,1439226946,9414512866,-3368,,
1533409208,9414766787,1439477500,9414763419,-3368,,
1533659824,9415017403,1439728116,9415014036,-3367,,
1533910417,9415267995,1439978708,9415264627,-3368,,
1534160667,9415518245,1440228958,9415514877,-3368,,
1534178701,9415536279,1440246991,9415532911,-3368,9415532826,
1534428916,9415786495,1440497207,9415783106,-3389,,
1534679510,9416037089,1440747802,9416033680,-3409,,
1534929994,9416287574,1440998286,9416284144,-3430,,
1535180521,9416538100,1441248822,9416534659,-3441,,
1535430757,9416788335,1441499058,9416784894,-3441,,
1535681505,9417039084,1441749797,9417035633,-3451,,
1535932040,9417289619,1442000331,9417286178,-3441,,
1536182536,9417540115,1442250827,9417536664,-3451,,
1536200595,9417558173,1442268885,9417554721,-3452,9417554789,
1536450925,9417808504,1442519216,9417805070,-3434,,
1536701297,9418058876,1442769589,9418055460,-3416,,
1536951459,9418309049,1443019761,9418305649,-3400,,
1537201661,9418559240,1443269952,9418555858,-3382,,
1537452530,9418810109,1443520821,9418806727,-3382,,
1537702875,9419060464,1443771177,9419057082,-3382,,
1537953495,9419311073,1444021786,9419307691,-3382,,
1538204133,9419561722,1444272435,9419558340,-3382,,
1538222141,9419579719,1444290431,9419576337,-3382,9419576227,
1538472629,9419830208,1444540921,9419826799,-3409,,
1538722838,9420080417,1444791130,9420076981,-3436,,
1538973079,9420330669,1445041381,9420327206,-3463,,
1539223182,9420580761,1445291474,9420577271,-3490,,
1539473578,9420831156,1445541869,9420827666,-3490,,
1539724272,9421081860,1445792573,9421078371,-3489,,
1539974599,9421332178,1446042890,9421328688,-3490,,
1540225186,9421582765,1446293477,9421579275,-3490,,
1540243208,9421600787,1446311499,9421597296,-3491,9421597366,
1540493790,9421851368,1446562080,9421847895,-3473,,
1540744082,9422101671,1446812384,9422098216,-3455,,
1540994809,9422352388,1447063100,9422348962,-3426,,
1541245062,9422602641,1447313354,9422599222,-3419,,
1541495862,9422853441,1447564153,9422850021,-3420,,
1541746488,9423104067,1447814790,9423100658,-3409,,
1541996775,9423354365,1448065077,9423350945,-3420,,
1542246887,9423604465,1448315178,9423601046,-3419,,
1542264907,9423622485,1448333197,9423619066,-3419,9423619011,
1542515091,9423872669,1448583382,9423869236,-3433,,
1542765168,9424122747,1448833460,9424119301,-3446,,
1543015398,9424372977,1449083689,9424369518,-3459,,
1543265779,9424623357,1449334069,9424619885,-3472,,
1543515998,9424873576,1449584289,9424870104,-3472,,
1543766272,9425123851,1449834563,9425120389,-3462,,
1544016481,9425374071,1450084783,9425370599,-3472,,
1544267014,9425624592,1450335305,9425621120,-3472,,
1544284992,9425642570,1450353283,9425639098,-3472,9425639126,
1544535846,9425893425,1450604137,9425889959,-3466,,
1544786439,9426144018,1450854741,9426140570,-3448,,
1545036653,9426394243,1451104955,9426390792,-3451,,
1545287305,9426644884,1451355596,9426641440,-3444,,
1545537605,9426895183,1451605896,9426891740,-3443,,
1545788002,9427145581,1451856303,9427142148,-3433,,
1546038572,9427396151,1452106874,9427392719,-3432,,
1546288972,9427646551,1452357263,9427643108,-3443,,
1546307124,9427664702,1452375415,9427661259,-3443,9427661230,
1546557640,9427915219,1452625931,9427911767,-3452,,
1546807723,9428165302,1452876014,9428161844,-3458,,
1547058275,9428415864,1453126577,9428412400,-3464,,
1547309019,9428666597,1453377310,9428663126,-3471,,
1547559610,9428917189,1453627901,9428913718,-3471,,
1547810043,9429167622,1453878335,9429164151,-3471,,
1548060215,9429417794,1454128507,9429414324,-3470,,
1548310641,9429668230,1454378943,9429664759,-3471,,
1548328675,9429686253,1454396966,9429682782,-3471,9429682781,
1548579206,9429936784,1454647497,9429933324,-3460,,
1548830181,9430187760,1454898472,9430184289,-3471,,
1549080737,9430438327,1455149039,9430434856,-3471,,
1549331549,9430689127,1455399839,9430685657,-3470,,
1549582125,9430939704,1455650416,9430936233,-3471,,
1549832745,9431190323,1455901036,9431186853,-3470,,
1550083199,9431440778,1456151490,9431437308,-3470,,
1550333950,9431691528,1456402251,9431688068,-3460,,
1550352017,9431709596,1456420308,9431706126,-3470,9431706104,
1550602280,9431959858,1456670570,9431956382,-3476,,
1550852400,9432209979,1456920691,9432206499,-3480,,
1551102730,9432460308,1457171021,9432456833,-3475,,
1551353295,9432710874,1457421586,9432707384,-3490,,
1551603672,9432961250,1457671973,9432957770,-3480,,
1551854027,9433211607,1457922319,9433208117,-3490,,
1552104353,9433461931,1458172654,9433458451,-3480,,
1552354501,9433712080,1458422802,9433708600,-3480,,
1552372805,9433730383,1458441095,9433726893,-3490,9433726818,
1552623225,9433980804,1458691516,9433977296,-3508,,
1552873795,9434231374,1458942087,9434227847,-3527,,
1553124259,9434481838,1459192550,9434478293,-3545,,
1553375068,9434732647,1459443359,9434729084,-3563,,
1553625552,9434983131,1459693843,9434979578,-3553,,
1553875952,9435233532,1459944245,9435229970,-3562,,
1554126270,9435483849,1460194561,9435480286,-3563,,
1554376437,9435734026,1460444738,9435730463,-3563,,
1554394606,9435752184,1460462897,9435748621,-3563,9435748779,
1554644780,9436002358,1460713071,9435998834,-3524,,
1554895045,9436252624,1460963337,9436249140,-3484,,
1555145597,9436503176,1461213888,9436499731,-3445,,
1555396080,9436753658,1461464371,9436750265,-3393,,
1555646539,9437004118,1461714830,9437000713,-3405,,
1555896704,9437254283,1461964996,9437250880,-3403,,
1556147342,9437504921,1462215633,9437501516,-3405,,
1556397732,9437755311,1462466033,9437751917,-3394,,
1556415848,9437773427,1462484139,9437770023,-3404,9437769950,
1556666626,9438024205,1462734917,9438020782,-3423,,
1556917116,9438274705,1462985417,9438271265,-3440,,
1557168177,9438525756,1463236468,9438522297,-3459,,
1557418508,9438776086,1463486799,9438772611,-3475,,
1557668658,9439026237,1463736949,9439022761,-3476,,
1557919183,9439276763,1463987475,9439273288,-3475,,
1558169378,9439526956,1464237680,9439523492,-3464,,
1558420031,9439777610,1464488322,9439774135,-3475,,
1558438134,9439795712,1464506425,9439792237,-3475,9439792255,
1558688684,9440046262,1464756975,9440042791,-3471,,
1558939042,9440296621,1465007333,9440293155,-3466,,
1559189278,9440546857,1465257569,9440543396,-3461,,
1559439651,9440797240,1465507953,9440793784,-3456,,
1559689870,9441047449,1465758161,9441043992,-3457,,
1559940519,9441298098,1466008821,9441294653,-3445,,
1560191036,9441548614,1466259326,9441545158,-3456,,
1560441865,9441799443,1466510156,9441795987,-3456,,
1560459968,9441817546,1466528258,9441814089,-3457,9441814059,
1560710051,9442067629,1466778341,9442064165,-3464,,
1560960789,9442318368,1467029081,9442314898,-3470,,
1561210902,9442568481,1467279203,9442565013,-3468,,
1561461132,9442818711,1467529423,9442815226,-3485,,
1561711664,9443069243,1467779955,9443065757,-3486,,
1561961900,9443319490,1468030202,9443316005,-3485,,
1562212227,9443569806,1468280518,9443566321,-3485,,
1562462461,9443820039,1468530752,9443816565,-3474,,
1562480523,9443838101,1468548813,9443834616,-3485,9443834579,
1562730819,9444088398,1468799110,9444084903,-3495,,
1562981429,9444339008,1469049721,9444335506,-3502,,
1563231890,9444589469,1469300181,9444585966,-3503,,
1563482495,9444840084,1469550796,9444836564,-3520,,
1563733024,9445090603,1469801315,9445087082,-3521,,
1563983253,9445340831,1470051554,9445337321,-3510,,
1564233471,9445591049,1470301762,9445587529,-3520,,
1564484122,9445841711,1470552424,9445838191,-3520,,
1564502262,9445859840,1470570552,9445856320,-3520,9445856301,
1564752595,9446110174,1470820886,9446106650,-3524,,
1565003124,9446360704,1471071417,9446357176,-3528,,
1565253555,9446611134,1471321847,9446607602,-3532,,
1565504369,9446861948,1471572670,9446858421,-3527,,
1565754531,9447112109,1471822822,9447108572,-3537,,
1566005173,9447362762,1472073475,9447359225,-3537,,
1566255322,9447612901,1472323613,9447609364,-3537,,
1566505734,9447863313,1472574025,9447859775,-3538,,
1566523973,9447881552,1472592264,9447878015,-3537,9447878055,
1566774829,9448132408,1472843120,9448128881,-3527,,
1567025583,9448383163,1473093876,9448379647,-3516,,
1567276208,9448633786,1473344499,9448630291,-3495,,
1567526435,9448884014,1473594727,9448880519,-3495,,
1567776545,9449134123,1473844836,9449130628,-3495,,
1568026730,9449384309,1474095021,9449380814,-3495,,
1568277015,9449634594,1474345306,9449631109,-3485,,
1568527535,9449885113,1474595826,9449881618,-3495,,
1568545645,9449903224,1474613936,9449899728,-3496,9449899699,
1568796279,9450153857,1474864570,9450150355,-3502,,
1569046541,9450404131,1475114844,9450400622,-3509,,
1569296856,9450654434,1475365147,9450650918,-3516,,
1569547154,9450904733,1475615445,9450901209,-3524,,
1569798126,9451155705,1475866417,9451152181,-3524,,
1570048676,9451406265,1476116977,9451402742,-3523,,
1570299101,9451656679,1476367392,9451653156,-3523,,
1570549191,9451906770,1476617482,9451903247,-3523,,
1570567228,9451924807,1476635519,9451921284,-3523,9451921286,
1570817805,9452175384,1476886096,9452171862,-3522,,
1571068046,9452425625,1477136337,9452422104,-3521,,
1571318794,9452676373,1477387085,9452672852,-3521,,
1571569017,9452926595,1477637308,9452923076,-3519,,
1571819136,9453176715,1477887437,9453173206,-3509,,
1572069355,9453426934,1478137656,9453423425,-3509,,
1572319892,9453677470,1478388182,9453673962,-3508,,
1572570051,9453927630,1478638343,9453924111,-3519,,
1572588130,9453945708,1478656420,9453942189,-3519,9453942139,
1572838458,9454196037,1478906749,9454192505,-3532,,
1573089050,9454446629,1479157341,9454443096,-3533,,
1573339197,9454696776,1479407488,9454693231,-3545,,
1573589732,9454947310,1479658023,9454943743,-3567,,
1573840175,9455197754,1479908467,9455194187,-3567,,
1574090586,9455448165,1480158877,9455444598,-3567,,
1574340986,9455698565,1480409277,9455694998,-3567,,
1574591588,9455949166,1480659879,9455945599,-3567,,
1574609647,9455967225,1480677937,9455963658,-3567,9455963687,
1574859711,9456217290,1480928002,9456213741,-3549,,
1575110128,9456467707,1481178419,9456464156,-3551,,
1575360726,9456718305,1481429017,9456714761,-3544,,
1575611069,9456968648,1481679360,9456965112,-3536,,
1575861166,9457218745,1481929457,9457215209,-3536,,
1576111527,9457469117,1482179829,9457465581,-3536,,
1576362268,9457719847,1482430569,9457716321,-3526,,
1576612897,9457970475,1482681188,9457966939,-3536,,
1576630929,9457988507,1482699220,9457984971,-3536,9457984970,
1576881449,9458239028,1482949740,9458235501,-3527,,
1577132004,9458489583,1483200296,9458486046,-3537,,
1577382172,9458739751,1483450463,9458736213,-3538,,
1577632523,9458990102,1483700814,9458986565,-3537,,
1577883392,9459240971,1483951684,9459237435,-3536,,
1578133571,9459491159,1484201872,9459487623,-3536,,
1578384092,9459741671,1484452383,9459738134,-3537,,
1578634619,9459992198,1484702910,9459988662,-3536,,
1578652661,9460010239,1484720951,9460006703,-3536,9460006685,
1578903366,9460260945,1484971657,9460257405,-3540,,
1579153669,9460511247,1485221960,9460507703,-3544,,
1579403869,9460761448,1485472160,9460757900,-3548,,
1579654099,9461011677,1485722390,9461008125,-3552,,
1579904706,9461262286,1485972999,9461258734,-3552,,
1580155301,9461512880,1486223592,9461509328,-3552,,
1580405874,9461763452,1486474165,9461759900,-3552,,
1580656535,9462014114,1486724826,9462010562,-3552,,
1580674681,9462032259,1486742971,9462028707,-3552,9462028665,
1580925275,9462282854,1486993566,9462279291,-3563,,
1581175493,9462533072,1487243784,9462529499,-3573,,
1581425838,9462783417,1487494129,9462779835,-3582,,
1581676005,9463033584,1487744296,9463029992,-3592,,
1581926862,9463284441,1487995154,9463280849,-3592,,
1582177137,9463534716,1488245428,9463531124,-3592,,
1582427558,9463785137,1488495849,9463781545,-3592,,
1582677883,9464035461,1488746174,9464031869,-3592,,
1582695950,9464053528,1488764240,9464049936,-3592,9464049963,
1582946124,9464303703,1489014415,9464300117,-3586,,
1583196718,9464554296,1489265008,9464550718,-3578,,
1583446889,9464804468,1489515180,9464800896,-3572,,
1583697233,9465054812,1489765535,9465051259,-3553,,
1583947432,9465305012,1490015724,9465301448,-3564,,
1584197786,9465555374,1490266087,9465551811,-3563,,
1584448358,9465805937,1490516649,9465802373,-3564,,
1584699191,9466056770,1490767483,9466053206,-3564,,
1584717289,9466074867,1490785580,9466071303,-3564,9466071320,
1584967929,9466325507,1491036220,9466321939,-3568,,
1585218541,9466576120,1491286832,9466572568,-3552,,
1585469086,9466826665,1491537377,9466823112,-3553,,
1585719239,9467076817,1491787540,9467073281,-3536,,
1585969760,9467327339,1492038052,9467323793,-3546,,
1586220259,9467577838,1492288550,9467574292,-3546,,
1586470478,9467828056,1492538769,9467824510,-3546,,
1586720743,9468078322,1492789034,9468074776,-3546,,
1586738802,9468096381,1492807093,9468092834,-3547,9468092822,
1586989197,9468346776,1493057488,9468343226,-3550,,
1587239374,9468596953,1493307665,9468593401,-3552,,
1587489722,9468847301,1493558013,9468843747,-3554,,
1587740104,9469097683,1493808395,9469094125,-3558,,
1587990309,9469347888,1494058600,9469344331,-3557,,
1588240806,9469598385,1494309097,9469594828,-3557,,
1588491138,9469848717,1494559430,9469845160,-3557,,
1588741646,9470099225,1494809937,9470095668,-3557,,
1588759775,9470117354,1494828066,9470113796,-3558,9470113799,
1589010199,9470367789,1495078501,9470364231,-3558,,
1589260600,9470618179,1495328901,9470614634,-3545,,
1589511277,9470868856,1495579568,9470865301,-3555,,
1589761396,9471118974,1495829687,9471115421,-3553,,
1590011937,9471369516,1496080228,9471365963,-3553,,
1590262108,9471619687,1496330410,9471616144,-3543,,
1590512685,9471870263,1496580976,9471866710,-3553,,
1590763125,9472120704,1496831416,9472117151,-3553,,
1590781222,9472138800,1496849513,9472135247,-3553,9472135243,
1591031802,9472389381,1497100093,9472385837,-3544,,
1591282196,9472639784,1497350497,9472636229,-3555,,
1591532325,9472889904,1497600616,9472886348,-3556,,
1591782944,9473140523,1497851235,9473136967,-3556,,
1592033361,9473390940,1498101653,9473387384,-3556,,
1592283567,9473641147,1498351859,9473637591,-3556,,
1592534331,9473891910,1498602622,9473888354,-3556,,
1592785074,9474142652,1498853365,9474139096,-3556,,
1592803166,9474160745,1498871457,9474157188,-3557,9474157130,
1593053728,9474411307,1499122019,9474407735,-3572,,
1593304277,9474661856,1499372569,9474658272,-3584,,
1593554728,9474912307,1499623019,9474908708,-3599,,
1593805330,9475162908,1499873621,9475159295,-3613,,
1594055664,9475413243,1500123955,9475409630,-3613,,
1594306135,9475663714,1500374427,9475660101,-3613,,
1594556246,9475913825,1500624538,9475910212,-3613,,
1594806481,9476164059,1500874772,9476160446,-3613,,
1594824790,9476182368,1500893081,9476178755,-3613,9476178899,
1595075150,9476432729,1501143441,9476429151,-3578,,
1595325752,9476683330,1501394043,9476679800,-3530,,
1595576347,9476933925,1501644637,9476930421,-3504,,
1595826468,9477184046,1501894759,9477180578,-3468,,
1596077123,9477434701,1502145414,9477431233,-3468,,
1596327326,9477684904,1502395617,9477681436,-3468,,
1596577552,9477935131,1502645844,9477931663,-3468,,
1596828073,9478185652,1502896364,9478182194,-3458,,
1596846257,9478203835,1502914548,9478200367,-3468,9478200344,
1597097046,9478454625,1503165337,9478451152,-3473,,
1597347672,9478705251,1503415974,9478701782,-3469,,
1597598039,9478955618,1503666330,9478952144,-3474,,
1597848341,9479205920,1503916632,9479202430,-3490,,
1598098685,9479456274,1504166987,9479452785,-3489,,
1598349402,9479706991,1504417703,9479703502,-3489,,
1598599592,9479957171,1504667883,9479953682,-3489,,
1598849814,9480207393,1504918105,9480203904,-3489,,
1598867804,9480225383,1504936095,9480221893,-3490,9480221735,
1599118035,9480475624,1505186336,9480472095,-3529,,
1599368619,9480726198,1505436910,9480722630,-3568,,
1599618920,9480976499,1505687211,9480972891,-3608,,
1599869064,9481226653,1505937365,9481223006,-3647,,
1600119912,9481477490,1506188202,9481473844,-3646,,
1600370074,9481727653,1506438365,9481724007,-3646,,
1600620852,9481978431,1506689154,9481974795,-3636,,
1600871032,9482228611,1506939323,9482224965,-3646,,
1600889164,9482246742,1506957454,9482243096,-3646,9482243144,
1601139285,9482496864,1507207576,9482493230,-3634,,
1601389476,9482747054,1507457767,9482743433,-3621,,
1601639747,9482997326,1507708049,9482993727,-3599,,
1601889927,9483247505,1507958228,9483243919,-3586,,
1602140378,9483497956,1508208669,9483494360,-3596,,
1602390945,9483748523,1508459235,9483744927,-3596,,
1602641375,9483998953,1508709666,9483995357,-3596,,
1602891939,9484249517,1508960230,9484245921,-3596,,
1602909895,9484267474,1508978186,9484263877,-3597,9484263872,
1603160489,9484518067,1509228791,9484514480,-3587,,
1603411071,9484768661,1509479373,9484765063,-3598,,
1603661874,9485019453,1509730165,9485015865,-3588,,
1603912112,9485269691,1509980404,9485266091,-3600,,
1604162643,9485520232,1510230945,9485516633,-3599,,
1604412749,9485770327,1510481040,9485766727,-3600,,
1604663739,9486021317,1510732030,9486017717,-3600,,
1604913890,9486271468,1510982181,9486267868,-3600,,
1604931835,9486289413,1511000125,9486285813,-3600,9486285770,
1605182411,9486539991,1511250703,9486536381,-3610,,
1605432663,9486790242,1511500954,9486786620,-3622,,
1605682904,9487040483,1511751196,9487036862,-3621,,
1605933765,9487291345,1512002057,9487287704,-3641,,
1606184217,9487541796,1512252508,9487538155,-3641,,
1606434899,9487792478,1512503201,9487788847,-3631,,
1606685013,9488042592,1512753304,9488038950,-3642,,
1606935349,9488292928,1513003640,9488289286,-3642,,
1606953524,9488311103,1513021815,9488307461,-3642,9488307446,
1607204181,9488561759,1513272482,9488558123,-3636,,
1607454747,9488812326,1513523038,9488808687,-3639,,
1607705402,9489062981,1513773693,9489059328,-3653,,
1607955750,9489313330,1514024043,9489309676,-3654,,
1608206334,9489563914,1514274626,9489560258,-3656,,
1608456728,9489814307,1514525020,9489810652,-3655,,
1608707290,9490064868,1514775581,9490061213,-3655,,
1608958197,9490315776,1515026488,9490312120,-3656,,
1608976337,9490333916,1515044628,9490330260,-3656,9490330300,
1609226457,9490584036,1515294749,9490580390,-3646,,
1609477433,9490835012,1515545724,9490831376,-3636,,
1609727566,9491085145,1515795857,9491081520,-3625,,
1609978063,9491335643,1516046356,9491332029,-3614,,
1610228687,9491586266,1516296979,9491582653,-3613,,
1610478808,9491836386,1516547099,9491832783,-3603,,
1610728933,9492086512,1516797224,9492082898,-3614,,
1610979099,9492336678,1517047390,9492333063,-3615,,
1610997071,9492354650,1517065362,9492351035,-3615,9492351014,
1611247244,9492604823,1517315535,9492601203,-3620,,
1611497664,9492855243,1517565955,9492851618,-3625,,
1611747852,9493105431,1517816144,9493101801,-3630,,
1611998447,9493356027,1518066740,9493352393,-3634,,
1612248682,9493606261,1518316974,9493602627,-3634,,
1612498917,9493856496,1518567208,9493852871,-3625,,
1612749757,9494107335,1518818048,9494103701,-3634,,
1613000357,9494357936,1519068648,9494354301,-3635,,
1613018601,9494376180,1519086892,9494372545,-3635,9494372415,
1613269042,9494626621,1519337343,9494622964,-3657,,
1613519215,9494876793,1519587506,9494873094,-3699,,
1613769559,9495127138,1519837861,9495123417,-3721,,
1614020116,9495377695,1520088408,9495373932,-3763,,
1614270442,9495628021,1520338733,9495624257,-3764,,
1614520664,9495878243,1520588956,9495874480,-3763,,
1614771133,9496128711,1520839424,9496124948,-3763,,
1615021534,9496379112,1521089825,9496375349,-3763,,
1615039720,9496397299,1521108011,9496393535,-3764,9496393618,
1615289907,9496647486,1521358208,9496643753,-3733,,
1615540397,9496897976,1521608688,9496894255,-3721,,
1615790815,9497148394,1521859106,9497144693,-3701,,
1616041143,9497398722,1522109434,9497395043,-3679,,
1616291600,9497649179,1522359902,9497645510,-3669,,
1616541764,9497899354,1522610066,9497895675,-3679,,
1616791962,9498149540,1522860253,9498145861,-3679,,
1617042454,9498400034,1523110746,9498396355,-3679,,
1617060870,9498418448,1523129161,9498414769,-3679,9498414683,
1617311400,9498668978,1523379691,9498665289,-3689,,
1617561618,9498919196,1523629908,9498915475,-3721,,
1617812416,9499169994,1523880707,9499166252,-3742,,
1618062528,9499420117,1524130829,9499416353,-3764,,
1618313452,9499671030,1524381743,9499667267,-3763,,
1618563601,9499921190,1524631903,9499917427,-3763,,
1618814200,9500171778,1524882491,9500168015,-3763,,
1619064814,9500422393,1525133105,9500418630,-3763,,
1619082976,9500440554,1525151266,9500436791,-3763,9500436874,
1619333088,9500690667,1525401380,9500686925,-3742,,
1619583293,9500940872,1525651585,9500937151,-3721,,
1619833840,9501191419,1525902131,9501187719,-3700,,
1620084195,9501441774,1526152497,9501438106,-3668,,
1620334799,9501692388,1526403101,9501688710,-3678,,
1620585116,9501942695,1526653408,9501939017,-3678,,
1620835286,9502192864,1526903588,9502189197,-3667,,
1621085764,9502443343,1527154056,9502439666,-3677,,
1621103732,9502461310,1527172023,9502457632,-3678,9502457680,
1621354287,9502711876,1527422589,9502708210,-3666,,
1621604825,9502962404,1527673116,9502958751,-3653,,
1621855444,9503213023,1527923735,9503209382,-3641,,
1622105760,9503463339,1528174051,9503459710,-3629,,
1622356730,9503714319,1528425032,9503710691,-3628,,
1622607328,9503964906,1528675618,9503961278,-3628,,
1622857564,9504215143,1528925855,9504211525,-3618,,
1623107957,9504465546,1529176258,9504461918,-3628,,
1623126039,9504483617,1529194330,9504479989,-3628,9504479931,
1623376158,9504733737,1529444449,9504730095,-3642,,
1623626848,9504984427,1529695139,9504980771,-3656,,
1623877148,9505234727,1529945439,9505231056,-3671,,
1624127700,9505485279,1530195991,9505481594,-3685,,
1624377864,9505735443,1530446156,9505731759,-3684,,
1624628362,9505985941,1530696653,9505982257,-3684,,
1624878473,9506236051,1530946763,9506232367,-3684,,
1625128814,9506486392,1531197105,9506482708,-3684,,
1625146908,9506504487,1531215199,9506500802,-3685,9506500874,
1625397170,9506754749,1531465462,9506751082,-3667,,
1625647304,9507004883,1531715606,9507001245,-3638,,
1625897926,9507255504,1531966217,9507251875,-3629,,
1626148492,9507506071,1532216784,9507502460,-3611,,
1626398709,9507756288,1532467001,9507752678,-3610,,
1626649012,9508006591,1532717303,9508002979,-3612,,
1626899389,9508256968,1532967680,9508253357,-3611,,
1627150295,9508507874,1533218586,9508504263,-3611,,
1627168828,9508526406,1533237119,9508522795,-3611,9508522924,
1627419166,9508776745,1533487458,9508773166,-3579,,
1627669287,9509026865,1533737578,9509023319,-3546,,
1627919707,9509277286,1533987999,9509273772,-3514,,
1628169809,9509527398,1534238110,9509523917,-3481,,
1628420706,9509778285,1534488998,9509774804,-3481,,
1628671301,9510028880,1534739593,9510025399,-3481,,
1628921541,9510279120,1534989832,9510275639,-3481,,
1629172007,9510529586,1535240299,9510526105,-3481,,
1629190095,9510547674,1535258386,9510544192,-3482,9510543966,
1629440398,9510797977,1535508689,9510794439,-3538,,
1629690914,9511048493,1535759205,9511044899,-3594,,
1629941299,9511298878,1536009591,9511295229,-3649,,
1630192228,9511549807,1536260519,9511546100,-3707,,
1630442427,9511800006,1536510719,9511796300,-3706,,
1630692589,9512050167,1536760880,9512046461,-3706,,
1630943047,9512300626,1537011338,9512296920,-3706,,
1631193437,9512551015,1537261728,9512547309,-3706,,
1631211345,9512568923,1537279635,9512565217,-3706,9512565287,
1631462242,9512819822,1537530534,9512816133,-3689,,
1631712385,9513069964,1537780676,9513066294,-3670,,
1631962934,9513320514,1538031226,9513316862,-3652,,
1632213615,9513571194,1538281906,9513567560,-3634,,
1632463855,9513821434,1538532147,9513817800,-3634,,
1632714301,9514071879,1538782592,9514068245,-3634,,
1632964545,9514322123,1539032835,9514318489,-3634,,
1633214806,9514572385,1539283097,9514568751,-3634,,
1633232750,9514590328,1539301041,9514586694,-3634,9514586626,
1633482958,9514840536,1539551249,9514836886,-3650,,
1633733575,9515091154,1539801867,9515087486,-3668,,
1633984136,9515341715,1540052427,9515338031,-3684,,
1634234600,9515592179,1540302891,9515588477,-3702,,
1634484697,9515842276,1540552989,9515838575,-3701,,
1634735171,9516092750,1540803462,9516089049,-3701,,
1634985727,9516343306,1541054018,9516339615,-3691,,
1635236570,9516594149,1541304861,9516590448,-3701,,
1635254721,9516612299,1541323011,9516608598,-3701,9516608573,
1635504928,9516862507,1541573219,9516858800,-3707,,
1635755258,9517112847,1541823560,9517109134,-3713,,
1636005899,9517363478,1542074190,9517359759,-3719,,
1636256283,9517613862,1542324574,9517610138,-3724,,
1636506636,9517864215,1542574928,9517860492,-3723,,
1636756803,9518114382,1542825094,9518110668,-3714,,
1637007270,9518364849,1543075561,9518361125,-3724,,
1637257469,9518615048,1543325760,9518611324,-3724,,
1637275530,9518633108,1543343821,9518629384,-3724,9518629349,
1637525760,9518883339,1543594051,9518879605,-3734,,
1637776608,9519134186,1543844899,9519130444,-3742,,
1638026938,9519384518,1544095231,9519380768,-3750,,
1638277857,9519635445,1544346158,9519631688,-3757,,
1638528005,9519885584,1544596297,9519881826,-3758,,
1638778822,9520136401,1544847123,9520132653,-3748,,
1639029200,9520386779,1545097491,9520383020,-3759,,
1639279602,9520637181,1545347894,9520633423,-3758,,
1639297565,9520655144,1545365856,9520651386,-3758,9520651460,
1639547891,9520905480,1545616193,9520901741,-3739,,
1639798360,9521155939,1545866651,9521152218,-3721,,
1640048792,9521406372,1546117084,9521402671,-3701,,
1640299286,9521656865,1546367578,9521653193,-3672,,
1640549764,9521907343,1546618056,9521903661,-3682,,
1640800259,9522157838,1546868550,9522154166,-3672,,
1641050789,9522408368,1547119080,9522404686,-3682,,
1641301235,9522658814,1547369526,9522655131,-3683,,
1641319207,9522676785,1547387498,9522673103,-3682,9522673046,
1641569701,9522927280,1547637993,9522923583,-3697,,
1641820182,9523177761,1547888473,9523174050,-3711,,
1642070646,9523428224,1548138947,9523424509,-3715,,
1642320930,9523678509,1548389221,9523674771,-3738,,
1642571131,9523928710,1548639422,9523924972,-3738,,
1642821225,9524178803,1548889516,9524175065,-3738,,
1643071502,9524429080,1549139793,9524425343,-3737,,
1643322012,9524679591,1549390303,9524675863,-3728,,
1643340095,9524697673,1549408386,9524693935,-3738,9524693957,
1643590732,9524948311,1549659023,9524944589,-3722,,
1643841259,9525198838,1549909551,9525195111,-3727,,
1644091531,9525449110,1550159822,9525445388,-3722,,
1644341931,9525699509,1550410222,9525695794,-3715,,
1644592219,9525949797,1550660510,9525946082,-3715,,
1644843062,9526200641,1550911364,9526196936,-3705,,
1645093632,9526451222,1551161935,9526447507,-3715,,
1645343860,9526701439,1551412151,9526697734,-3705,,
1645361852,9526719430,1551430143,9526715715,-3715,9526715742,
1645612148,9526969727,1551680440,9526966020,-3707,,
1645862811,9527220389,1551931102,9527216689,-3700,,
1646112989,9527470567,1552181280,9527466873,-3694,,
1646363464,9527721042,1552431755,9527717355,-3687,,
1646614014,9527971594,1552682307,9527967908,-3686,,
1646864125,9528221704,1552932426,9528218027,-3677,,
1647114590,9528472179,1553182892,9528468492,-3687,,
1647364848,9528722427,1553433140,9528718740,-3687,,
1647382932,9528740510,1553451223,9528736823,-3687,9528736793,
1647633382,9528990961,1553701673,9528987266,-3695,,
1647883547,9529241126,1553951839,9529237424,-3702,,
1648134123,9529491702,1554202414,9529487993,-3709,,
1648384467,9529742045,1554452758,9529738339,-3706,,
1648634885,9529992464,1554703176,9529988758,-3706,,
1648885328,9530242906,1554953629,9530239200,-3706,,
1649135624,9530493213,1555203926,9530489497,-3716,,
1649386094,9530743672,1555454395,9530739967,-3705,,
1649404207,9530761786,1555472498,9530758069,-3717,9530758094,
1649654768,9531012347,1555723060,9531008647,-3700,,
1649905371,9531262949,1555973662,9531259255,-3694,,
1650156093,9531513672,1556224384,9531509974,-3698,,
1650406370,9531763949,1556474661,9531760258,-3691,,
1650656820,9532014399,1556725111,9532010708,-3691,,
1650907375,9532264954,1556975666,9532261264,-3690,,
1651157962,9532515541,1557226253,9532511851,-3690,,
1651408063,9532765652,1557476364,9532761962,-3690,,
1651426149,9532783727,1557494439,9532780037,-3690,9532780030,
1651676535,9533034114,1557744826,9533030414,-3700,,
1651926696,9533284275,1557994987,9533280577,-3698,,
1652177007,9533534595,1558245307,9533530898,-3697,,
1652427426,9533785005,1558495717,9533781309,-3696,,
1652678015,9534035594,1558746317,9534031910,-3684,,
1652928622,9534286200,1558996913,9534282515,-3685,,
1653178800,9534536379,1559247091,9534532684,-3695,,
1653429034,9534786612,1559497325,9534782917,-3695,,
1653447208,9534804786,1559515498,9534801091,-3695,9534801109,
1653697796,9535055375,1559766088,9535051696,-3679,,
1653948417,9535305996,1560016709,9535302312,-3684,,
1654198841,9535556419,1560267131,9535552739,-3680,,
1654449223,9535806801,1560517513,9535803126,-3675,,
1654699482,9536057060,1560767773,9536053396,-3664,,
1654950353,9536307932,1561018644,9536304256,-3676,,
1655200934,9536558513,1561269225,9536554837,-3676,,
1655451292,9536808870,1561519583,9536805195,-3675,,
1655469649,9536827227,1561537939,9536823552,-3675,9536823568,
1655720299,9537077878,1561788590,9537074217,-3661,,
1655970419,9537327998,1562038710,9537324332,-3666,,
1656221008,9537578587,1562289300,9537574925,-3662,,
1656471119,9537828698,1562539410,9537825040,-3658,,
1656721268,9538078846,1562789559,9538075189,-3657,,
1656971566,9538329145,1563039857,9538325498,-3647,,
1657222155,9538579734,1563290447,9538576077,-3657,,
1657472538,9538830116,1563540829,9538826459,-3657,,
1657490603,9538848182,1563558894,9538844525,-3657,9538844379,
1657741058,9539098637,1563809349,9539094942,-3695,,
1657991930,9539349509,1564060222,9539345780,-3729,,
1658242460,9539600039,1564310752,9539596273,-3766,,
1658492643,9539850222,1564560935,9539846421,-3801,,
1658743122,9540100701,1564811413,9540096899,-3802,,
1658993634,9540351212,1565061924,9540347411,-3801,,
1659243969,9540601548,1565312271,9540597758,-3790,,
1659494098,9540851676,1565562389,9540847875,-3801,,
1659512335,9540869913,1565580626,9540866112,-3801,9540866196,
1659762569,9541120148,1565830860,9541116367,-3781,,
1660012710,9541370290,1566081002,9541366531,-3759,,
1660263070,9541620649,1566331371,9541616922,-3727,,
1660513636,9541871214,1566581927,9541867499,-3715,,
1660763757,9542121336,1566832058,9542117630,-3706,,
1661014493,9542372072,1567082784,9542368356,-3716,,
1661265068,9542622647,1567333359,9542618932,-3715,,
1661515531,9542873109,1567583821,9542869394,-3715,,
1661533582,9542891161,1567601873,9542887446,-3715,9542887394,
1661784073,9543141651,1567852364,9543137922,-3729,,
1662034260,9543391839,1568102551,9543388098,-3741,,
1662284896,9543642474,1568353187,9543638731,-3743,,
1662535266,9543892845,1568603557,9543889080,-3765,,
1662785678,9544143257,1568853969,9544139492,-3765,,
1663035825,9544393404,1569104116,9544389638,-3766,,
1663286545,9544644123,1569354836,9544640358,-3765,,
1663536696,9544894275,1569604987,9544890509,-3766,,
1663554845,9544912423,1569623136,9544908658,-3765,9544908733,
1663805390,9545162968,1569873681,9545159231,-3737,,
1664056048,9545413628,1570124341,9545409901,-3727,,
1664306356,9545663935,1570374647,9545660226,-3709,,
1664556807,9545914385,1570625097,9545910696,-3689,,
1664807184,9546164763,1570875476,9546161074,-3689,,
1665057996,9546415574,1571126287,9546411885,-3689,,
1665308573,9546666151,1571376864,9546662462,-3689,,
1665558809,9546916388,1571627100,9546912698,-3690,,
1665576879,9546934458,1571645170,9546930769,-3689,9546930686,
1665826994,9547184572,1571895285,9547180862,-3710,,
1666077683,9547435272,1572145985,9547431542,-3730,,
1666328177,9547685756,1572396468,9547682005,-3751,,
1666578679,9547936257,1572646970,9547932487,-3770,,
1666829247,9548186825,1572897538,9548183065,-3760,,
1667080180,9548437758,1573148471,9548433988,-3770,,
1667330320,9548687899,1573398611,9548684129,-3770,,
1667580702,9548938280,1573649003,9548934520,-3760,,
1667598754,9548956333,1573667045,9548952562,-3771,9548952546,
1667849019,9549206597,1573917310,9549202822,-3775,,
1668099744,9549457332,1574168045,9549453555,-3777,,
1668349906,9549707485,1574418197,9549703702,-3783,,
1668600366,9549957945,1574668657,9549954160,-3785,,
1668850780,9550208358,1574919071,9550204573,-3785,,
1669100935,9550458513,1575169226,9550454728,-3785,,
1669351113,9550708691,1575419404,9550704906,-3785,,
1669601270,9550958849,1575669561,9550955064,-3785,,
1669619463,9550977041,1575687754,9550973256,-3785,9550973260,
1669869697,9551227276,1575937998,9551223502,-3774,,
1670120346,9551477924,1576188637,9551474142,-3782,,
1670370840,9551728419,1576439131,9551724639,-3780,,
1670621341,9551978929,1576689642,9551975150,-3779,,
1670872004,9552229583,1576940295,9552225804,-3779,,
1671122386,9552479964,1577190677,9552476195,-3769,,
1671373234,9552730812,1577441525,9552727033,-3779,,
1671623428,9552981007,1577691730,9552977238,-3769,,
1671641406,9552998985,1577709697,9552995206,-3779,9552995176,
1671891845,9553249424,1577960147,9553245647,-3777,,
1672142660,9553500238,1578210951,9553496444,-3794,,
1672393115,9553750694,1578461406,9553746893,-3801,,
1672643675,9554001254,1578711977,9553997457,-3797,,
1672893886,9554251476,1578962188,9554247668,-3808,,
1673144173,9554501752,1579212465,9554497945,-3807,,
1673394759,9554752337,1579463050,9554748540,-3797,,
1673645055,9555002633,1579713346,9554998826,-3807,,
1673663256,9555020834,1579731547,9555017027,-3807,9555017168,
1673913814,9555271393,1579982106,9555267620,-3773,,
1674164348,9555521937,1580232650,9555518200,-3737,,
1674414976,9555772555,1580483267,9555768853,-3702,,
1674665108,9556022687,1580733399,9556019032,-3655,,
1674915901,9556273480,1580984192,9556269815,-3665,,
1675166533,9556524112,1581234824,9556520447,-3665,,
1675417119,9556774698,1581485420,9556771043,-3655,,
1675667550,9557025129,1581735841,9557021463,-3666,,
1675686184,9557043762,1581754474,9557040097,-3665,9557039785,
1675936320,9557293909,1582004622,9557290167,-3742,,
1676186893,9557544471,1582255184,9557540650,-3821,,
1676437076,9557794655,1582505367,9557790767,-3888,,
1676687355,9558044944,1582755657,9558040969,-3975,,
1676937720,9558295299,1583006012,9558291324,-3975,,
1677188346,9558545935,1583256648,9558541960,-3975,,
1677438891,9558796469,1583507182,9558792494,-3975,,
1677689120,9559046698,1583757411,9559042723,-3975,,
1677707241,9559064819,1583775531,9559060844,-3975,9559061044,
1677957438,9559315028,1584025741,9559311103,-3925,,
1678207558,9559565137,1584275850,9559561263,-3874,,
1678458089,9559815667,1584526380,9559811843,-3824,,
1678708446,9560066025,1584776737,9560062252,-3773,,
1678958687,9560316266,1585026978,9560312492,-3774,,
1679209009,9560566588,1585277300,9560562815,-3773,,
1679459431,9560817009,1585527721,9560813236,-3773,,
1679709694,9561067272,1585777985,9561063499,-3773,,
1679727716,9561085294,1585796007,9561081521,-3773,9561081493,
1679978076,9561335656,1586046368,9561331876,-3780,,
1680228218,9561585797,1586296520,9561582021,-3776,,
1680478631,9561836210,1586546922,9561832417,-3793,,
1680729438,9562087016,1586797729,9562083228,-3788,,
1680979900,9562337479,1587048191,9562333679,-3800,,
1681230286,9562587864,1587298577,9562584065,-3799,,
1681480469,9562838048,1587548760,9562834249,-3799,,
1681731201,9563088779,1587799492,9563084980,-3799,,
1681749357,9563106935,1587817647,9563103136,-3799,9563103072,
1681999727,9563357306,1588068019,9563353491,-3815,,
1682250109,9563607688,1588318400,9563603858,-3830,,
1682500430,9563858009,1588568721,9563854172,-3837,,
1682750697,9564108276,1588818989,9564104426,-3850,,
1683001114,9564358693,1589069405,9564354842,-3851,,
1683251439,9564609018,1589319730,9564605157,-3861,,
1683502121,9564859700,1589570412,9564855839,-3861,,
1683752885,9565110464,1589821176,9565106602,-3862,,
1683770871,9565128449,1589839162,9565124588,-3861,9565124687,
1684021383,9565378963,1590089675,9565375127,-3836,,
1684271959,9565629538,1590340261,9565625737,-3801,,
1684522568,9565880147,1590590859,9565876362,-3785,,
1684773390,9566130969,1590841681,9566127209,-3760,,
1685024014,9566381593,1591092315,9566377843,-3750,,
1685274386,9566631964,1591342677,9566628204,-3760,,
1685524570,9566882148,1591592861,9566878388,-3760,,
1685775510,9567133089,1591843802,9567129329,-3760,,
1685793733,9567151311,1591862023,9567147551,-3760,9567147502,
1686044495,9567402074,1592112787,9567398304,-3770,,
1686294673,9567652252,1592362964,9567648479,-3773,,
1686545255,9567902833,1592613546,9567899048,-3785,,
1686795379,9568152968,1592863680,9568149161,-3807,,
1687046030,9568403619,1593114332,9568399813,-3806,,
1687296551,9568654130,1593364842,9568650323,-3807,,
1687547046,9568904625,1593615337,9568900818,-3807,,
1687797659,9569155249,1593865961,9569151441,-3808,,
1687815891,9569173470,1593884182,9569169662,-3808,9569169854,
1688066077,9569423656,1594134369,9569419896,-3760,,
1688316393,9569673972,1594384684,9569670261,-3711,,
1688566570,9569924149,1594634871,9569920496,-3653,,
1688817196,9570174785,1594885498,9570171171,-3614,,
1689067420,9570424999,1595135711,9570421384,-3615,,
1689317963,9570675541,1595386254,9570671937,-3604,,
1689568089,9570925668,1595636390,9570922063,-3605,,
1689818706,9571176295,1595887007,9571172681,-3614,,
1689836925,9571194503,1595905215,9571190889,-3614,9571190632,
1690087630,9571445210,1596155922,9571441532,-3678,,
1690338144,9571695732,1596406445,9571691991,-3741,,
1690589005,9571946584,1596657296,9571942777,-3807,,
1690839116,9572196694,1596907407,9572192825,-3869,,
1691089721,9572447300,1597158012,9572443431,-3869,,
1691339906,9572697484,1597408197,9572693615,-3869,,
1691590429,9572948008,1597658721,9572944139,-3869,,
1691840949,9573198527,1597909250,9573194668,-3859,,
1691859054,9573216632,1597927344,9573212763,-3869,9573212795,
1692109684,9573467274,1598177987,9573463413,-3861,,
1692359891,9573717481,1598428193,9573713629,-3852,,
1692610033,9573967611,1598678334,9573963777,-3834,,
1692860778,9574218357,1598929070,9574214522,-3835,,
1693111317,9574468906,1599179618,9574465071,-3835,,
1693362072,9574719650,1599430363,9574715815,-3835,,
1693612294,9574969873,1599680585,9574966038,-3835,,
1693862760,9575220349,1599931061,9575216514,-3835,,
1693880823,9575238401,1599949113,9575234566,-3835,9575234552,
1694131231,9575488821,1600199533,9575484983,-3838,,
1694381505,9575739095,1600449808,9575735254,-3841,,
1694632154,9575989732,1600700445,9575985888,-3844,,
1694882721,9576240309,1600951022,9576236462,-3847,,
1695133147,9576490726,1601201438,9576486879,-3847,,
1695383277,9576740856,1601451568,9576737019,-3837,,
1695633628,9576991207,1601701919,9576987359,-3848,,
1695884061,9577241640,1601952362,9577237803,-3837,,
1695902146,9577259724,1601970437,9577255877,-3847,9577255859,
1696152415,9577509993,1602220706,9577506141,-3852,,
1696403419,9577760998,1602471721,9577757152,-3846,,
1696653637,9578011216,1602721928,9578007355,-3861,,
1696903939,9578261518,1602972241,9578257664,-3854,,
1697154085,9578511664,1603222377,9578507800,-3864,,
1697404918,9578762507,1603473220,9578758643,-3864,,
1697655206,9579012785,1603723497,9579008921,-3864,,
1697905365,9579262943,1603973666,9579259090,-3853,,
1697923526,9579281104,1603991817,9579277240,-3864,9579277220,
1698173674,9579531253,1604241965,9579527385,-3868,,
1698423998,9579781577,1604492290,9579777704,-3873,,
1698674254,9580031833,1604742545,9580027956,-3877,,
1698924630,9580282209,1604992922,9580278327,-3882,,
1699175141,9580532720,1605243433,9580528838,-3882,,
1699425309,9580782888,1605493600,9580779006,-3882,,
1699675481,9581033060,1605743783,9581029188,-3872,,
1699926084,9581283662,1605994375,9581279790,-3872,,
1699944147,9581301725,1606012438,9581297843,-3882,9581297865,
1700194652,9581552231,1606262944,9581548354,-3877,,
1700445051,9581802630,1606513352,9581798768,-3862,,
1700695524,9582053103,1606763815,9582049238,-3865,,
1700945780,9582303369,1607014082,9582299510,-3859,,
1701196177,9582553756,1607264468,9582549897,-3859,,
1701446323,9582803902,1607514614,9582800043,-3859,,
1701697120,9583054699,1607765411,9583050839,-3860,,
1701947294,9583304873,1608015586,9583301014,-3859,,
1701965457,9583323035,1608033747,9583319176,-3859,9583319163,
1702215973,9583573552,1608284264,9583569690,-3862,,
1702466942,9583824521,1608535233,9583820655,-3866,,
1702717474,9584075053,1608785765,9584071185,-3868,,
1702967999,9584325577,1609036300,9584321717,-3860,,
1703218165,9584575744,1609286457,9584571874,-3870,,
1703468672,9584826250,1609536962,9584822380,-3870,,
1703719306,9585076884,1609787597,9585073014,-3870,,
1703969888,9585327467,1610038189,9585323607,-3860,,
1703988055,9585345634,1610056346,9585341763,-3871,9585341773,
1704238746,9585596325,1610307037,9585592456,-3869,,
1704489213,9585846792,1610557504,9585842936,-3856,,
1704739605,9586097184,1610807896,9586093322,-3862,,
1704989940,9586347519,1611058232,9586343660,-3859,,
1705240292,9586597870,1611308593,9586594022,-3848,,
1705490605,9586848184,1611558897,9586844325,-3859,,
1705740839,9587098417,1611809129,9587094569,-3848,,
1705991186,9587348765,1612059487,9587344916,-3849,,
1706009225,9587366803,1612077515,9587362944,-3859,9587362910,
1706259403,9587616982,1612327694,9587613113,-3869,,
1706509911,9587867490,1612578203,9587863613,-3877,,
1706760132,9588117711,1612828424,9588113826,-3885,,
1707010673,9588368251,1613078964,9588364359,-3892,,
1707260804,9588618383,1613329095,9588614491,-3892,,
1707511372,9588868950,1613579663,9588865058,-3892,,
1707761906,9589119485,1613830197,9589115593,-3892,,
1708012499,9589370079,1614080792,9589366187,-3892,,
1708030596,9589388175,1614098887,9589384283,-3892,9589384343,
1708280863,9589638458,1614349171,9589634582,-3876,,
1708531355,9589888933,1614599646,9589885072,-3861,,
1708781680,9590139259,1614849971,9590135423,-3836,,
1709031872,9590389451,1615100173,9590385631,-3820,,
1709282074,9590639653,1615350365,9590635823,-3830,,
1709532452,9590890031,1615600743,9590886200,-3831,,
1709783340,9591140919,1615851631,9591137089,-3830,,
1710033520,9591391100,1616101812,9591387270,-3830,,
1710051582,9591409160,1616119873,9591405330,-3830,9591405274,
1710302015,9591659594,1616370306,9591655750,-3844,,
1710552352,9591909931,1616620644,9591906073,-3858,,
1710803051,9592160630,1616871343,9592156759,-3871,,
1711053668,9592411246,1617121969,9592407372,-3874,,
1711303947,9592661526,1617372238,9592657642,-3884,,
1711554145,9592911724,1617622436,9592907840,-3884,,
1711804464,9593162042,1617872755,9593158158,-3884,,
1712054679,9593412258,1618122971,9593408374,-3884,,
1712072722,9593430301,1618141013,9593426417,-3884,9593426391,
1712322903,9593680482,1618391194,9593676591,-3891,,
1712573334,9593930913,1618641625,9593927016,-3897,,
1712823543,9594181122,1618891834,9594177218,-3904,,
1713074575,9594432164,1619142877,9594428256,-3908,,
1713325163,9594682742,1619393454,9594678834,-3908,,
1713575303,9594932882,1619643594,9594928973,-3909,,
1713825864,9595183442,1619894154,9595179534,-3908,,
1714076269,9595433849,1620144562,9595429941,-3908,,
1714094462,9595452041,1620162753,9595448132,-3909,9595448156,
1714345021,9595702599,1620413312,9595698707,-3892,,
1714595204,9595952783,1620663495,9595948886,-3897,,
1714845455,9596203034,1620913746,9596199145,-3889,,
1715096052,9596453641,1621164354,9596449758,-3883,,
1715346689,9596704268,1621414980,9596700384,-3884,,
1715597123,9596954702,1621665414,9596950819,-3883,,
1715847246,9597204825,1621915537,9597200941,-3884,,
1716097612,9597455192,1622165905,9597451309,-3883,,
1716115782,9597473360,1622184072,9597469476,-3884,9597469413,
1716366570,9597724149,1622434861,9597720249,-3900,,
1716617116,9597974694,1622685407,9597970779,-3915,,
1716867569,9598225148,1622935860,9598221218,-3930,,
1717117840,9598475429,1623186141,9598471484,-3945,,
1717368071,9598725650,1623436362,9598721714,-3936,,
1717618190,9598975768,1623686481,9598971823,-3945,,
1717868574,9599226152,1623936865,9599222207,-3945,,
1718119243,9599476823,1624187536,9599472878,-3945,,
1718137374,9599494953,1624205665,9599491007,-3946,9599491040,
1718387477,9599745056,1624455769,9599741119,-3937,,
1718637691,9599995270,1624705982,9599991342,-3928,,
1718888359,9600245937,1624956650,9600242017,-3920,,
1719138802,9600496381,1625207093,9600492470,-3911,,
1719389354,9600746933,1625457645,9600743031,-3902,,
1719639663,9600997241,1625707953,9600993330,-3911,,
1719890489,9601248068,1625958780,9601244157,-3911,,
1720140808,9601498387,1626209099,9601494476,-3911,,
1720158796,9601516374,1626227086,9601512463,-3911,9601512461,
1720409249,9601766828,1626477540,9601762916,-3912,,
1720660283,9602017861,1626728573,9602013950,-3911,,
1720910407,9602267986,1626978698,9602264075,-3911,,
1721160678,9602518257,1627228970,9602514346,-3911,,
1721410857,9602768436,1627479148,9602764525,-3911,,
1721661425,9603019004,1627729716,9603015093,-3911,,
1721911861,9603269440,1627980153,9603265529,-3911,,
1722162277,9603519857,1628230569,9603515946,-3911,,
1722180312,9603537891,1628248603,9603533979,-3912,9603533961,
1722431000,9603788579,1628499291,9603784662,-3917,,
1722681312,9604038891,1628749603,9604034971,-3920,,
1722931651,9604289230,1628999942,9604285306,-3924,,
1723181933,9604539513,1629250226,9604535585,-3928,,
1723432180,9604789759,1629500481,9604785840,-3919,,
1723682297,9605039876,1629750588,9605035947,-3929,,
1723932680,9605290259,1630000971,9605286330,-3929,,
1724182809,9605540388,1630251101,9605536461,-3927,,
1724200780,9605558358,1630269070,9605554430,-3928,9605554424,
1724451448,9605809027,1630519739,9605805107,-3920,,
1724702004,9606059583,1630770296,9606055653,-3930,,
1724952296,9606309874,1631020587,9606305943,-3931,,
1725202623,9606560202,1631270915,9606556271,-3931,,
1725452733,9606810312,1631521024,9606806380,-3932,,
1725703180,9607060758,1631771471,9607056826,-3932,,
1725953722,9607311300,1632022013,9607307368,-3932,,
1726204657,9607562246,1632272959,9607558314,-3932,,
1726222694,9607580273,1632290985,9607576340,-3933,9607576331,
1726473086,9607830665,1632541388,9607826741,-3924,,
1726723376,9608080955,1632791667,9608077028,-3927,,
1726974160,9608331738,1633042450,9608327800,-3938,,
1727224611,9608582190,1633292903,9608578250,-3940,,
1727475070,9608832649,1633543361,9608828719,-3930,,
1727725223,9609082801,1633793514,9609078861,-3940,,
1727975512,9609333091,1634043803,9609329151,-3940,,
1728225633,9609583213,1634293925,9609579273,-3940,,
1728243679,9609601258,1634311970,9609597318,-3940,9609597350,
1728493836,9609851415,1634562127,9609847483,-3932,,
1728744028,9610101607,1634812319,9610097683,-3924,,
1728994548,9610352127,1635062839,9610348212,-3915,,
1729245414,9610602993,1635313706,9610599087,-3906,,
1729495576,9610853165,1635563877,9610849259,-3906,,
1729745799,9611103378,1635814090,9611099472,-3906,,
1729995939,9611353518,1636064230,9611349612,-3906,,
1730246323,9611603912,1636314625,9611600006,-3906,,
1730264514,9611622092,1636332805,9611618186,-3906,9611618111,
1730515259,9611872837,1636583550,9611868911,-3926,,
1730765474,9612123053,1636833765,9612119109,-3944,,
1731016306,9612373886,1637084598,9612369924,-3962,,
1731266487,9612624065,1637334778,9612620085,-3980,,
1731516858,9612874448,1637585160,9612870467,-3981,,
1731767162,9613124740,1637835453,9613120760,-3980,,
1732017266,9613374845,1638085557,9613370865,-3980,,
1732268113,9613625692,1638336414,9613621722,-3970,,
1732286266,9613643844,1638354556,9613639864,-3980,9613639931,
1732536429,9613894008,1638604721,9613890046,-3962,,
1732786711,9614144289,1638855002,9614140344,-3945,,
1733037669,9614395248,1639105960,9614391320,-3928,,
1733288144,9614645722,1639356435,9614641822,-3900,,
1733538569,9614896147,1639606860,9614892236,-3911,,
1733789373,9615146952,1639857664,9615143041,-3911,,
1734040051,9615397630,1640108343,9615393719,-3911,,
1734291052,9615648631,1640359343,9615644720,-3911,,
1734309130,9615666708,1640377421,9615662797,-3911,9615662733,
1734559785,9615917373,1640628086,9615913446,-3927,,
1734810037,9616167616,1640878328,9616163674,-3942,,
1735060561,9616418140,1641128852,9616414182,-3958,,
1735311354,9616668933,1641379646,9616664961,-3972,,
1735561905,9616919494,1641630207,9616915522,-3972,,
1735812056,9617169635,1641880347,9617165661,-3974,,
1736062344,9617419923,1642130636,9617415950,-3973,,
1736312538,9617670117,1642380830,9617666144,-3973,,
1736330653,9617688231,1642398943,9617684258,-3973,9617684281,
1736580954,9617938533,1642649255,9617934575,-3958,,
1736831499,9618189077,1642899790,9618185116,-3961,,
1737081897,9618439476,1643150188,9618435521,-3955,,
1737332621,9618690211,1643400923,9618686263,-3948,,
1737583240,9618940819,1643651531,9618936870,-3949,,
1737833784,9619191363,1643902075,9619187415,-3948,,
1738084001,9619441581,1644152294,9619437634,-3947,,
1738334190,9619691769,1644402482,9619687822,-3947,,
1738352226,9619709805,1644420517,9619705856,-3949,9619705843,
1738602405,9619959983,1644670696,9619956032,-3951,,
1738852993,9620210572,1644921284,9620206618,-3954,,
1739103631,9620461209,1645171922,9620457252,-3957,,
1739353852,9620711442,1645422155,9620707482,-3960,,
1739604374,9620961952,1645672664,9620957992,-3960,,
1739854901,9621212479,1645923192,9621208529,-3950,,
1740105302,9621462881,1646173594,9621458922,-3959,,
1740356156,9621713735,1646424448,9621709776,-3959,,
1740374230,9621731809,1646442521,9621727848,-3961,9621727858,
1740624626,9621982204,1646692917,9621978246,-3958,,
1740874806,9622232394,1646943107,9622228439,-3955,,
1741125118,9622482696,1647193409,9622478744,-3952,,
1741375407,9622732985,1647443698,9622729036,-3949,,
1741625648,9622983226,1647693939,9622979277,-3949,,
1741875811,9623233401,1647944113,9623229452,-3949,,
1742126473,9623484052,1648194765,9623480104,-3948,,
1742377342,9623734921,1648445634,9623730972,-3949,,
1742395418,9623752996,1648463709,9623749047,-3949,9623749056,
1742645720,9624003299,1648714011,9623999353,-3946,,
1742895944,9624253523,1648964235,9624249590,-3933,,
1743146080,9624503658,1649214371,9624499717,-3941,,
1743396634,9624754213,1649464935,9624750284,-3929,,
1743647109,9625004687,1649715400,9625000749,-3938,,
1743897437,9625255016,1649965728,9625251088,-3928,,
1744147968,9625505548,1650216260,9625501610,-3938,,
1744398363,9625755952,1650466664,9625752014,-3938,,
1744416425,9625774003,1650484716,9625770065,-3938,9625769972,
1744666913,9626024492,1650735204,9626020529,-3963,,
1744917435,9626275024,1650985736,9626271039,-3985,,
1745168065,9626525644,1651236356,9626521635,-4009,,
1745418185,9626775764,1651486476,9626771734,-4030,,
1745668630,9627026209,1651736921,9627022178,-4031,,
1745918813,9627276392,1651987105,9627272373,-4019,,
1746169099,9627526677,1652237389,9627522647,-4030,,
1746419374,9627776962,1652487675,9627772932,-4030,,
1746437485,9627795064,1652505776,9627791033,-4031,9627791063,
1746687991,9628045570,1652756282,9628041546,-4024,,
1746938144,9628295723,1653006436,9628291708,-4015,,
1747188443,9628546032,1653256744,9628542024,-4008,,
1747438578,9628796157,1653506869,9628792158,-3999,,
1747689198,9629046777,1653757489,9629042777,-4000,,
1747939558,9629297137,1654007850,9629293138,-3999,,
1748189927,9629547506,1654258218,9629543507,-3999,,
1748440122,9629797701,1654508413,9629793702,-3999,,
1748458203,9629815782,1654526494,9629811782,-4000,9629811809,
1748708735,9630066314,1654777027,9630062322,-3992,,
1748959515,9630317094,1655027806,9630313108,-3986,,
1749209639,9630567228,1655277941,9630563251,-3977,,
1749460365,9630817953,1655528666,9630813982,-3971,,
1749710567,9631068146,1655778858,9631064175,-3971,,
1749961114,9631318692,1656029405,9631314732,-3960,,
1750211724,9631569314,1656280026,9631565343,-3971,,
1750462700,9631820279,1656530991,9631816319,-3960,,
1750480750,9631838328,1656549041,9631834357,-3971,9631834347,
1750730948,9632088526,1656799239,9632084552,-3974,,
1750981159,9632338737,1657049450,9632334761,-3976,,
1751231317,9632588896,1657299618,9632584928,-3968,,
1751481528,9632839107,1657549830,9632835137,-3970,,
1751731763,9633089341,1657800053,9633085361,-3980,,
1751981993,9633339571,1658050284,9633335591,-3980,,
1752232386,9633589964,1658300677,9633585984,-3980,,
1752482904,9633840482,1658551205,9633836512,-3970,,
1752500900,9633858479,1658569191,9633854498,-3981,9633854492,
1752751485,9634109063,1658819776,9634105081,-3982,,
1753001621,9634359199,1659069912,9634355216,-3983,,
1753252208,9634609787,1659320500,9634605803,-3984,,
1753502537,9634860115,1659570838,9634856141,-3974,,
1753752874,9635110452,1659821165,9635106467,-3985,,
1754003023,9635360601,1660071314,9635356616,-3985,,
1754253510,9635611088,1660321801,9635607103,-3985,,
1754504073,9635861662,1660572374,9635857677,-3985,,
1754522151,9635879729,1660590442,9635875744,-3985,9635875720,
1754772575,9636130153,1660840866,9636126163,-3990,,
1755022872,9636380460,1661091173,9636376464,-3996,,
1755273044,9636630623,1661341336,9636626621,-4002,,
1755523635,9636881214,1661591926,9636877206,-4008,,
1755774230,9637131809,1661842521,9637127802,-4007,,
1756024752,9637382330,1662093042,9637378323,-4007,,
1756274895,9637632474,1662343186,9637628467,-4007,,
1756525033,9637882612,1662593325,9637878605,-4007,,
1756543093,9637900671,1662611384,9637896664,-4007,9637896697,
1756793507,9638151085,1662861798,9638147086,-3999,,
1757043794,9638401373,1663112086,9638397383,-3990,,
1757293962,9638651541,1663362254,9638647560,-3981,,
1757544515,9638902094,1663612807,9638898121,-3973,,
1757795255,9639152833,1663863545,9639148870,-3963,,
1758045412,9639402991,1664113703,9639399017,-3974,,
1758296009,9639653588,1664364301,9639649615,-3973,,
1758546599,9639904188,1664614900,9639900215,-3973,,
1758564724,9639922302,1664633014,9639918329,-3973,9639918299,
1758814835,9640172414,1664883126,9640168433,-3981,,
1759065737,9640423317,1665134030,9640419330,-3987,,
1759316510,9640674089,1665384802,9640670095,-3994,,
1759566846,9640924435,1665635148,9640920433,-4002,,
1759817162,9641174741,1665885464,9641170749,-3992,,
1760067691,9641425270,1666135982,9641421267,-4003,,
1760317816,9641675396,1666386108,9641671394,-4002,,
1760568018,9641925596,1666636308,9641921594,-4002,,
1760586088,9641943666,1666654379,9641939664,-4002,9641939630,
1760836810,9642194389,1666905102,9642190378,-4011,,
1761087339,9642444917,1667155630,9642440898,-4019,,
1761337673,9642695252,1667405965,9642691225,-4027,,
1761588251,9642945829,1667656542,9642941804,-4025,,
1761838529,9643196108,1667906820,9643192073,-4035,,
1762089042,9643446622,1668157334,9643442587,-4035,,
1762339735,9643697314,1668408026,9643693279,-4035,,
1762590428,9643948007,1668658720,9643943972,-4035,,
1762608487,9643966065,1668676777,9643962030,-4035,9643962041,
1762858885,9644216464,1668927177,9644212442,-4022,,
1763109484,9644467063,1669177776,9644463035,-4028,,
1763359613,9644717192,1669427905,9644713167,-4025,,
1763609826,9644967404,1669678127,9644963392,-4012,,
1763860045,9645217634,1669928346,9645213612,-4022,,
1764110881,9645468460,1670179173,9645464438,-4022,,
1764361231,9645718810,1670429523,9645714788,-4022,,
1764611623,9645969202,1670679915,9645965180,-4022,,
1764629654,9645987232,1670697945,9645983210,-4022,9645983215,
1764880053,9646237632,1670948344,9646233611,-4021,,
1765130408,9646487987,1671198699,9646483967,-4020,,
1765380901,9646738480,1671449192,9646734462,-4018,,
1765631769,9646989348,1671700061,9646985332,-4016,,
1765882454,9647240033,1671950746,9647236017,-4016,,
1766132926,9647490505,1672201218,9647486489,-4016,,
1766383842,9647741421,1672452133,9647737404,-4017,,
1766634245,9647991824,1672702536,9647987808,-4016,,
1766652253,9648009832,1672720544,9648005815,-4017,9648005776,
1766902467,9648260045,1672970758,9648256019,-4026,,
1767153124,9648510703,1673221416,9648506669,-4034,,
1767403312,9648760891,1673471604,9648756847,-4044,,
1767654314,9649011893,1673722605,9649007839,-4054,,
1767904703,9649262282,1673972994,9649258227,-4055,,
1768155494,9649513074,1674223787,9649509020,-4054,,
1768405655,9649763234,1674473946,9649759179,-4055,,
1768656061,9650013650,1674724363,9650009597,-4053,,
1768674167,9650031745,1674742458,9650027691,-4054,9650027666,
1768924570,9650282149,1674992861,9650278087,-4062,,
1769174730,9650532309,1675243021,9650528241,-4068,,
1769425413,9650782992,1675493704,9650778920,-4072,,
1769675600,9651033178,1675743891,9651029100,-4078,,
1769926489,9651284068,1675994780,9651279989,-4079,,
1770177100,9651534679,1676245391,9651530601,-4078,,
1770427567,9651785145,1676495858,9651781067,-4078,,
1770677704,9652035283,1676745995,9652031215,-4068,,
1770695664,9652053243,1676763955,9652049165,-4078,9652049161,
1770946164,9652303743,1677014456,9652299664,-4079,,
1771196970,9652554548,1677265261,9652550469,-4079,,
1771447592,9652805171,1677515883,9652801101,-4070,,
1771697830,9653055408,1677766121,9653051328,-4080,,
1771948549,9653306128,1678016841,9653302049,-4079,,
1772199191,9653556781,1678267494,9653552702,-4079,,
1772450103,9653807682,1678518394,9653803601,-4081,,
1772700797,9654058376,1678769088,9654054296,-4080,,
1772718924,9654076502,1678787215,9654072422,-4080,9654072528,
1772969942,9654327521,1679038233,9654323466,-4055,,
1773220339,9654577917,1679288630,9654573890,-4027,,
1773470772,9654828351,1679539063,9654824351,-4000,,
1773721360,9655078949,1679789662,9655074977,-3972,,
1773971507,9655329086,1680039799,9655325113,-3973,,
1774222170,9655579749,1680290461,9655575776,-3973,,
1774472369,9655829948,1680540660,9655825975,-3973,,
1774722774,9656080353,1680791066,9656076380,-3973,,
1774740802,9656098380,1680809093,9656094407,-3973,9656094329,
1774991508,9656349087,1681059799,9656345094,-3993,,
1775241836,9656599415,1681310128,9656595404,-4011,,
1775492238,9656849827,1681560540,9656845797,-4030,,
1775742381,9657099971,1681810683,9657095922,-4049,,
1775992762,9657350340,1682061053,9657346291,-4049,,
1776243361,9657600939,1682311652,9657596890,-4049,,
1776493631,9657851220,1682561932,9657847171,-4049,,
1776744381,9658101959,1682812672,9658097921,-4038,,
1776762458,9658120036,1682830749,9658115987,-4049,9658115933,
1777013262,9658370841,1683081553,9658366778,-4063,,
1777263773,9658621362,1683332074,9658617286,-4076,,
1777514052,9658871631,1683582344,9658867542,-4089,,
1777764569,9659122158,1683832870,9659118056,-4102,,
1778015160,9659372738,1684083451,9659368636,-4102,,
1778265559,9659623148,1684333861,9659619047,-4101,,
1778516278,9659873867,1684584579,9659869765,-4102,,
1778766475,9660124054,1684834766,9660119952,-4102,,
1778784591,9660142170,1684852882,9660138067,-4103,9660138113,
1779034664,9660392242,1685102955,9660388152,-4090,,
1779284839,9660642418,1685353130,9660638339,-4079,,
1779535209,9660892788,1685603510,9660888730,-4058,,
1779785688,9661143267,1685853990,9661139222,-4045,,
1780035822,9661393400,1686104112,9661389345,-4055,,
1780286348,9661643927,1686354639,9661639871,-4056,,
1780536588,9661894167,1686604890,9661890122,-4045,,
1780787182,9662144761,1686855473,9662140706,-4055,,
1780805349,9662162927,1686873639,9662158872,-4055,9662158884,
1781055615,9662413194,1687123907,9662409144,-4050,,
1781305777,9662663356,1687374069,9662659308,-4048,,
1781556404,9662913993,1687624705,9662909949,-4044,,
1781806538,9663164127,1687874840,9663160086,-4041,,
1782057137,9663414715,1688125428,9663410674,-4041,,
1782307336,9663664914,1688375626,9663660873,-4041,,
1782557932,9663915521,1688626234,9663911480,-4041,,
1782808078,9664165657,1688876369,9664161615,-4042,,
1782826145,9664183723,1688894435,9664179682,-4041,9664179653,
1783076475,9664434055,1689144768,9664430007,-4048,,
1783326808,9664684386,1689395099,9664680331,-4055,,
1783577255,9664934834,1689645546,9664930773,-4061,,
1783827430,9665185009,1689895721,9665180941,-4068,,
1784077633,9665435211,1690145924,9665431143,-4068,,
1784327984,9665685563,1690396275,9665681495,-4068,,
1784578541,9665936120,1690646833,9665932053,-4067,,
1784829397,9666186976,1690897688,9666182908,-4068,,
1784847533,9666205111,1690915823,9666201043,-4068,9666201035,
1785097811,9666455390,1691166103,9666451319,-4071,,
1785348208,9666705787,1691416500,9666701715,-4072,,
1785598418,9666955998,1691666711,9666951924,-4074,,
1785848761,9667206340,1691917052,9667202265,-4075,,
1786098856,9667456445,1692167157,9667452370,-4075,,
1786349476,9667707054,1692417767,9667702990,-4064,,
1786599632,9667957211,1692667924,9667953136,-4075,,
1786850377,9668207955,1692918668,9668203890,-4065,,
1786868338,9668225916,1692936629,9668221841,-4075,9668221848,
1787118777,9668476355,1693187068,9668472282,-4073,,
1787369378,9668726956,1693437669,9668722885,-4071,,
1787619601,9668977180,1693687893,9668973111,-4069,,
1787869690,9669227269,1693937981,9669223201,-4068,,
1788120100,9669477680,1694188392,9669473613,-4067,,
1788370457,9669728036,1694438749,9669723970,-4066,,
1788620667,9669978246,1694688959,9669974179,-4067,,
1788870770,9670228349,1694939061,9670224281,-4068,,
1788888882,9670246461,1694957173,9670242393,-4068,9670242398,
1789139256,9670496835,1695207547,9670492768,-4067,,
1789389886,9670747465,1695458177,9670743400,-4065,,
1789640277,9670997866,1695708579,9670993803,-4063,,
1789890778,9671248357,1695959069,9671244295,-4062,,
1790141094,9671498674,1696209386,9671494613,-4061,,
1790391260,9671748839,1696459551,9671744778,-4061,,
1790641412,9671998991,1696709704,9671994931,-4060,,
1790891606,9672249185,1696959897,9672245123,-4062,,
1790909738,9672267317,1696978029,9672263255,-4062,9672263221,
1791159944,9672517523,1697228236,9672513453,-4070,,
1791410405,9672767984,1697478696,9672763905,-4079,,
1791660803,9673018382,1697729094,9673014296,-4086,,
1791910942,9673268521,1697979233,9673264426,-4095,,
1792161161,9673518740,1698229453,9673514647,-4093,,
1792411366,9673768945,1698479667,9673764860,-4085,,
1792662042,9674019631,1698730344,9674015537,-4094,,
1792912461,9674270039,1698980751,9674265945,-4094,,
1792930726,9674288304,1698999017,9674284210,-4094,9674284254,
1793180811,9674538389,1699249102,9674534305,-4084,,
1793431045,9674788624,1699499336,9674784551,-4073,,
1793681209,9675038788,1699749501,9675034727,-4061,,
1793931467,9675289046,1699999758,9675284997,-4049,,
1794181888,9675539467,1700250180,9675535419,-4048,,
1794432439,9675790018,1700500740,9675785978,-4040,,
1794682917,9676040496,1700751209,9676036447,-4049,,
1794933178,9676290757,1701001469,9676286708,-4049,,
1794951227,9676308805,1701019517,9676304756,-4049,9676304683,
1795201677,9676559256,1701269968,9676555187,-4069,,
1795452169,9676809747,1701520460,9676805661,-4086,,
1795702973,9677060563,1701771275,9677056459,-4104,,
1795953273,9677310852,1702021565,9677306731,-4121,,
1796203802,9677561381,1702272094,9677557260,-4121,,
1796454621,9677812200,1702522912,9677808079,-4121,,
1796704791,9678062369,1702773082,9678058249,-4120,,
1796955294,9678312873,1703023585,9678308752,-4121,,
1796973371,9678330949,1703041662,9678326828,-4121,9678326817,
1797223914,9678581493,1703292205,9678577368,-4125,,
1797474298,9678831877,1703542589,9678827749,-4128,,
1797724983,9679082572,1703793285,9679078443,-4129,,
1797975524,9679333102,1704043814,9679328971,-4131,,
1798225678,9679583257,1704293969,9679579125,-4132,,
1798476065,9679833644,1704544356,9679829512,-4132,,
1798726439,9680084019,1704794731,9680079887,-4132,,
1798976545,9680334124,1705044837,9680329993,-4131,,
1798994541,9680352119,1705062832,9680347988,-4131,9680348001,
1799245104,9680602682,1705313395,9680598555,-4127,,
1799495608,9680853187,1705563899,9680849062,-4125,,
1799746148,9681103738,1705814450,9681099618,-4120,,
1799996619,9681354198,1706064910,9681350081,-4117,,
1800246726,9681604305,1706315017,9681600188,-4117,,
1800497139,9681854717,1706565430,9681850601,-4116,,
1800747722,9682105311,1706816024,9682101195,-4116,,
1800998024,9682355603,1707066315,9682351487,-4116,,
1801016236,9682373815,1707084527,9682369698,-4117,9682369770,
1801266638,9682624227,1707334939,9682620129,-4098,,
1801516957,9682874535,1707585248,9682870456,-4079,,
1801767790,9683125369,1707836081,9683121308,-4061,,
1802018094,9683375672,1708086384,9683371629,-4043,,
1802268943,9683626522,1708337234,9683622478,-4044,,
1802519165,9683876744,1708587457,9683872701,-4043,,
1802769793,9684127372,1708838084,9684123329,-4043,,
1803019917,9684377496,1709088208,9684373453,-4043,,
1803038091,9684395669,1709106381,9684391626,-4043,9684391582,
1803288550,9684646139,1709356851,9684642085,-4054,,
1803538954,9684896533,1709607256,9684892478,-4055,,
1803789468,9685147057,1709857770,9685142982,-4075,,
1804039877,9685397455,1710108168,9685393370,-4085,,
1804290079,9685647658,1710358370,9685643572,-4086,,
1804540344,9685897923,1710608635,9685893847,-4076,,
1804790820,9686148399,1710859111,9686144314,-4085,,
1805041307,9686398885,1711109598,9686394800,-4085,,
1805059452,9686417031,1711127743,9686412946,-4085,9686412914,
1805309911,9686667490,1711378202,9686663397,-4093,,
1805560654,9686918243,1711628956,9686914143,-4100,,
1805811189,9687168778,1711879491,9687164670,-4108,,
1806061404,9687418983,1712129695,9687414867,-4116,,
1806311665,9687669243,1712379956,9687665128,-4115,,
1806562267,9687919845,1712630557,9687915730,-4115,,
1806812421,9688170010,1712880722,9688165895,-4115,,
1807062836,9688420414,1713131127,9688416299,-4115,,
1807081089,9688438678,1713149391,9688434563,-4115,9688434519,
1807331786,9688689365,1713400077,9688685242,-4123,,
1807582521,9688940100,1713650823,9688935979,-4121,,
1807832698,9689190287,1713901000,9689186149,-4138,,
1808083046,9689440625,1714151338,9689436478,-4147,,
1808333582,9689691161,1714401883,9689687024,-4137,,
1808583914,9689941492,1714652204,9689937345,-4147,,
1808834103,9690191692,1714902405,9690187545,-4147,,
1809084524,9690442103,1715152816,9690437956,-4147,,
1809102679,9690460258,1715170970,9690456111,-4147,9690456127,
1809352878,9690710457,1715421169,9690706315,-4142,,
1809603048,9690960627,1715671340,9690956489,-4138,,
1809853847,9691211426,1715922138,9691207293,-4133,,
1810103987,9691461565,1716172278,9691457436,-4129,,
1810354526,9691712105,1716422817,9691707976,-4129,,
1810605014,9691962593,1716673305,9691958464,-4129,,
1810855663,9692213241,1716923954,9692209112,-4129,,
1811105999,9692463578,1717174290,9692459449,-4129,,
1811124084,9692481662,1717192375,9692477533,-4129,9692477498,
1811374196,9692731774,1717442486,9692727635,-4139,,
1811624631,9692982210,1717692922,9692978062,-4148,,
1811875090,9693232670,1717943382,9693228514,-4156,,
1812125508,9693483087,1718193800,9693478924,-4163,,
1812376089,9693733667,1718444380,9693729504,-4163,,
1812626494,9693984073,1718694785,9693979910,-4163,,
1812876820,9694234399,1718945112,9694230236,-4163,,
1813127314,9694484893,1719195605,9694480730,-4163,,
1813145451,9694503030,1719213742,9694498867,-4163,9694498837,
1813395805,9694753383,1719464096,9694749213,-4170,,
1813646149,9695003728,1719714440,9694999551,-4177,,
1813896713,9695254292,1719965004,9695250107,-4185,,
1814147283,9695504862,1720215575,9695500671,-4191,,
1814397443,9695755021,1720465734,9695750830,-4191,,
1814647686,9696005265,1720715977,9696001074,-4191,,
1814898248,9696255827,1720966540,9696251636,-4191,,
1815148408,9696505986,1721216699,9696501795,-4191,,
1815166725,9696524303,1721235015,9696520112,-4191,9696520163,
1815417708,9696775287,1721485999,9696771110,-4177,,
1815667873,9697025451,1721736164,9697021287,-4164,,
1815918087,9697275676,1721986389,9697271525,-4151,,
1816168939,9697526518,1722237230,9697522380,-4138,,
1816419411,9697776990,1722487702,9697772852,-4138,,
1816670037,9698027616,1722738328,9698023478,-4138,,
1816920213,9698277792,1722988505,9698273654,-4138,,
1817170371,9698527950,1723238672,9698523821,-4129,,
1817188540,9698546119,1723256831,9698541980,-4139,9698541957,
1817438648,9698796227,1723506940,9698792082,-4145,,
1817689453,9699047032,1723757745,9699042882,-4150,,
1817939637,9699297215,1724007928,9699293060,-4155,,
1818190031,9699547611,1724258323,9699543451,-4160,,
1818440618,9699798207,1724508919,9699794047,-4160,,
1818690998,9700048577,1724759289,9700044427,-4150,,
1818941165,9700298753,1725009466,9700294594,-4159,,
1819191305,9700548883,1725259595,9700544723,-4160,,
1819209294,9700566873,1725277585,9700562713,-4160,9700562712,
1819460012,9700817591,1725528303,9700813429,-4162,,
1819710149,9701067728,1725778440,9701063567,-4161,,
1819960490,9701318068,1726028781,9701313908,-4160,,
1820210750,9701568329,1726279042,9701564170,-4159,,
1820461104,9701818682,1726529395,9701814523,-4159,,
1820711418,9702068997,1726779709,9702064837,-4160,,
1820961744,9702319322,1727030035,9702315163,-4159,,
1821211881,9702569459,1727280172,9702565300,-4159,,
1821229762,9702587340,1727298052,9702583181,-4159,9702583148,
1821479919,9702837498,1727548210,9702833330,-4168,,
1821730718,9703088297,1727799009,9703084122,-4175,,
1821980915,9703338494,1728049207,9703334311,-4183,,
1822231543,9703589122,1728299834,9703584931,-4191,,
1822481781,9703839360,1728550073,9703835170,-4190,,
1822732136,9704089715,1728800427,9704085525,-4190,,
1822982571,9704340159,1729050872,9704335969,-4190,,
1823233026,9704590604,1729301317,9704586414,-4190,,
1823251059,9704608637,1729319350,9704604447,-4190,9704604471,
1823501664,9704859242,1729569955,9704855058,-4184,,
1823751827,9705109405,1729820118,9705105227,-4178,,
1824002426,9705360004,1730070717,9705355833,-4171,,
1824253164,9705610743,1730321455,9705606577,-4166,,
1824503288,9705860867,1730571590,9705856712,-4155,,
1824753670,9706111249,1730821962,9706107084,-4165,,
1825003780,9706361359,1731072071,9706357194,-4165,,
1825253996,9706611575,1731322287,9706607410,-4165,,
1825272203,9706629781,1731340493,9706625615,-4166,9706625562,
1825522971,9706880560,1731591273,9706876382,-4178,,
1825773378,9707130956,1731841669,9707126776,-4180,,
1826023953,9707381532,1732092244,9707377328,-4204,,
1826274598,9707632177,1732342890,9707627970,-4207,,
1826524981,9707882559,1732593272,9707878342,-4217,,
1826775738,9708133317,1732844030,9708129100,-4217,,
1827026465,9708384043,1733094756,9708379826,-4217,,
1827276985,9708634564,1733345276,9708630347,-4217,,
1827295027,9708652606,1733363318,9708648388,-4218,9708648401,
1827545490,9708903069,1733613781,9708898854,-4215,,
1827795650,9709153229,1733863941,9709149019,-4210,,
1828045924,9709403503,1734114215,9709399296,-4207,,
1828296261,9709653839,1734364562,9709649647,-4192,,
1828546573,9709904151,1734614864,9709899948,-4203,,
1828797161,9710154739,1734865452,9710150536,-4203,,
1829047445,9710405023,1735115736,9710400820,-4203,,
1829297796,9710655385,1735366097,9710651182,-4203,,
1829315875,9710673453,1735384166,9710669250,-4203,9710669275,
1829566583,9710924161,1735634874,9710919964,-4197,,
1829816733,9711174312,1735885025,9711170122,-4190,,
1830067520,9711425099,1736135811,9711420915,-4184,,
1830317638,9711675216,1736385939,9711671050,-4166,,
1830568028,9711925607,1736636319,9711921430,-4177,,
1830818330,9712175909,1736886621,9712171731,-4178,,
1831068420,9712425998,1737136711,9712421821,-4177,,
1831318570,9712676149,1737386862,9712671972,-4177,,
1831336990,9712694569,1737405281,9712690391,-4178,9712690520,
1831587589,9712945168,1737655880,9712941023,-4145,,
1831837781,9713195361,1737906074,9713191249,-4112,,
1832088366,9713445944,1738156656,9713441865,-4079,,
1832338530,9713696109,1738406832,9713692073,-4036,,
1832588682,9713946260,1738656973,9713942213,-4047,,
1832839154,9714196733,1738907446,9714192686,-4047,,
1833089294,9714446883,1739157595,9714442836,-4047,,
1833339523,9714697102,1739407815,9714693055,-4047,,
1833357588,9714715166,1739425878,9714711119,-4047,9714710905,
1833607830,9714965408,1739676121,9714961308,-4100,,
1833858281,9715215860,1739926572,9715211707,-4153,,
1834108458,9715466036,1740176749,9715461841,-4195,,
1834358809,9715716398,1740427111,9715712139,-4259,,
1834608996,9715966575,1740677287,9715962316,-4259,,
1834859488,9716217067,1740927779,9716212808,-4259,,
1835110109,9716467688,1741178400,9716463429,-4259,,
1835360748,9716718327,1741429049,9716714078,-4249,,
1835378983,9716736562,1741447274,9716732302,-4260,9716732375,
1835629949,9716987528,1741698240,9716983286,-4242,,
1835880553,9717238142,1741948855,9717233919,-4223,,
1836131007,9717488585,1742199298,9717484381,-4204,,
1836381169,9717738748,1742449470,9717734572,-4176,,
1836631506,9717989085,1742699798,9717984900,-4185,,
1836882048,9718239637,1742950349,9718235452,-4185,,
1837132574,9718490154,1743200866,9718485969,-4185,,
1837383112,9718740702,1743451414,9718736517,-4185,,
1837401270,9718758848,1743469561,9718754663,-4185,9718754707,
1837651624,9719009203,1743719916,9719005029,-4174,,
1837902015,9719259593,1743970317,9719255442,-4151,,
1838152347,9719509926,1744220638,9719505775,-4151,,
1838402505,9719760084,1744470797,9719755945,-4139,,
1838652661,9720010240,1744720952,9720006101,-4139,,
1838902793,9720260371,1744971084,9720256232,-4139,,
1839153232,9720510811,1745221523,9720506672,-4139,,
1839403809,9720761388,1745472110,9720757258,-4130,,
1839421929,9720779508,1745490220,9720775369,-4139,9720775293,
1839672420,9721029999,1745740711,9721025840,-4159,,
1839922880,9721280470,1745991182,9721276294,-4176,,
1840173107,9721530687,1746241399,9721526492,-4195,,
1840423231,9721780809,1746491522,9721776596,-4213,,
1840673498,9722031076,1746741788,9722026863,-4213,,
1840923908,9722281487,1746992200,9722277274,-4213,,
1841174716,9722532295,1747243007,9722528082,-4213,,
1841425262,9722782841,1747493553,9722778627,-4214,,
1841443259,9722800837,1747511550,9722796624,-4213,9722796627,
1841693758,9723051336,1747762048,9723047123,-4213,,
1841944344,9723301922,1748012645,9723297720,-4202,,
1842194564,9723552144,1748262857,9723547933,-4211,,
1842444860,9723802439,1748513152,9723798230,-4209,,
1842695188,9724052766,1748763489,9724048567,-4199,,
1842945379,9724302958,1749013681,9724298759,-4199,,
1843195915,9724553494,1749264216,9724549294,-4200,,
1843446384,9724803973,1749514685,9724799763,-4210,,
1843464431,9724822009,1749532722,9724817800,-4209,9724817755,
1843714533,9725072112,1749782824,9725067890,-4222,,
1843965082,9725322661,1750033374,9725318430,-4231,,
1844215603,9725573182,1750283895,9725568940,-4242,,
1844465775,9725823353,1750534066,9725819100,-4253,,
1844716049,9726073628,1750784351,9726069385,-4243,,
1844966318,9726323896,1751034609,9726319643,-4253,,
1845217012,9726574590,1751285303,9726570337,-4253,,
1845467335,9726824924,1751535637,9726820671,-4253,,
1845485556,9726843134,1751553847,9726838881,-4253,9726838863,
1845736081,9727093659,1751804372,9727089412,-4247,,
1845986821,9727344411,1752055124,9727340150,-4261,,
1846237349,9727594928,1752305641,9727590663,-4265,,
1846488038,9727845616,1752556329,9727841347,-4269,,
1846738624,9728096203,1752806915,9728091934,-4269,,
1846988842,9728346421,1753057133,9728342152,-4269,,
1847239009,9728596587,1753307300,9728592318,-4269,,
1847489493,9728847072,1753557784,9728842803,-4269,,
1847507516,9728865094,1753575806,9728860825,-4269,9728860840,
1847758080,9729115658,1753826371,9729111393,-4265,,
1848008247,9729365826,1754076539,9729361565,-4261,,
1848258423,9729616002,1754326714,9729611746,-4256,,
1848508784,9729866362,1754577075,9729862110,-4252,,
1848759408,9730116986,1754827699,9730112734,-4252,,
1849009977,9730367556,1755078269,9730363305,-4251,,
1849260132,9730617710,1755328423,9730613458,-4252,,
1849510260,9730867839,1755578552,9730863587,-4252,,
1849528380,9730885959,1755596671,9730881707,-4252,9730881615,
1849778865,9731136444,1755847156,9731132170,-4274,,
1850029264,9731386843,1756097556,9731382546,-4297,,
1850279473,9731637052,1756347764,9731632732,-4320,,
1850530049,9731887627,1756598340,9731883285,-4342,,
1850780251,9732137830,1756848542,9732133487,-4343,,
1851030548,9732388127,1757098840,9732383785,-4342,,
1851281121,9732638700,1757349412,9732634358,-4342,,
1851531669,9732889247,1757599960,9732884905,-4342,,
1851549830,9732907408,1757618121,9732903066,-4342,9732903211,
1851800010,9733157588,1757868301,9733153282,-4306,,
1852050497,9733408076,1758118788,9733403806,-4270,,
1852300634,9733658213,1758368925,9733653980,-4233,,
1852551055,9733908634,1758619346,9733904437,-4197,,
1852801443,9734159022,1758869735,9734154836,-4186,,
1853051661,9734409251,1759119964,9734405055,-4196,,
1853302090,9734659668,1759370381,9734655472,-4196,,
1853552234,9734909812,1759620525,9734905616,-4196,,
1853570380,9734927958,1759638671,9734923762,-4196,9734923744,
1853820960,9735178538,1759889251,9735174338,-4200,,
1854071751,9735429330,1760140043,9735425126,-4204,,
1854322193,9735679772,1760390484,9735675564,-4208,,
1854572678,9735930267,1760640979,9735926055,-4212,,
1854823223,9736180802,1760891514,9736176589,-4213,,
1855073509,9736431088,1761141801,9736426877,-4211,,
1855323811,9736681401,1761392113,9736677189,-4212,,
1855574576,9736932155,1761642867,9736927942,-4213,,
1855592792,9736950370,1761661082,9736946158,-4212,9736946177,
1855843206,9737200785,1761911497,9737196578,-4207,,
1856093590,9737451170,1762161882,9737446968,-4202,,
1856344210,9737701789,1762412511,9737697602,-4187,,
1856594465,9737952043,1762662756,9737947852,-4191,,
1856844629,9738202208,1762912920,9738198017,-4191,,
1857095109,9738452688,1763163401,9738448497,-4191,,
1857345549,9738703128,1763413840,9738698937,-4191,,
1857596125,9738953704,1763664417,9738949513,-4191,,
1857614319,9738971897,1763682610,9738967706,-4191,9738967633,
1857864403,9739221982,1763932695,9739217782,-4200,,
1858114786,9739472365,1764183078,9739468137,-4228,,
1858365344,9739722923,1764433636,9739718677,-4246,,
1858615803,9739973381,1764684094,9739969118,-4263,,
1858865948,9740223526,1764934239,9740219263,-4263,,
1859116527,9740474107,1765184819,9740469844,-4263,,
1859366639,9740724218,1765434941,9740719965,-4253,,
1859616891,9740974470,1765685182,9740970207,-4263,,
1859635171,9740992749,1765703462,9740988486,-4263,9740988595,
1859885836,9741243415,1765954127,9741239179,-4236,,
1860136556,9741494135,1766204847,9741489926,-4209,,
1860386937,9741744516,1766455228,9741740336,-4180,,
1860637041,9741994620,1766705332,9741990467,-4153,,
1860887732,9742245310,1766956023,9742241157,-4153,,
1861137919,9742495498,1767206211,9742491345,-4153,,
1861388478,9742746057,1767456769,9742741903,-4154,,
1861638934,9742996513,1767707225,9742992359,-4154,,
1861656937,9743014515,1767725227,9743010362,-4153,9743010246,
1861907458,9743265037,1767975749,9743260855,-4182,,
1862157803,9743515381,1768226094,9743511170,-4211,,
1862407950,9743765528,1768476240,9743761299,-4229,,
1862658734,9744016312,1768727025,9744012044,-4268,,
1862909496,9744267074,1768977787,9744262806,-4268,,
1863159954,9744517533,1769228246,9744513266,-4267,,
1863410515,9744768094,1769478806,9744763825,-4269,,
1863660762,9745018341,1769729053,9745014073,-4268,,
1863678740,9745036319,1769747031,9745032051,-4268,9745032025,
1863929137,9745286716,1769997428,9745282441,-4275,,
1864179596,9745537175,1770247887,9745532894,-4281,,
1864429795,9745787374,1770498086,9745783088,-4286,,
1864680610,9746038189,1770748902,9746033897,-4292,,
1864930872,9746288451,1770999174,9746284170,-4281,,
1865181630,9746539208,1771249921,9746534916,-4292,,
1865431849,9746789428,1771500151,9746785146,-4282,,
1865682344,9747039923,1771750635,9747035630,-4293,,
1865700477,9747058055,1771768767,9747053762,-4293,9747053770,
1865950706,9747308285,1772018997,9747303995,-4290,,
1866200913,9747558492,1772269204,9747554204,-4288,,
1866451309,9747808887,1772519611,9747804613,-4274,,
1866701431,9748059010,1772769722,9748054737,-4273,,
1866952188,9748309767,1773020479,9748305483,-4284,,
1867202564,9748560142,1773270855,9748555859,-4283,,
1867453181,9748810760,1773521483,9748806488,-4272,,
1867703685,9749061263,1773771976,9749056980,-4283,,
1867721852,9749079431,1773790143,9749075147,-4284,9749075185,
1867972035,9749329613,1774040326,9749325340,-4273,,
1868222279,9749579858,1774290570,9749575594,-4264,,
1868472794,9749830374,1774541086,9749826120,-4254,,
1868723383,9750080962,1774791674,9750076718,-4244,,
1868973837,9750331416,1775042128,9750327171,-4245,,
1869224468,9750582046,1775292759,9750577802,-4244,,
1869474607,9750832186,1775542908,9750827952,-4234,,
1869724812,9751082391,1775793103,9751078147,-4244,,
1869742880,9751100459,1775811171,9751096214,-4245,9751096203,
1869993113,9751350691,1776061403,9751346444,-4247,,
1870243654,9751601233,1776311946,9751596984,-4249,,
1870494290,9751851869,1776562581,9751847617,-4252,,
1870744406,9752101985,1776812697,9752097741,-4244,,
1870994717,9752352295,1777063008,9752348041,-4254,,
1871245299,9752602877,1777313590,9752598623,-4254,,
1871495922,9752853500,1777564212,9752849246,-4254,,
1871746052,9753103630,1777814343,9753099376,-4254,,
1871764465,9753122043,1777832756,9753117789,-4254,9753117682,
1872014940,9753372519,1778083231,9753368247,-4272,,
1872265182,9753622762,1778333474,9753618454,-4308,,
1872516095,9753873674,1778584387,9753869341,-4333,,
1872766274,9754123852,1778834565,9754119492,-4360,,
1873016450,9754374029,1779084741,9754369669,-4360,,
1873267342,9754624921,1779335633,9754620560,-4361,,
1873517522,9754875101,1779585814,9754870741,-4360,,
1873768254,9755125833,1779836545,9755121473,-4360,,
1873786631,9755144209,1779854921,9755139849,-4360,9755140037,
1874037145,9755394724,1780105436,9755390410,-4314,,
1874287472,9755645051,1780355764,9755640786,-4265,,
1874537855,9755895433,1780606145,9755891216,-4217,,
1874787992,9756145570,1780856283,9756141400,-4170,,
1875038791,9756396369,1781107082,9756392199,-4170,,
1875289410,9756646989,1781357701,9756642818,-4171,,
1875539612,9756897190,1781607902,9756893020,-4170,,
1875789907,9757147486,1781858208,9757143326,-4160,,
1875808075,9757165653,1781876366,9757161483,-4170,9757161411,
1876058336,9757415915,1782126627,9757411727,-4188,,
1876309198,9757666776,1782377500,9757662582,-4194,,
1876559365,9757916944,1782627657,9757912721,-4223,,
1876809771,9758167350,1782878073,9758163121,-4229,,
1877060184,9758417763,1783128485,9758413533,-4230,,
1877310594,9758668172,1783378885,9758663932,-4240,,
1877560776,9758918354,1783629067,9758914114,-4240,,
1877810970,9759168548,1783879261,9759164318,-4230,,
1877829098,9759186676,1783897389,9759182436,-4240,9759182346,
1878079523,9759437112,1784147824,9759432850,-4262,,
1878330181,9759687759,1784398472,9759683485,-4274,,
1878580819,9759938398,1784649110,9759934091,-4307,,
1878831130,9760188709,1784899421,9760184380,-4329,,
1879082057,9760439635,1785150347,9760435307,-4328,,
1879332716,9760690294,1785401007,9760685966,-4328,,
1879582832,9760940411,1785651123,9760936082,-4329,,
1879833344,9761190922,1785901635,9761186594,-4328,,
1879851435,9761209014,1785919726,9761204685,-4329,9761204716,
1880101858,9761459436,1786170159,9761455126,-4310,,
1880352485,9761710064,1786420776,9761705752,-4312,,
1880602941,9761960519,1786671232,9761956215,-4304,,
1880853416,9762210994,1786921707,9762206698,-4296,,
1881104141,9762461730,1787172443,9762457434,-4296,,
1881354667,9762712246,1787422969,9762707960,-4286,,
1881605101,9762962679,1787673392,9762958383,-4296,,
1881855875,9763213453,1787924166,9763209157,-4296,,
1881874075,9763231653,1787942365,9763227356,-4297,9763227374,
1882124343,9763481922,1788192634,9763477642,-4280,,
1882374486,9763732064,1788442777,9763727777,-4287,,
1882624886,9763982465,1788693177,9763978183,-4282,,
1882875182,9764232761,1788943473,9764228493,-4268,,
1883125309,9764482888,1789193600,9764478611,-4277,,
1883375679,9764733258,1789443970,9764728980,-4278,,
1883626202,9764983781,1789694493,9764979504,-4277,,
1883876362,9765233941,1789944653,9765229663,-4278,,
1883894614,9765252192,1789962905,9765247915,-4277,9765247823,
1884145335,9765502914,1790213636,9765498624,-4290,,
1884395584,9765753162,1790463875,9765748839,-4323,,
1884645819,9766003398,1790714110,9765999052,-4346,,
1884896355,9766253934,1790964646,9766249566,-4368,,
1885147133,9766504713,1791215426,9766500345,-4368,,
1885397623,9766755212,1791465924,9766750844,-4368,,
1885647881,9767005470,1791716182,9767001102,-4368,,
1885898119,9767255698,1791966410,9767251340,-4358,,
1885916428,9767274007,1791984719,9767269638,-4369,9767269810,
1886166861,9767524451,1792235163,9767520127,-4324,,
1886417095,9767774673,1792485386,9767770392,-4281,,
1886667525,9768025104,1792735816,9768020865,-4239,,
1886918459,9768276038,1792986750,9768271843,-4195,,
1887168573,9768526152,1793236865,9768521957,-4195,,
1887418806,9768776385,1793487108,9768772201,-4184,,
1887669127,9769026706,1793737418,9769022511,-4195,,
1887919429,9769277007,1793987720,9769272812,-4195,,
1887937699,9769295278,1794005990,9769291082,-4196,9769290947,
1888188345,9769545924,1794256646,9769541705,-4219,,
1888438518,9769796107,1794506819,9769791845,-4262,,
1888689172,9770046750,1794757463,9770042454,-4296,,
1888939296,9770296874,1795007587,9770292545,-4329,,
1889189959,9770547539,1795258252,9770543210,-4329,,
1889440144,9770797723,1795508436,9770793394,-4329,,
1889690478,9771048057,1795758769,9771043728,-4329,,
1889940607,9771298185,1796008897,9771293856,-4329,,
1889958630,9771316208,1796026920,9771311879,-4329,9771311843,
1890209347,9771566926,1796277639,9771562589,-4337,,
1890459937,9771817516,1796528229,9771813170,-4346,,
1890710529,9772068108,1796778820,9772063753,-4355,,
1890960919,9772318498,1797029210,9772314135,-4363,,
1891211169,9772568748,1797279461,9772564385,-4363,,
1891461804,9772819383,1797530095,9772815019,-4364,,
1891712239,9773069818,1797780530,9773065454,-4364,,
1891962544,9773320123,1798030836,9773315760,-4363,,
1891980732,9773338310,1798049022,9773333947,-4363,9773333974,
1892231519,9773589098,1798299811,9773584743,-4355,,
1892481875,9773839454,1798550166,9773835106,-4348,,
1892732559,9774090137,1798800849,9774085796,-4341,,
1892983275,9774340853,1799051566,9774336519,-4334,,
1893233598,9774591187,1799301900,9774586853,-4334,,
1893483959,9774841537,1799552250,9774837203,-4334,,
1893734635,9775092214,1799802926,9775087880,-4334,,
1893984949,9775342527,1800053239,9775338193,-4334,,
1894003029,9775360607,1800071320,9775356273,-4334,9775356243,
1894253695,9775611274,1800321987,9775606932,-4342,,
1894503859,9775861438,1800572150,9775857088,-4350,,
1894753984,9776111563,1800822275,9776107206,-4357,,
1895004463,9776362042,1801072754,9776357678,-4364,,
1895255024,9776612603,1801323315,9776608240,-4363,,
1895505322,9776862901,1801573613,9776858538,-4363,,
1895755710,9777113288,1801824001,9777108925,-4363,,
1896006078,9777363656,1802074369,9777359293,-4363,,
1896024350,9777381928,1802092640,9777377565,-4363,9777377507,
1896275230,9777632810,1802343522,9777628433,-4377,,
1896525776,9777883354,1802594067,9777878963,-4391,,
1896776549,9778134128,1802844840,9778129722,-4406,,
1897026711,9778384290,1803095002,9778379870,-4420,,
1897276848,9778634437,1803345150,9778630018,-4419,,
1897527012,9778884591,1803595303,9778880171,-4420,,
1897777460,9779135038,1803845751,9779130619,-4419,,
1898027756,9779385334,1804096047,9779380915,-4419,,
1898045831,9779403409,1804114121,9779398990,-4419,9779398990,
1898296167,9779653745,1804364458,9779649327,-4418,,
1898546337,9779903915,1804614627,9779899497,-4418,,
1898796450,9780154029,1804864741,9780149611,-4418,,
1899047188,9780404767,1805115479,9780400350,-4417,,
1899297479,9780655058,1805365770,9780650641,-4417,,
1899548005,9780905584,1805616297,9780901167,-4417,,
1899798106,9781155685,1805866397,9781151268,-4417,,
1900048780,9781406359,1806117071,9781401941,-4418,,
1900067012,9781424591,1806135303,9781420173,-4418,9781420166,
1900317393,9781674972,1806385685,9781670553,-4419,,
1900567876,9781925454,1806636167,9781921044,-4410,,
1900818515,9782176094,1806886806,9782171672,-4422,,
1901068682,9782426260,1807136973,9782421847,-4413,,
1901319142,9782676721,1807387444,9782672309,-4412,,
1901569756,9782927334,1807638047,9782922911,-4423,,
1901820126,9783177705,1807888417,9783173282,-4423,,
1902070360,9783427939,1808138652,9783423516,-4423,,
1902088520,9783446098,1808156811,9783441675,-4423,9783441703,
1902338996,9783696575,1808407288,9783692158,-4417,,
1902589867,9783947446,1808658158,9783943036,-4410,,
1902840508,9784198086,1808908799,9784193684,-4402,,
1903091111,9784448690,1809159402,9784444295,-4395,,
1903342128,9784699707,1809410420,9784695313,-4394,,
1903592609,9784950187,1809660911,9784945804,-4383,,
1903843182,9785200761,1809911473,9785196367,-4394,,
1904093682,9785451261,1810161973,9785446867,-4394,,
1904111733,9785469312,1810180024,9785464918,-4394,9785464920,
1904362088,9785719667,1810430380,9785715274,-4393,,
1904612513,9785970092,1810680805,9785965700,-4392,,
1904863150,9786220728,1810931441,9786216337,-4391,,
1905113277,9786470856,1811181579,9786466476,-4380,,
1905363611,9786721190,1811431902,9786716800,-4390,,
1905613749,9786971339,1811682052,9786966949,-4390,,
1905864228,9787221807,1811932519,9787217416,-4391,,
1906114418,9787471996,1812182709,9787467617,-4379,,
1906132540,9787490118,1812200831,9787485728,-4390,9787485693,
1906383162,9787740740,1812451453,9787736343,-4397,,
1906633343,9787990922,1812701634,9787986515,-4407,,
1906883437,9788241015,1812951727,9788236601,-4414,,
1907133830,9788491409,1813202121,9788486986,-4423,,
1907384163,9788741742,1813452468,9788737333,-4409,,
1907634674,9788992253,1813702965,9788987829,-4424,,
1907885234,9789242813,1813953525,9789238389,-4424,,
1908135804,9789493382,1814204095,9789488959,-4423,,
1908153842,9789511420,1814222133,9789506997,-4423,9789507013,
1908404288,9789761867,1814472579,9789757448,-4419,,
1908654508,9790012087,1814722799,9790007672,-4415,,
1908905061,9790262640,1814973352,9790258230,-4410,,
1909155681,9790513260,1815223973,9790508855,-4405,,
1909406028,9790763608,1815474320,9790759202,-4406,,
1909656126,9791013705,1815724417,9791009298,-4407,,
1909906367,9791263945,1815974657,9791259539,-4406,,
1910156871,9791514450,1816225163,9791510044,-4406,,
1910175109,9791532687,1816243399,9791528280,-4407,9791528272,
1910425537,9791783116,1816493829,9791778709,-4407,,
1910676360,9792033938,1816744651,9792029529,-4409,,
1910926498,9792284077,1816994789,9792279666,-4411,,
1911177061,9792534640,1817245353,9792530227,-4413,,
1911427536,9792785115,1817495828,9792780703,-4412,,
1911678147,9793035737,1817746449,9793031324,-4413,,
1911928517,9793286096,1817996808,9793281683,-4413,,
1912178885,9793536464,1818247176,9793532051,-4413,,
1912197065,9793554644,1818265356,9793550230,-4414,9793550244,
1912447188,9793804767,1818515479,9793800357,-4410,,
1912697705,9794055284,1818765996,9794050878,-4406,,
1912947863,9794305442,1819016154,9794301040,-4402,,
1913198143,9794555723,1819266435,9794551325,-4398,,
1913448424,9794806003,1819516716,9794801605,-4398,,
1913698704,9795056283,1819766995,9795051885,-4398,,
1913948904,9795306483,1820017195,9795302084,-4399,,
1914199690,9795557269,1820267981,9795552871,-4398,,
1914217801,9795575380,1820286092,9795570981,-4399,9795570939,
1914468402,9795825981,1820536694,9795821572,-4409,,
1914718777,9796076356,1820787068,9796071936,-4420,,
1914969179,9796326758,1821037481,9796322339,-4419,,
1915219807,9796577386,1821288099,9796572947,-4439,,
1915470014,9796827593,1821538305,9796823154,-4439,,
1915720369,9797077947,1821788660,9797073508,-4439,,
1915970807,9797328386,1822039098,9797323957,-4429,,
1916221252,9797578831,1822289544,9797574392,-4439,,
1916239521,9797597099,1822307812,9797592660,-4439,9797592809,
1916489758,9797847336,1822558049,9797842934,-4402,,
1916740200,9798097778,1822808491,9798093414,-4364,,
1916990671,9798348250,1823058962,9798343934,-4316,,
1917240911,9798598490,1823309203,9798594201,-4289,,
1917491109,9798848698,1823559410,9798844409,-4289,,
1917741570,9799099149,1823809861,9799094860,-4289,,
1917991761,9799349340,1824060052,9799345061,-4279,,
1918242276,9799599855,1824310567,9799595566,-4289,,
1918260266,9799617844,1824328557,9799613555,-4289,9799613437,
1918511054,9799868633,1824579345,9799864314,-4319,,
1918761166,9800118745,1824829457,9800114397,-4348,,
1919011669,9800369248,1825079970,9800364881,-4367,,
1919261963,9800619541,1825330254,9800615135,-4406,,
1919512512,9800870102,1825580814,9800865696,-4406,,
1919763065,9801120644,1825831356,9801116238,-4406,,
1920013261,9801370839,1826081552,9801366433,-4406,,
1920263587,9801621166,1826331879,9801616761,-4405,,
1920281762,9801639341,1826350053,9801634935,-4406,9801634889,
1920532409,9801889988,1826600700,9801885570,-4418,,
1920782630,9802140208,1826850920,9802135780,-4428,,
1921033196,9802390774,1827101487,9802386335,-4439,,
1921283747,9802641326,1827352038,9802636875,-4451,,
1921534056,9802891635,1827602347,9802887184,-4451,,
1921784510,9803142089,1827852802,9803137639,-4450,,
1922034970,9803392549,1828103261,9803388098,-4451,,
1922285733,9803643312,1828354025,9803638863,-4449,,
1922303839,9803661418,1828372130,9803656967,-4451,9803656977,
1922554095,9803911673,1828622386,9803907225,-4448,,
1922804585,9804162164,1828872876,9804157718,-4446,,
1923054980,9804412559,1829123271,9804408116,-4443,,
1923305074,9804662652,1829373375,9804658223,-4429,,
1923555329,9804912907,1829623620,9804908468,-4439,,
1923805683,9805163261,1829873974,9805158822,-4439,,
1924056204,9805413783,1830124495,9805409343,-4440,,
1924306354,9805663944,1830374656,9805659505,-4439,,
1924324479,9805682057,1830392769,9805677618,-4439,9805677663,
1924574739,9805932318,1830643030,9805927891,-4427,,
1924825543,9806183121,1830893834,9806178706,-4415,,
1925075838,9806433417,1831144130,9806429014,-4403,,
1925326499,9806684078,1831394790,9806679686,-4392,,
1925576616,9806934194,1831644907,9806929802,-4392,,
1925826930,9807184509,1831895221,9807180116,-4393,,
1926077111,9807434690,1832145402,9807430297,-4393,,
1926327678,9807685257,1832395969,9807680865,-4392,,
1926345747,9807703325,1832414037,9807698933,-4392,9807698837,
1926596034,9807953613,1832664325,9807949198,-4415,,
1926846431,9808204009,1832914721,9808199570,-4439,,
1927097004,9808454583,1833165295,9808450120,-4463,,
1927347517,9808705096,1833415809,9808700610,-4486,,
1927597612,9808955190,1833665913,9808950714,-4476,,
1927847715,9809205294,1833916007,9809200808,-4486,,
1928097876,9809455455,1834166167,9809450969,-4486,,
1928348478,9809706057,1834416769,9809701571,-4486,,
1928366502,9809724080,1834434793,9809719594,-4486,9809719585,
1928616646,9809974225,1834684948,9809969747,-4478,,
1928866928,9810224507,1834935219,9810220017,-4490,,
1929117233,9810474811,1835185524,9810470320,-4491,,
1929367775,9810725354,1835436077,9810720871,-4483,,
1929618729,9810976307,1835687019,9810971814,-4493,,
1929869358,9811226937,1835937649,9811222444,-4493,,
1930119681,9811477259,1836187972,9811472766,-4493,,
1930370444,9811728023,1836438736,9811723530,-4493,,
1930388743,9811746321,1836457033,9811741828,-4493,9811741958,
1930639734,9811997313,1836708025,9811992852,-4461,,
1930890018,9812247597,1836958309,9812243169,-4428,,
1931140376,9812497955,1837208667,9812493562,-4393,,
1931390909,9812748488,1837459201,9812744127,-4361,,
1931641214,9812998793,1837709515,9812994441,-4352,,
1931891983,9813249562,1837960274,9813245200,-4362,,
1932142414,9813499993,1838210705,9813495632,-4361,,
1932393030,9813750609,1838461321,9813746248,-4361,,
1932411174,9813768753,1838479465,9813764392,-4361,9813764260,
1932661629,9814019207,1838729920,9814014813,-4394,,
1932911736,9814269315,1838980027,9814264889,-4426,,
1933162137,9814519715,1839230428,9814515256,-4459,,
1933412399,9814769977,1839480690,9814765486,-4491,,
1933663067,9815020646,1839731358,9815016155,-4491,,
1933913170,9815270749,1839981462,9815266258,-4491,,
1934163946,9815521525,1840232238,9815517034,-4491,,
1934414097,9815771675,1840482388,9815767184,-4491,,
1934432245,9815789824,1840500536,9815785333,-4491,9815785354,
1934682633,9816040211,1840750924,9816035725,-4486,,
1934932857,9816290436,1841001148,9816285956,-4480,,
1935183353,9816540931,1841251644,9816536457,-4474,,
1935433823,9816791413,1841502126,9816786945,-4468,,
1935684436,9817042015,1841752737,9817037556,-4459,,
1935934956,9817292534,1842003246,9817288066,-4468,,
1936185069,9817542648,1842253360,9817538191,-4457,,
1936435178,9817792756,1842503468,9817788288,-4468,,
1936453268,9817810847,1842521559,9817806378,-4469,9817806321,
1936703445,9818061023,1842771735,9818056541,-4482,,
1936954427,9818312006,1843022718,9818307510,-4496,,
1937205174,9818562753,1843273466,9818558244,-4509,,
1937455544,9818813123,1843523835,9818808598,-4525,,
1937706036,9819063615,1843774327,9819059091,-4524,,
1937956272,9819313851,1844024563,9819309327,-4524,,
1938207075,9819564653,1844275366,9819560129,-4524,,
1938457645,9819815224,1844525936,9819810710,-4514,,
1938475851,9819833429,1844544142,9819828905,-4524,9819828973,
1938726489,9820084068,1844794780,9820079562,-4506,,
1938977023,9820334601,1845045314,9820330112,-4489,,
1939227813,9820585393,1845296106,9820580922,-4471,,
1939478164,9820835753,1845546465,9820831299,-4454,,
1939728612,9821086191,1845796903,9821081737,-4454,,
1939979216,9821336795,1846047508,9821332341,-4454,,
1940229712,9821587291,1846298003,9821582837,-4454,,
1940479917,9821837495,1846548207,9821833041,-4454,,
1940498055,9821855633,1846566346,9821851179,-4454,9821851173,
1940748235,9822105814,1846816526,9822101358,-4456,,
1940998429,9822356008,1847066721,9822351551,-4457,,
1941248858,9822606438,1847317151,9822601980,-4458,,
1941498991,9822856569,1847567282,9822852110,-4459,,
1941749144,9823106733,1847817445,9823102273,-4460,,
1941999526,9823357104,1848067817,9823352645,-4459,,
1942249638,9823607217,1848317929,9823602757,-4460,,
1942499848,9823857427,1848568139,9823852968,-4459,,
1942518098,9823875676,1848586389,9823871217,-4459,9823871201,
1942768684,9824126273,1848836985,9824121808,-4465,,
1943019139,9824376718,1849087431,9824372261,-4457,,
1943269652,9824627231,1849337943,9824622760,-4471,,
1943519827,9824877405,1849588118,9824872931,-4474,,
1943769985,9825127564,1849838287,9825123101,-4463,,
1944020320,9825377899,1850088611,9825373424,-4475,,
1944270920,9825628498,1850339211,9825624024,-4474,,
1944521074,9825878652,1850589365,9825874178,-4474,,
1944539076,9825896654,1850607367,9825892180,-4474,9825892215,
1944789676,9826147265,1850857978,9826142801,-4464,,
1945039952,9826397531,1851108243,9826393075,-4456,,
1945290135,9826647715,1851358428,9826643269,-4446,,
1945540846,9826898425,1851609138,9826893988,-4437,,
1945791208,9827148797,1851859510,9827144360,-4437,,
1946041673,9827399251,1852109963,9827394814,-4437,,
1946292124,9827649702,1852360415,9827645265,-4437,,
1946542450,9827900028,1852610741,9827895591,-4437,,
1946560513,9827918091,1852628803,9827913654,-4437,9827913634,
1946811132,9828168711,1852879423,9828164268,-4443,,
1947061262,9828418841,1853129554,9828414405,-4436,,
1947311687,9828669266,1853379978,9828664813,-4453,,
1947562218,9828919797,1853630509,9828915341,-4456,,
1947812430,9829170008,1853880721,9829165552,-4456,,
1948062616,9829420204,1854130917,9829415748,-4456,,
1948313120,9829670699,1854381412,9829666244,-4455,,
1948563706,9829921295,1854632008,9829916839,-4456,,
1948581831,9829939409,1854650121,9829934953,-4456,9829934897,
1948832270,9830189849,1854900561,9830185379,-4470,,
1949082959,9830440537,1855151250,9830436054,-4483,,
1949333244,9830690822,1855401534,9830686325,-4497,,
1949583588,9830941166,1855651879,9830936656,-4510,,
1949833735,9831191314,1855902027,9831186814,-4500,,
1950083924,9831441503,1856152225,9831437003,-4500,,
1950334627,9831692205,1856402918,9831687696,-4509,,
1950584954,9831942533,1856653246,9831938023,-4510,,
1950603071,9831960649,1856671362,9831956139,-4510,9831956179,
1950853665,9832211243,1856921956,9832206744,-4499,,
1951104041,9832461620,1857172332,9832457131,-4489,,
1951354358,9832711937,1857422649,9832707459,-4478,,
1951604469,9832962048,1857672760,9832957590,-4458,,
1951855137,9833212717,1857923429,9833208249,-4468,,
1952105648,9833463226,1858173939,9833458768,-4458,,
1952356123,9833713702,1858424424,9833709243,-4459,,
1952606500,9833964078,1858674790,9833959610,-4468,,
1952624581,9833982160,1858692872,9833977692,-4468,9833977658,
1952874789,9834232368,1858943080,9834227890,-4478,,
1953125368,9834482947,1859193659,9834478462,-4485,,
1953375695,9834733274,1859443986,9834728781,-4493,,
1953626208,9834983787,1859694499,9834979286,-4501,,
1953876731,9835234310,1859945022,9835229810,-4500,,
1954127692,9835485271,1860195984,9835480771,-4500,,
1954378277,9835735856,1860446568,9835731356,-4500,,
1954628408,9835985987,1860696699,9835981486,-4501,,
1954646399,9836003978,1860714690,9835999477,-4501,9835999424,
1954896709,9836254288,1860965000,9836249774,-4514,,
1955146846,9836504425,1861215137,9836499897,-4528,,
1955397289,9836754867,1861465580,9836750327,-4540,,
1955647688,9837005267,1861715979,9837000715,-4552,,
1955898056,9837255635,1861966347,9837251082,-4553,,
1956148631,9837506210,1862216922,9837501657,-4553,,
1956398976,9837756555,1862467277,9837752012,-4543,,
1956649447,9838007026,1862717739,9838002474,-4552,,
1956667441,9838025019,1862735732,9838020467,-4552,9838020458,
1956917570,9838275149,1862985861,9838270593,-4556,,
1957167772,9838525352,1863236075,9838520805,-4547,,
1957418089,9838775668,1863486380,9838771109,-4559,,
1957668590,9839026168,1863736881,9839021608,-4560,,
1957919107,9839276685,1863987398,9839272125,-4560,,
1958169297,9839526876,1864237589,9839522316,-4560,,
1958419625,9839777204,1864487916,9839772644,-4560,,
1958669979,9840027558,1864738270,9840022998,-4560,,
1958688192,9840045770,1864756482,9840041210,-4560,9840041331,
1958939255,9840296833,1865007546,9840292303,-4530,,
1959189813,9840547392,1865258105,9840542893,-4499,,
1959440136,9840797714,1865508427,9840793246,-4468,,
1959690624,9841048203,1865758925,9841043775,-4428,,
1959940823,9841298402,1866009114,9841293964,-4438,,
1960190972,9841548550,1866259263,9841544112,-4438,,
1960441384,9841798963,1866509675,9841794525,-4438,,
1960692046,9842049625,1866760337,9842045187,-4438,,
1960710146,9842067725,1866778437,9842063286,-4439,9842063182,
1960960249,9842317828,1867028540,9842313362,-4466,,
1961210621,9842568200,1867278913,9842563710,-4490,,
1961460752,9842818331,1867529044,9842813815,-4516,,
1961711257,9843068836,1867779549,9843064295,-4541,,
1961962066,9843319644,1868030356,9843315103,-4541,,
1962212427,9843570006,1868280718,9843565465,-4541,,
1962462615,9843820194,1868530906,9843815652,-4542,,
1962713084,9844070663,1868781376,9844066122,-4541,,
1962731101,9844088680,1868799392,9844084138,-4542,9844084127,
1962981340,9844338918,1869049631,9844334374,-4544,,
1963231751,9844589331,1869300044,9844584784,-4547,,
1963482373,9844839962,1869550675,9844835413,-4549,,
1963732889,9845090468,1869801180,9845085917,-4551,,
1963983795,9845341373,1870052086,9845336822,-4551,,
1964234021,9845591599,1870302312,9845587048,-4551,,
1964484933,9845842512,1870553224,9845837961,-4551,,
1964735148,9846092726,1870803439,9846088175,-4551,,
1964753662,9846111241,1870821953,9846106689,-4552,9846106517,
1965003772,9846361351,1871072073,9846356766,-4585,,
1965254335,9846611914,1871322627,9846607277,-4637,,
1965504492,9846862071,1871572783,9846857392,-4679,,
1965755090,9847112669,1871823382,9847107947,-4722,,
1966005578,9847363156,1872073869,9847358434,-4722,,
1966255935,9847613513,1872324226,9847608791,-4722,,
1966506199,9847863777,1872574490,9847859065,-4712,,
1966757024,9848114602,1872825315,9848109880,-4722,,
1966775163,9848132741,1872843454,9848128019,-4722,9848128169,
1967025380,9848382958,1873093670,9848378273,-4685,,
1967275686,9848633265,1873343978,9848628619,-4646,,
1967525843,9848883422,1873594134,9848878813,-4609,,
1967776215,9849133794,1873844507,9849129223,-4571,,
1968026506,9849384085,1874094797,9849379513,-4572,,
1968276835,9849634413,1874345126,9849629842,-4571,,
1968527146,9849884725,1874595448,9849880165,-4560,,
1968777569,9850135147,1874845860,9850130576,-4571,,
1968795719,9850153297,1874864010,9850148726,-4571,9850148771,
1969046331,9850403910,1875114622,9850399351,-4559,,
1969296904,9850654484,1875365196,9850649937,-4547,,
1969547189,9850904768,1875615480,9850900233,-4535,,
1969797319,9851154908,1875865621,9851150384,-4524,,
1970047489,9851405068,1876115780,9851400544,-4524,,
1970298062,9851655641,1876366354,9851651117,-4524,,
1970548406,9851905985,1876616707,9851901471,-4514,,
1970798882,9852156461,1876867173,9852151936,-4525,,
1970816941,9852174520,1876885232,9852169995,-4525,9852169956,
1971067374,9852424952,1877135665,9852420418,-4534,,
1971317798,9852675378,1877386091,9852670835,-4543,,
1971568146,9852925725,1877636437,9852921171,-4554,,
1971818408,9853175986,1877886699,9853171424,-4562,,
1972068986,9853426565,1878137278,9853422003,-4562,,
1972319617,9853677196,1878387908,9853672634,-4562,,
1972570168,9853927746,1878638459,9853923184,-4562,,
1972820399,9854177988,1878888701,9854173426,-4562,,
1972838478,9854196056,1878906769,9854191494,-4562,9854191468,
1973088723,9854446302,1879157024,9854441743,-4559,,
1973339154,9854696732,1879407445,9854692157,-4575,,
1973589524,9854947102,1879657815,9854942521,-4581,,
1973840376,9855197955,1879908678,9855193378,-4577,,
1974090565,9855448144,1880158856,9855443557,-4587,,
1974340904,9855698483,1880409196,9855693897,-4586,,
1974591467,9855949046,1880659759,9855944459,-4587,,
1974841863,9856199442,1880910155,9856194855,-4587,,
1974859943,9856217521,1880928234,9856212934,-4587,9856212925,
1975110143,9856467722,1881178434,9856463135,-4587,,
1975360258,9856717837,1881428549,9856713240,-4597,,
1975610809,9856968388,1881679112,9856963803,-4585,,
1975861209,9857218787,1881929500,9857214192,-4595,,
1976111758,9857469336,1882180049,9857464741,-4595,,
1976362362,9857719951,1882430664,9857715356,-4595,,
1976612524,9857970103,1882680815,9857965508,-4595,,
1976863069,9858220658,1882931371,9858216063,-4595,,
1976881304,9858238882,1882949594,9858234287,-4595,9858234263,
1977131439,9858489018,1883199730,9858484416,-4602,,
1977382271,9858739849,1883450562,9858735243,-4606,,
1977632545,9858990124,1883700836,9858985512,-4612,,
1977882766,9859240354,1883951067,9859235737,-4617,,
1978132907,9859490486,1884201198,9859485869,-4617,,
1978383386,9859740965,1884451677,9859736348,-4617,,
1978633505,9859991084,1884701796,9859986476,-4608,,
1978883817,9860241406,1884952119,9860236789,-4617,,
1978901928,9860259506,1884970218,9860254888,-4618,9860254875,
1979152147,9860509725,1885220438,9860505105,-4620,,
1979402369,9860759959,1885470671,9860755336,-4623,,
1979652791,9861010369,1885721081,9861005743,-4626,,
1979903168,9861260747,1885971459,9861256118,-4629,,
1980154026,9861511605,1886222317,9861506976,-4629,,
1980404614,9861762193,1886472905,9861757563,-4630,,
1980655302,9862012880,1886723593,9862008251,-4629,,
1980905474,9862263052,1886973765,9862258423,-4629,,
1980923566,9862281144,1886991857,9862276515,-4629,9862276579,
1981173803,9862531382,1887242094,9862526769,-4613,,
1981423918,9862781497,1887492209,9862776900,-4597,,
1981674029,9863031607,1887742320,9863027027,-4580,,
1981924517,9863282106,1887992819,9863277542,-4564,,
1982175122,9863532700,1888243413,9863528136,-4564,,
1982425373,9863782951,1888493664,9863778387,-4564,,
1982675809,9864033388,1888744100,9864028833,-4555,,
1982926267,9864283846,1888994559,9864279282,-4564,,
1982944436,9864302015,1889012727,9864297450,-4565,9864297401,
1983194567,9864552145,1889262857,9864547569,-4576,,
1983444830,9864802408,1889513121,9864797820,-4588,,
1983695271,9865052850,1889763562,9865048250,-4600,,
1983945455,9865303034,1890013746,9865298422,-4612,,
1984195707,9865553286,1890263998,9865548674,-4612,,
1984446135,9865803713,1890514426,9865799101,-4612,,
1984696333,9866053911,1890764624,9866049299,-4612,,
1984946480,9866304059,1891014772,9866299447,-4612,,
1984964772,9866322351,1891033063,9866317738,-4613,9866317815,
1985214976,9866572555,1891283267,9866567960,-4595,,
1985465144,9866822722,1891533435,9866818148,-4574,,
1985715456,9867073035,1891783747,9867068481,-4554,,
1985965612,9867323201,1892033914,9867318668,-4533,,
1986215969,9867573548,1892284260,9867569013,-4535,,
1986466365,9867823943,1892534655,9867819409,-4534,,
1986716504,9868074082,1892784794,9868069548,-4534,,
1986966855,9868324434,1893035147,9868319901,-4533,,
1986984913,9868342491,1893053204,9868337957,-4534,9868337901,
1987235437,9868593016,1893303729,9868588470,-4546,,
1987485556,9868843135,1893553848,9868838574,-4561,,
1987735913,9869093492,1893804204,9869088918,-4574,,
1987986033,9869343612,1894054325,9869339024,-4588,,
1988236604,9869594183,1894304895,9869589594,-4589,,
1988487344,9869844923,1894555646,9869840345,-4578,,
1988737715,9870095294,1894806006,9870090706,-4588,,
1988988516,9870346095,1895056808,9870341508,-4587,,
1989006743,9870364322,1895075034,9870359734,-4588,9870359641,
1989257103,9870614682,1895325395,9870610071,-4611,,
1989507469,9870865047,1895575760,9870860414,-4633,,
1989757656,9871115234,1895825946,9871110578,-4656,,
1990007919,9871365498,1896076211,9871360820,-4678,,
1990258038,9871615617,1896326329,9871610948,-4669,,
1990508463,9871866041,1896576753,9871861362,-4679,,
1990759030,9872116609,1896827321,9872111929,-4680,,
1991009520,9872367099,1897077811,9872362420,-4679,,
1991027592,9872385171,1897095883,9872380491,-4680,9872380443,
1991277996,9872635575,1897346288,9872630883,-4692,,
1991528301,9872885880,1897596592,9872881176,-4704,,
1991778835,9873136414,1897847127,9873131699,-4715,,
1992029333,9873386913,1898097625,9873382187,-4726,,
1992280331,9873637909,1898348622,9873633183,-4726,,
1992530764,9873888343,1898599055,9873883616,-4727,,
1992780991,9874138569,1898849281,9874133843,-4726,,
1993031695,9874389273,1899099996,9874384558,-4715,,
1993049876,9874407455,1899118167,9874402728,-4727,9874402790,
1993300474,9874658054,1899368767,9874653343,-4711,,
1993550693,9874908272,1899618984,9874903577,-4695,,
1993801195,9875158774,1899869486,9875154094,-4680,,
1994051416,9875408994,1900119707,9875404331,-4663,,
1994302017,9875659596,1900370308,9875654932,-4664,,
1994552235,9875909814,1900620527,9875905151,-4663,,
1994802382,9876159960,1900870673,9876155297,-4663,,
1995052595,9876410174,1901120887,9876405511,-4663,,
1995070888,9876428467,1901139179,9876423803,-4664,9876423826,
1995321797,9876679377,1901390089,9876674720,-4657,,
1995572688,9876930266,1901640979,9876925615,-4651,,
1995823013,9877180592,1901891304,9877175947,-4645,,
1996073524,9877431103,1902141815,9877426473,-4630,,
1996324174,9877681753,1902392465,9877677114,-4639,,
1996574771,9877932350,1902643062,9877927711,-4639,,
1996825231,9878182809,1902893522,9878178170,-4639,,
1997075386,9878432965,1903143687,9878428336,-4629,,
1997093534,9878451113,1903161825,9878446473,-4640,9878446454,
1997344114,9878701694,1903412406,9878697050,-4644,,
1997594655,9878952234,1903662946,9878947585,-4649,,
1997844754,9879202333,1903913045,9879197679,-4654,,
1998095288,9879452867,1904163580,9879448210,-4657,,
1998345484,9879703063,1904413775,9879698406,-4657,,
1998595845,9879953424,1904664137,9879948767,-4657,,
1998846132,9880203710,1904914423,9880199053,-4657,,
1999096698,9880454277,1905164989,9880449620,-4657,,
1999114771,9880472350,1905183062,9880467692,-4658,9880467696,
1999365083,9880722663,1905433376,9880718007,-4656,,
1999615561,9880973140,1905683852,9880968485,-4655,,
1999865733,9881223311,1905934024,9881218669,-4642,,
2000116328,9881473906,1906184619,9881469254,-4652,,
2000366783,9881724362,1906435085,9881719720,-4642,,
2000617320,9881974898,1906685611,9881970246,-4652,,
2000867803,9882225381,1906936094,9882220729,-4652,,
2001118052,9882475631,1907186353,9882470989,-4642,,
2001136251,9882493829,1907204541,9882489177,-4652,9882489180,
2001386702,9882744291,1907455003,9882739639,-4652,,
2001637337,9882994915,1907705628,9882990265,-4650,,
2001887663,9883245241,1907955954,9883240592,-4649,,
2002138079,9883495657,1908206370,9883491009,-4648,,
2002388785,9883746364,1908457077,9883741716,-4648,,
2002639535,9883997114,1908707826,9883992466,-4648,,
2002890177,9884247756,1908958469,9884243108,-4648,,
2003140803,9884498381,1909209094,9884493733,-4648,,
2003158945,9884516523,1909227235,9884511875,-4648,9884511887,
2003409133,9884766712,1909477434,9884762078,-4634,,
2003659250,9885016829,1909727542,9885012188,-4641,,
2003909965,9885267543,1909978256,9885262906,-4637,,
2004160477,9885518056,1910228779,9885513432,-4624,,
2004411092,9885768671,1910479384,9885764037,-4634,,
2004661200,9886018779,1910729491,9886014144,-4635,,
2004911662,9886269241,1910979953,9886264606,-4635,,
2005162079,9886519657,1911230370,9886515024,-4633,,
2005180138,9886537716,1911248429,9886533082,-4634,9886533087,
2005430584,9886788173,1911498885,9886783538,-4635,,
2005681334,9887038912,1911749625,9887034280,-4632,,
2005931729,9887289308,1912000020,9887284677,-4631,,
2006182317,9887539895,1912250607,9887535277,-4618,,
2006432580,9887790159,1912500871,9887785530,-4629,,
2006682789,9888040368,1912751080,9888035740,-4628,,
2006933275,9888290854,1913001566,9888286226,-4628,,
2007184093,9888541682,1913252394,9888537054,-4628,,
2007202106,9888559685,1913270397,9888555056,-4629,9888555047,
2007452458,9888810036,1913520749,9888805406,-4630,,
2007702721,9889060310,1913771022,9889055678,-4632,,
2007953484,9889311063,1914021775,9889306428,-4635,,
2008203978,9889561567,1914272280,9889556931,-4636,,
2008454504,9889812082,1914522795,9889807446,-4636,,
2008704760,9890062339,1914773051,9890057703,-4636,,
2008955167,9890312745,1915023457,9890308109,-4636,,
2009205681,9890563270,1915273983,9890558634,-4636,,
2009223682,9890581260,1915291973,9890576624,-4636,9890576578,
2009474451,9890832029,1915542741,9890827382,-4647,,
2009724704,9891082283,1915792995,9891077624,-4659,,
2009974894,9891332473,1916043186,9891327804,-4669,,
2010225114,9891582692,1916293405,9891578012,-4680,,
2010475369,9891832948,1916543660,9891828268,-4680,,
2010725832,9892083411,1916794123,9892078731,-4680,,
2010976353,9892333932,1917044644,9892329252,-4680,,
2011226964,9892584554,1917295266,9892579874,-4680,,
2011245037,9892602615,1917313328,9892597935,-4680,9892597914,
2011495235,9892852814,1917563526,9892848128,-4686,,
2011745580,9893103159,1917813882,9893098479,-4680,,
2011995869,9893353448,1918064161,9893348753,-4695,,
2012246649,9893604227,1918314950,9893599538,-4689,,
2012496990,9893854568,1918565281,9893849868,-4700,,
2012747132,9894104720,1918815433,9894100020,-4700,,
2012997304,9894354883,1919065595,9894350182,-4701,,
2013247853,9894605432,1919316145,9894600733,-4699,,
2013266016,9894623594,1919334306,9894618894,-4700,9894618894,
2013516509,9894874088,1919584800,9894869388,-4700,,
2013766922,9895124501,1919835214,9895119812,-4689,,
2014017496,9895375075,1920085787,9895370376,-4699,,
2014268008,9895625586,1920336309,9895620899,-4687,,
2014518627,9895876206,1920586918,9895871507,-4699,,
2014769032,9896126611,1920837324,9896121914,-4697,,
2015019415,9896376994,1921087706,9896372296,-4698,,
2015270133,9896627712,1921338425,9896623014,-4698,,
2015288235,9896645814,1921356526,9896641115,-4699,9896641060,
2015538641,9896896219,1921606932,9896891507,-4712,,
2015789307,9897146886,1921857598,9897142172,-4714,,
2016039835,9897397414,1922108126,9897392675,-4739,,
2016290076,9897647655,1922358367,9897642902,-4753,,
2016540652,9897898230,1922608943,9897893478,-4752,,
2016790864,9898148443,1922859155,9898143691,-4752,,
2017041226,9898398805,1923109518,9898394053,-4752,,
2017291833,9898649412,1923360125,9898644660,-4752,,
2017309981,9898667559,1923378271,9898662806,-4753,9898662846,
2017560537,9898918115,1923628828,9898913372,-4743,,
2017810958,9899168537,1923879249,9899163805,-4732,,
2018061365,9899418944,1924129656,9899414222,-4722,,
2018311605,9899669183,1924379896,9899664472,-4711,,
2018561798,9899919377,1924630100,9899914676,-4701,,
2018812000,9900169578,1924880291,9900164867,-4711,,
2019062269,9900419848,1925130560,9900415136,-4712,,
2019312622,9900670202,1925380914,9900665491,-4711,,
2019330793,9900688371,1925399083,9900683660,-4711,9900683546,
2019580898,9900938476,1925649189,9900933748,-4728,,
2019831718,9901189297,1925900009,9901184530,-4767,,
2020082311,9901439890,1926150613,9901435105,-4785,,
2020332685,9901690264,1926400987,9901685451,-4813,,
2020582995,9901940574,1926651286,9901935750,-4824,,
2020833140,9902190719,1926901431,9902185895,-4824,,
2021083246,9902440825,1927151537,9902436002,-4823,,
2021334162,9902691742,1927402455,9902686919,-4823,,
2021352239,9902709817,1927420530,9902704994,-4823,9902705127,
2021602603,9902960181,1927670894,9902955392,-4789,,
2021852827,9903210405,1927921118,9903205649,-4756,,
2022103065,9903460644,1928171356,9903455932,-4712,,
2022353227,9903710805,1928421518,9903706128,-4677,,
2022603958,9903961537,1928672249,9903956848,-4689,,
2022854744,9904212322,1928923035,9904207634,-4688,,
2023105125,9904462704,1929173427,9904458027,-4677,,
2023355762,9904713340,1929424052,9904708652,-4688,,
2023373908,9904731487,1929442199,9904726798,-4689,9904726791,
2023624114,9904981692,1929692405,9904977002,-4690,,
2023874635,9905232213,1929942926,9905227521,-4692,,
2024125114,9905482693,1930193416,9905478011,-4682,,
2024375673,9905733253,1930443966,9905728559,-4694,,
2024626132,9905983711,1930694424,9905979017,-4694,,
2024876284,9906233863,1930944575,9906229169,-4694,,
2025126410,9906483999,1931194711,9906479305,-4694,,
2025377287,9906734865,1931445578,9906730171,-4694,,
2025395330,9906752908,1931463621,9906748214,-4694,9906748252,
2025645600,9907003179,1931713891,9906998495,-4684,,
2025895916,9907253494,1931964207,9907248820,-4674,,
2026146422,9907504000,1932214713,9907499346,-4654,,
2026396607,9907754186,1932464898,9907749531,-4655,,
2026647037,9908004616,1932715328,9907999972,-4644,,
2026897160,9908254739,1932965451,9908250097,-4642,,
2027147280,9908504859,1933215571,9908500215,-4644,,
2027397406,9908754985,1933465697,9908750331,-4654,,
2027415630,9908773209,1933483921,9908768554,-4655,9908768454,
2027666233,9909023811,1933734523,9909019131,-4680,,
2027916495,9909274074,1933984787,9909269369,-4705,,
2028166840,9909524419,1934235141,9909519699,-4720,,
2028417246,9909774824,1934485547,9909770081,-4743,,
2028667482,9910025061,1934735773,9910020307,-4754,,
2028918083,9910275662,1934986375,9910270909,-4753,,
2029168528,9910526106,1935236830,9910521364,-4742,,
2029418743,9910776322,1935487034,9910771568,-4754,,
2029436874,9910794452,1935505165,9910789709,-4743,9910789752,
2029687328,9911044907,1935755619,9911040166,-4741,,
2029937615,9911295193,1936005906,9911290466,-4727,,
2030188180,9911545759,1936256471,9911541046,-4713,,
2030438659,9911796239,1936506951,9911791540,-4699,,
2030689029,9912046608,1936757331,9912041919,-4689,,
2030939719,9912297297,1937008010,9912292598,-4699,,
2031190232,9912547811,1937258523,9912543112,-4699,,
2031440735,9912798314,1937509027,9912793615,-4699,,
2031459047,9912816626,1937527338,9912811927,-4699,9912812098,
2031709846,9913067425,1937778137,9913062780,-4645,,
2031959999,9913317578,1938028290,9913312965,-4613,,
2032210254,9913567833,1938278545,9913563263,-4570,,
2032460780,9913818370,1938529082,9913813844,-4526,,
2032711354,9914068933,1938779645,9914064406,-4527,,
2032961495,9914319074,1939029787,9914314548,-4526,,
2033212152,9914569730,1939280443,9914565204,-4526,,
2033462516,9914820105,1939530818,9914815579,-4526,,
2033480626,9914838204,1939548917,9914833678,-4526,9914833448,
2033730722,9915088301,1939799014,9915083717,-4584,,
2033981270,9915338849,1940049561,9915334208,-4641,,
2034231741,9915589319,1940300032,9915584621,-4698,,
2034482212,9915839791,1940550503,9915835035,-4756,,
2034732759,9916090338,1940801050,9916085583,-4755,,
2034983289,9916340868,1941051580,9916336123,-4745,,
2035233565,9916591143,1941301856,9916586388,-4755,,
2035483775,9916841353,1941552066,9916836598,-4755,,
2035501862,9916859441,1941570153,9916854685,-4756,9916854707,
2035751978,9917109556,1941820269,9917104806,-4750,,
2036002081,9917359660,1942070372,9917354915,-4745,,
2036252378,9917609956,1942320669,9917605218,-4738,,
2036502553,9917860132,1942570844,9917855400,-4732,,
2036752926,9918110505,1942821218,9918105773,-4732,,
2037003448,9918361027,1943071739,9918356295,-4732,,
2037253661,9918611240,1943321952,9918606508,-4732,,
2037503855,9918861433,1943572146,9918856701,-4732,,
2037522139,9918879717,1943590429,9918874984,-4733,9918875010,
2037772953,9919130531,1943841244,9919125806,-4725,,
2038023134,9919380712,1944091436,9919376004,-4708,,
2038273575,9919631154,1944341867,9919626442,-4712,,
2038523925,9919881504,1944592216,9919876799,-4705,,
2038774414,9920131993,1944842705,9920127287,-4706,,
2039024773,9920382352,1945093064,9920377646,-4706,,
2039275397,9920632976,1945343689,9920628271,-4705,,
2039525547,9920883126,1945593838,9920878421,-4705,,
2039543707,9920901285,1945611998,9920896580,-4705,9920896540,
2039794273,9921151851,1945862564,9921147136,-4715,,
2040044752,9921402331,1946113043,9921397606,-4725,,
2040295043,9921652621,1946363333,9921647887,-4734,,
2040545315,9921902894,1946613606,9921898151,-4743,,
2040795539,9922153117,1946863830,9922148374,-4743,,
2041046008,9922403587,1947114299,9922398843,-4744,,
2041296591,9922654170,1947364883,9922649428,-4742,,
2041547085,9922904664,1947615377,9922899922,-4742,,
2041565188,9922922766,1947633479,9922918023,-4743,9922918013,
2041815390,9923172969,1947883691,9923168233,-4736,,
2042065562,9923423140,1948133853,9923418393,-4747,,
2042316584,9923674162,1948384875,9923669413,-4749,,
2042567570,9923925159,1948635872,9923920408,-4751,,
2042817931,9924175510,1948886222,9924170759,-4751,,
2043068230,9924425809,1949136521,9924421058,-4751,,
2043318736,9924676316,1949387028,9924671565,-4751,,
2043569147,9924926726,1949637439,9924921975,-4751,,
2043587320,9924944899,1949655611,9924940147,-4752,9924940071,
2043838187,9925195766,1949906479,9925190996,-4770,,
2044089063,9925446642,1950157354,9925441853,-4789,,
2044339230,9925696808,1950407521,9925692010,-4798,,
2044589861,9925947450,1950658163,9925942625,-4825,,
2044840422,9926198000,1950908713,9926193174,-4826,,
2045091078,9926448656,1951159369,9926443830,-4826,,
2045341577,9926699156,1951409869,9926694330,-4826,,
2045591769,9926949348,1951660060,9926944522,-4826,,
2045609855,9926967433,1951678145,9926962607,-4826,9926962642,
2045860109,9927217688,1951928400,9927212870,-4818,,
2046110274,9927467853,1952178565,9927463046,-4807,,
2046361047,9927718635,1952429348,9927713837,-4798,,
2046611314,9927968892,1952679604,9927964103,-4789,,
2046861486,9928219065,1952929778,9928214286,-4779,,
2047111649,9928469227,1953179950,9928464448,-4779,,
2047362041,9928719620,1953430333,9928714831,-4789,,
2047612160,9928969749,1953680461,9928964960,-4789,,
2047630265,9928987843,1953698555,9928983054,-4789,9928982995,
2047880941,9929238520,1953949242,9929233727,-4793,,
2048131527,9929489105,1954199818,9929484288,-4817,,
2048381684,9929739263,1954449975,9929734431,-4832,,
2048632120,9929989709,1954700422,9929984863,-4846,,
2048882306,9930239885,1954950597,9930235050,-4835,,
2049133147,9930490725,1955201438,9930485879,-4846,,
2049383773,9930741353,1955452066,9930736508,-4845,,
2049633959,9930991538,1955702260,9930986701,-4837,,
2049652101,9931009680,1955720392,9931004833,-4847,9931004889,
2049902893,9931260471,1955971184,9931255639,-4832,,
2050153141,9931510719,1956221432,9931505902,-4817,,
2050403250,9931760839,1956471551,9931756035,-4804,,
2050653621,9932011199,1956721912,9932006410,-4789,,
2050903906,9932261495,1956972208,9932256707,-4788,,
2051154475,9932512053,1957222766,9932507264,-4789,,
2051405110,9932762690,1957473402,9932757901,-4789,,
2051655685,9933013264,1957723976,9933008475,-4789,,
2051673844,9933031423,1957742135,9933026633,-4790,9933026666,
2051924178,9933281757,1957992479,9933276987,-4770,,
2052174319,9933531897,1958242610,9933527125,-4772,,
2052424653,9933782232,1958492945,9933777470,-4762,,
2052675240,9934032819,1958743532,9934028064,-4755,,
2052925542,9934283131,1958993843,9934278376,-4755,,
2053175707,9934533286,1959243998,9934528531,-4755,,
2053426256,9934783845,1959494557,9934779090,-4755,,
2053676572,9935034150,1959744863,9935029395,-4755,,
2053694715,9935052294,1959763006,9935047538,-4756,9935047463,
2053945475,9935303055,1960013767,9935298280,-4775,,
2054196032,9935553611,1960264323,9935548819,-4792,,
2054446403,9935803982,1960514695,9935799171,-4811,,
2054697262,9936054841,1960765563,9936050022,-4819,,
2054947529,9936305118,1961015831,9936300289,-4829,,
2055198005,9936555583,1961266296,9936550754,-4829,,
2055448548,9936806127,1961516839,9936801297,-4830,,
2055698817,9937056396,1961767108,9937051566,-4830,,
2055716922,9937074500,1961785213,9937069671,-4829,9937069703,
2055967030,9937324609,1962035322,9937319787,-4822,,
2056217198,9937574777,1962285500,9937569974,-4803,,
2056467561,9937825140,1962535853,9937820335,-4805,,
2056717725,9938075304,1962786017,9938070508,-4796,,
2056968564,9938326143,1963036855,9938321347,-4796,,
2057219172,9938576750,1963287463,9938571964,-4786,,
2057469600,9938827179,1963537902,9938822394,-4785,,
2057719783,9939077362,1963788074,9939072565,-4797,,
2057737765,9939095343,1963806055,9939090547,-4796,9939090517,
2057988349,9939345927,1964056640,9939341124,-4803,,
2058238771,9939596350,1964307062,9939591539,-4811,,
2058488989,9939846567,1964557280,9939841750,-4817,,
2058739289,9940096867,1964807580,9940092043,-4824,,
2058989612,9940347191,1965057903,9940342366,-4825,,
2059239807,9940597386,1965308098,9940592561,-4825,,
2059489934,9940847522,1965558234,9940842698,-4824,,
2059740341,9941097920,1965808632,9941093096,-4824,,
2059758381,9941115959,1965826671,9941111135,-4824,9941111167,
2060008564,9941366142,1966076855,9941361327,-4815,,
2060258803,9941616382,1966327095,9941611575,-4807,,
2060509247,9941866826,1966577539,9941862028,-4798,,
2060759816,9942117394,1966828117,9942112615,-4779,,
2061010405,9942367983,1967078696,9942363193,-4790,,
2061260620,9942618198,1967328911,9942613408,-4790,,
2061510948,9942868527,1967579239,9942863737,-4790,,
2061761120,9943118699,1967829411,9943113909,-4790,,
2061779243,9943136821,1967847533,9943132031,-4790,9943132072,
2062029746,9943387324,1968098037,9943382545,-4779,,
2062280134,9943637713,1968348426,9943632945,-4768,,
2062530342,9943887921,1968598634,9943883165,-4756,,
2062781252,9944138832,1968849544,9944134085,-4747,,
2063031443,9944389032,1969099744,9944384285,-4747,,
2063281659,9944639237,1969349960,9944634501,-4736,,
2063532594,9944890183,1969600895,9944885436,-4747,,
2063783177,9945140756,1969851479,9945136019,-4737,,
2063801286,9945158865,1969869577,9945154118,-4747,9945154021,
2064051690,9945409268,1970119981,9945404498,-4770,,
2064301992,9945659570,1970370293,9945654786,-4784,,
2064552504,9945910083,1970620795,9945905264,-4819,,
2064802961,9946160540,1970871252,9946155697,-4843,,
2065053383,9946410961,1971121673,9946406119,-4842,,
2065303856,9946661436,1971372149,9946656594,-4842,,
2065554103,9946911682,1971622395,9946906841,-4841,,
2065805060,9947162639,1971873362,9947157807,-4832,,
2065823139,9947180717,1971891430,9947175875,-4842,9947175939,
2066073270,9947430848,1972141561,9947426021,-4827,,
2066323505,9947681084,1972391797,9947676284,-4800,,
2066573842,9947931421,1972642134,9947926627,-4794,,
2066824551,9948182129,1972892853,9948177363,-4766,,
2067074821,9948432400,1973143112,9948427623,-4777,,
2067324960,9948682540,1973393252,9948677762,-4778,,
2067575723,9948933302,1973644015,9948928525,-4777,,
2067826244,9949183822,1973894545,9949179055,-4767,,
2067844524,9949202103,1973912815,9949197325,-4778,9949197277,
2068095009,9949452588,1974163300,9949447798,-4790,,
2068345668,9949703246,1974413959,9949698455,-4791,,
2068596492,9949954081,1974664794,9949949268,-4813,,
2068847112,9950204691,1974915403,9950199867,-4824,,
2069097601,9950455179,1975165892,9950450355,-4824,,
2069347954,9950705533,1975416246,9950700710,-4823,,
2069598187,9950955766,1975666479,9950950942,-4824,,
2069848429,9951206007,1975916720,9951201193,-4814,,
2069866510,9951224088,1975934801,9951219264,-4824,9951219219,
2070116622,9951474201,1976184913,9951469366,-4835,,
2070367580,9951725158,1976435871,9951720312,-4846,,
2070618129,9951975719,1976686432,9951970862,-4857,,
2070868640,9952226218,1976936931,9952221351,-4867,,
2071119195,9952476774,1977187487,9952471907,-4867,,
2071369586,9952727165,1977437878,9952722299,-4866,,
2071620183,9952977773,1977688485,9952972906,-4867,,
2071870426,9953228006,1977938718,9953223139,-4867,,
2071888682,9953246260,1977956973,9953241393,-4867,9953241464,
2072139633,9953497212,1978207924,9953492361,-4851,,
2072390501,9953748080,1978458792,9953743248,-4832,,
2072641155,9953998743,1978709456,9953993930,-4813,,
2072891651,9954249230,1978959943,9954244435,-4795,,
2073141942,9954499521,1979210234,9954494726,-4795,,
2073392106,9954749685,1979460398,9954744891,-4794,,
2073642505,9955000085,1979710797,9954995290,-4795,,
2073892871,9955250449,1979961162,9955245654,-4795,,
2073911150,9955268728,1979979441,9955263933,-4795,9955263868,
2074161350,9955518929,1980229641,9955514119,-4810,,
2074411645,9955769223,1980479936,9955764397,-4826,,
2074661758,9956019337,1980730049,9956014495,-4842,,
2074912499,9956270078,1980980790,9956265230,-4848,,
2075162699,9956520278,1981230991,9956515420,-4858,,
2075413378,9956770957,1981481670,9956766099,-4858,,
2075663553,9957021133,1981731846,9957016275,-4858,,
2075913928,9957271507,1981982220,9957266660,-4847,,
2075932064,9957289642,1982000355,9957284784,-4858,9957284784,
2076182670,9957540248,1982250961,9957535391,-4857,,
2076432788,9957790367,1982501079,9957785510,-4857,,
2076683748,9958041327,1982752040,9958036471,-4856,,
2076934201,9958291779,1983002492,9958286923,-4856,,
2077184353,9958541931,1983252644,9958537075,-4856,,
2077435258,9958792837,1983503550,9958787981,-4856,,
2077685792,9959043371,1983754083,9959038515,-4856,,
2077936315,9959293894,1984004606,9959289038,-4856,,
2077954396,9959311975,1984022687,9959307119,-4856,9959307113,
2078205183,9959562761,1984273474,9959557904,-4857,,
2078455702,9959813291,1984524003,9959808433,-4858,,
2078706301,9960063880,1984774592,9960059021,-4859,,
2078956476,9960314055,1985024777,9960309205,-4850,,
2079206990,9960564569,1985275281,9960559708,-4861,,
2079457529,9960815108,1985525820,9960810247,-4861,,
2079708109,9961065689,1985776401,9961060829,-4860,,
2079958483,9961316061,1986026774,9961311201,-4860,,
2079976538,9961334116,1986044829,9961329256,-4860,9961329248,
2080226894,9961584473,1986295185,9961579610,-4863,,
2080477738,9961835327,1986546040,9961830463,-4864,,
2080727957,9962085536,1986796249,9962080671,-4865,,
2080978833,9962336412,1987047124,9962331544,-4868,,
2081229356,9962586934,1987297647,9962582067,-4867,,
2081480132,9962837711,1987548434,9962832854,-4857,,
2081730240,9963087819,1987798532,9963082952,-4867,,
2081980496,9963338085,1988048797,9963333217,-4868,,
2081998617,9963356196,1988066908,9963351328,-4868,9963351364,
2082249060,9963606639,1988317351,9963601779,-4860,,
2082499670,9963857248,1988567961,9963852399,-4849,,
2082750057,9964107646,1988818358,9964102806,-4840,,
2083000289,9964357868,1989068580,9964353037,-4831,,
2083250894,9964608472,1989319185,9964603642,-4830,,
2083501436,9964859014,1989569727,9964854184,-4830,,
2083751891,9965109470,1989820183,9965104640,-4830,,
2084002894,9965360472,1990071185,9965355642,-4830,,
2084021281,9965378860,1990089572,9965374029,-4831,9965374043,
2084271676,9965629255,1990339967,9965624428,-4827,,
2084521991,9965879570,1990590283,9965874747,-4823,,
2084772795,9966130374,1990841087,9966125555,-4819,,
2085023318,9966380897,1991091609,9966376082,-4815,,
2085273794,9966631373,1991342085,9966626557,-4816,,
2085524475,9966882054,1991592766,9966877239,-4815,,
2085774905,9967132494,1991843207,9967127680,-4814,,
2086025210,9967382789,1992093512,9967377984,-4805,,
2086043291,9967400870,1992111582,9967396055,-4815,9967395929,
2086293562,9967651141,1992361853,9967646294,-4847,,
2086543992,9967901570,1992612283,9967896693,-4877,,
2086794556,9968152135,1992862847,9968147227,-4908,,
2087045076,9968402655,1993113367,9968397726,-4929,,
2087295670,9968653249,1993363961,9968648309,-4940,,
2087546190,9968903769,1993614481,9968898830,-4939,,
2087796916,9969154494,1993865207,9969149555,-4939,,
2088047414,9969404993,1994115705,9969400064,-4929,,
2088065545,9969423123,1994133835,9969418183,-4940,9969418192,
2088316190,9969673779,1994384491,9969668843,-4936,,
2088566668,9969924256,1994634969,9969919323,-4933,,
2088817229,9970174818,1994885530,9970169887,-4931,,
2089067440,9970425018,1995135741,9970420099,-4919,,
2089317568,9970675147,1995385859,9970670218,-4929,,
2089567935,9970925514,1995636226,9970920584,-4930,,
2089818301,9971175880,1995886593,9971170951,-4929,,
2090068538,9971426117,1996136841,9971421199,-4918,,
2090086713,9971444291,1996155004,9971439362,-4929,9971439527,
2090336914,9971694493,1996405206,9971689605,-4888,,
2090587308,9971944898,1996655610,9971940051,-4847,,
2090837602,9972195192,1996905904,9972190387,-4805,,
2091087885,9972445474,1997156187,9972440711,-4763,,
2091338294,9972695873,1997406585,9972691110,-4763,,
2091588480,9972946059,1997656781,9972941306,-4753,,
2091839312,9973196890,1997907603,9973192137,-4753,,
2092089887,9973447476,1998158189,9973442713,-4763,,
2092107903,9973465481,1998176194,9973460718,-4763,9973460609,
2092358368,9973715947,1998426659,9973711156,-4791,,
2092608975,9973966554,1998677266,9973961738,-4816,,
2092859139,9974216718,1998927430,9974211874,-4844,,
2093109416,9974466994,1999177707,9974462135,-4859,,
2093359830,9974717410,1999428122,9974712540,-4870,,
2093609956,9974967545,1999678258,9974962675,-4870,,
2093860345,9975217935,1999928647,9975213065,-4870,,
2094110538,9975468117,2000178840,9975463257,-4860,,
2094128588,9975486166,2000196879,9975481296,-4870,9975481238,
2094379051,9975736629,2000447341,9975731745,-4884,,
2094629845,9975987425,2000698138,9975982527,-4898,,
2094880356,9976237934,2000948647,9976233022,-4912,,
2095130712,9976488291,2001199003,9976483375,-4916,,
2095380927,9976738507,2001449219,9976733581,-4926,,
2095631051,9976988630,2001699342,9976983704,-4926,,
2095881439,9977239018,2001949731,9977234092,-4926,,
2096131652,9977489241,2002199953,9977484315,-4926,,
2096149628,9977507206,2002217919,9977502280,-4926,9977502255,
2096400460,9977758039,2002468751,9977753106,-4933,,
2096651282,9978008861,2002719573,9978003921,-4940,,
2096901528,9978259107,2002969819,9978254163,-4944,,
2097152325,9978509904,2003220627,9978504964,-4940,,
2097402897,9978760476,2003471189,9978755526,-4950,,
2097653274,9979010853,2003721565,9979005903,-4950,,
2097903441,9979261020,2003971732,9979256070,-4950,,
2098153924,9979511503,2004222215,9979506553,-4950,,
2098172062,9979529640,2004240352,9979524689,-4951,9979524700,
2098422375,9979779954,2004490666,9979775006,-4948,,
2098672525,9980030104,2004740817,9980025160,-4944,,
2098922778,9980280357,2004991069,9980275426,-4931,,
2099173086,9980530665,2005241378,9980525737,-4928,,
2099424128,9980781708,2005492421,9980776770,-4938,,
2099674488,9981032067,2005742779,9981027129,-4938,,
2099924579,9981282158,2005992880,9981277230,-4928,,
2100175061,9981532639,2006243361,9981527711,-4928,,
2100193187,9981550765,2006261477,9981545826,-4939,9981545885,
2100443303,9981800881,2006511594,9981795958,-4923,,
2100693803,9982051381,2006762094,9982046474,-4907,,
2100944410,9982301999,2007012711,9982297106,-4893,,
2101195019,9982552597,2007263310,9982547719,-4878,,
2101445781,9982803361,2007514073,9982798483,-4878,,
2101695981,9983053560,2007764272,9983048681,-4879,,
2101946257,9983303846,2008014558,9983298968,-4878,,
2102196494,9983554083,2008264795,9983549205,-4878,,
2102214544,9983572122,2008282835,9983567244,-4878,9983567150,
2102465333,9983822911,2008533624,9983818009,-4902,,
2102715662,9984073240,2008783953,9984068315,-4925,,
2102965946,9984323525,2009034237,9984318576,-4949,,
2103216402,9984573981,2009284693,9984569022,-4959,,
2103467083,9984824661,2009535374,9984819691,-4970,,
2103717577,9985075156,2009785869,9985070185,-4971,,
2103968231,9985325810,2010036522,9985320838,-4972,,
2104218772,9985576351,2010287063,9985571379,-4972,,
2104236770,9985594348,2010305061,9985589377,-4971,9985589456,
2104486905,9985844484,2010555196,9985839533,-4951,,
2104737442,9986095021,2010805733,9986090090,-4931,,
2104987645,9986345224,2011055946,9986340323,-4901,,
2105237938,9986595517,2011306229,9986590627,-4890,,
2105488555,9986846133,2011556845,9986841243,-4890,,
2105739078,9987096657,2011807369,9987091767,-4890,,
2105989607,9987347186,2012057898,9987342296,-4890,,
2106239789,9987597368,2012308080,9987592478,-4890,,
2106257811,9987615390,2012326102,9987610499,-4891,9987610472,
2106508381,9987865959,2012576672,9987861062,-4897,,
2106758795,9988116374,2012827086,9988111470,-4904,,
2107009438,9988367017,2013077729,9988362107,-4910,,
2107259814,9988617393,2013328105,9988612477,-4916,,
2107510732,9988868310,2013579022,9988863404,-4906,,
2107761332,9989118911,2013829623,9989113994,-4917,,
2108011962,9989369541,2014080253,9989364624,-4917,,
2108262354,9989619932,2014330645,9989615016,-4916,,
2108280473,9989638051,2014348763,9989633135,-4916,9989633133,
2108530847,9989888426,2014599138,9989883509,-4917,,
2108781176,9990138755,2014849467,9990133837,-4918,,
2109031713,9990389292,2015100004,9990384374,-4918,,
2109282365,9990639943,2015350656,9990635026,-4917,,
2109532832,9990890411,2015601134,9990885505,-4906,,
2109783011,9991140589,2015851302,9991135672,-4917,,
2110033365,9991390944,2016101656,9991386026,-4918,,
2110283807,9991641386,2016352098,9991636469,-4917,,
2110301830,9991659409,2016370121,9991654492,-4917,9991654480,
2110552460,9991910038,2016620762,9991905130,-4908,,
2110802817,9992160396,2016871108,9992155474,-4922,,
2111053402,9992410981,2017121694,9992406057,-4924,,
2111303571,9992661149,2017371862,9992656222,-4927,,
2111554039,9992911617,2017622330,9992906690,-4927,,
2111804271,9993161849,2017872562,9993156922,-4927,,
2112054608,9993412187,2018122899,9993407259,-4928,,
2112304765,9993662344,2018373057,9993657417,-4927,,
2112322796,9993680374,2018391086,9993675447,-4927,9993675461,
2112573433,9993931012,2018641724,9993926087,-4925,,
2112824065,9994181654,2018892367,9994176734,-4920,,
2113074674,9994432253,2019142965,9994427337,-4916,,
2113325381,9994682959,2019393672,9994678047,-4912,,
2113575947,9994933526,2019644238,9994928614,-4912,,
2113826849,9995184428,2019895140,9995179516,-4912,,
2114077245,9995434824,2020145536,9995429922,-4902,,
2114327420,9995684998,2020395711,9995680086,-4912,,
2114345607,9995703186,2020413898,9995698274,-4912,9995698327,
2114596099,9995953678,2020664390,9995948790,-4888,,
2114846637,9996204215,2020914928,9996199330,-4885,,
2115096905,9996454484,2021165196,9996449613,-4871,,
2115347079,9996704668,2021415381,9996699811,-4857,,
2115597409,9996954988,2021665710,9996950140,-4848,,
2115847599,9997205178,2021915891,9997200332,-4846,,
2116098291,9997455870,2022166582,9997451013,-4857,,
2116348445,9997706024,2022416737,9997701167,-4857,,
2116366478,9997724056,2022434769,9997719199,-4857,9997719092,
2116616736,9997974315,2022685027,9997969431,-4884,,
2116867093,9998224672,2022935384,9998219771,-4901,,
2117117688,9998475266,2023185979,9998470329,-4937,,
2117368084,9998725663,2023436376,9998720700,-4963,,
2117618217,9998975796,2023686509,9998970833,-4963,,
2117868399,9999225978,2023936691,9999221015,-4963,,
2118118670,9999476249,2024186961,9999471286,-4963,,
2118369071,9999726649,2024437362,9999721686,-4963,,
2118387027,9999744605,2024455317,9999739642,-4963,9999739591,
2118637522,9999995111,2024705823,9999990135,-4976,,
2118887817,10000245395,2024956108,10000240407,-4988,,
2119138520,10000496099,2025206811,10000491098,-5001,,
2119388734,10000746313,2025457026,10000741302,-5011,,
2119638924,10000996512,2025707225,10000991500,-5012,,
2119889102,10001246681,2025957394,10001241669,-5012,,
2120139485,10001497064,2026207776,10001492051,-5013,,
2120389779,10001747358,2026458080,10001742356,-5002,,
2120407881,10001765460,2026476172,10001760448,-5012,10001760463,
2120658574,10002016152,2026726865,10002011144,-5008,,
2120909128,10002266716,2026977429,10002261713,-5003,,
2121159245,10002516823,2027227536,10002511824,-4999,,
2121409693,10002767272,2027477985,10002762277,-4995,,
2121659812,10003017401,2027728113,10003012406,-4995,,
2121910232,10003267811,2027978524,10003262816,-4995,,
2122160345,10003517934,2028228646,10003512939,-4995,,
2122410462,10003768041,2028478753,10003763045,-4996,,
2122428491,10003786069,2028496782,10003781074,-4995,10003781155,
2122678967,10004036545,2028747257,10004031570,-4975,,
2122929530,10004287109,2028997821,10004282155,-4954,,
2123180127,10004537705,2029248418,10004532772,-4933,,
2123430229,10004787808,2029498521,10004782895,-4913,,
2123680471,10005038050,2029748762,10005033137,-4913,,
2123930597,10005288176,2029998888,10005283262,-4914,,
2124181310,10005538889,2030249601,10005533976,-4913,,
2124431466,10005789044,2030499757,10005784131,-4913,,
2124449784,10005807362,2030518074,10005802449,-4913,10005802548,
2124700142,10006057720,2030768433,10006052833,-4887,,
2124950677,10006308255,2031018968,10006303393,-4862,,
2125200845,10006558424,2031269136,10006553587,-4837,,
2125451510,10006809089,2031519802,10006804277,-4812,,
2125702184,10007059763,2031770476,10007054951,-4812,,
2125952956,10007310534,2032021257,10007305732,-4802,,
2126203063,10007560652,2032271364,10007555839,-4813,,
2126453235,10007810813,2032521526,10007806012,-4801,,
2126471264,10007828843,2032539555,10007824031,-4812,10007823902,
2126721500,10008079078,2032789791,10008074233,-4845,,
2126971714,10008329294,2033040006,10008324418,-4876,,
2127222248,10008579827,2033290539,10008574919,-4908,,
2127472794,10008830374,2033541086,10008825435,-4939,,
2127722996,10009080575,2033791287,10009075636,-4939,,
2127973529,10009331108,2034041821,10009326169,-4939,,
2128223844,10009581423,2034292136,10009576484,-4939,,
2128474025,10009831603,2034542326,10009826675,-4928,,
2128492067,10009849645,2034560357,10009844706,-4939,10009844639,
2128742796,10010100374,2034811087,10010095427,-4947,,
2128993561,10010351140,2035061853,10010346167,-4973,,
2129243655,10010601234,2035311946,10010596245,-4989,,
2129494033,10010851621,2035562334,10010846616,-5005,,
2129744405,10011101983,2035812696,10011096978,-5005,,
2129995011,10011352590,2036063303,10011347585,-5005,,
2130245125,10011602704,2036313416,10011597699,-5005,,
2130495456,10011853035,2036563747,10011848029,-5006,,
2130513510,10011871088,2036581801,10011866083,-5005,10011866054,
2130763922,10012121500,2036832213,10012116489,-5011,,
2131014083,10012371661,2037082374,10012366643,-5018,,
2131264397,10012621975,2037332688,10012616950,-5025,,
2131514790,10012872368,2037583092,10012867347,-5021,,
2131765442,10013123020,2037833732,10013117988,-5032,,
2132016103,10013373682,2038084394,10013368650,-5032,,
2132267040,10013624619,2038335331,10013619587,-5032,,
2132517166,10013874744,2038585457,10013869712,-5032,,
2132535172,10013892750,2038603463,10013887718,-5032,10013887706,
2132785457,10014143036,2038853749,10014138001,-5035,,
2133035744,10014393333,2039104046,10014388296,-5037,,
2133285931,10014643510,2039354222,10014638470,-5040,,
2133536420,10014894010,2039604723,10014888969,-5041,,
2133787150,10015144729,2039855441,10015139697,-5032,,
2134037677,10015395255,2040105968,10015390213,-5042,,
2134287872,10015645451,2040356173,10015640419,-5032,,
2134538279,10015895857,2040606569,10015890815,-5042,,
2134556254,10015913833,2040624545,10015908790,-5043,10015908872,
2134806664,10016164243,2040874955,10016159221,-5022,,
2135056872,10016414451,2041125163,10016409450,-5001,,
2135307786,10016665365,2041376077,10016660386,-4979,,
2135558072,10016915650,2041626363,10016910691,-4959,,
2135808187,10017165765,2041876478,10017160806,-4959,,
2136058320,10017415899,2042126611,10017410940,-4959,,
2136308677,10017666267,2042376980,10017661308,-4959,,
2136559245,10017916824,2042627537,10017911865,-4959,,
2136577402,10017934981,2042645693,10017930022,-4959,10017929964,
2136828178,10018185757,2042896469,10018180783,-4974,,
2137078299,10018435878,2043146590,10018430891,-4987,,
2137328437,10018686016,2043396729,10018681016,-5000,,
2137578776,10018936364,2043647076,10018931349,-5015,,
2137829085,10019186664,2043897376,10019181648,-5016,,
2138079335,10019436914,2044147626,10019431899,-5015,,
2138329776,10019687355,2044398068,10019682341,-5014,,
2138580364,10019937942,2044648655,10019932937,-5005,,
2138598474,10019956052,2044666765,10019951037,-5015,10019951006,
2138848660,10020206239,2044916951,10020201215,-5024,,
2139099084,10020456663,2045167375,10020451632,-5031,,
2139349698,10020707276,2045417989,10020702238,-5038,,
2139600209,10020957787,2045668500,10020952742,-5045,,
2139850561,10021208140,2045918853,10021203095,-5045,,
2140100835,10021458414,2046169126,10021453369,-5045,,
2140351081,10021708660,2046419383,10021703626,-5034,,
2140601265,10021958844,2046669556,10021953809,-5035,,
2140619379,10021976957,2046687670,10021971912,-5045,10021971943,
2140869772,10022227351,2046938063,10022222312,-5039,,
2141120252,10022477831,2047188543,10022472801,-5030,,
2141371005,10022728583,2047439296,10022723561,-5022,,
2141621619,10022979198,2047689910,10022974185,-5013,,
2141872366,10023229945,2047940657,10023224931,-5014,,
2142122479,10023480057,2048190781,10023475055,-5002,,
2142372759,10023730338,2048441050,10023725325,-5013,,
2142623224,10023980803,2048691515,10023975790,-5013,,
2142641470,10023999048,2048709760,10023994035,-5013,10023994050,
2142892375,10024249953,2048960666,10024244944,-5009,,
2143142590,10024500168,2049210881,10024495174,-4994,,
2143392899,10024750478,2049461190,10024745477,-5001,,
2143643384,10025000963,2049711675,10024995966,-4997,,
2143893490,10025251069,2049961781,10025246073,-4996,,
2144143726,10025501305,2050212018,10025496309,-4996,,
2144394608,10025752188,2050462900,10025747192,-4996,,
2144644863,10026002452,2050713165,10025997456,-4996,,
2144662987,10026020566,2050731278,10026015569,-4997,10026015544,
2144913210,10026270788,2050981512,10026265796,-4992,,
2145163381,10026520970,2051231682,10026515961,-5009,,
2145413615,10026771194,2051481906,10026766180,-5014,,
2145663946,10027021525,2051732237,10027016505,-5020,,
2145914091,10027271670,2051982382,10027266650,-5020,,
2146164286,10027521865,2052232577,10027516855,-5010,,
2146414617,10027772196,2052482909,10027767176,-5020,,
2146664799,10028022378,2052733090,10028017358,-5020,,
2146682977,10028040555,2052751267,10028035535,-5020,10028035509,
2146933161,10028290740,2053001452,10028285714,-5026,,
2147183362,10028540940,2053251653,10028535908,-5032,,
2147433586,10028791164,2053501877,10028786126,-5038,,
2147683732,10029041311,2053752023,10029036267,-5044,,
2147934006,10029291585,2054002297,10029286540,-5045,,
2148184581,10029542160,2054252872,10029537125,-5035,,
2148435065,10029792645,2054503358,10029787601,-5044,,
2148685442,10030043021,2054753734,10030037978,-5043,,
2148703723,10030061301,2054772013,10030056257,-5044,10030056343,
2148954237,10030311816,2055022528,10030306793,-5023,,
2149205010,10030562589,2055273302,10030557588,-5001,,
2149455369,10030812947,2055523660,10030807968,-4979,,
2149706211,10031063801,2055774514,10031058844,-4957,,
2149956422,10031314001,2056024713,10031309043,-4958,,
2150206723,10031564302,2056275014,10031559345,-4957,,
2150457528,10031815108,2056525820,10031810151,-4957,,
2150707743,10032065321,2056776034,10032060375,-4946,,
2150725754,10032083332,2056794045,10032078375,-4957,10032078285,
2150976327,10032333906,2057044618,10032328936,-4970,,
2151226507,10032584097,2057294809,10032579095,-5002,,
2151476659,10032834237,2057544950,10032829213,-5024,,
2151727247,10033084826,2057795549,10033079790,-5036,,
2151977650,10033335229,2058045941,10033330183,-5046,,
2152228273,10033585851,2058296575,10033580816,-5035,,
2152478462,10033836041,2058546754,10033830996,-5045,,
2152728836,10034086415,2058797127,10034081379,-5036,,
2152747070,10034104649,2058815361,10034099602,-5047,10034099663,
2152997608,10034355187,2059065899,10034350156,-5031,,
2153248022,10034605601,2059316313,10034600586,-5015,,
2153498132,10034855711,2059566423,10034850720,-4991,,
2153748587,10035106166,2059816879,10035101182,-4984,,
2153999234,10035356813,2060067525,10035351828,-4985,,
2154249761,10035607340,2060318053,10035602356,-4984,,
2154499899,10035857478,2060568190,10035852493,-4985,,
2154750479,10036108057,2060818770,10036103074,-4983,,
2154768464,10036126042,2060836754,10036121057,-4985,10036121011,
2155019033,10036376612,2061087324,10036371616,-4996,,
2155269606,10036627196,2061337908,10036622190,-5006,,
2155519810,10036877389,2061588101,10036872372,-5017,,
2155770123,10037127702,2061838414,10037122673,-5029,,
2156020248,10037377826,2062088538,10037372797,-5029,,
2156270795,10037628374,2062339097,10037623355,-5019,,
2156521105,10037878684,2062589397,10037873656,-5028,,
2156771301,10038128880,2062839592,10038123860,-5020,,
2156789373,10038146952,2062857664,10038141922,-5030,10038141873,
2157039678,10038397257,2063107970,10038392216,-5041,,
2157290290,10038647869,2063358591,10038642826,-5043,,
2157540886,10038898464,2063609177,10038893399,-5065,,
2157791344,10039148922,2063859635,10039143845,-5077,,
2158041578,10039399157,2064109869,10039394079,-5078,,
2158291827,10039649406,2064360118,10039644339,-5067,,
2158542453,10039900032,2064610755,10039894965,-5067,,
2158792848,10040150438,2064861151,10040145361,-5077,,
2158810909,10040168487,2064879200,10040163410,-5077,10040163462,
2159061233,10040418812,2065129524,10040413749,-5063,,
2159311666,10040669255,2065379968,10040664206,-5049,,
2159562272,10040919851,2065630563,10040914815,-5036,,
2159812597,10041170175,2065880888,10041165152,-5023,,
2160062701,10041420279,2066130992,10041415256,-5023,,
2160313319,10041670898,2066381610,10041665875,-5023,,
2160563786,10041921365,2066632077,10041916342,-5023,,
2160813971,10042171550,2066882263,10042166527,-5023,,
2160832052,10042189630,2066900343,10042184607,-5023,10042184528,
2161082316,10042439895,2067150607,10042434851,-5044,,
2161332470,10042690049,2067400762,10042684986,-5063,,
2161582696,10042940274,2067650987,10042935192,-5082,,
2161833245,10043190824,2067901536,10043185723,-5101,,
2162083674,10043441253,2068151966,10043436152,-5101,,
2162334120,10043691700,2068402412,10043686599,-5101,,
2162585010,10043942589,2068653301,10043937487,-5102,,
2162835121,10044192700,2068903412,10044187599,-5101,,
2162853113,10044210692,2068921404,10044205591,-5101,10044205576,
2163103679,10044461269,2069171981,10044456164,-5105,,
2163354287,10044711876,2069422589,10044706768,-5108,,
2163604870,10044962449,2069673161,10044957337,-5112,,
2163855311,10045212889,2069923602,10045207775,-5114,,
2164105909,10045463499,2070174211,10045458385,-5114,,
2164356453,10045714033,2070424745,10045708918,-5115,,
2164606784,10045964373,2070675086,10045959260,-5113,,
2164857276,10046214854,2070925567,10046209740,-5114,,
2164875267,10046232845,2070943558,10046227731,-5114,10046227765,
2165125633,10046483222,2071193935,10046478116,-5106,,
2165376094,10046733672,2071444396,10046728586,-5086,,
2165626451,10046984029,2071694742,10046978941,-5088,,
2165877103,10047234682,2071945394,10047229603,-5079,,
2166127483,10047485062,2072195774,10047479983,-5079,,
2166378083,10047735661,2072446373,10047730582,-5079,,
2166628288,10047985867,2072696579,10047980788,-5079,,
2166878505,10048236084,2072946796,10048231004,-5080,,
2166896567,10048254146,2072964858,10048249067,-5079,10048249011,
2167146958,10048504537,2073215249,10048499443,-5094,,
2167397474,10048755053,2073465766,10048749947,-5106,,
2167647596,10049005174,2073715897,10049000064,-5110,,
2167898093,10049255672,2073966384,10049250538,-5134,,
2168148363,10049505942,2074216654,10049500808,-5134,,
2168398947,10049756536,2074467249,10049751403,-5133,,
2168649613,10050007191,2074717904,10050002058,-5133,,
2168899733,10050257311,2074968024,10050252178,-5133,,
2168917711,10050275289,2074986001,10050270156,-5133,10050270213,
2169168399,10050525978,2075236690,10050520859,-5119,,
2169418712,10050776291,2075487004,10050771188,-5103,,
2169668930,10051026509,2075737221,10051021419,-5090,,
2169919474,10051277052,2075987765,10051271978,-5074,,
2170169639,10051527217,2076237930,10051522143,-5074,,
2170419976,10051777555,2076488277,10051772491,-5064,,
2170670156,10052027735,2076738447,10052022661,-5074,,
2170920533,10052278111,2076988824,10052273037,-5074,,
2170939175,10052296754,2077007466,10052291679,-5075,10052291928,
2171189766,10052547345,2077258058,10052542333,-5012,,
2171440075,10052797654,2077508367,10052792705,-4949,,
2171690266,10053047845,2077758568,10053042968,-4877,,
2171940430,10053298008,2078008721,10053293184,-4824,,
2172190984,10053548563,2078259275,10053543738,-4825,,
2172441643,10053799221,2078509934,10053794397,-4824,,
2172692008,10054049587,2078760299,10054044763,-4824,,
2172942196,10054299775,2079010487,10054294951,-4824,,
2172960301,10054317879,2079028592,10054313055,-4824,10054312788,
2173210431,10054568010,2079278722,10054563119,-4891,,
2173461328,10054818907,2079529619,10054813950,-4957,,
2173711562,10055069141,2079779854,10055064117,-5024,,
2173961974,10055319553,2080030265,10055314463,-5090,,
2174212095,10055569674,2080280386,10055564584,-5090,,
2174462368,10055819956,2080530669,10055814867,-5089,,
2174712493,10056070072,2080780784,10056064981,-5091,,
2174962940,10056320519,2081031231,10056315429,-5090,,
2174981059,10056338637,2081049350,10056333547,-5090,10056333586,
2175231343,10056588921,2081299634,10056583840,-5081,,
2175482259,10056839838,2081550551,10056834768,-5070,,
2175732866,10057090445,2081801158,10057085385,-5060,,
2175983698,10057341276,2082051989,10057336226,-5050,,
2176234111,10057591689,2082302402,10057586639,-5050,,
2176484518,10057842107,2082552820,10057837057,-5050,,
2176734735,10058092313,2082803025,10058087263,-5050,,
2176985380,10058342959,2083053671,10058337908,-5051,,
2177003409,10058360987,2083071699,10058355936,-5051,10058355861,
2177254239,10058611818,2083322530,10058606748,-5070,,
2177504823,10058862402,2083573114,10058857315,-5087,,
2177755396,10059112974,2083823687,10059107868,-5106,,
2178005920,10059363499,2084074212,10059358375,-5124,,
2178256391,10059613970,2084324683,10059608846,-5124,,
2178506491,10059864070,2084574783,10059858946,-5124,,
2178757256,10060114834,2084825557,10060109721,-5113,,
2179007487,10060365066,2085075779,10060359942,-5124,,
2179025533,10060383111,2085093824,10060377987,-5124,10060377945,
2179275756,10060633335,2085344047,10060628200,-5135,,
2179526097,10060883677,2085594389,10060878532,-5145,,
2179776221,10061133799,2085844512,10061128644,-5155,,
2180026896,10061384474,2086095187,10061379309,-5165,,
2180277436,10061635015,2086345727,10061629850,-5165,,
2180527956,10061885545,2086596257,10061880380,-5165,,
2180778059,10062135638,2086846360,10062130483,-5155,,
2181028576,10062386155,2087096867,10062380989,-5166,,
2181046680,10062404259,2087114971,10062399093,-5166,10062399143,
2181296946,10062654525,2087365237,10062649372,-5153,,
2181547123,10062904703,2087615415,10062899563,-5140,,
2181797595,10063155174,2087865886,10063150047,-5127,,
2182047863,10063405442,2088116154,10063400327,-5115,,
2182298505,10063656083,2088366796,10063650969,-5114,,
2182549087,10063906665,2088617378,10063901551,-5114,,
2182799611,10064157189,2088867902,10064152075,-5114,,
2183050079,10064407657,2089118370,10064402543,-5114,,
2183068244,10064425823,2089136535,10064420708,-5115,10064420685,
2183318816,10064676395,2089387108,10064671275,-5120,,
2183569582,10064927160,2089637873,10064922045,-5115,,
2183820203,10065177782,2089888495,10065172651,-5131,,
2184070888,10065428467,2090139179,10065423331,-5136,,
2184321133,10065678712,2090389424,10065673576,-5136,,
2184571371,10065928950,2090639662,10065923814,-5136,,
2184821552,10066179141,2090889853,10066174005,-5136,,
2185072075,10066429654,2091140366,10066424517,-5137,,
2185090404,10066447982,2091158694,10066442845,-5137,10066442938,
2185341141,10066698720,2091409432,10066693607,-5113,,
2185591574,10066949153,2091659866,10066944064,-5089,,
2185842181,10067199770,2091910483,10067194705,-5065,,
2186092375,10067449954,2092160666,10067444912,-5042,,
2186342787,10067700366,2092411078,10067695323,-5043,,
2186593342,10067950920,2092661632,10067945888,-5032,,
2186843943,10068201521,2092912234,10068196479,-5042,,
2187094428,10068452006,2093162719,10068446964,-5042,,
2187112789,10068470368,2093181080,10068465326,-5042,10068465194,
2187362898,10068720477,2093431189,10068715400,-5077,,
2187613141,10068970721,2093681433,10068965613,-5108,,
2187863512,10069221091,2093931814,10069215961,-5130,,
2188113926,10069471505,2094182217,10069466332,-5173,,
2188364337,10069721916,2094432628,10069716754,-5162,,
2188614778,10069972357,2094683069,10069967184,-5173,,
2188864878,10070222457,2094933170,10070217285,-5172,,
2189115627,10070473206,2095183919,10070468034,-5172,,
2189133791,10070491369,2095202081,10070486197,-5172,10070486273,
2189384389,10070741968,2095452680,10070736815,-5153,,
2189634716,10070992295,2095703008,10070987162,-5133,,
2189884884,10071242463,2095953185,10071237359,-5104,,
2190135242,10071492820,2096203533,10071487726,-5094,,
2190385772,10071743351,2096454063,10071738257,-5094,,
2190636264,10071993843,2096704555,10071988749,-5094,,
2190886459,10072244048,2096954761,10072238954,-5094,,
2191136780,10072494359,2097205072,10072489265,-5094,,
2191154923,10072512502,2097223214,10072507407,-5095,10072507377,
2191405467,10072763056,2097473768,10072757954,-5102,,
2191655936,10073013514,2097724227,10073008405,-5109,,
2191906934,10073264514,2097975227,10073259399,-5115,,
2192157452,10073515031,2098225754,10073509918,-5113,,
2192408400,10073765979,2098476701,10073760865,-5114,,
2192658518,10074016096,2098726809,10074010983,-5113,,
2192908993,10074266572,2098977295,10074261460,-5112,,
2193159297,10074516876,2099227588,10074511752,-5124,,
2193177372,10074534950,2099245663,10074529827,-5123,10074529730,
2193427838,10074785417,2099496130,10074780269,-5148,,
2193678546,10075036125,2099746838,10075030953,-5172,,
2193928781,10075286360,2099997072,10075281164,-5196,,
2194179493,10075537072,2100247784,10075531853,-5219,,
2194429646,10075787224,2100497937,10075782005,-5219,,
2194679767,10076037346,2100748059,10076032127,-5219,,
2194930514,10076288092,2100998805,10076282873,-5219,,
2195180665,10076538243,2101248956,10076533024,-5219,,
2195198689,10076556267,2101266980,10076551048,-5219,10076551159,
2195449186,10076806764,2101517477,10076801582,-5182,,
2195700191,10077057770,2101768482,10077052606,-5164,,
2195950823,10077308401,2102019114,10077303266,-5135,,
2196201177,10077558756,2102269468,10077553649,-5107,,
2196451543,10077809122,2102519835,10077804015,-5107,,
2196702046,10078059625,2102770337,10078054517,-5108,,
2196952746,10078310325,2103021038,10078305218,-5107,,
2197203404,10078560983,2103271695,10078555876,-5107,,
2197221365,10078578943,2103289656,10078573836,-5107,10078573718,
2197471497,10078829076,2103539788,10078823939,-5137,,
2197722030,10079079609,2103790321,10079074443,-5166,,
2197972132,10079329710,2104040423,10079324515,-5195,,
2198222274,10079579853,2104290565,10079574629,-5224,,
2198472405,10079829984,2104540697,10079824761,-5223,,
2198723153,10080080732,2104791445,10080075508,-5224,,
2198973274,10080330853,2105041566,10080325629,-5224,,
2199223441,10080581019,2105291732,10080575795,-5224,,
2199241603,10080599181,2105309893,10080593957,-5224,10080593969,
2199491911,10080849490,2105560202,10080844269,-5221,,
2199742312,10081099901,2105810613,10081094682,-5219,,
2199993059,10081350637,2106061350,10081345423,-5214,,
2200243392,10081600971,2106311683,10081595759,-5212,,
2200494018,10081851598,2106562311,10081846387,-5211,,
2200744351,10082101929,2106812641,10082096718,-5211,,
2200994706,10082352285,2107062997,10082347074,-5211,,
2201244868,10082602447,2107313159,10082597247,-5200,,
2201263017,10082620596,2107331308,10082615384,-5212,10082615387,
2201513129,10082870707,2107581420,10082865496,-5211,,
2201763936,10083121515,2107832227,10083116304,-5211,,
2202014308,10083371887,2108082599,10083366678,-5209,,
2202264533,10083622111,2108332824,10083616915,-5196,,
2202514646,10083872225,2108582938,10083867019,-5206,,
2202764927,10084122505,2108833229,10084117309,-5196,,
2203015295,10084372873,2109083586,10084367666,-5207,,
2203265529,10084623107,2109333830,10084617910,-5197,,
2203283678,10084641257,2109351969,10084636049,-5208,10084636103,
2203533868,10084891446,2109602158,10084886252,-5194,,
2203784364,10085141943,2109852656,10085136763,-5180,,
2204034760,10085392338,2110103051,10085387172,-5166,,
2204284961,10085642540,2110353252,10085637387,-5153,,
2204535615,10085893195,2110603907,10085888043,-5152,,
2204786654,10086144233,2110854946,10086139081,-5152,,
2205037172,10086394751,2111105464,10086389599,-5152,,
2205287515,10086645094,2111355816,10086639951,-5143,,
2205305608,10086663186,2111373898,10086658034,-5152,10086658030,
2205556223,10086913801,2111624524,10086908659,-5142,,
2205806426,10087164005,2111874718,10087158852,-5153,,
2206056676,10087414254,2112124967,10087409101,-5153,,
2206306859,10087664437,2112375150,10087659293,-5144,,
2206557839,10087915418,2112626131,10087910264,-5154,,
2206808294,10088165883,2112876595,10088160729,-5154,,
2207058975,10088416553,2113127266,10088411399,-5154,,
2207309547,10088667126,2113377838,10088661972,-5154,,
2207327784,10088685363,2113396075,10088680208,-5155,10088680168,
2207578151,10088935729,2113646442,10088930564,-5165,,
2207828793,10089186371,2113897083,10089181197,-5174,,
2208079321,10089436900,2114147612,10089431715,-5185,,
2208329948,10089687526,2114398239,10089682333,-5193,,
2208580337,10089937915,2114648628,10089932722,-5193,,
2208830682,10090188261,2114898974,10090183068,-5193,,
2209080787,10090438366,2115149078,10090433173,-5193,,
2209331190,10090688769,2115399481,10090683576,-5193,,
2209349345,10090706923,2115417636,10090701730,-5193,10090701685,
2209599935,10090957513,2115668226,10090952319,-5194,,
2209850144,10091207722,2115918435,10091202507,-5215,,
2210100627,10091458205,2116168918,10091452979,-5226,,
2210350761,10091708339,2116419052,10091703102,-5237,,
2210600918,10091958496,2116669219,10091953269,-5227,,
2210851560,10092209153,2116919865,10092203916,-5237,,
2211101880,10092459459,2117170171,10092454222,-5237,,
2211352051,10092709630,2117420342,10092704403,-5227,,
2211370074,10092727653,2117438365,10092722415,-5238,10092722448,
2211620220,10092977799,2117688511,10092972570,-5229,,
2211870593,10093228171,2117938884,10093222951,-5220,,
2212121079,10093478658,2118189370,10093473447,-5211,,
2212371645,10093729224,2118439936,10093724020,-5204,,
2212622367,10093979946,2118690658,10093974743,-5203,,
2212873077,10094230655,2118941368,10094225452,-5203,,
2213123509,10094481087,2119191800,10094475884,-5203,,
2213374087,10094731666,2119442378,10094726463,-5203,,
2213392119,10094749697,2119460409,10094744494,-5203,10094744517,
2213642277,10094999856,2119710568,10094994659,-5197,,
2213892677,10095250256,2119960968,10095245064,-5192,,
2214142804,10095500383,2120211096,10095495209,-5174,,
2214393028,10095750606,2120461319,10095745428,-5178,,
2214643440,10096001019,2120711731,10095995841,-5178,,
2214894036,10096251614,2120962327,10096246436,-5178,,
2215144240,10096501819,2121212532,10096496641,-5178,,
2215395011,10096752589,2121463302,10096747411,-5178,,
2215413122,10096770700,2121481412,10096765521,-5179,10096765497,
2215663975,10097021554,2121732266,10097016380,-5174,,
2215914085,10097271664,2121982377,10097266474,-5190,,
2216164390,10097521969,2122232681,10097516774,-5195,,
2216414561,10097772140,2122482852,10097766938,-5202,,
2216664749,10098022338,2122733051,10098017137,-5201,,
2216915363,10098272941,2122983654,10098267740,-5201,,
2217165781,10098523359,2123234072,10098518158,-5201,,
2217416068,10098773647,2123484359,10098768445,-5202,,
2217434224,10098791803,2123502515,10098786601,-5202,10098786582,
2217684689,10099042267,2123752990,10099037071,-5196,,
2217934934,10099292513,2124003225,10099287302,-5211,,
2218185233,10099542811,2124253524,10099537597,-5214,,
2218435808,10099793387,2124504099,10099788167,-5220,,
2218685920,10100043499,2124754211,10100038280,-5219,,
2218936538,10100294116,2125004829,10100288897,-5219,,
2219186661,10100544240,2125254952,10100539021,-5219,,
2219436991,10100794570,2125505283,10100789351,-5219,,
2219455147,10100812725,2125523437,10100807506,-5219,10100807490,
2219705465,10101063044,2125773756,10101057821,-5223,,
2219955818,10101313397,2126024110,10101308171,-5226,,
2220206055,10101563634,2126274346,10101558403,-5231,,
2220456194,10101813773,2126524485,10101808540,-5233,,
2220706732,10102064311,2126775033,10102059087,-5224,,
2220957145,10102314723,2127025436,10102309490,-5233,,
2221207742,10102565321,2127276034,10102560088,-5233,,
2221458109,10102815688,2127526401,10102810455,-5233,,
2221476197,10102833775,2127544487,10102828542,-5233,10102828560,
2221726400,10103083989,2127794701,10103078761,-5228,,
2221976615,10103334194,2128044906,10103328971,-5223,,
2222227161,10103584740,2128295452,10103579522,-5218,,
2222477922,10103835501,2128546213,10103830288,-5213,,
2222728165,10104085744,2128796456,10104080531,-5213,,
2222978929,10104336508,2129047220,10104331294,-5214,,
2223229513,10104587091,2129297804,10104581878,-5213,,
2223479648,10104837227,2129547939,10104832014,-5213,,
2223497824,10104855402,2129566115,10104850189,-5213,10104850174,
2223748183,10105105762,2129816474,10105100544,-5218,,
2223998991,10105356569,2130067282,10105351348,-5221,,
2224249153,10105606732,2130317444,10105601507,-5225,,
2224499678,10105857257,2130567970,10105852030,-5227,,
2224749855,10106107434,2130818146,10106102207,-5227,,
2225000909,10106358488,2131069200,10106353260,-5228,,
2225251071,10106608649,2131319362,10106603422,-5227,,
2225501828,10106859407,2131570120,10106854180,-5227,,
2225519998,10106877576,2131588288,10106872349,-5227,10106872379,
2225770141,10107127719,2131838432,10107122500,-5219,,
2226020254,10107377833,2132088545,10107372622,-5211,,
2226270972,10107628551,2132339263,10107623347,-5204,,
2226521137,10107878715,2132589428,10107873531,-5184,,
2226771319,10108128898,2132839610,10108123703,-5195,,
2227021506,10108379085,2133089797,10108373900,-5185,,
2227271792,10108629370,2133340083,10108624175,-5195,,
2227522002,10108879582,2133590294,10108874387,-5195,,
2227540211,10108897789,2133608501,10108892594,-5195,10108892590,
2227790668,10109148246,2133858959,10109143050,-5196,,
2228041443,10109399021,2134109734,10109393825,-5196,,
2228291624,10109649203,2134359916,10109644006,-5197,,
2228542430,10109900009,2134610721,10109894811,-5198,,
2228792561,10110150140,2134860853,10110144943,-5197,,
2229043124,10110400713,2135111425,10110395516,-5197,,
2229293470,10110651049,2135361761,10110645852,-5197,,
2229544017,10110901597,2135612309,10110896400,-5197,,
2229562196,10110919774,2135630486,10110914577,-5197,10110914497,
2229812357,10111169936,2135880648,10111164719,-5217,,
2230062578,10111420157,2136130870,10111414921,-5236,,
2230312951,10111670530,2136381243,10111665274,-5256,,
2230563547,10111921125,2136631838,10111915860,-5265,,
2230814518,10112172097,2136882810,10112166822,-5275,,
2231065026,10112422604,2137133317,10112417329,-5275,,
2231315641,10112673219,2137383932,10112667944,-5275,,
2231565795,10112923374,2137634087,10112918099,-5275,,
2231583943,10112941522,2137652234,10112936246,-5276,10112936230,
2231834357,10113191935,2137902648,10113186658,-5277,,
2232084932,10113442511,2138153234,10113437243,-5268,,
2232335682,10113693260,2138403973,10113687981,-5279,,
2232586103,10113943682,2138654395,10113938402,-5280,,
2232836472,10114194050,2138904763,10114188770,-5280,,
2233087132,10114444711,2139155433,10114439441,-5270,,
2233337634,10114695212,2139405925,10114689932,-5280,,
2233587851,10114945440,2139656153,10114940160,-5280,,
2233606028,10114963607,2139674319,10114958326,-5281,10114958338,
2233856891,10115214470,2139925182,10115209192,-5278,,
2234107023,10115464602,2140175324,10115459338,-5264,,
2234357290,10115714868,2140425581,10115709598,-5270,,
2234607874,10115965452,2140676164,10115960185,-5267,,
2234858704,10116216283,2140926995,10116211015,-5268,,
2235108991,10116466570,2141177282,10116461302,-5268,,
2235359255,10116716834,2141427546,10116711567,-5267,,
2235609389,10116966967,2141677680,10116961700,-5267,,
2235627396,10116984974,2141695687,10116979707,-5267,10116979735,
2235877818,10117235397,2141946110,10117230137,-5260,,
2236128506,10117486085,2142196797,10117480833,-5252,,
2236378855,10117736434,2142447146,10117731188,-5246,,
2236629031,10117986610,2142697322,10117981373,-5237,,
2236879216,10118236794,2142947506,10118231557,-5237,,
2237129529,10118487108,2143197820,10118481870,-5238,,
2237379716,10118737304,2143448017,10118732067,-5237,,
2237630327,10118987905,2143698618,10118982668,-5237,,
2237648450,10119006029,2143716741,10119000791,-5238,10119000813,
2237898915,10119256494,2143967207,10119251272,-5222,,
2238149611,10119507190,2144217902,10119501964,-5226,,
2238400095,10119757674,2144468386,10119752453,-5221,,
2238650646,10120008225,2144718937,10120003011,-5214,,
2238900940,10120258519,2144969241,10120253315,-5204,,
2239151192,10120508771,2145219484,10120503567,-5204,,
2239401284,10120758862,2145469575,10120753648,-5214,,
2239651799,10121009388,2145720100,10121004174,-5214,,
2239669891,10121027469,2145738182,10121022255,-5214,10121022161,
2239920392,10121277971,2145988694,10121272743,-5228,,
2240170888,10121528467,2146239179,10121523206,-5261,,
2240421040,10121778619,2146489331,10121773335,-5284,,
2240671686,10122029265,2146739977,10122023957,-5308,,
2240921801,10122279380,2146990093,10122274083,-5297,,
2241172255,10122529834,2147240546,10122524527,-5307,,
2241422412,10122779991,2147490703,10122774684,-5307,,
2241672653,10123030231,2147740944,10123024924,-5307,,
2241690753,10123048331,2147759044,10123043024,-5307,10123043014,
2241940960,10123298538,2148009251,10123293239,-5299,,
2242191487,10123549066,2148259778,10123543754,-5312,,
2242442252,10123799830,2148510543,10123794527,-5303,,
2242692448,10124050027,2148760739,10124044711,-5316,,
2242942995,10124300574,2149011296,10124295267,-5307,,
2243193370,10124550949,2149261661,10124545632,-5317,,
2243443912,10124801491,2149512203,10124796184,-5307,,
2243694452,10125052031,2149762743,10125046715,-5316,,
2243712613,10125070192,2149780904,10125064875,-5317,10125064902,
2243962792,10125320381,2150031093,10125315071,-5310,,
2244213174,10125570753,2150281466,10125565450,-5303,,
2244463394,10125820973,2150531686,10125815677,-5296,,
2244713663,10126071242,2150781955,10126065954,-5288,,
2244964569,10126322148,2151032871,10126316870,-5278,,
2245215557,10126573136,2151283848,10126567847,-5289,,
2245466087,10126823665,2151534378,10126818377,-5288,,
2245716701,10127074280,2151784992,10127068992,-5288,,
2245735126,10127092705,2151803417,10127087416,-5289,10127087566,
2245985578,10127343158,2152053870,10127337907,-5251,,
2246235719,10127593298,2152304021,10127588096,-5202,,
2246486326,10127843905,2152554618,10127838731,-5174,,
2246736585,10128094164,2152804876,10128089027,-5137,,
2246987184,10128344762,2153055475,10128339625,-5137,,
2247237702,10128595281,2153305993,10128590144,-5137,,
2247488582,10128846160,2153556873,10128841023,-5137,,
2247738976,10129096554,2153807267,10129091417,-5137,,
2247757054,10129114632,2153825345,10129109495,-5137,10129109311,
2248007186,10129364765,2154075478,10129359582,-5183,,
2248257607,10129615186,2154325898,10129609957,-5229,,
2248507808,10129865388,2154576100,10129860114,-5274,,
2248758262,10130115841,2154826553,10130110521,-5320,,
2249008710,10130366299,2155077012,10130360980,-5319,,
2249258957,10130616536,2155327248,10130611217,-5319,,
2249509229,10130866808,2155577520,10130861489,-5319,,
2249759841,10131117420,2155828132,10131112101,-5319,,
2249777871,10131135450,2155846162,10131130131,-5319,10131130189,
2250027984,10131385562,2156096285,10131380268,-5294,,
2250278524,10131636103,2156346815,10131630812,-5291,,
2250529308,10131886888,2156597601,10131881613,-5275,,
2250779546,10132137125,2156847838,10132131866,-5259,,
2251029716,10132387295,2157098007,10132382036,-5259,,
2251279933,10132637511,2157348224,10132632252,-5259,,
2251530104,10132887683,2157598395,10132882423,-5260,,
2251780677,10133138256,2157848969,10133132997,-5259,,
2251798647,10133156226,2157866938,10133150966,-5260,10133150870,
2252049021,10133406600,2158117313,10133401316,-5284,,
2252299375,10133656954,2158367666,10133651645,-5309,,
2252549993,10133907572,2158618285,10133902242,-5330,,
2252800199,10134157778,2158868490,10134152435,-5343,,
2253050787,10134408366,2159119078,10134403011,-5355,,
2253301395,10134658974,2159369686,10134653619,-5355,,
2253552232,10134909811,2159620524,10134904457,-5354,,
2253802407,10135159986,2159870699,10135154632,-5354,,
2253820518,10135178096,2159888809,10135172742,-5354,10135172764,
2254070602,10135428181,2160138893,10135422833,-5348,,
2254320987,10135678566,2160389278,10135673223,-5343,,
2254571107,10135928686,2160639399,10135923350,-5336,,
2254821670,10136179259,2160889971,10136173929,-5330,,
2255072116,10136429705,2161140418,10136424375,-5330,,
2255322287,10136679865,2161390578,10136674535,-5330,,
2255572794,10136930372,2161641085,10136925052,-5320,,
2255823616,10137181195,2161891907,10137175875,-5320,,
2255841694,10137199272,2161909984,10137193942,-5330,10137193973,
2256091922,10137449501,2162160224,10137444189,-5312,,
2256342413,10137699992,2162410704,10137694679,-5313,,
2256592928,10137950508,2162661220,10137945203,-5305,,
2256843044,10138200633,2162911345,10138195336,-5297,,
2257093890,10138451469,2163162191,10138446182,-5287,,
2257344051,10138701630,2163412342,10138696333,-5297,,
2257594333,10138951911,2163662624,10138946614,-5297,,
2257844646,10139202225,2163912937,10139196938,-5287,,
2257862683,10139220262,2163930974,10139214965,-5297,10139214897,
2258112834,10139470413,2164181125,10139465099,-5314,,
2258363241,10139720820,2164431532,10139715489,-5331,,
2258613630,10139971219,2164681932,10139965872,-5347,,
2258864068,10140221657,2164932369,10140216294,-5363,,
2259114610,10140472188,2165182911,10140466836,-5352,,
2259364793,10140722372,2165433084,10140717008,-5364,,
2259614971,10140972550,2165683262,10140967187,-5363,,
2259865574,10141223152,2165933865,10141217789,-5363,,
2259883753,10141241331,2165952043,10141235968,-5363,10141235964,
2260134185,10141491763,2166202476,10141486400,-5363,,
2260384769,10141742347,2166453060,10141736983,-5364,,
2260635479,10141993058,2166703770,10141987693,-5365,,
2260886064,10142243642,2166954355,10142238277,-5365,,
2261136568,10142494157,2167204870,10142488793,-5364,,
2261387285,10142744863,2167455576,10142739508,-5355,,
2261637415,10142994993,2167705706,10142989628,-5365,,
2261887994,10143245573,2167956285,10143240208,-5365,,
2261906163,10143263741,2167974454,10143258376,-5365,10143258451,
2262156443,10143514022,2168224734,10143508675,-5347,,
2262406607,10143764186,2168474898,10143758858,-5328,,
2262657404,10144014983,2168725695,10144009675,-5308,,
2262907582,10144265161,2168975873,10144259872,-5289,,
2263158120,10144515709,2169226422,10144510420,-5289,,
2263408283,10144765861,2169476584,10144760583,-5278,,
2263658507,10145016086,2169726799,10145010797,-5289,,
2263908628,10145266207,2169976919,10145260918,-5289,,
2263926649,10145284227,2169994939,10145278938,-5289,10145278889,
2264176788,10145534367,2170245079,10145529065,-5302,,
2264427227,10145784806,2170495518,10145779492,-5314,,
2264677776,10146035365,2170746077,10146030040,-5325,,
2264928003,10146285582,2170996294,10146280244,-5338,,
2265178206,10146535785,2171246498,10146530448,-5337,,
2265428720,10146786299,2171497012,10146780972,-5327,,
2265679333,10147036911,2171747624,10147031574,-5337,,
2265929962,10147287541,2171998253,10147282203,-5338,,
2265948097,10147305675,2172016388,10147300338,-5337,10147300355,
2266198268,10147555857,2172266569,10147550523,-5334,,
2266448769,10147806347,2172517060,10147801019,-5328,,
2266699416,10148056994,2172767707,10148051671,-5323,,
2266950013,10148307592,2173018304,10148302273,-5319,,
2267200572,10148558151,2173268864,10148552833,-5318,,
2267450918,10148808497,2173519209,10148803178,-5319,,
2267701482,10149059061,2173769774,10149053742,-5319,,
2267951679,10149309257,2174019970,10149303938,-5319,,
2267970114,10149327692,2174038405,10149322373,-5319,10149322518,
2268220839,10149578418,2174289131,10149573136,-5282,,
2268471102,10149828681,2174539394,10149823445,-5236,,
2268721249,10150078828,2174789541,10150073618,-5210,,
2268971828,10150329417,2175040130,10150324244,-5173,,
2269221942,10150579521,2175290233,10150574348,-5173,,
2269472705,10150830284,2175540996,10150825110,-5174,,
2269723216,10151080795,2175791507,10151075622,-5173,,
2269973807,10151331385,2176042098,10151326212,-5173,,
2269991940,10151349519,2176060231,10151344345,-5174,10151344086,
2270242149,10151599728,2176310441,10151594489,-5239,,
2270492751,10151850330,2176561043,10151845027,-5303,,
2270743108,10152100686,2176811399,10152095318,-5368,,
2270994080,10152351659,2177062371,10152346227,-5432,,
2271244570,10152602149,2177312862,10152596718,-5431,,
2271494692,10152852271,2177562983,10152846839,-5432,,
2271745000,10153102578,2177813291,10153097147,-5431,,
2271995235,10153352813,2178063526,10153347382,-5431,,
2272013359,10153370937,2178081649,10153365506,-5431,10153365575,
2272263930,10153621509,2178332231,10153616106,-5403,,
2272514298,10153871877,2178582590,10153866481,-5396,,
2272765239,10154122817,2178833530,10154117439,-5378,,
2273015820,10154373399,2179084111,10154368038,-5361,,
2273266357,10154623937,2179334649,10154618576,-5361,,
2273516623,10154874203,2179584915,10154868843,-5360,,
2273766790,10155124368,2179835080,10155119018,-5350,,
2274017319,10155374897,2180085610,10155369537,-5360,,
2274035324,10155392902,2180103614,10155387542,-5360,10155387552,
2274285829,10155643407,2180354120,10155638050,-5357,,
2274536225,10155893813,2180604526,10155888459,-5354,,
2274786895,10156144474,2180855187,10156139123,-5351,,
2275037221,10156394800,2181105512,10156389452,-5348,,
2275287689,10156645268,2181355980,10156639919,-5349,,
2275537850,10156895429,2181606142,10156890081,-5348,,
2275788446,10157146025,2181856737,10157140677,-5348,,
2276038586,10157396164,2182106877,10157390816,-5348,,
2276056702,10157414281,2182124993,10157408933,-5348,10157408917,
2276306831,10157664410,2182375122,10157659058,-5352,,
2276557119,10157914698,2182625410,10157909342,-5356,,
2276807400,10158164979,2182875691,10158159621,-5358,,
2277058139,10158415717,2183126430,10158410355,-5362,,
2277308619,10158666197,2183376910,10158660835,-5362,,
2277559001,10158916580,2183627293,10158911219,-5361,,
2277809435,10159167014,2183877726,10159161662,-5352,,
2278059902,10159417481,2184128193,10159412119,-5362,,
2278078071,10159435649,2184146362,10159430287,-5362,10159430319,
2278328299,10159685877,2184396589,10159680532,-5345,,
2278578489,10159936067,2184646780,10159930721,-5346,,
2278828697,10160186276,2184896999,10160180949,-5327,,
2279079072,10160436650,2185147363,10160431321,-5329,,
2279329674,10160687252,2185397965,10160681923,-5329,,
2279580474,10160938053,2185648766,10160932725,-5328,,
2279830629,10161188208,2185898920,10161182879,-5329,,
2280080978,10161438557,2186149270,10161433228,-5329,,
2280098989,10161456567,2186167279,10161451237,-5330,10161451182,
2280349540,10161707119,2186417831,10161701776,-5343,,
2280599733,10161957323,2186668035,10161951966,-5357,,
2280850287,10162207865,2186918578,10162202495,-5370,,
2281100613,10162458191,2187168903,10162452808,-5383,,
2281350873,10162708451,2187419174,10162703078,-5373,,
2281601017,10162958596,2187669309,10162953214,-5382,,
2281851275,10163208853,2187919576,10163203480,-5373,,
2282101600,10163459178,2188169891,10163453795,-5383,,
2282119698,10163477276,2188187989,10163471893,-5383,10163471922,
2282369812,10163727391,2188438103,10163722015,-5376,,
2282620011,10163977589,2188688302,10163972220,-5369,,
2282870336,10164227915,2188938627,10164222553,-5362,,
2283120891,10164478469,2189189182,10164473116,-5353,,
2283371285,10164728864,2189439576,10164723521,-5343,,
2283621479,10164979058,2189689771,10164973706,-5352,,
2283872027,10165229605,2189940317,10165224252,-5353,,
2284122813,10165480392,2190191104,10165475039,-5353,,
2284140881,10165498459,2190209171,10165493106,-5353,10165493062,
2284391420,10165748999,2190459711,10165743645,-5354,,
2284641868,10165999447,2190710159,10165994082,-5365,,
2284892082,10166249660,2190960373,10166244275,-5385,,
2285142412,10166499991,2191210703,10166494594,-5397,,
2285392852,10166750431,2191461144,10166745046,-5385,,
2285643368,10167000947,2191711660,10166995551,-5396,,
2285893779,10167251358,2191962070,10167245962,-5396,,
2286144385,10167501964,2192212677,10167496568,-5396,,
2286162389,10167519967,2192230680,10167514571,-5396,10167514592,
2286412714,10167770293,2192481005,10167764902,-5391,,
2286663070,10168020649,2192731372,10168015274,-5375,,
2286913670,10168271249,2192981961,10168265870,-5379,,
2287163988,10168521566,2193232279,10168516192,-5374,,
2287414549,10168772128,2193482840,10168766753,-5375,,
2287665145,10169022724,2193733437,10169017350,-5374,,
2287915832,10169273410,2193984123,10169268036,-5374,,
2288166073,10169523652,2194234364,10169518287,-5365,,
2288184863,10169542441,2194253153,10169537067,-5374,10169537380,
2288435182,10169792760,2194503473,10169787465,-5295,,
2288685697,10170043276,2194753988,10170038060,-5216,,
2288935791,10170293370,2195004083,10170288232,-5138,,
2289185937,10170543515,2195254228,10170538456,-5059,,
2289436570,10170794149,2195504861,10170789090,-5059,,
2289687155,10171044734,2195755446,10171039685,-5049,,
2289937404,10171294983,2196005695,10171289923,-5060,,
2290187611,10171545190,2196255902,10171540130,-5060,,
2290205659,10171563237,2196273950,10171558178,-5059,10171557841,
2290456378,10171813956,2196524668,10171808822,-5134,,
2290706759,10172064337,2196775050,10172059119,-5218,,
2290957199,10172314777,2197025490,10172309466,-5311,,
2291207407,10172564986,2197275698,10172559590,-5396,,
2291457823,10172815402,2197526114,10172810017,-5385,,
2291708672,10173066258,2197776971,10173060863,-5395,,
2291958913,10173316491,2198027204,10173311096,-5395,,
2292209022,10173566600,2198277323,10173561216,-5384,,
2292227118,10173584697,2198295409,10173579302,-5395,10173579337,
2292477594,10173835173,2198545885,10173829787,-5386,,
2292728152,10174085731,2198796444,10174080354,-5377,,
2292978784,10174336363,2199047076,10174330996,-5367,,
2293229468,10174587046,2199297759,10174581688,-5358,,
2293479811,10174837389,2199548102,10174832031,-5358,,
2293730149,10175087728,2199798440,10175082370,-5358,,
2293980567,10175338146,2200048869,10175332798,-5348,,
2294231184,10175588763,2200299475,10175583405,-5358,,
2294249217,10175606795,2200317508,10175601437,-5358,10175601373,
2294499892,10175857471,2200568183,10175852097,-5374,,
2294750444,10176108022,2200818735,10176102632,-5390,,
2295000948,10176358537,2201069250,10176353132,-5405,,
2295251208,10176608786,2201319499,10176603365,-5421,,
2295501574,10176859153,2201569865,10176853732,-5421,,
2295751720,10177109299,2201820011,10177103877,-5422,,
2296001839,10177359418,2202070130,10177354007,-5411,,
2296252261,10177609840,2202320553,10177604419,-5421,,
2296270452,10177628030,2202338743,10177622609,-5421,10177622598,
2296520816,10177878395,2202589108,10177872971,-5424,,
2296771556,10178129135,2202839847,10178123707,-5428,,
2297021743,10178379322,2203090035,10178373893,-5429,,
2297272282,10178629860,2203340572,10178624429,-5431,,
2297522842,10178880421,2203591134,10178874990,-5431,,
2297773926,10179131505,2203842217,10179126073,-5432,,
2298024410,10179381989,2204092701,10179376558,-5431,,
2298274908,10179632487,2204343199,10179627056,-5431,,
2298293020,10179650599,2204361311,10179645168,-5431,10179645134,
2298543446,10179901025,2204611738,10179895587,-5438,,
2298793770,10180151348,2204862061,10180145901,-5447,,
2299044420,10180401999,2205112711,10180396543,-5456,,
2299294646,10180652224,2205362937,10180646761,-5463,,
2299545233,10180902811,2205613524,10180897348,-5463,,
2299795708,10181153286,2205863999,10181147823,-5463,,
2300046595,10181404174,2206114886,10181398710,-5464,,
2300296759,10181654338,2206365050,10181648875,-5463,,
2300314951,10181672529,2206383242,10181667066,-5463,10181667074,
2300565925,10181923504,2206634217,10181918043,-5461,,
2300816083,10182173662,2206884374,10182168202,-5460,,
2301066262,10182423841,2207134553,10182418383,-5458,,
2301316825,10182674404,2207385117,10182668950,-5454,,
2301567262,10182924840,2207635553,10182919386,-5454,,
2301817680,10183175259,2207885972,10183169805,-5454,,
2302068233,10183425811,2208136524,10183420367,-5444,,
2302318784,10183676362,2208387075,10183670918,-5444,,
2302336749,10183694328,2208405040,10183688873,-5455,10183688873,
2302587124,10183944703,2208655416,10183939248,-5455,,
2302837686,10184195264,2208905977,10184189810,-5454,,
2303088355,10184445933,2209156646,10184440479,-5454,,
2303338741,10184696319,2209407032,10184690876,-5443,,
2303588953,10184946532,2209657244,10184941089,-5443,,
2303839202,10185196780,2209907493,10185191327,-5453,,
2304089498,10185447077,2210157789,10185441623,-5454,,
2304339827,10185697416,2210408128,10185691963,-5453,,
2304358046,10185715624,2210426336,10185710171,-5453,10185710213,
2304608372,10185965952,2210676665,10185960510,-5442,,
2304858601,10186216180,2210926892,10186210749,-5431,,
2305108971,10186466550,2211177262,10186461129,-5421,,
2305359187,10186716765,2211427488,10186711366,-5399,,
2305609501,10186967081,2211677793,10186961672,-5409,,
2305860133,10187217722,2211928434,10187212313,-5409,,
2306110445,10187468024,2212178736,10187462614,-5410,,
2306360745,10187718324,2212429036,10187712915,-5409,,
2306378874,10187736452,2212447165,10187731043,-5409,10187731037,
2306629477,10187987056,2212697769,10187981646,-5410,,
2306879892,10188237471,2212948183,10188232059,-5412,,
2307130372,10188487950,2213198663,10188482537,-5413,,
2307380811,10188738399,2213449112,10188732986,-5413,,
2307631430,10188989009,2213699721,10188983594,-5415,,
2307881711,10189239289,2213950002,10189233875,-5414,,
2308131995,10189489573,2214200286,10189484159,-5414,,
2308382286,10189739865,2214450578,10189734451,-5414,,
2308400515,10189758093,2214468806,10189752679,-5414,10189752695,
2308650724,10190008303,2214719016,10190002904,-5399,,
2308901006,10190258584,2214969308,10190253189,-5395,,
2309151828,10190509407,2215220119,10190504005,-5402,,
2309401943,10190759521,2215470234,10190754124,-5397,,
2309652091,10191009670,2215720382,10191004273,-5397,,
2309902669,10191260248,2215970960,10191254851,-5397,,
2310153206,10191510785,2216221497,10191505398,-5387,,
2310403667,10191761246,2216471959,10191755859,-5387,,
2310422351,10191779930,2216490642,10191774532,-5398,10191774696,
2310672454,10192030033,2216740745,10192024676,-5357,,
2310922638,10192280217,2216990930,10192274903,-5314,,
2311173235,10192530814,2217241526,10192525541,-5273,,
2311423407,10192780996,2217491709,10192775764,-5232,,
2311673631,10193031210,2217741922,10193025977,-5233,,
2311924172,10193281751,2217992464,10193276519,-5232,,
2312174578,10193532156,2218242869,10193526924,-5232,,
2312424720,10193782298,2218493011,10193777076,-5222,,
2312442759,10193800338,2218511050,10193795106,-5232,10193794871,
2312693146,10194050725,2218761437,10194045433,-5292,,
2312943576,10194301155,2219011867,10194295806,-5349,,
2313193763,10194551341,2219262054,10194545934,-5407,,
2313444034,10194801613,2219512325,10194796148,-5465,,
2313694472,10195052051,2219762763,10195046585,-5466,,
2313945005,10195302583,2220013296,10195297118,-5465,,
2314195328,10195552906,2220263619,10195547441,-5465,,
2314445626,10195803205,2220513917,10195797739,-5466,,
2314463624,10195821202,2220531914,10195815736,-5466,10195815774,
2314714046,10196071625,2220782337,10196066169,-5456,,
2314964554,10196322133,2221032846,10196316687,-5446,,
2315214784,10196572362,2221283075,10196566926,-5436,,
2315465374,10196822953,2221533665,10196817526,-5427,,
2315715590,10197073169,2221783881,10197067743,-5426,,
2315965859,10197323438,2222034150,10197318011,-5427,,
2316216635,10197574214,2222284926,10197568788,-5426,,
2316467163,10197824741,2222535454,10197819315,-5426,,
2316485309,10197842887,2222553599,10197837461,-5426,10197837374,
2316736170,10198093749,2222804461,10198088301,-5448,,
2316986479,10198344057,2223054770,10198338588,-5469,,
2317236641,10198594220,2223304932,10198588730,-5490,,
2317487208,10198844787,2223555499,10198839275,-5512,,
2317737388,10199094967,2223805679,10199089466,-5501,,
2317987678,10199345257,2224055969,10199339746,-5511,,
2318238674,10199596253,2224306965,10199590741,-5512,,
2318488791,10199846369,2224557082,10199840858,-5511,,
2318506792,10199864370,2224575083,10199858859,-5511,10199858905,
2318756953,10200114532,2224825244,10200109032,-5500,,
2319007707,10200365285,2225075998,10200359797,-5488,,
2319258205,10200615784,2225326497,10200610308,-5476,,
2319508335,10200865914,2225576626,10200860450,-5464,,
2319758880,10201116459,2225827182,10201111006,-5453,,
2320009113,10201366692,2226077415,10201361239,-5453,,
2320259496,10201617074,2226327787,10201611610,-5464,,
2320510404,10201867983,2226578695,10201862528,-5455,,
2320528674,10201886252,2226596965,10201880788,-5464,10201880714,
2320779476,10202137055,2226847767,10202131572,-5483,,
2321029703,10202387282,2227097994,10202381781,-5501,,
2321280495,10202638074,2227348787,10202632556,-5518,,
2321530768,10202888347,2227599060,10202882812,-5535,,
2321781515,10203139105,2227849817,10203133569,-5536,,
2322031996,10203389575,2228100288,10203384039,-5536,,
2322282531,10203640109,2228350822,10203634573,-5536,,
2322532839,10203890418,2228601140,10203884891,-5527,,
2322551117,10203908696,2228619408,10203903160,-5536,10203903192,
2322801725,10204159304,2228870017,10204153775,-5529,,
2323052272,10204409850,2229120563,10204404330,-5520,,
2323302858,10204660437,2229371149,10204654926,-5511,,
2323553244,10204910823,2229621535,10204905321,-5502,,
2323803378,10205160957,2229871680,10205155465,-5492,,
2324053698,10205411277,2230121989,10205405775,-5502,,
2324303896,10205661475,2230372187,10205655972,-5503,,
2324554233,10205911812,2230622535,10205906321,-5491,,
2324572407,10205929985,2230640697,10205924482,-5503,10205924567,
2324822512,10206180091,2230890803,10206174611,-5480,,
2325073090,10206430669,2231141381,10206425210,-5459,,
2325323987,10206681565,2231392278,10206676128,-5437,,
2325574405,10206931985,2231642697,10206926569,-5416,,
2325824617,10207182196,2231892909,10207176780,-5416,,
2326075076,10207432655,2232143367,10207427239,-5416,,
2326325446,10207683024,2232393737,10207677608,-5416,,
2326576264,10207933843,2232644556,10207928437,-5406,,
2326594467,10207952045,2232662758,10207946629,-5416,10207946547,
2326845099,10208202678,2232913390,10208197242,-5436,,
2327095694,10208453273,2233163986,10208447817,-5456,,
2327346077,10208703656,2233414368,10208698180,-5476,,
2327596205,10208953784,2233664496,10208948288,-5496,,
2327846743,10209204322,2233915035,10209198826,-5496,,
2328097060,10209454639,2234165352,10209449143,-5496,,
2328347708,10209705286,2234415999,10209699790,-5496,,
2328597821,10209955411,2234666123,10209949915,-5496,,
2328616191,10209973769,2234684481,10209968273,-5496,10209968229,
2328866328,10210223907,2234934619,10210218411,-5496,,
2329116537,10210474116,2235184828,10210468599,-5517,,
2329366759,10210724338,2235435050,10210718810,-5528,,
2329617329,10210974908,2235685621,10210969370,-5538,,
2329867592,10211225171,2235935883,10211219633,-5538,,
2330118042,10211475620,2236186333,10211470082,-5538,,
2330368851,10211726430,2236437142,10211720891,-5539,,
2330618968,10211976546,2236687259,10211971008,-5538,,
2330637018,10211994597,2236705309,10211989058,-5539,10211989107,
2330887710,10212245289,2236956001,10212239763,-5526,,
2331137830,10212495409,2237206122,10212489896,-5513,,
2331388394,10212745973,2237456685,10212740472,-5501,,
2331638574,10212996154,2237706867,10212990666,-5488,,
2331889383,10213246961,2237957683,10213241483,-5478,,
2332139511,10213497090,2238207802,10213491602,-5488,,
2332390083,10213747661,2238458374,10213742183,-5478,,
2332640258,10213997847,2238708560,10213992359,-5488,,
2332658357,10214015935,2238726647,10214010446,-5489,10214010396,
2332908591,10214266169,2238976882,10214260669,-5500,,
2333158810,10214516388,2239227101,10214510876,-5512,,
2333409107,10214766686,2239477398,10214761172,-5514,,
2333659343,10215016922,2239727635,10215011385,-5537,,
2333909624,10215267203,2239977916,10215261666,-5537,,
2334159839,10215517418,2240228130,10215511891,-5527,,
2334409959,10215767547,2240478260,10215762010,-5537,,
2334660141,10216017720,2240728442,10216012193,-5527,,
2334678314,10216035892,2240746605,10216030355,-5537,10216030377,
2334928487,10216286066,2240996778,10216280535,-5531,,
2335179121,10216536700,2241247413,10216531186,-5514,,
2335429496,10216787075,2241497787,10216781555,-5520,,
2335679716,10217037306,2241748019,10217031793,-5513,,
2335930298,10217287877,2241998589,10217282363,-5514,,
2336180872,10217538451,2242249164,10217532949,-5502,,
2336431448,10217789026,2242499739,10217783513,-5513,,
2336681861,10218039439,2242750151,10218033926,-5513,,
2336699862,10218057441,2242768153,10218051928,-5513,10218051872,
2336950196,10218307774,2243018487,10218302247,-5527,,
2337200817,10218558395,2243269118,10218552864,-5531,,
2337451014,10218808592,2243519305,10218803038,-5554,,
2337701695,10219059273,2243769986,10219053706,-5567,,
2337951908,10219309487,2244020200,10219303920,-5567,,
2338202244,10219559823,2244270535,10219554265,-5558,,
2338452595,10219810173,2244520886,10219804606,-5567,,
2338702931,10220060510,2244771222,10220054943,-5567,,
2338720946,10220078524,2244789237,10220072957,-5567,10220073004,
2338971404,10220328982,2245039695,10220323426,-5556,,
2339221686,10220579265,2245289988,10220573732,-5533,,
2339472299,10220829877,2245540590,10220824345,-5532,,
2339723205,10221080784,2245791496,10221075265,-5519,,
2339973674,10221331253,2246041965,10221325734,-5519,,
2340224223,10221581801,2246292514,10221576282,-5519,,
2340474454,10221832032,2246542745,10221826513,-5519,,
2340724741,10222082320,2246793032,10222076801,-5519,,
2340742838,10222100417,2246811129,10222094897,-5520,10222094886,
2340992957,10222350535,2247061248,10222345012,-5523,,
2341243142,10222600721,2247311433,10222595196,-5525,,
2341493709,10222851287,2247561999,10222845760,-5527,,
2341744128,10223101707,2247812419,10223096178,-5529,,
2341994312,10223351891,2248062603,10223346361,-5530,,
2342244699,10223602278,2248312990,10223596748,-5530,,
2342494808,10223852387,2248563099,10223846857,-5530,,
2342745149,10224102727,2248813440,10224097198,-5529,,
2342763249,10224120828,2248831540,10224115298,-5530,10224115278,
2343013473,10224371052,2249081764,10224365517,-5535,,
2343263777,10224621355,2249332068,10224615816,-5539,,
2343514077,10224871656,2249582368,10224866112,-5544,,
2343764615,10225122194,2249832907,10225116646,-5548,,
2344014837,10225372416,2250083128,10225366867,-5549,,
2344265299,10225622878,2250333590,10225617329,-5549,,
2344516054,10225873633,2250584345,10225868084,-5549,,
2344766168,10226123746,2250834459,10226118198,-5548,,
2344784136,10226141714,2250852427,10226136166,-5548,10226136091,
2345034265,10226391844,2251102557,10226386278,-5566,,
2345284516,10226642095,2251352807,10226636510,-5585,,
2345534690,10226892268,2251602981,10226886665,-5603,,
2345784864,10227142443,2251853155,10227136822,-5621,,
2346035740,10227393319,2252104031,10227387697,-5622,,
2346286181,10227643760,2252354472,10227638139,-5621,,
2346536983,10227894561,2252605274,10227888940,-5621,,
2346787138,10228144716,2252855440,10228139106,-5610,,
2346805274,10228162852,2252873565,10228157231,-5621,10228157301,
2347055399,10228412978,2253123690,10228407373,-5605,,
2347306011,10228663590,2253374302,10228658004,-5586,,
2347556197,10228913775,2253624498,10228908218,-5557,,
2347806543,10229164122,2253874845,10229158583,-5539,,
2348056875,10229414454,2254125167,10229408904,-5550,,
2348307412,10229664991,2254375703,10229659441,-5550,,
2348557528,10229915108,2254625820,10229909558,-5550,,
2348808137,10230165726,2254876438,10230160176,-5550,,
2348826267,10230183845,2254894557,10230178295,-5550,10230178253,
2349076899,10230434477,2255145189,10230428916,-5561,,
2349327213,10230684791,2255395504,10230679230,-5561,,
2349578000,10230935579,2255646302,10230930008,-5571,,
2349828603,10231186182,2255896905,10231180601,-5581,,
2350079191,10231436769,2256147482,10231431178,-5591,,
2350329351,10231686930,2256397642,10231681339,-5591,,
2350580105,10231937684,2256648397,10231932094,-5590,,
2350830432,10232188021,2256898733,10232182430,-5591,,
2350848674,10232206253,2256916965,10232200661,-5592,10232200675,
2351098975,10232456553,2257167266,10232450965,-5588,,
2351349300,10232706878,2257417590,10232701294,-5584,,
2351599539,10232957117,2257667830,10232951547,-5570,,
2351849935,10233207514,2257918226,10233201938,-5576,,
2352100426,10233458005,2258168717,10233452429,-5576,,
2352350659,10233708238,2258418950,10233702662,-5576,,
2352601093,10233958672,2258669385,10233953096,-5576,,
2352851756,10234209335,2258920047,10234203758,-5577,,
2352869929,10234227507,2258938219,10234221931,-5576,10234221935,
2353120474,10234478053,2259188765,10234472477,-5576,,
2353370619,10234728197,2259438910,10234722624,-5573,,
2353621355,10234978934,2259689646,10234973362,-5572,,
2353871933,10235229521,2259940234,10235223951,-5570,,
2354122341,10235479919,2260190632,10235474349,-5570,,
2354372465,10235730044,2260440756,10235724473,-5571,,
2354622980,10235980559,2260691272,10235974989,-5570,,
2354873111,10236230690,2260941413,10236225131,-5559,,
2354891251,10236248830,2260959542,10236243259,-5571,10236243270,
2355141344,10236498923,2261209635,10236493356,-5567,,
2355391559,10236749138,2261459850,10236743573,-5565,,
2355641686,10236999265,2261709977,10236993704,-5561,,
2355891996,10237249574,2261960287,10237244016,-5558,,
2356142606,10237500185,2262210897,10237494627,-5558,,
2356393029,10237750608,2262461320,10237745050,-5558,,
2356643168,10238000747,2262711460,10237995189,-5558,,
2356893811,10238251390,2262962102,10238245831,-5559,,
2356911901,10238269479,2262980192,10238263921,-5558,10238263873,
2357162175,10238519754,2263230467,10238514183,-5571,,
2357412347,10238769926,2263480649,10238764355,-5571,,
2357662629,10239020208,2263730920,10239014613,-5595,,
2357913247,10239270826,2263981538,10239265221,-5605,,
2358164071,10239521649,2264232362,10239516044,-5605,,
2358414563,10239772142,2264482855,10239766537,-5605,,
2358665033,10240022612,2264733325,10240017007,-5605,,
2358915251,10240272840,2264983552,10240267235,-5605,,
2358933339,10240290917,2265001629,10240285311,-5606,10240285311,
2359183711,10240541290,2265252002,10240535684,-5606,,
2359433944,10240791523,2265502235,10240785919,-5604,,
2359684571,10241042150,2265752862,10241036546,-5604,,
2359934736,10241292325,2266003038,10241286722,-5603,,
2360185090,10241542669,2266253381,10241537075,-5594,,
2360435742,10241793320,2266504033,10241787716,-5604,,
2360686719,10242044298,2266755011,10242038694,-5604,,
2360937689,10242295269,2267005981,10242289664,-5605,,
2360955735,10242313313,2267024025,10242307709,-5604,10242307730,
2361206191,10242563769,2267274482,10242558169,-5600,,
2361456385,10242813963,2267524676,10242808379,-5584,,
2361706662,10243064241,2267774953,10243058653,-5588,,
2361957247,10243314827,2268025539,10243309245,-5582,,
2362207750,10243565329,2268276042,10243559747,-5582,,
2362458351,10243815930,2268526643,10243810348,-5582,,
2362709399,10244066978,2268777691,10244061396,-5582,,
2362960009,10244317588,2269028301,10244312006,-5582,,
2362978130,10244335709,2269046421,10244330126,-5583,10244330125,
2363228254,10244585833,2269296545,10244580260,-5573,,
2363478832,10244836411,2269547123,10244830829,-5582,,
2363729199,10245086778,2269797491,10245081197,-5581,,
2363979381,10245336961,2270047673,10245331379,-5582,,
2364229755,10245587334,2270298046,10245581762,-5572,,
2364479923,10245837501,2270548214,10245831919,-5582,,
2364730958,10246088537,2270799249,10246082954,-5583,,
2364981353,10246338932,2271049645,10246333351,-5581,,
2364999483,10246357061,2271067774,10246351479,-5582,10246351468,
2365250035,10246607614,2271318327,10246602030,-5584,,
2365500299,10246857877,2271568590,10246852290,-5587,,
2365750536,10247108115,2271818838,10247102536,-5579,,
2366000908,10247358487,2272069200,10247352895,-5592,,
2366251012,10247608590,2272319303,10247602998,-5592,,
2366501474,10247859053,2272569765,10247853461,-5592,,
2366751841,10248109420,2272820143,10248103839,-5581,,
2367002478,10248360057,2273070770,10248354465,-5592,,
2367020702,10248378280,2273088993,10248372688,-5592,10248372786,
2367271230,10248628808,2273339521,10248623240,-5568,,
2367521667,10248879245,2273589958,10248873702,-5543,,
2367772300,10249129879,2273840591,10249124361,-5518,,
2368022548,10249380127,2274090840,10249374635,-5492,,
2368273549,10249631128,2274341841,10249625635,-5493,,
2368523930,10249881509,2274592221,10249876015,-5494,,
2368774213,10250131792,2274842504,10250126299,-5493,,
2369024401,10250381981,2275092693,10250376488,-5493,,
2369042517,10250400095,2275110807,10250394602,-5493,10250394472,
2369292843,10250650422,2275361134,10250644897,-5525,,
2369543255,10250900834,2275611546,10250895276,-5558,,
2369793626,10251151205,2275861917,10251145626,-5579,,
2370044267,10251401857,2276112569,10251396236,-5621,,
2370294604,10251652183,2276362896,10251646562,-5621,,
2370544986,10251902565,2276613277,10251896944,-5621,,
2370795267,10252152845,2276863558,10252147224,-5621,,
2371045898,10252403487,2277114199,10252397866,-5621,,
2371063943,10252421521,2277132233,10252415900,-5621,10252415867,
2371314406,10252671984,2277382697,10252666355,-5629,,
2371564743,10252922322,2277633034,10252916685,-5637,,
2371814973,10253172552,2277883264,10253166908,-5644,,
2372065436,10253423015,2278133728,10253417363,-5652,,
2372316081,10253673660,2278384372,10253668008,-5652,,
2372566578,10253924156,2278634869,10253918504,-5652,,
2372816881,10254174459,2278885172,10254168807,-5652,,
2373067103,10254424692,2279135404,10254419040,-5652,,
2373085212,10254442790,2279153503,10254437138,-5652,10254437161,
2373335694,10254693272,2279403985,10254687625,-5647,,
2373585951,10254943530,2279654243,10254937889,-5641,,
2373836398,10255193977,2279904689,10255188342,-5635,,
2374086561,10255444140,2280154852,10255438511,-5629,,
2374337035,10255694614,2280405327,10255688986,-5628,,
2374587670,10255945248,2280655961,10255939620,-5628,,
2374838267,10256195845,2280906558,10256190217,-5628,,
2375088612,10256446190,2281156903,10256440562,-5628,,
2375106626,10256464204,2281174916,10256458576,-5628,10256458590,
2375357067,10256714645,2281425357,10256709021,-5624,,
2375607393,10256964973,2281675685,10256959353,-5620,,
2375857580,10257215159,2281925871,10257209543,-5616,,
2376108091,10257465680,2282176393,10257460068,-5612,,
2376358300,10257715878,2282426591,10257710276,-5602,,
2376608533,10257966111,2282676824,10257960510,-5601,,
2376859039,10258216618,2282927330,10258211006,-5612,,
2377109520,10258467098,2283177822,10258461497,-5601,,
2377127638,10258485217,2283195929,10258479605,-5612,10258479593,
2377378020,10258735599,2283446311,10258729985,-5614,,
2377628161,10258985741,2283696453,10258980124,-5617,,
2377878488,10259236066,2283946779,10259230447,-5619,,
2378128888,10259486477,2284197189,10259480855,-5622,,
2378379297,10259736876,2284447588,10259731254,-5622,,
2378629465,10259987043,2284697756,10259981421,-5622,,
2378879727,10260237306,2284948018,10260231683,-5623,,
2379130000,10260487589,2285198301,10260481966,-5623,,
2379148116,10260505694,2285216407,10260500072,-5622,10260499991,
2379398681,10260756260,2285466973,10260750618,-5642,,
2379649182,10261006762,2285717475,10261001100,-5662,,
2379899337,10261256916,2285967638,10261251245,-5671,,
2380150254,10261507843,2286218556,10261502142,-5701,,
2380400848,10261758437,2286469150,10261752736,-5701,,
2380651585,10262009164,2286719876,10262003462,-5702,,
2380902294,10262259873,2286970585,10262254172,-5701,,
2381152525,10262510104,2287220827,10262504413,-5691,,
2381170641,10262528219,2287238931,10262522518,-5701,10262522585,
2381420870,10262778449,2287489172,10262772775,-5674,,
2381671306,10263028885,2287739598,10263023219,-5666,,
2381921942,10263279520,2287990233,10263273870,-5650,,
2382172029,10263529618,2288240331,10263523985,-5633,,
2382422730,10263780319,2288491032,10263774686,-5633,,
2382673081,10264030660,2288741372,10264025027,-5633,,
2382923432,10264281011,2288991723,10264275378,-5633,,
2383173666,10264531245,2289241958,10264525612,-5633,,
2383191675,10264549253,2289259966,10264543620,-5633,10264543611,
2383441938,10264799517,2289510240,10264793893,-5624,,
2383692145,10265049724,2289760437,10265044089,-5635,,
2383942439,10265300018,2290010731,10265294380,-5638,,
2384193269,10265550848,2290261571,10265545219,-5629,,
2384443730,10265801309,2290512021,10265795669,-5640,,
2384693972,10266051551,2290762263,10266045910,-5641,,
2384944339,10266301918,2291012630,10266296278,-5640,,
2385195066,10266552644,2291263357,10266547005,-5639,,
2385213249,10266570828,2291281540,10266565187,-5641,10266565179,
2385463428,10266821007,2291531719,10266815365,-5642,,
2385713738,10267071317,2291782030,10267065673,-5644,,
2385964375,10267321954,2292032666,10267316309,-5645,,
2386214974,10267572564,2292283276,10267566917,-5647,,
2386465410,10267822989,2292533701,10267817342,-5647,,
2386715612,10268073191,2292783914,10268067554,-5637,,
2386965782,10268323360,2293034073,10268317713,-5647,,
2387216367,10268573946,2293284658,10268568309,-5637,,
2387234494,10268592072,2293302784,10268586425,-5647,10268586313,
2387484687,10268842266,2293552978,10268836590,-5676,,
2387735130,10269092708,2293803421,10269087006,-5702,,
2387985382,10269342960,2294053673,10269337230,-5730,,
2388235627,10269593205,2294303929,10269587459,-5746,,
2388485967,10269843545,2294554258,10269837788,-5757,,
2388736644,10270094222,2294804935,10270088465,-5757,,
2388986938,10270344527,2295055240,10270338770,-5757,,
2389237247,10270594826,2295305548,10270589079,-5747,,
2389255908,10270613486,2295324199,10270607729,-5757,10270608080,
2389506374,10270863952,2295574665,10270858283,-5669,,
2389756750,10271114328,2295825041,10271108747,-5581,,
2390006886,10271364465,2296075177,10271358973,-5492,,
2390257113,10271614692,2296325405,10271609297,-5395,,
2390507668,10271865247,2296575959,10271859841,-5406,,
2390757858,10272115436,2296826149,10272110031,-5405,,
2391008029,10272365608,2297076320,10272360213,-5395,,
2391258650,10272616229,2297326941,10272610834,-5395,,
2391276763,10272634341,2297345054,10272628936,-5405,10272628624,
2391527056,10272884634,2297595347,10272879151,-5483,,
2391777204,10273134783,2297845495,10273129233,-5550,,
2392027485,10273385064,2298095776,10273379426,-5638,,
2392277812,10273635391,2298346113,10273629686,-5705,,
2392528002,10273885581,2298596293,10273879866,-5715,,
2392778411,10274136000,2298846712,10274130285,-5715,,
2393029045,10274386624,2299097337,10274380909,-5715,,
2393279391,10274636971,2299347683,10274631256,-5715,,
2393297413,10274654992,2299365704,10274649276,-5716,10274649317,
2393547724,10274905303,2299616015,10274899597,-5706,,
2393798218,10275155797,2299866510,10275150102,-5695,,
2394048741,10275406319,2300117032,10275400635,-5684,,
2394299041,10275656621,2300367333,10275650948,-5673,,
2394549178,10275906757,2300617469,10275901084,-5673,,
2394799646,10276157225,2300867938,10276151552,-5673,,
2395050282,10276407860,2301118573,10276402187,-5673,,
2395300597,10276658176,2301368888,10276652502,-5674,,
2395318634,10276676212,2301386924,10276670538,-5674,10276670527,
2395569203,10276926782,2301637494,10276921105,-5677,,
2395819680,10277177259,2301887972,10277171580,-5679,,
2396069929,10277427508,2302138220,10277421827,-5681,,
2396320468,10277678047,2302388760,10277672364,-5683,,
2396570588,10277928166,2302638879,10277922483,-5683,,
2396820703,10278178282,2302888994,10278172599,-5683,,
2397071240,10278428818,2303139531,10278423135,-5683,,
2397322205,10278679784,2303390497,10278674111,-5673,,
2397340322,10278697901,2303408613,10278692217,-5684,10278692154,
2397590994,10278948574,2303659286,10278942875,-5699,,
2397841177,10279198756,2303909468,10279193042,-5714,,
2398091664,10279449242,2304159955,10279443522,-5720,,
2398341965,10279699553,2304410266,10279693808,-5745,,
2398592590,10279950168,2304660891,10279944434,-5734,,
2398843291,10280200870,2304911582,10280195124,-5746,,
2399093548,10280451126,2305161839,10280445381,-5745,,
2399343756,10280701334,2305412047,10280695589,-5745,,
2399361809,10280719387,2305430099,10280713642,-5745,10280713714,
2399612432,10280970011,2305680724,10280964284,-5727,,
2399862555,10281220134,2305930847,10281214426,-5708,,
2400112806,10281470384,2306181097,10281464705,-5679,,
2400362917,10281720496,2306431209,10281714826,-5670,,
2400613804,10281971382,2306682095,10281965721,-5661,,
2400864410,10282221988,2306932701,10282216317,-5671,,
2401114730,10282472319,2307183032,10282466648,-5671,,
2401365137,10282722716,2307433428,10282717045,-5671,,
2401383198,10282740776,2307451489,10282735105,-5671,10282735141,
2401633711,10282991290,2307702002,10282985628,-5662,,
2401884035,10283241613,2307952326,10283235960,-5653,,
2402134441,10283492020,2308202733,10283486377,-5643,,
2402384736,10283742314,2308453026,10283736680,-5634,,
2402635625,10283993205,2308703917,10283987571,-5634,,
2402886309,10284243887,2308954600,10284238253,-5634,,
2403136826,10284494405,2309205128,10284488781,-5624,,
2403387268,10284744846,2309455559,10284739212,-5634,,
2403405337,10284762915,2309473627,10284757280,-5635,10284757232,
2403655879,10285013458,2309724170,10285007822,-5636,,
2403906137,10285263715,2309974428,10285258057,-5658,,
2404156605,10285514184,2310224897,10285508515,-5669,,
2404407240,10285764819,2310475531,10285759138,-5681,,
2404657525,10286015104,2310725817,10286009423,-5681,,
2404907963,10286265541,2310976254,10286259860,-5681,,
2405158074,10286515663,2311226375,10286509981,-5682,,
2405408669,10286766248,2311476961,10286760567,-5681,,
2405426726,10286784304,2311495017,10286778623,-5681,10286778629,
2405677358,10287034937,2311745650,10287029259,-5678,,
2405927524,10287285103,2311995815,10287279426,-5677,,
2406177906,10287535485,2312246208,10287529820,-5665,,
2406428091,10287785670,2312496382,10287779996,-5674,,
2406678643,10288036222,2312746935,10288030550,-5672,,
2406928804,10288286383,2312997096,10288280710,-5673,,
2407179068,10288536647,2313247369,10288530984,-5663,,
2407429402,10288786981,2313497693,10288781308,-5673,,
2407447412,10288804991,2313515703,10288799317,-5674,10288799293,
2407697492,10289055071,2313765784,10289049391,-5680,,
2407948092,10289305671,2314016383,10289299986,-5685,,
2408198394,10289555982,2314266695,10289550291,-5691,,
2408449120,10289806698,2314517411,10289801002,-5696,,
2408699335,10290056914,2314767627,10290051218,-5696,,
2408949539,10290307118,2315017830,10290301422,-5696,,
2409199930,10290557509,2315268222,10290551823,-5686,,
2409450694,10290808273,2315518985,10290802577,-5696,,
2409468705,10290826283,2315536995,10290820587,-5696,10290820503,
2409719317,10291076895,2315787608,10291071178,-5717,,
2409969548,10291327127,2316037839,10291321389,-5738,,
2410220019,10291577597,2316288310,10291571839,-5758,,
2410470139,10291827717,2316538440,10291821950,-5767,,
2410720513,10292078092,2316788805,10292072314,-5778,,
2410970654,10292328232,2317038945,10292322454,-5778,,
2411220962,10292578540,2317289252,10292572762,-5778,,
2411471173,10292828752,2317539464,10292822974,-5778,,
2411489347,10292846925,2317557637,10292841147,-5778,10292841226,
2411739918,10293097496,2317808209,10293091738,-5758,,
2411990562,10293348141,2318058853,10293342403,-5738,,
2412240737,10293598316,2318309028,10293592599,-5717,,
2412491272,10293848850,2318559573,10293843164,-5686,,
2412741540,10294099119,2318809831,10294093422,-5697,,
2412991762,10294349341,2319060053,10294343644,-5697,,
2413242123,10294599702,2319310414,10294594005,-5697,,
2413492302,10294849891,2319560603,10294844194,-5697,,
2413510533,10294868112,2319578824,10294862415,-5697,10294862345,
2413761196,10295118775,2319829487,10295113060,-5715,,
2414011399,10295368978,2320079690,10295363246,-5732,,
2414262077,10295619655,2320330368,10295613907,-5748,,
2414512674,10295870253,2320580977,10295864499,-5754,,
2414763078,10296120657,2320831370,10296114893,-5764,,
2415013859,10296371438,2321082160,10296365683,-5755,,
2415264578,10296622157,2321332869,10296616402,-5755,,
2415515038,10296872617,2321583329,10296866852,-5765,,
2415533063,10296890642,2321601354,10296884876,-5766,10296884982,
2415783158,10297140736,2321851449,10297134998,-5738,,
2416033385,10297390963,2322101676,10297385252,-5711,,
2416283654,10297641232,2322351944,10297635548,-5684,,
2416534054,10297891643,2322602355,10297885985,-5658,,
2416784219,10298141797,2322852510,10298136139,-5658,,
2417034601,10298392179,2323102892,10298386521,-5658,,
2417285190,10298642768,2323353480,10298637110,-5658,,
2417535576,10298893165,2323603878,10298887507,-5658,,
2417553723,10298911301,2323622013,10298905643,-5658,10298905578,
2417804147,10299161726,2323872438,10299156062,-5664,,
2418054482,10299412060,2324122773,10299406370,-5690,,
2418305255,10299662834,2324373547,10299657128,-5706,,
2418555759,10299913338,2324624050,10299907617,-5721,,
2418806420,10300163999,2324874721,10300158288,-5711,,
2419056913,10300414492,2325125205,10300408771,-5721,,
2419307079,10300664658,2325375370,10300658947,-5711,,
2419557413,10300915002,2325625714,10300909281,-5721,,
2419575482,10300933061,2325643773,10300927340,-5721,10300927326,
2419825755,10301183333,2325894046,10301177609,-5724,,
2420075923,10301433501,2326144214,10301427774,-5727,,
2420326494,10301684073,2326394785,10301678343,-5730,,
2420577124,10301934703,2326645415,10301928980,-5723,,
2420827274,10302184867,2326895579,10302179134,-5733,,
2421077557,10302435136,2327145848,10302429402,-5734,,
2421328085,10302685663,2327396376,10302679930,-5733,,
2421578282,10302935860,2327646572,10302930127,-5733,,
2421596427,10302954005,2327664718,10302948272,-5733,10302948282,
2421847033,10303204612,2327915324,10303198882,-5730,,
2422097622,10303455200,2328165913,10303449473,-5727,,
2422347996,10303705574,2328416287,10303699850,-5724,,
2422598476,10303956055,2328666767,10303950334,-5721,,
2422848927,10304206516,2328917229,10304200796,-5720,,
2423099593,10304457171,2329167884,10304451450,-5721,,
2423350010,10304707588,2329418301,10304701867,-5721,,
2423600126,10304957705,2329668417,10304951983,-5722,,
2423618386,10304975964,2329686677,10304970243,-5721,10304970227,
2423868805,10305226383,2329937096,10305220658,-5725,,
2424119245,10305476824,2330187536,10305471095,-5729,,
2424369413,10305726991,2330437704,10305721259,-5732,,
2424619587,10305977166,2330687879,10305971430,-5736,,
2424869931,10306227520,2330938232,10306221784,-5736,,
2425120349,10306477928,2331188640,10306472192,-5736,,
2425370464,10306728042,2331438755,10306722306,-5736,,
2425621461,10306979040,2331689753,10306973304,-5736,,
2425639862,10306997440,2331708153,10306991704,-5736,10306991662,
2425890337,10307247916,2331958628,10307242169,-5747,,
2426140939,10307498518,2332209230,10307492760,-5758,,
2426391083,10307748661,2332459374,10307742894,-5767,,
2426641191,10307998770,2332709482,10307993003,-5767,,
2426891744,10308249323,2332960035,10308243545,-5778,,
2427142123,10308499701,2333210413,10308493924,-5777,,
2427392690,10308750268,2333460980,10308744491,-5777,,
2427642970,10309000550,2333711262,10308994773,-5777,,
2427661054,10309018632,2333729344,10309012855,-5777,10309012890,
2427911264,10309268842,2333979555,10309263073,-5769,,
2428161671,10309519250,2334229962,10309513491,-5759,,
2428412118,10309769697,2334480409,10309763946,-5751,,
2428662762,10310020340,2334731053,10310014599,-5741,,
2428913329,10310270908,2334981620,10310265167,-5741,,
2429163566,10310521145,2335231857,10310515403,-5742,,
2429413908,10310771487,2335482199,10310765746,-5741,,
2429664597,10311022176,2335732889,10311016436,-5740,,
2429682700,10311040278,2335750990,10311034537,-5741,10311034495,
2429933244,10311290823,2336001535,10311285081,-5742,,
2430183806,10311541385,2336252097,10311535624,-5761,,
2430433953,10311791531,2336502244,10311785760,-5771,,
2430684129,10312041708,2336752420,10312035927,-5781,,
2430934249,10312291838,2337002550,10312286056,-5782,,
2431184509,10312542088,2337252800,10312536306,-5782,,
2431435120,10312792699,2337503422,10312786928,-5771,,
2431685308,10313042888,2337753601,10313037107,-5781,,
2431703489,10313061067,2337771780,10313055286,-5781,10313055324,
2431954193,10313311773,2338022485,10313306001,-5772,,
2432204874,10313562453,2338273165,10313556690,-5763,,
2432455193,10313812782,2338523495,10313807030,-5752,,
2432705727,10314063306,2338774018,10314057564,-5742,,
2432956315,10314313904,2339024616,10314308162,-5742,,
2433206899,10314564477,2339275190,10314558735,-5742,,
2433457117,10314814695,2339525408,10314808963,-5732,,
2433707332,10315064911,2339775624,10315059170,-5741,,
2433725632,10315083211,2339793923,10315077468,-5743,10315077427,
2433975855,10315333433,2340044146,10315327690,-5743,,
2434226194,10315583773,2340294485,10315578011,-5762,,
2434476382,10315833961,2340544683,10315828199,-5762,,
2434726560,10316084139,2340794852,10316078357,-5782,,
2434976945,10316334523,2341045236,10316328752,-5771,,
2435227149,10316584728,2341295440,10316578945,-5783,,
2435477394,10316834983,2341545696,10316829201,-5782,,
2435728054,10317085634,2341796346,10317079852,-5782,,
2435746220,10317103799,2341814511,10317098016,-5783,10317098045,
2435996720,10317354299,2342065012,10317348524,-5775,,
2436247095,10317604674,2342315387,10317598907,-5767,,
2436497442,10317855021,2342565734,10317849262,-5759,,
2436747979,10318105558,2342816270,10318099806,-5752,,
2436998307,10318355885,2343066598,10318350134,-5751,,
2437248458,10318606036,2343316749,10318600284,-5752,,
2437498807,10318856396,2343567109,10318850644,-5752,,
2437749007,10319106586,2343817299,10319100835,-5751,,
2437767104,10319124682,2343835395,10319118930,-5752,10319118850,
2438017305,10319374884,2344085596,10319369122,-5762,,
2438267471,10319625050,2344335762,10319619259,-5791,,
2438517618,10319875197,2344585919,10319869396,-5801,,
2438767764,10320125342,2344836055,10320119512,-5830,,
2439018138,10320375717,2345086440,10320369897,-5820,,
2439268251,10320625829,2345336542,10320620010,-5819,,
2439518481,10320876059,2345586783,10320870240,-5819,,
2439769018,10321126607,2345837320,10321120777,-5830,,
2439787127,10321144705,2345855418,10321138875,-5830,10321138913,
2440037727,10321395305,2346106017,10321389485,-5820,,
2440288112,10321645691,2346356403,10321639881,-5810,,
2440538448,10321896026,2346606739,10321890226,-5800,,
2440789015,10322146593,2346857306,10322140803,-5790,,
2441039260,10322396839,2347107551,10322391049,-5790,,
2441289630,10322647209,2347357921,10322641419,-5790,,
2441540001,10322897590,2347608303,10322891800,-5790,,
2441790435,10323148013,2347858726,10323142223,-5790,,
2441808504,10323166082,2347876795,10323160292,-5790,10323160313,
2442058801,10323416379,2348127092,10323410594,-5785,,
2442309195,10323666774,2348377486,10323660995,-5779,,
2442559755,10323917344,2348628056,10323911570,-5774,,
2442810612,10324168191,2348878903,10324162423,-5768,,
2443061103,10324418681,2349129394,10324412913,-5768,,
2443311644,10324669223,2349379935,10324663466,-5757,,
2443562320,10324919899,2349630622,10324914142,-5757,,
2443813164,10325170752,2349881465,10325164984,-5768,,
2443831486,10325189064,2349899776,10325183296,-5768,10325183292,
2444081756,10325439335,2350150047,10325433566,-5769,,
2444332180,10325689759,2350400471,10325683990,-5769,,
2444582678,10325940267,2350650979,10325934498,-5769,,
2444833227,10326190806,2350901518,10326185036,-5770,,
2445083449,10326441027,2351151740,10326435257,-5770,,
2445333683,10326691262,2351401974,10326685492,-5770,,
2445584164,10326941742,2351652465,10326935982,-5760,,
2445834585,10327192163,2351902876,10327186393,-5770,,
2445852975,10327210553,2351921266,10327204783,-5770,10327204855,
2446103457,10327461035,2352171748,10327455284,-5751,,
2446353778,10327711357,2352422070,10327705624,-5733,,
2446604204,10327961793,2352672506,10327956079,-5714,,
2446854748,10328212327,2352923040,10328206631,-5696,,
2447104941,10328462519,2353173232,10328456823,-5696,,
2447355106,10328712684,2353423407,10328706998,-5686,,
2447605572,10328963161,2353673874,10328957465,-5696,,
2447856553,10329214142,2353924855,10329208447,-5695,,
2447874607,10329232185,2353942898,10329226489,-5696,10329226395,
2448125224,10329482803,2354193515,10329477083,-5720,,
2448375677,10329733266,2354443978,10329727524,-5742,,
2448626137,10329983716,2354694439,10329977961,-5755,,
2448876320,10330233898,2354944611,10330228110,-5788,,
2449126513,10330484092,2355194804,10330478303,-5789,,
2449377115,10330734693,2355445405,10330728905,-5788,,
2449627251,10330984830,2355695543,10330979042,-5788,,
2449877915,10331235494,2355946207,10331229706,-5788,,
2449895980,10331253558,2355964271,10331247770,-5788,10331247717,
2450146207,10331503786,2356214498,10331497984,-5802,,
2450396371,10331753950,2356464663,10331748135,-5815,,
2450646576,10332004156,2356714868,10331998329,-5827,,
2450896891,10332254470,2356965193,10332248641,-5829,,
2451147711,10332505290,2357216002,10332499450,-5840,,
2451397810,10332755389,2357466101,10332749549,-5840,,
2451648135,10333005714,2357716426,10332999874,-5840,,
2451898256,10333255834,2357966546,10333249994,-5840,,
2451916479,10333274057,2357984769,10333268217,-5840,10333268146,
2452166889,10333524467,2358235180,10333518610,-5857,,
2452417712,10333775290,2358486003,10333769415,-5875,,
2452667910,10334025490,2358736202,10334019598,-5892,,
2452918736,10334276314,2358987027,10334270405,-5909,,
2453169414,10334526992,2359237705,10334521083,-5909,,
2453420076,10334777655,2359488367,10334771746,-5909,,
2453670528,10335028107,2359738820,10335022198,-5909,,
2453920752,10335278330,2359989043,10335272421,-5909,,
2453938814,10335296392,2360007105,10335290483,-5909,10335290463,
2454189170,10335546748,2360257461,10335540834,-5914,,
2454439700,10335797279,2360507991,10335791361,-5918,,
2454690283,10336047862,2360758575,10336041939,-5923,,
2454940866,10336298455,2361009168,10336292528,-5927,,
2455191216,10336548795,2361259507,10336542867,-5928,,
2455441739,10336799318,2361510030,10336793390,-5928,,
2455691990,10337049569,2361760282,10337043642,-5927,,
2455942280,10337299858,2362010571,10337293931,-5927,,
2455960284,10337317862,2362028575,10337311935,-5927,10337311961,
2456210589,10337568168,2362278880,10337562247,-5921,,
2456460770,10337818348,2362529061,10337812434,-5914,,
2456711000,10338068580,2362779293,10338062673,-5907,,
2456961355,10338318944,2363029657,10338313044,-5900,,
2457211485,10338569063,2363279776,10338563163,-5900,,
2457462072,10338819651,2363530363,10338813750,-5901,,
2457712179,10339069768,2363780480,10339063868,-5900,,
2457962565,10339320144,2364030856,10339314243,-5901,,
2457980532,10339338110,2364048823,10339332210,-5900,10339332241,
2458231170,10339588749,2364299461,10339582856,-5893,,
2458481357,10339838936,2364549648,10339833051,-5885,,
2458731749,10340089328,2364800041,10340083451,-5877,,
2458981903,10340339482,2365050195,10340333624,-5858,,
2459232531,10340590109,2365300822,10340584241,-5868,,
2459482854,10340840432,2365551145,10340834564,-5868,,
2459733331,10341090911,2365801624,10341085043,-5868,,
2459983502,10341341081,2366051793,10341335213,-5868,,
2460003315,10341360894,2366071606,10341355025,-5869,10341354133,
2460254012,10341611590,2366322303,10341605498,-6092,,
2460504505,10341862084,2366572797,10341855769,-6315,,
2460755150,10342112729,2366823442,10342106191,-6538,,
2461005439,10342363018,2367073731,10342356259,-6759,,
2461255933,10342613511,2367324224,10342606752,-6759,,
2461506243,10342863821,2367574533,10342857062,-6759,,
2461756415,10343113994,2367824707,10343107235,-6759,,
2462006508,10343364086,2368074799,10343357337,-6749,,
2462024537,10343382115,2368092827,10343375356,-6759,10343376254,
2462275017,10343632596,2368343308,10343626054,-6542,,
2462525207,10343882785,2368593498,10343876471,-6314,,
2462776015,10344133595,2368844308,10344127509,-6086,,
2463026149,10344383727,2369094440,10344377867,-5860,,
2463276241,10344633820,2369344532,10344627960,-5860,,
2463526609,10344884187,2369594900,10344878327,-5860,,
2463777682,10345135271,2369845984,10345129411,-5860,,
2464027840,10345385418,2370096131,10345379558,-5860,,
2464045855,10345403433,2370114146,10345397573,-5860,10345397575,
2464296056,10345653635,2370364347,10345647774,-5861,,
2464546914,10345904492,2370615204,10345898633,-5859,,
2464797342,10346154921,2370865634,10346149063,-5858,,
2465047906,10346405484,2371116197,10346399627,-5857,,
2465298083,10346655662,2371366374,10346649805,-5857,,
2465548949,10346906528,2371617240,10346900670,-5858,,
2465799227,10347156805,2371867518,10347150958,-5847,,
2466049363,10347406952,2372117665,10347401095,-5857,,
2466067405,10347424983,2372135696,10347419126,-5857,10347419055,
2466317810,10347675389,2372386101,10347669514,-5875,,
2466568078,10347925657,2372636370,10347919765,-5892,,
2466818549,10348176128,2372886841,10348170220,-5908,,
2467068943,10348426522,2373137235,10348420596,-5926,,
2467319034,10348676613,2373387326,10348670687,-5926,,
2467569572,10348927151,2373637863,10348921225,-5926,,
2467819697,10349177276,2373887998,10349171359,-5917,,
2468070077,10349427655,2374138378,10349421739,-5916,,
2468088117,10349445696,2374156408,10349439769,-5927,10349439713,
2468338409,10349695988,2374406701,10349690047,-5941,,
2468588699,10349946278,2374656990,10349940323,-5955,,
2468838907,10350196486,2374907198,10350190518,-5968,,
2469089141,10350446720,2375157432,10350440739,-5981,,
2469339911,10350697490,2375408202,10350691509,-5981,,
2469590260,10350947839,2375658551,10350941857,-5982,,
2469840468,10351198047,2375908760,10351192066,-5981,,
2470090819,10351448398,2376159120,10351442426,-5972,,
2470109004,10351466582,2376177294,10351460600,-5982,10351460727,
2470359611,10351717189,2376427902,10351711240,-5949,,
2470609947,10351967526,2376678238,10351961609,-5917,,
2470860064,10352217653,2376928366,10352211768,-5885,,
2471110574,10352468162,2377178875,10352462309,-5853,,
2471360893,10352718471,2377429184,10352712629,-5842,,
2471611235,10352968813,2377679526,10352962960,-5853,,
2471861522,10353219100,2377929813,10353213247,-5853,,
2472111841,10353469419,2378180142,10353463577,-5842,,
2472129939,10353487517,2378198229,10353481663,-5854,10353481599,
2472380150,10353737729,2378448441,10353731860,-5869,,
2472630437,10353988016,2378698728,10353982131,-5885,,
2472880560,10354238139,2378948852,10354232238,-5901,,
2473130830,10354488419,2379199132,10354482503,-5916,,
2473381037,10354738626,2379449339,10354732710,-5916,,
2473631514,10354989093,2379699805,10354983177,-5916,,
2473881968,10355239547,2379950259,10355233640,-5907,,
2474132292,10355489871,2380200583,10355483954,-5917,,
2474150178,10355507756,2380218468,10355501840,-5916,10355501894,
2474400307,10355757886,2380468599,10355751984,-5902,,
2474651070,10356008649,2380719361,10356002760,-5889,,
2474901684,10356259263,2380969976,10356253389,-5874,,
2475151816,10356509405,2381220118,10356503546,-5859,,
2475402191,10356759770,2381470482,10356753910,-5860,,
2475652813,10357010392,2381721104,10357004532,-5860,,
2475903292,10357260871,2381971583,10357255021,-5850,,
2476153479,10357511058,2382221770,10357505208,-5850,,
2476171434,10357529012,2382239724,10357523152,-5860,10357523134,
2476421999,10357779578,2382490290,10357773714,-5864,,
2476672834,10358030413,2382741125,10358024545,-5868,,
2476923352,10358280931,2382991643,10358275059,-5872,,
2477173515,10358531104,2383241816,10358525227,-5877,,
2477423967,10358781546,2383492258,10358775670,-5876,,
2477674236,10359031814,2383742538,10359025949,-5865,,
2477924788,10359282367,2383993079,10359276491,-5876,,
2478174913,10359532492,2384243204,10359526626,-5866,,
2478192911,10359550490,2384261202,10359544613,-5877,10359544539,
2478443429,10359801008,2384511721,10359795113,-5895,,
2478693639,10360051218,2384761930,10360045304,-5914,,
2478944508,10360302087,2385012799,10360296156,-5931,,
2479195134,10360552723,2385263436,10360546774,-5949,,
2479445251,10360802830,2385513542,10360796881,-5949,,
2479695698,10361053277,2385763990,10361047328,-5949,,
2479946252,10361303830,2386014543,10361297881,-5949,,
2480196392,10361553971,2386264683,10361548022,-5949,,
2480214393,10361571972,2386282684,10361566022,-5950,10361566118,
2480464749,10361822328,2386533040,10361816402,-5926,,
2480715580,10362073158,2386783871,10362067257,-5901,,
2480965733,10362323312,2387034024,10362317434,-5878,,
2481216166,10362573745,2387284457,10362567893,-5852,,
2481466270,10362823849,2387534561,10362817997,-5852,,
2481716597,10363074177,2387784889,10363068325,-5852,,
2481966786,10363324365,2388035077,10363318513,-5852,,
2482217707,10363575286,2388285998,10363569445,-5841,,
2482235779,10363593358,2388304070,10363587505,-5853,10363587448,
2482486719,10363844297,2388555010,10363838430,-5867,,
2482736885,10364094464,2388805176,10364088583,-5881,,
2482987701,10364345279,2389055992,10364339385,-5894,,
2483238024,10364595603,2389306315,10364589695,-5908,,
2483488778,10364846357,2389557070,10364840449,-5908,,
2483739145,10365096725,2389807437,10365090817,-5908,,
2483989603,10365347181,2390057894,10365341273,-5908,,
2484239718,10365597296,2390308008,10365591388,-5908,,
2484257739,10365615317,2390326029,10365609409,-5908,10365609402,
2484507966,10365865545,2390576257,10365859635,-5910,,
2484758654,10366116233,2390826945,10366110321,-5912,,
2485009328,10366366918,2391077630,10366361005,-5913,,
2485260058,10366617637,2391328350,10366611724,-5913,,
2485510166,10366867755,2391578467,10366861842,-5913,,
2485761028,10367118607,2391829320,10367112694,-5913,,
2486011157,10367368736,2392079449,10367362823,-5913,,
2486261328,10367618907,2392329619,10367612994,-5913,,
2486279387,10367636966,2392347678,10367631053,-5913,10367630995,
2486529694,10367887272,2392597984,10367881345,-5927,,
2486779805,10368137383,2392848096,10368131442,-5941,,
2487030038,10368387628,2393098340,10368381672,-5956,,
2487280172,10368637751,2393348463,10368631793,-5958,,
2487530520,10368888099,2393598821,10368882140,-5959,,
2487781066,10369138645,2393849358,10369132677,-5968,,
2488031544,10369389123,2394099835,10369383154,-5969,,
2488281653,10369639232,2394349944,10369633263,-5969,,
2488299636,10369657214,2394367926,10369651245,-5969,10369651265,
2488549806,10369907385,2394618098,10369901422,-5963,,
2488800307,10370157885,2394868598,10370151927,-5958,,
2489050814,10370408404,2395119117,10370402452,-5952,,
2489301585,10370659164,2395369876,10370653216,-5948,,
2489552204,10370909794,2395620506,10370903847,-5947,,
2489802492,10371160072,2395870784,10371154125,-5947,,
2490052800,10371410379,2396121102,10371404442,-5937,,
2490303331,10371660909,2396371621,10371654962,-5947,,
2490321382,10371678960,2396389673,10371673013,-5947,10371672989,
2490571685,10371929264,2396639986,10371923322,-5942,,
2490822168,10372179747,2396890459,10372173789,-5958,,
2491072471,10372430050,2397140763,10372424087,-5963,,
2491323281,10372680860,2397391572,10372674891,-5969,,
2491574283,10372931862,2397642574,10372925893,-5969,,
2491824494,10373182073,2397892785,10373176104,-5969,,
2492074979,10373432558,2398143271,10373426590,-5968,,
2492325249,10373682828,2398393541,10373676859,-5969,,
2492343388,10373700967,2398411679,10373694998,-5969,10373695087,
2492593615,10373951193,2398661906,10373945246,-5947,,
2492843996,10374201575,2398912288,10374195651,-5924,,
2493094167,10374451746,2399162458,10374445845,-5901,,
2493344971,10374702550,2399413262,10374696672,-5878,,
2493595387,10374952966,2399663679,10374947088,-5878,,
2493845973,10375203552,2399914274,10375197684,-5868,,
2494096403,10375453982,2400164694,10375448103,-5879,,
2494346627,10375704206,2400414918,10375698328,-5878,,
2494364635,10375722214,2400432926,10375716335,-5879,10375716249,
2494615162,10375972740,2400683453,10375966840,-5900,,
2494865489,10376223067,2400933780,10376217146,-5921,,
2495116022,10376473600,2401184313,10376467658,-5942,,
2495366233,10376723812,2401434524,10376717849,-5963,,
2495616538,10376974116,2401684829,10376968153,-5963,,
2495867538,10377225117,2401935830,10377219154,-5963,,
2496117914,10377475492,2402186205,10377469529,-5963,,
2496368260,10377725839,2402436551,10377719875,-5964,,
2496386409,10377743987,2402454699,10377738023,-5964,10377737993,
2496636538,10377994116,2402704829,10377988145,-5971,,
2496887328,10378244917,2402955630,10378238939,-5978,,
2497137440,10378495019,2403205731,10378489034,-5985,,
2497387968,10378745547,2403456260,10378739555,-5992,,
2497638319,10378995898,2403706610,10378989906,-5992,,
2497888919,10379246509,2403957221,10379240517,-5992,,
2498139125,10379496703,2404207416,10379490711,-5992,,
2498389512,10379747091,2404457803,10379741099,-5992,,
2498407707,10379765286,2404475998,10379759294,-5992,10379759475,
2498657940,10380015518,2404726231,10380009571,-5947,,
2498908443,10380266022,2404976735,10380260122,-5900,,
2499159078,10380516657,2405227369,10380510802,-5855,,
2499409200,10380766778,2405477491,10380760980,-5798,,
2499659830,10381017409,2405728122,10381011600,-5809,,
2499910205,10381267785,2405978497,10381261976,-5809,,
2500160826,10381518405,2406229118,10381512596,-5809,,
2500410962,10381768540,2406479252,10381762731,-5809,,
2500428947,10381786525,2406497238,10381780716,-5809,10381780549,
2500679438,10382037017,2406747729,10382031165,-5852,,
2500930001,10382287580,2406998293,10382281687,-5893,,
2501180184,10382537762,2407248475,10382531828,-5934,,
2501430630,10382788209,2407498921,10382782234,-5975,,
2501681305,10383038884,2407749596,10383032908,-5976,,
2501931571,10383289150,2407999863,10383283175,-5975,,
2502181737,10383539316,2408250028,10383533341,-5975,,
2502432029,10383789608,2408500320,10383783632,-5976,,
2502450066,10383807645,2408518357,10383801669,-5976,10383801618,
2502700260,10384057839,2408768552,10384051851,-5988,,
2502950696,10384308275,2409018988,10384302275,-6000,,
2503200972,10384558550,2409269263,10384552537,-6013,,
2503451187,10384808765,2409519478,10384802740,-6025,,
2503701731,10385059310,2409770022,10385053284,-6026,,
2503952498,10385310077,2410020790,10385304052,-6025,,
2504203033,10385560612,2410271325,10385554587,-6025,,
2504453705,10385811284,2410521996,10385805259,-6025,,
2504471655,10385829234,2410539946,10385823208,-6026,10385823248,
2504722246,10386079825,2410790538,10386073809,-6016,,
2504972858,10386330437,2411041150,10386324433,-6004,,
2505222987,10386580566,2411291278,10386574571,-5995,,
2505473205,10386830783,2411541496,10386824799,-5984,,
2505723515,10387081094,2411791806,10387075120,-5974,,
2505973712,10387331292,2412042004,10387325307,-5985,,
2506223866,10387581445,2412292157,10387575461,-5984,,
2506474662,10387832241,2412542953,10387826256,-5985,,
2506492794,10387850372,2412561084,10387844387,-5985,10387844427,
2506742971,10388100550,2412811263,10388094575,-5975,,
2506993124,10388350703,2413061415,10388344738,-5965,,
2507243620,10388601199,2413311911,10388595245,-5954,,
2507494049,10388851627,2413562339,10388845684,-5943,,
2507745075,10389102654,2413813366,10389096710,-5944,,
2507995847,10389353435,2414064148,10389347493,-5942,,
2508246013,10389603592,2414314304,10389597649,-5943,,
2508496153,10389853731,2414564444,10389847788,-5943,,
2508514386,10389871965,2414582677,10389866021,-5944,10389865941,
2508765083,10390122662,2414833375,10390116698,-5964,,
2509015724,10390373302,2415084015,10390367318,-5984,,
2509265922,10390623501,2415334213,10390617497,-6004,,
2509516971,10390874550,2415585262,10390868528,-6022,,
2509767359,10391124938,2415835650,10391118916,-6022,,
2510017595,10391375183,2416085896,10391369161,-6022,,
2510267987,10391625566,2416336278,10391619543,-6023,,
2510518691,10391876269,2416586982,10391870247,-6022,,
2510536767,10391894346,2416605058,10391888323,-6023,10391888368,
2510787006,10392144585,2416855298,10392138575,-6010,,
2511037734,10392395323,2417106035,10392389324,-5999,,
2511288283,10392645862,2417356574,10392639875,-5987,,
2511538435,10392896014,2417606727,10392890049,-5965,,
2511789120,10393146699,2417857411,10393140723,-5976,,
2512039597,10393397176,2418107898,10393391210,-5966,,
2512289821,10393647399,2418358112,10393641423,-5976,,
2512540115,10393897693,2418608406,10393891717,-5976,,
2512558199,10393915777,2418626490,10393909801,-5976,10393909794,
2512808597,10394166177,2418876889,10394160200,-5977,,
2513058924,10394416503,2419127216,10394410524,-5979,,
2513309397,10394666976,2419377689,10394660996,-5980,,
2513559804,10394917382,2419628095,10394911401,-5981,,
2513809927,10395167505,2419878218,10395161524,-5981,,
2514060334,10395417922,2420128635,10395411941,-5981,,
2514310706,10395668285,2420378997,10395662303,-5982,,
2514561347,10395918925,2420629638,10395912944,-5981,,
2514579454,10395937032,2420647745,10395931051,-5981,10395931108,
2514829805,10396187385,2420898097,10396181419,-5966,,
2515079984,10396437563,2421148276,10396431613,-5950,,
2515330682,10396688261,2421398973,10396682324,-5937,,
2515581507,10396939086,2421649798,10396933164,-5922,,
2515831668,10397189246,2421899959,10397183324,-5922,,
2516082086,10397439665,2422150388,10397433754,-5911,,
2516332695,10397690273,2422400997,10397684362,-5911,,
2516582844,10397940423,2422651146,10397934511,-5912,,
2516600950,10397958528,2422669240,10397952606,-5922,10397952495,
2516851296,10398208875,2422919587,10398202935,-5940,,
2517101774,10398459353,2423170066,10398453377,-5976,,
2517352156,10398709735,2423420458,10398703742,-5993,,
2517602547,10398960125,2423670838,10398954094,-6031,,
2517852675,10399210254,2423920966,10399204222,-6032,,
2518102924,10399460513,2424171225,10399454482,-6031,,
2518353044,10399710633,2424421345,10399704602,-6031,,
2518603447,10399961025,2424671738,10399954994,-6031,,
2518621470,10399979049,2424689761,10399973017,-6032,10399973088,
2518872386,10400229964,2424940677,10400223951,-6013,,
2519122841,10400480420,2425191133,10400474425,-5995,,
2519373578,10400731167,2425441880,10400725190,-5977,,
2519623692,10400981270,2425691983,10400975311,-5959,,
2519873986,10401231564,2425942277,10401225605,-5959,,
2520124100,10401481679,2426192391,10401475719,-5960,,
2520374550,10401732129,2426442841,10401726170,-5959,,
2520625069,10401982647,2426693359,10401976688,-5959,,
2520643231,10402000809,2426711521,10401994850,-5959,10401994829,
2520893750,10402251329,2426962041,10402245364,-5965,,
2521143945,10402501538,2427212250,10402495569,-5969,,
2521394072,10402751651,2427462363,10402745677,-5974,,
2521644724,10403002302,2427713014,10402996324,-5978,,
2521894829,10403252408,2427963120,10403246430,-5978,,
2522145116,10403502695,2428213407,10403496717,-5978,,
2522395813,10403753392,2428464114,10403747424,-5968,,
2522645934,10404003513,2428714225,10403997545,-5968,,
2522663999,10404021577,2428732290,10404015599,-5978,10404015590,
2522914419,10404271998,2428982710,10404266018,-5980,,
2523164747,10404522326,2429233039,10404516345,-5981,,
2523415212,10404772801,2429483513,10404766818,-5983,,
2523666192,10405023770,2429734483,10405017785,-5985,,
2523916478,10405274056,2429984768,10405268071,-5985,,
2524166619,10405524208,2430234921,10405518223,-5985,,
2524417165,10405774744,2430485467,10405768769,-5975,,
2524667728,10406025307,2430736019,10406019321,-5986,,
2524685819,10406043397,2430754110,10406037412,-5985,10406037446,
2524936335,10406293914,2431004626,10406287937,-5977,,
2525187317,10406544896,2431255619,10406538940,-5956,,
2525437855,10406795444,2431506157,10406789486,-5958,,
2525688226,10407045805,2431756517,10407039856,-5949,,
2525938372,10407295951,2432006663,10407290002,-5949,,
2526188534,10407546113,2432256826,10407540164,-5949,,
2526439136,10407796714,2432507427,10407790765,-5949,,
2526689666,10408047244,2432757957,10408041295,-5949,,
2526707793,10408065371,2432776084,10408059422,-5949,10408059362,
2526958209,10408315787,2433026500,10408309823,-5964,,
2527208587,10408566176,2433276889,10408560198,-5978,,
2527458753,10408816332,2433527044,10408810338,-5994,,
2527709442,10409067021,2433777733,10409061014,-6007,,
2527959785,10409317363,2434028076,10409311356,-6007,,
2528210304,10409567893,2434278605,10409561886,-6007,,
2528460458,10409818036,2434528749,10409812029,-6007,,
2528710581,10410068160,2434778872,10410062152,-6008,,
2528728689,10410086267,2434796979,10410080260,-6007,10410080233,
2528979349,10410336927,2435047640,10410330914,-6013,,
2529229866,10410587455,2435298168,10410581436,-6019,,
2529480177,10410837755,2435548468,10410831729,-6026,,
2529730866,10411088446,2435799158,10411082414,-6032,,
2529981249,10411338827,2436049540,10411332795,-6032,,
2530231345,10411588934,2436299646,10411582901,-6033,,
2530481794,10411839372,2436550085,10411833340,-6032,,
2530732241,10412089829,2436800542,10412083798,-6031,,
2530750382,10412107960,2436818672,10412101927,-6033,10412101864,
2531000565,10412358144,2437068856,10412352097,-6047,,
2531250875,10412608453,2437319166,10412602390,-6063,,
2531500988,10412858567,2437569279,10412852488,-6079,,
2531751901,10413109480,2437820193,10413103386,-6094,,
2532002015,10413359594,2438070306,10413353499,-6095,,
2532252413,10413609992,2438320715,10413603908,-6084,,
2532502534,10413860113,2438570826,10413854019,-6094,,
2532753320,10414110898,2438821610,10414104804,-6094,,
2532771406,10414128985,2438839697,10414122890,-6095,10414122983,
2533021664,10414379243,2439089955,10414373171,-6072,,
2533272144,10414629723,2439340435,10414623675,-6048,,
2533522276,10414879855,2439590567,10414873830,-6025,,
2533772546,10415130126,2439840838,10415124126,-6000,,
2534023281,10415380860,2440091572,10415374859,-6001,,
2534273467,10415631060,2440341773,10415625060,-6000,,
2534524149,10415881728,2440592440,10415875727,-6001,,
2534774624,10416132203,2440842926,10416126213,-5990,,
2534792624,10416150202,2440860915,10416144202,-6000,10416144206,
2535042750,10416400328,2441111041,10416394329,-5999,,
2535293351,10416650929,2441361642,10416644931,-5998,,
2535543727,10416901305,2441612018,10416895309,-5996,,
2535794065,10417151644,2441862357,10417145649,-5995,,
2536044274,10417401853,2442112566,10417395858,-5995,,
2536294798,10417652377,2442363089,10417646382,-5995,,
2536545201,10417902780,2442613492,10417896785,-5995,,
2536795592,10418153171,2442863883,10418147175,-5996,,
2536813679,10418171257,2442881970,10418165262,-5995,10418165183,
2537063866,10418421444,2443132157,10418415430,-6014,,
2537314111,10418671689,2443382401,10418665656,-6033,,
2537564363,10418921942,2443632654,10418915889,-6053,,
2537814517,10419172096,2443882809,10419166024,-6072,,
2538065040,10419422618,2444133331,10419416546,-6072,,
2538315868,10419673447,2444384159,10419667375,-6072,,
2538566270,10419923848,2444634561,10419917776,-6072,,
2538816386,10420173964,2444884677,10420167903,-6061,,
2538834529,10420192108,2444902820,10420186036,-6072,10420186107,
2539085106,10420442695,2445153408,10420436641,-6054,,
2539335451,10420693030,2445403742,10420687004,-6026,,
2539585966,10420943545,2445654257,10420937537,-6008,,
2539836414,10421193994,2445904706,10421187995,-5999,,
2540086564,10421444143,2446154866,10421438155,-5988,,
2540337109,10421694687,2446405400,10421688699,-5988,,
2540587258,10421944836,2446655548,10421938837,-5999,,
2540837805,10422195384,2446906097,10422189385,-5999,,
2540855908,10422213487,2446924199,10422207487,-6000,10422207421,
2541106441,10422464020,2447174732,10422458004,-6016,,
2541357194,10422714772,2447425485,10422708740,-6032,,
2541607437,10422965016,2447675728,10422958967,-6049,,
2541857878,10423215467,2447926180,10423209403,-6064,,
2542108383,10423465962,2448176674,10423459897,-6065,,
2542358773,10423716352,2448427065,10423710288,-6064,,
2542609236,10423966814,2448677527,10423960750,-6064,,
2542859838,10424217417,2448928129,10424211352,-6065,,
2542877824,10424235402,2448946114,10424229338,-6064,10424229358,
2543128207,10424485786,2449196498,10424479727,-6059,,
2543378719,10424736297,2449447010,10424730244,-6053,,
2543629271,10424986850,2449697562,10424980802,-6048,,
2543879474,10425237053,2449947765,10425231010,-6043,,
2544129804,10425487383,2450198095,10425481352,-6031,,
2544379952,10425737542,2450448254,10425731500,-6042,,
2544630443,10425988022,2450698735,10425981980,-6042,,
2544880607,10426238186,2450948909,10426232154,-6032,,
2544898666,10426256244,2450966956,10426250202,-6042,10426250152,
2545149027,10426506606,2451217318,10426500552,-6054,,
2545399522,10426757101,2451467813,10426751044,-6057,,
2545649803,10427007383,2451718096,10427001305,-6078,,
2545900565,10427258143,2451968856,10427252053,-6090,,
2546150989,10427508567,2452219280,10427502477,-6090,,
2546401636,10427759215,2452469927,10427753125,-6090,,
2546651757,10428009335,2452720047,10428003245,-6090,,
2546901954,10428259532,2452970245,10428253442,-6090,,
2546920127,10428277705,2452988418,10428271615,-6090,10428271621,
2547170746,10428528325,2453239038,10428522237,-6088,,
2547420959,10428778538,2453489250,10428772450,-6088,,
2547671925,10429029503,2453740216,10429023418,-6085,,
2547922224,10429279803,2453990515,10429273720,-6083,,
2548172461,10429530039,2454240763,10429523967,-6072,,
2548423442,10429781020,2454491733,10429774937,-6083,,
2548673762,10430031341,2454742053,10430025257,-6084,,
2548924083,10430281661,2454992373,10430275578,-6083,,
2548942243,10430299821,2455010533,10430293738,-6083,10430293845,
2549192603,10430550192,2455260905,10430544135,-6057,,
2549442773,10430800351,2455511075,10430794333,-6018,,
2549693369,10431050948,2455761661,10431044946,-6002,,
2549943668,10431301247,2456011959,10431295271,-5976,,
2550193806,10431551384,2456262097,10431545409,-5975,,
2550444178,10431801756,2456512469,10431795781,-5975,,
2550694608,10432052186,2456762898,10432046211,-5975,,
2550944771,10432302349,2457013062,10432296374,-5975,,
2550962909,10432320488,2457031200,10432314512,-5976,10432314416,
2551213038,10432570617,2457281329,10432564629,-5988,,
2551464068,10432821647,2457532360,10432815624,-6023,,
2551714243,10433071821,2457782534,10433065775,-6046,,
2551964972,10433322551,2458033264,10433316482,-6069,,
2552215377,10433572956,2458283668,10433566885,-6071,,
2552466269,10433823848,2458534561,10433817778,-6070,,
2552716942,10434074521,2458785234,10434068451,-6070,,
2552967334,10434324913,2459035626,10434318844,-6069,,
2552985385,10434342963,2459053676,10434336893,-6070,10434336847,
2553235539,10434593119,2459303831,10434587037,-6082,,
2553485853,10434843433,2459554146,10434837340,-6093,,
2553736372,10435093951,2459804664,10435087847,-6104,,
2553986889,10435344468,2460055181,10435338353,-6115,,
2554237240,10435594829,2460305542,10435588714,-6115,,
2554487575,10435845154,2460555867,10435839040,-6114,,
2554738026,10436095605,2460806318,10436089505,-6100,,
2554988730,10436346308,2461057021,10436340193,-6115,,
2555006687,10436364266,2461074978,10436358151,-6115,10436358201,
2555256809,10436614388,2461325100,10436608284,-6104,,
2555507627,10436865207,2461575919,10436859118,-6089,,
2555757837,10437115415,2461826128,10437109339,-6076,,
2556008494,10437366072,2462076784,10437360009,-6063,,
2556258609,10437616188,2462326900,10437610125,-6063,,
2556509079,10437866667,2462577380,10437860604,-6063,,
2556759341,10438116921,2462827634,10438110858,-6063,,
2557009725,10438367314,2463078026,10438361250,-6064,,
2557027754,10438385333,2463096045,10438379270,-6063,10438379280,
2557277899,10438635478,2463346191,10438629418,-6060,,
2557528018,10438885597,2463596310,10438879541,-6056,,
2557778366,10439135945,2463846657,10439129891,-6054,,
2558029106,10439386685,2464097397,10439380633,-6052,,
2558279234,10439636813,2464347525,10439630761,-6052,,
2558530008,10439887597,2464598309,10439881546,-6051,,
2558780178,10440137757,2464848470,10440131706,-6051,,
2559030845,10440388424,2465099136,10440382383,-6041,,
2559048969,10440406547,2465117260,10440400496,-6051,10440400457,
2559299153,10440656732,2465367444,10440650679,-6053,,
2559549337,10440906916,2465617628,10440900845,-6071,,
2559799601,10441157180,2465867892,10441151100,-6080,,
2560049952,10441407531,2466118243,10441401442,-6089,,
2560300571,10441658150,2466368862,10441652061,-6089,,
2560550770,10441908359,2466619072,10441902270,-6089,,
2560801427,10442159007,2466869719,10442152918,-6089,,
2561051584,10442409163,2467119876,10442403074,-6089,,
2561069729,10442427308,2467138020,10442421218,-6090,10442421225,
2561319853,10442677432,2467388145,10442671344,-6088,,
2561570555,10442928134,2467638846,10442922048,-6086,,
2561820718,10443178297,2467889010,10443172214,-6083,,
2562071000,10443428579,2468139291,10443422498,-6081,,
2562321130,10443678708,2468389421,10443672627,-6081,,
2562571711,10443929290,2468640002,10443923209,-6081,,
2562822321,10444179901,2468890614,10444173820,-6081,,
2563072523,10444430112,2469140825,10444424031,-6081,,
2563090643,10444448222,2469158934,10444442141,-6081,10444442133,
2563340882,10444698461,2469409173,10444692378,-6083,,
2563591495,10444949074,2469659787,10444942990,-6084,,
2563842486,10445200065,2469910777,10445193979,-6086,,
2564092897,10445450475,2470161188,10445444388,-6087,,
2564343129,10445700707,2470411420,10445694620,-6087,,
2564593846,10445951425,2470662137,10445945338,-6087,,
2564844515,10446202094,2470912807,10446196008,-6086,,
2565094733,10446452312,2471163024,10446446224,-6088,,
2565112931,10446470509,2471181221,10446464421,-6088,10446464323,
2565363604,10446721182,2471431895,10446715073,-6109,,
2565613973,10446971552,2471682264,10446965432,-6120,,
2565864511,10447222089,2471932802,10447215937,-6152,,
2566115009,10447472588,2472183300,10447466413,-6175,,
2566365628,10447723206,2472433919,10447717032,-6174,,
2566616050,10447973628,2472684341,10447967454,-6174,,
2566866666,10448224245,2472934958,10448218071,-6174,,
2567117221,10448474800,2473185512,10448468626,-6174,,
2567135315,10448492894,2473203606,10448486720,-6174,10448486846,
2567385481,10448743060,2473453772,10448736917,-6143,,
2567636167,10448993745,2473704458,10448987635,-6110,,
2567886743,10449244321,2473955034,10449238243,-6078,,
2568137158,10449494737,2474205449,10449488691,-6046,,
2568387398,10449744977,2474455689,10449738930,-6047,,
2568637637,10449995216,2474705928,10449989170,-6046,,
2568887954,10450245543,2474956256,10450239497,-6046,,
2569138094,10450495673,2475206386,10450489627,-6046,,
2569156216,10450513794,2475224507,10450507748,-6046,10450507635,
2569406848,10450764426,2475475139,10450758351,-6075,,
2569657371,10451014950,2475725662,10451008847,-6103,,
2569907469,10451265048,2475975760,10451258928,-6120,,
2570158130,10451515708,2476226421,10451509550,-6158,,
2570408647,10451766226,2476476938,10451760068,-6158,,
2570659420,10452016998,2476727711,10452010840,-6158,,
2570909806,10452267385,2476978098,10452261227,-6158,,
2571160712,10452518291,2477229003,10452512133,-6158,,
2571178734,10452536312,2477247025,10452530154,-6158,10452530228,
2571429041,10452786620,2477497332,10452780481,-6139,,
2571679174,10453036753,2477747466,10453030633,-6120,,
2571929668,10453287247,2477997960,10453281157,-6090,,
2572179852,10453537430,2478248143,10453531348,-6082,,
2572430205,10453787784,2478498496,10453781701,-6083,,
2572681193,10454038782,2478749494,10454032700,-6082,,
2572931422,10454289001,2478999713,10454282919,-6082,,
2573181571,10454539149,2479249862,10454533067,-6082,,
2573199587,10454557165,2479267877,10454551083,-6082,10454551012,
2573450503,10454808081,2479518794,10454801981,-6100,,
2573700942,10455058520,2479769232,10455052403,-6117,,
2573951175,10455308754,2480019466,10455302619,-6135,,
2574201284,10455558862,2480269575,10455552711,-6151,,
2574451529,10455809108,2480519820,10455802956,-6152,,
2574701719,10456059297,2480770010,10456053146,-6151,,
2574951989,10456309568,2481020280,10456303416,-6152,,
2575202257,10456559836,2481270549,10456553685,-6151,,
2575220339,10456577918,2481288630,10456571766,-6152,10456571850,
2575470437,10456828015,2481538728,10456821884,-6131,,
2575721049,10457078627,2481789340,10457072518,-6109,,
2575971244,10457328822,2482039535,10457322734,-6088,,
2576221458,10457579047,2482289759,10457572981,-6066,,
2576472331,10457829910,2482540622,10457823844,-6066,,
2576722513,10458080092,2482790804,10458074026,-6066,,
2576972848,10458330427,2483041139,10458324361,-6066,,
2577223044,10458580622,2483291335,10458574556,-6066,,
2577241354,10458598933,2483309645,10458592866,-6067,10458592789,
2577492182,10458849761,2483560473,10458843686,-6075,,
2577742483,10459100062,2483810774,10459093957,-6105,,
2577992818,10459350396,2484061109,10459344273,-6123,,
2578242961,10459600539,2484311251,10459594397,-6142,,
2578493653,10459851231,2484561944,10459845089,-6142,,
2578743830,10460101408,2484812121,10460095266,-6142,,
2578994031,10460351620,2485062332,10460345478,-6142,,
2579244870,10460602449,2485313162,10460596307,-6142,,
2579262929,10460620507,2485331219,10460614365,-6142,10460614341,
2579513190,10460870769,2485581481,10460864620,-6149,,
2579764019,10461121598,2485832311,10461115444,-6154,,
2580014235,10461371814,2486082527,10461365654,-6160,,
2580264626,10461622205,2486332927,10461616050,-6155,,
2580514953,10461872531,2486583244,10461866366,-6165,,
2580765284,10462122862,2486833575,10462116697,-6165,,
2581015518,10462373097,2487083809,10462366931,-6166,,
2581265925,10462623504,2487334226,10462617349,-6155,,
2581284296,10462641875,2487352587,10462635709,-6166,10462635873,
2581534771,10462892349,2487603062,10462886224,-6125,,
2581784911,10463142490,2487853203,10463136408,-6082,,
2582035360,10463392938,2488103651,10463386906,-6032,,
2582285894,10463643484,2488354196,10463637484,-6000,,
2582536461,10463894041,2488604753,10463888041,-6000,,
2582787148,10464144726,2488855438,10464138726,-6000,,
2583037342,10464394921,2489105633,10464388920,-6001,,
2583287958,10464645537,2489356260,10464639547,-5990,,
2583306203,10464663781,2489374493,10464657781,-6000,10464657569,
2583557046,10464914625,2489625337,10464908581,-6044,,
2583807543,10465165123,2489875835,10465159017,-6106,,
2584058006,10465415585,2490126298,10465409426,-6159,,
2584308182,10465665761,2490376474,10465659550,-6211,,
2584558497,10465916076,2490626788,10465909864,-6212,,
2584809116,10466166695,2490877408,10466160484,-6211,,
2585059604,10466417182,2491127894,10466410971,-6211,,
2585309769,10466667347,2491378060,10466661146,-6201,,
2585327879,10466685458,2491396170,10466679246,-6212,10466679295,
2585578333,10466935912,2491646625,10466929713,-6199,,
2585828771,10467186350,2491897063,10467180164,-6186,,
2586079043,10467436622,2492147334,10467430448,-6174,,
2586329685,10467687264,2492397976,10467681102,-6162,,
2586579806,10467937384,2492648097,10467931223,-6161,,
2586830213,10468187792,2492898505,10468181631,-6161,,
2587080580,10468438159,2493148872,10468431998,-6161,,
2587331180,10468688759,2493399471,10468682598,-6161,,
2587349309,10468706887,2493417599,10468700725,-6162,10468700774,
2587599510,10468957088,2493667801,10468950939,-6149,,
2587850125,10469207704,2493918417,10469201568,-6136,,
2588100343,10469457922,2494168634,10469451798,-6124,,
2588350732,10469708311,2494419023,10469702199,-6112,,
2588601475,10469959064,2494669777,10469952953,-6111,,
2588851946,10470209525,2494920237,10470203413,-6112,,
2589102182,10470459761,2495170483,10470453660,-6101,,
2589352436,10470710014,2495420727,10470703903,-6111,,
2589370549,10470728127,2495438840,10470722016,-6111,10470721942,
2589621103,10470978692,2495689405,10470972562,-6130,,
2589871687,10471229267,2495939980,10471223119,-6148,,
2590122165,10471479743,2496190456,10471473577,-6166,,
2590372281,10471729860,2496440573,10471723676,-6184,,
2590622993,10471980572,2496691285,10471974388,-6184,,
2590873363,10472230942,2496941654,10472224758,-6184,,
2591123726,10472481305,2497192017,10472475121,-6184,,
2591373860,10472731439,2497442151,10472725255,-6184,,
2591391987,10472749565,2497460277,10472743381,-6184,10472743437,
2591642139,10472999719,2497710431,10472993549,-6170,,
2591892945,10473250524,2497961236,10473244369,-6155,,
2592143306,10473500885,2498211597,10473494743,-6142,,
2592393584,10473751163,2498461875,10473745037,-6126,,
2592644129,10474001708,2498712421,10473995582,-6126,,
2592894635,10474252214,2498962926,10474246087,-6127,,
2593144747,10474502326,2499213038,10474496199,-6127,,
2593395783,10474753361,2499464074,10474747235,-6126,,
2593414316,10474771894,2499482607,10474765768,-6126,10474765788,
2593664673,10475022253,2499732965,10475016131,-6122,,
2593915049,10475272627,2499983340,10475266511,-6116,,
2594165393,10475522971,2500233684,10475516860,-6111,,
2594415973,10475773551,2500484264,10475767456,-6095,,
2594666516,10476024095,2500734807,10476017990,-6105,,
2594916808,10476274387,2500985099,10476268292,-6095,,
2595167422,10476525001,2501235713,10476518895,-6106,,
2595417665,10476775243,2501485955,10476769138,-6105,,
2595435788,10476793366,2501504078,10476787261,-6105,10476787156,
2595686378,10477043957,2501754670,10477037826,-6131,,
2595936997,10477294575,2502005288,10477288418,-6157,,
2596187630,10477545208,2502255920,10477539026,-6182,,
2596438063,10477795642,2502506354,10477789434,-6208,,
2596688638,10478046217,2502756940,10478040019,-6198,,
2596938767,10478296346,2503007058,10478290137,-6209,,
2597188923,10478546501,2503257214,10478540293,-6208,,
2597439379,10478796958,2503507670,10478790761,-6197,,
2597457583,10478815161,2503525873,10478808953,-6208,10478808967,
2597708204,10479065782,2503776505,10479059587,-6195,,
2597958617,10479316206,2504026919,10479310005,-6201,,
2598209350,10479566928,2504277641,10479560731,-6197,,
2598459539,10479817118,2504527831,10479810925,-6193,,
2598710095,10480067674,2504778397,10480061491,-6183,,
2598960303,10480317882,2505028594,10480311689,-6193,,
2599210642,10480568221,2505278933,10480562028,-6193,,
2599460979,10480818558,2505529281,10480812375,-6183,,
2599479074,10480836653,2505547365,10480830459,-6194,10480830432,
2599729482,10481087071,2505797783,10481080871,-6200,,
2599979695,10481337274,2506047987,10481331078,-6196,,
2600230088,10481587666,2506298379,10481581454,-6212,,
2600480685,10481838263,2506548976,10481832044,-6219,,
2600730893,10482088472,2506799195,10482082264,-6208,,
2600981510,10482339089,2507049801,10482332870,-6219,,
2601231624,10482589203,2507299915,10482582984,-6219,,
2601481946,10482839524,2507550237,10482833305,-6219,,
2601500124,10482857702,2507568415,10482851483,-6219,10482851501,
2601750252,10483107831,2507818544,10483101616,-6215,,
2602001106,10483358684,2508069397,10483352474,-6210,,
2602251500,10483609079,2508319791,10483602884,-6195,,
2602501957,10483859535,2508570248,10483853335,-6200,,
2602752248,10484109827,2508820539,10484103627,-6200,,
2603002939,10484360518,2509071230,10484354317,-6201,,
2603253112,10484610690,2509321403,10484604490,-6200,,
2603503630,10484861225,2509571938,10484855025,-6200,,
2603521649,10484879227,2509589940,10484873027,-6200,10484873035,
2603771907,10485129485,2509840198,10485123286,-6199,,
2604022202,10485379780,2510090493,10485373585,-6195,,
2604272843,10485630422,2510341134,10485624228,-6194,,
2604523258,10485880836,2510591549,10485874655,-6181,,
2604773514,10486131093,2510841805,10486124911,-6182,,
2605023791,10486381370,2511092082,10486375179,-6191,,
2605274078,10486631656,2511342369,10486625465,-6191,,
2605524297,10486881876,2511592589,10486875695,-6181,,
2605542415,10486899994,2511610706,10486893802,-6192,10486893754,
2605792795,10487150375,2511861087,10487144171,-6204,,
2606043143,10487400722,2512111434,10487394507,-6215,,
2606293617,10487651196,2512361908,10487644969,-6227,,
2606543823,10487901402,2512612114,10487895163,-6239,,
2606794290,10488151869,2512862581,10488145630,-6239,,
2607045200,10488402779,2513113492,10488396541,-6238,,
2607295322,10488652901,2513363613,10488646663,-6238,,
2607545821,10488903410,2513614122,10488897172,-6238,,
2607563953,10488921531,2513632244,10488915293,-6238,10488915324,
2607814561,10489172141,2513882853,10489165909,-6232,,
2608064715,10489422293,2514133006,10489416071,-6222,,
2608315336,10489672915,2514383628,10489666701,-6214,,
2608565439,10489923018,2514633730,10489916822,-6196,,
2608815752,10490173331,2514884043,10490167125,-6206,,
2609066615,10490424203,2515134916,10490417997,-6206,,
2609316751,10490674330,2515385042,10490668134,-6196,,
2609567146,10490924725,2515635437,10490918518,-6207,,
2609585212,10490942791,2515653503,10490936584,-6207,10490936562,
2609835558,10491193136,2515903849,10491186935,-6201,,
2610085773,10491443352,2516154075,10491437145,-6207,,
2610335871,10491693450,2516404162,10491687228,-6222,,
2610586606,10491944185,2516654897,10491937958,-6227,,
2610837041,10492194620,2516905333,10492188394,-6226,,
2611087241,10492444820,2517155532,10492438593,-6227,,
2611337834,10492695412,2517406125,10492689185,-6227,,
2611588410,10492945988,2517656701,10492939761,-6227,,
2611606569,10492964147,2517674859,10492957920,-6227,10492957903,
2611856816,10493214396,2517925108,10493208164,-6232,,
2612107362,10493464941,2518175654,10493458705,-6236,,
2612357596,10493715175,2518425887,10493708936,-6239,,
2612608196,10493965774,2518676487,10493959531,-6243,,
2612859044,10494216624,2518927336,10494210381,-6243,,
2613109477,10494467056,2519177769,10494460813,-6243,,
2613360008,10494717587,2519428299,10494711344,-6243,,
2613610174,10494967752,2519678465,10494961509,-6243,,
2613628283,10494985861,2519696573,10494979618,-6243,10494979637,
2613878697,10495236276,2519946999,10495230049,-6227,,
2614128874,10495486453,2520197165,10495480220,-6233,,
2614379146,10495736724,2520447437,10495730497,-6227,,
2614629558,10495987137,2520697849,10495980915,-6222,,
2614880281,10496237860,2520948573,10496231639,-6221,,
2615130675,10496488264,2521198976,10496482042,-6222,,
2615380840,10496738419,2521449131,10496732207,-6212,,
2615631299,10496988878,2521699590,10496982656,-6222,,
2615649419,10497006997,2521717709,10497000775,-6222,10497000786,
2615899716,10497257305,2521968018,10497251087,-6218,,
2616150108,10497507687,2522218399,10497501472,-6215,,
2616400587,10497758166,2522468878,10497751954,-6212,,
2616651317,10498008895,2522719607,10498002686,-6209,,
2616901514,10498259094,2522969806,10498252885,-6209,,
2617152047,10498509626,2523220338,10498503416,-6210,,
2617402223,10498759802,2523470524,10498753602,-6200,,
2617652619,10499010198,2523720910,10499003988,-6210,,
2617670772,10499028350,2523739062,10499022141,-6209,10499022107,
2617921130,10499278708,2523989421,10499272500,-6208,,
2618171229,10499528808,2524239521,10499522582,-6226,,
2618421523,10499779101,2524489814,10499772867,-6234,,
2618671653,10500029232,2524739944,10500023000,-6232,,
2618922529,10500280109,2524990822,10500273867,-6242,,
2619172668,10500530247,2525240959,10500524005,-6242,,
2619423281,10500780870,2525491582,10500774628,-6242,,
2619673733,10501031311,2525742024,10501025080,-6231,,
2619691832,10501049410,2525760123,10501043168,-6242,10501043134,
2619942310,10501299889,2526010601,10501293637,-6252,,
2620192744,10501550323,2526261035,10501544064,-6259,,
2620443449,10501801028,2526511741,10501794761,-6267,,
2620693767,10502051346,2526762058,10502045070,-6276,,
2620944174,10502301754,2527012466,10502295479,-6275,,
2621194807,10502552386,2527263108,10502546120,-6266,,
2621445258,10502802846,2527513559,10502796571,-6275,,
2621695881,10503053459,2527764172,10503047184,-6275,,
2621713936,10503071514,2527782227,10503065239,-6275,10503065290,
2621964092,10503321670,2528032383,10503315420,-6250,,
2622214547,10503572126,2528282839,10503565888,-6238,,
2622465132,10503822710,2528533440,10503816492,-6218,,
2622715705,10504073283,2528783996,10504067061,-6222,,
2622966604,10504324183,2529034895,10504317961,-6222,,
2623217194,10504574773,2529285486,10504568551,-6222,,
2623467654,10504825233,2529535945,10504819021,-6212,,
2623717777,10505075356,2529786068,10505069133,-6223,,
2623735894,10505093472,2529804185,10505087250,-6222,10505087215,
2623986358,10505343947,2530054660,10505337716,-6231,,
2624236868,10505594446,2530305159,10505588207,-6239,,
2624487307,10505844886,2530555599,10505838639,-6247,,
2624737524,10506095103,2530805816,10506088847,-6256,,
2624988048,10506345627,2531056339,10506339370,-6257,,
2625238407,10506595985,2531306698,10506589729,-6256,,
2625488909,10506846488,2531557200,10506840232,-6256,,
2625739532,10507097110,2531807823,10507090854,-6256,,
2625757772,10507115350,2531826063,10507109094,-6256,10507109064,
2626008422,10507366001,2532076724,10507359747,-6254,,
2626258984,10507616562,2532327275,10507610291,-6271,,
2626509524,10507867103,2532577815,10507860825,-6278,,
2626760298,10508117877,2532828589,10508111592,-6285,,
2627010624,10508368203,2533078916,10508361918,-6285,,
2627261016,10508618594,2533329307,10508612309,-6285,,
2627511307,10508868886,2533579609,10508862611,-6275,,
2627761904,10509119483,2533830195,10509113197,-6286,,
2627780005,10509137583,2533848296,10509131298,-6285,10509131252,
2628030289,10509387867,2534098580,10509381581,-6286,,
2628280771,10509638349,2534349062,10509632041,-6308,,
2628531035,10509888614,2534599326,10509882295,-6319,,
2628781592,10510139170,2534849883,10510132850,-6320,,
2629032068,10510389658,2535100370,10510383328,-6330,,
2629282346,10510639925,2535350648,10510633605,-6320,,
2629533127,10510890705,2535601418,10510884375,-6330,,
2629783322,10511140901,2535851613,10511134570,-6331,,
2629801452,10511159030,2535869743,10511152700,-6330,10511152745,
2630051790,10511409369,2536120081,10511403060,-6309,,
2630301915,10511659493,2536370206,10511653185,-6308,,
2630552694,10511910272,2536620985,10511903976,-6296,,
2630803269,10512160847,2536871559,10512154563,-6284,,
2631053784,10512411372,2537122085,10512405088,-6284,,
2631304389,10512661967,2537372680,10512655683,-6284,,
2631554996,10512912575,2537623287,10512906290,-6285,,
2631805779,10513163357,2537874080,10513157084,-6273,,
2631823883,10513181462,2537892174,10513175177,-6285,10513175166,
2632074690,10513432269,2538142982,10513425982,-6287,,
2632325271,10513682850,2538393563,10513676560,-6290,,
2632576176,10513933755,2538644467,10513927463,-6292,,
2632826514,10514184093,2538894806,10514177799,-6294,,
2633076887,10514434466,2539145178,10514428172,-6294,,
2633327078,10514684657,2539395369,10514678363,-6294,,
2633577643,10514935222,2539645934,10514928938,-6284,,
2633828222,10515185802,2539896514,10515179508,-6294,,
2633846459,10515204038,2539914750,10515197743,-6295,10515197792,
2634096806,10515454384,2540165097,10515448102,-6282,,
2634347439,10515705017,2540415730,10515698758,-6259,,
2634598352,10515955930,2540666642,10515949673,-6257,,
2634848682,10516206261,2540916974,10516200017,-6244,,
2635098798,10516456386,2541167099,10516450142,-6244,,
2635349111,10516706690,2541417402,10516700445,-6245,,
2635599688,10516957266,2541667979,10516951032,-6234,,
2635850422,10517208002,2541918715,10517201758,-6244,,
2635868579,10517226157,2541936870,10517219913,-6244,10517219899,
2636119421,10517477000,2542187722,10517470762,-6238,,
2636369677,10517727256,2542437968,10517721005,-6251,,
2636620494,10517978073,2542688785,10517971818,-6255,,
2636870972,10518228550,2542939263,10518222293,-6257,,
2637121610,10518479200,2543189912,10518472942,-6258,,
2637372214,10518729793,2543440505,10518723536,-6257,,
2637622742,10518980331,2543691044,10518974074,-6257,,
2637873212,10519230792,2543941504,10519224535,-6257,,
2637891345,10519248923,2543959635,10519242666,-6257,10519242611,
2638141716,10519499305,2544210018,10519493035,-6270,,
2638391981,10519749560,2544460272,10519743277,-6283,,
2638642572,10520000151,2544710863,10519993853,-6298,,
2638892981,10520250559,2544961272,10520244249,-6310,,
2639143900,10520501479,2545212192,10520495170,-6309,,
2639394078,10520751657,2545462369,10520745346,-6311,,
2639644903,10521002482,2545713194,10520996172,-6310,,
2639895238,10521252817,2545963530,10521246508,-6309,,
2639913244,10521270822,2545981535,10521264512,-6310,10521264564,
2640163528,10521521108,2546231820,10521514811,-6297,,
2640413694,10521771273,2546481985,10521764988,-6285,,
2640664282,10522021861,2546732573,10522015591,-6270,,
2640914850,10522272429,2546983141,10522266172,-6257,,
2641165497,10522523087,2547233799,10522516829,-6258,,
2641416426,10522774005,2547484718,10522767748,-6257,,
2641667026,10523024604,2547735317,10523018347,-6257,,
2641917316,10523274896,2547985608,10523268638,-6258,,
2641935474,10523293053,2548003765,10523286795,-6258,10523286710,
2642185644,10523543223,2548253935,10523536944,-6279,,
2642435858,10523793437,2548504149,10523787136,-6301,,
2642686048,10524043627,2548754339,10524037305,-6322,,
2642936579,10524294158,2549004870,10524287816,-6342,,
2643186748,10524544328,2549255040,10524537987,-6341,,
2643436927,10524794506,2549505218,10524788165,-6341,,
2643687399,10525044978,2549755691,10525038637,-6341,,
2643937904,10525295483,2550006196,10525289143,-6340,,
2643956149,10525313727,2550024439,10525307386,-6341,10525307469,
2644206729,10525564308,2550275021,10525557988,-6320,,
2644456859,10525814438,2550525160,10525808150,-6288,,
2644707682,10526065261,2550775974,10526058984,-6277,,
2644958652,10526316231,2551026943,10526309974,-6257,,
2645209165,10526566744,2551277457,10526560488,-6256,,
2645459756,10526817334,2551528046,10526811078,-6256,,
2645710316,10527067895,2551778607,10527061639,-6256,,
2645960751,10527318330,2552029043,10527312074,-6256,,
2645978920,10527336499,2552047211,10527330242,-6257,10527330210,
2646229531,10527587110,2552297822,10527580845,-6265,,
2646480464,10527838042,2552548755,10527831770,-6272,,
2646730590,10528088168,2552798881,10528081888,-6280,,
2646981190,10528338769,2553049481,10528332482,-6287,,
2647231390,10528588970,2553299682,10528582682,-6288,,
2647481849,10528839428,2553550152,10528833152,-6276,,
2647732344,10529089923,2553800636,10529083636,-6287,,
2647982552,10529340142,2554050854,10529333854,-6288,,
2648000574,10529358152,2554068864,10529351865,-6287,10529351831,
2648251173,10529608752,2554319465,10529602456,-6296,,
2648501340,10529858918,2554569641,10529852625,-6293,,
2648751781,10530109359,2554820072,10530103047,-6312,,
2649002397,10530359975,2555070687,10530353655,-6320,,
2649252803,10530610382,2555321094,10530604062,-6320,,
2649503185,10530860774,2555571487,10530854454,-6320,,
2649753422,10531111001,2555821713,10531104681,-6320,,
2650003595,10531361174,2556071886,10531354853,-6321,,
2650021708,10531379287,2556089999,10531372966,-6321,10531372985,
2650272183,10531629761,2556340474,10531623445,-6316,,
2650522517,10531880096,2556590808,10531873785,-6311,,
2650772878,10532130457,2556841169,10532124151,-6306,,
2651023326,10532380904,2557091617,10532374604,-6300,,
2651274092,10532631671,2557342384,10532625371,-6300,,
2651524818,10532882397,2557593109,10532876097,-6300,,
2651775347,10533132925,2557843638,10533126625,-6300,,
2652025514,10533383103,2558093815,10533376803,-6300,,
2652043627,10533401206,2558111918,10533394906,-6300,10533394880,
2652294009,10533651587,2558362300,10533645292,-6295,,
2652544617,10533902196,2558612919,10533895894,-6302,,
2652795040,10534152619,2558863332,10534146301,-6318,,
2653045385,10534402964,2559113676,10534396640,-6324,,
2653296252,10534653831,2559364543,10534647506,-6325,,
2653546362,10534903940,2559614663,10534897626,-6314,,
2653796940,10535154519,2559865231,10535148194,-6325,,
2654047119,10535404698,2560115410,10535398374,-6324,,
2654065066,10535422644,2560133357,10535416320,-6324,10535416299,
2654315636,10535673215,2560383927,10535666886,-6329,,
2654566024,10535923603,2560634315,10535917270,-6333,,
2654816667,10536174246,2560884958,10536167907,-6339,,
2655066876,10536424455,2561135167,10536418112,-6343,,
2655317814,10536675392,2561386105,10536669049,-6343,,
2655568302,10536925891,2561636604,10536919548,-6343,,
2655818464,10537176043,2561886756,10537169700,-6343,,
2656068649,10537426228,2562136940,10537419885,-6343,,
2656086649,10537444227,2562154939,10537437884,-6343,10537437853,
2656337093,10537694682,2562405395,10537688331,-6351,,
2656587422,10537945001,2562655713,10537938643,-6358,,
2656838074,10538195653,2562906366,10538189288,-6365,,
2657088285,10538445863,2563156576,10538439491,-6372,,
2657338593,10538696171,2563406884,10538689809,-6362,,
2657589131,10538946720,2563657433,10538940348,-6372,,
2657839729,10539197319,2563908031,10539190946,-6373,,
2658090523,10539448101,2564158814,10539441729,-6372,,
2658108491,10539466069,2564176781,10539459697,-6372,10539459723,
2658358785,10539716364,2564427077,10539709999,-6365,,
2658609174,10539966753,2564677475,10539960404,-6349,,
2658859474,10540217054,2564927767,10540210703,-6351,,
2659109815,10540467394,2565178107,10540461050,-6344,,
2659359978,10540717567,2565428279,10540711223,-6344,,
2659610558,10540968137,2565678850,10540961793,-6344,,
2659860801,10541218380,2565929092,10541212035,-6345,,
2660111027,10541468605,2566179318,10541462261,-6344,,
2660129103,10541486681,2566197394,10541480337,-6344,10541480331,
2660379387,10541736966,2566447679,10541730621,-6345,,
2660629876,10541987455,2566698167,10541981107,-6348,,
2660880074,10542237653,2566948366,10542231306,-6347,,
2661130197,10542487775,2567198488,10542481436,-6339,,
2661380549,10542738128,2567448840,10542731779,-6349,,
2661631074,10542988653,2567699365,10542982303,-6350,,
2661881283,10543238861,2567949573,10543232512,-6349,,
2662131453,10543489032,2568199744,10543482693,-6339,,
2662149593,10543507171,2568217884,10543500822,-6349,10543500789,
2662400157,10543757735,2568468448,10543751378,-6357,,
2662650822,10544008401,2568719113,10544002037,-6364,,
2662901173,10544258753,2568969466,10544252381,-6372,,
2663151975,10544509554,2569220266,10544503173,-6381,,
2663402390,10544759968,2569470681,10544753588,-6380,,
2663652832,10545010411,2569721124,10545004031,-6380,,
2663902936,10545260515,2569971227,10545254134,-6381,,
2664153332,10545510911,2570221623,10545504531,-6380,,
2664171499,10545529077,2570239789,10545522697,-6380,10545522742,
2664422139,10545779718,2570490431,10545773350,-6368,,
2664672258,10546029837,2570740549,10546023491,-6346,,
2664923152,10546280731,2570991444,10546274388,-6343,,
2665173284,10546530863,2571241575,10546524530,-6333,,
2665423555,10546781134,2571491846,10546774801,-6333,,
2665674122,10547031701,2571742414,10547025368,-6333,,
2665924790,10547282369,2571993081,10547276036,-6333,,
2666174881,10547532460,2572243172,10547526127,-6333,,
2666192969,10547550547,2572261259,10547544214,-6333,10547544132,
2666443497,10547801077,2572511789,10547794723,-6354,,
2666693879,10548051458,2572762170,10548045083,-6375,,
2666944457,10548302037,2573012750,10548295643,-6394,,
2667195257,10548552837,2573263549,10548546423,-6414,,
2667445405,10548802984,2573513696,10548796570,-6414,,
2667695645,10549053224,2573763947,10549046820,-6404,,
2667945958,10549303548,2574014260,10549297134,-6414,,
2668196456,10549554034,2574264746,10549547620,-6414,,
2668214599,10549572178,2574282890,10549565763,-6415,10549565811,
2668464852,10549822431,2574533143,10549816029,-6402,,
2668715427,10550073005,2574783717,10550066615,-6390,,
2668965834,10550323414,2575034126,10550317037,-6377,,
2669216152,10550573731,2575284454,10550567376,-6355,,
2669466574,10550824153,2575534865,10550817788,-6365,,
2669717146,10551074725,2575785437,10551068359,-6366,,
2669967583,10551325173,2576035885,10551318808,-6365,,
2670217692,10551575271,2576285983,10551568916,-6355,,
2670235759,10551593337,2576304049,10551586971,-6366,10551586914,
2670486391,10551843970,2576554682,10551837590,-6380,,
2670736549,10552094128,2576804841,10552087735,-6393,,
2670987037,10552344616,2577055329,10552338210,-6406,,
2671237481,10552595060,2577305772,10552588639,-6421,,
2671488008,10552845587,2577556299,10552839165,-6422,,
2671738213,10553095791,2577806504,10553089370,-6421,,
2671988826,10553346405,2578057117,10553339984,-6421,,
2672239057,10553596636,2578307348,10553590215,-6421,,
2672257199,10553614777,2578325490,10553608356,-6421,10553608380,
2672507541,10553865120,2578575832,10553858706,-6414,,
2672758082,10554115660,2578826383,10554109262,-6398,,
2673008809,10554366388,2579077101,10554359988,-6400,,
2673259270,10554616848,2579327561,10554610453,-6395,,
2673509800,10554867379,2579578091,10554860984,-6395,,
2673760121,10555117699,2579828412,10555111314,-6385,,
2674010376,10555367954,2580078667,10555361559,-6395,,
2674260497,10555618076,2580328788,10555611681,-6395,,
2674278655,10555636233,2580346946,10555629838,-6395,10555629822,
2674529250,10555886829,2580597541,10555880431,-6398,,
2674779442,10556137021,2580847733,10556130618,-6403,,
2675030319,10556387898,2581098610,10556381492,-6406,,
2675280888,10556638467,2581349179,10556632057,-6410,,
2675531496,10556889074,2581599786,10556882665,-6409,,
2675781964,10557139543,2581850255,10557133133,-6410,,
2676032376,10557389954,2582100667,10557383545,-6409,,
2676282590,10557640169,2582350881,10557633760,-6409,,
2676300525,10557658103,2582368815,10557651693,-6410,10557651753,
2676550957,10557908536,2582619248,10557902142,-6394,,
2676801658,10558159236,2582869949,10558152858,-6378,,
2677051963,10558409542,2583120254,10558403179,-6363,,
2677302805,10558660384,2583371096,10558654036,-6348,,
2677553163,10558910742,2583621454,10558904393,-6349,,
2677803754,10559161333,2583872045,10559154984,-6349,,
2678054282,10559411861,2584122573,10559405513,-6348,,
2678304976,10559662554,2584373266,10559656206,-6348,,
2678322963,10559680541,2584391254,10559674193,-6348,10559674159,
2678573340,10559930919,2584641631,10559924563,-6356,,
2678823516,10560181095,2584891807,10560174730,-6365,,
2679073738,10560431317,2585142030,10560424945,-6372,,
2679324279,10560681858,2585392570,10560675478,-6380,,
2679574667,10560932245,2585642958,10560925865,-6380,,
2679825174,10561182753,2585893465,10561176372,-6381,,
2680075954,10561433533,2586144246,10561427153,-6380,,
2680326176,10561683765,2586394478,10561677385,-6380,,
2680344408,10561701986,2586412699,10561695606,-6380,10561695623,
2680594514,10561952093,2586662805,10561945716,-6377,,
2680845330,10562202909,2586913622,10562196537,-6372,,
2681095606,10562453184,2587163897,10562446817,-6367,,
2681345781,10562703360,2587414072,10562696998,-6362,,
2681596193,10562953772,2587664485,10562947410,-6362,,
2681846571,10563204150,2587914862,10563197787,-6363,,
2682096714,10563454293,2588165005,10563447930,-6363,,
2682347140,10563704719,2588415442,10563698367,-6352,,
2682365033,10563722612,2588433324,10563716249,-6363,10563716218,
2682615893,10563973471,2588684184,10563967101,-6370,,
2682866373,10564223952,2588934665,10564217575,-6377,,
2683116561,10564474140,2589184852,10564467755,-6385,,
2683367164,10564724743,2589435456,10564718351,-6392,,
2683617534,10564975113,2589685825,10564968721,-6392,,
2683867785,10565225364,2589936076,10565218972,-6392,,
2684118042,10565475620,2590186332,10565469228,-6392,,
2684368561,10565726140,2590436852,10565719747,-6393,,
2684386751,10565744329,2590455041,10565737937,-6392,10565737941,
2684636848,10565994426,2590705139,10565988035,-6391,,
2684887117,10566244696,2590955408,10566238307,-6389,,
2685137726,10566495305,2591206017,10566488917,-6388,,
2685387901,10566745480,2591456192,10566739094,-6386,,
2685638355,10566995934,2591706647,10566989548,-6386,,
2685888954,10567246534,2591957246,10567240148,-6386,,
2686139479,10567497058,2592207770,10567490672,-6386,,
2686390012,10567747601,2592458313,10567741215,-6386,,
2686408191,10567765770,2592476482,10567759384,-6386,10567759327,
2686659249,10568016828,2592727540,10568010428,-6400,,
2686909428,10568267007,2592977719,10568260592,-6415,,
2687159752,10568517331,2593228043,10568510904,-6427,,
2687409853,10568767432,2593478144,10568760990,-6442,,
2687660618,10569018197,2593728909,10569011756,-6441,,
2687911227,10569268807,2593979520,10569262366,-6441,,
2688161722,10569519301,2594230013,10569512859,-6442,,
2688412160,10569769739,2594480452,10569763298,-6441,,
2688430238,10569787816,2594498529,10569781375,-6441,10569781412,
2688680804,10570038383,2594749095,10570031951,-6432,,
2688931110,10570288688,2594999401,10570282266,-6422,,
2689181257,10570538836,2595249549,10570532424,-6412,,
2689432038,10570789616,2595500339,10570783223,-6393,,
2689682333,10571039911,2595750623,10571033508,-6403,,
2689932771,10571290350,2596001063,10571283947,-6403,,
2690183350,10571540929,2596251641,10571534526,-6403,,
2690433807,10571791386,2596502098,10571784982,-6404,,
2690451876,10571809455,2596520167,10571803051,-6404,10571803025,
2690702176,10572059755,2596770467,10572053345,-6410,,
2690953042,10572310620,2597021333,10572304203,-6417,,
2691203663,10572561241,2597271954,10572554818,-6423,,
2691454034,10572811613,2597522326,10572805185,-6428,,
2691704616,10573062194,2597772907,10573055766,-6428,,
2691955151,10573312730,2598023443,10573306302,-6428,,
2692205343,10573562921,2598273634,10573556493,-6428,,
2692455541,10573813129,2598523842,10573806701,-6428,,
2692473628,10573831207,2598541919,10573824778,-6429,10573824724,
2692724230,10574081809,2598792521,10574075367,-6442,,
2692974338,10574331916,2599042629,10574325461,-6455,,
2693225194,10574582773,2599293485,10574576304,-6469,,
2693475377,10574832955,2599543678,10574826484,-6471,,
2693725910,10575083489,2599794201,10575077007,-6482,,
2693976361,10575333940,2600044653,10575327460,-6480,,
2694226702,10575584281,2600294993,10575577799,-6482,,
2694476958,10575834536,2600545259,10575828065,-6471,,
2694495164,10575852742,2600563454,10575846261,-6481,10575846328,
2694745281,10576102860,2600813573,10576096395,-6465,,
2694996054,10576353633,2601064346,10576347185,-6448,,
2695246258,10576603837,2601314550,10576597407,-6430,,
2695496411,10576854000,2601564713,10576847588,-6412,,
2695747001,10577104580,2601815293,10577098167,-6413,,
2695997473,10577355061,2602065774,10577348649,-6412,,
2696247669,10577605248,2602315961,10577598835,-6413,,
2696498287,10577855876,2602566589,10577849463,-6413,,
2696516342,10577873921,2602584633,10577867507,-6414,10577867514,
2696766834,10578124413,2602835125,10578118002,-6411,,
2697017011,10578374590,2603085303,10578368181,-6409,,
2697267258,10578624837,2603335549,10578618429,-6408,,
2697518046,10578875635,2603586348,10578869230,-6405,,
2697768587,10579126166,2603836879,10579119762,-6404,,
2698019102,10579376680,2604087393,10579370286,-6394,,
2698269341,10579626919,2604337631,10579620514,-6405,,
2698519914,10579877503,2604588215,10579871098,-6405,,
2698538067,10579895645,2604606358,10579889240,-6405,10579889269,
2698788619,10580146198,2604856910,10580139800,-6398,,
2699038767,10580396346,2605107058,10580389954,-6392,,
2699288917,10580646496,2605357219,10580640124,-6372,,
2699539279,10580896868,2605607580,10580890493,-6375,,
2699789390,10581146980,2605857692,10581140604,-6376,,
2700039815,10581397394,2606108107,10581391019,-6375,,
2700290351,10581647931,2606358643,10581641556,-6375,,
2700541061,10581898640,2606609353,10581892265,-6375,,
2700559266,10581916844,2606627556,10581910469,-6375,10581910407,
2700809884,10582167463,2606878176,10582161073,-6390,,
2701060500,10582418078,2607128791,10582411673,-6405,,
2701310727,10582668306,2607379019,10582661886,-6420,,
2701561033,10582918612,2607629324,10582912177,-6435,,
2701811515,10583169094,2607879807,10583162659,-6435,,
2702062098,10583419677,2608130389,10583413242,-6435,,
2702312755,10583670334,2608381046,10583663899,-6435,,
2702563011,10583920590,2608631303,10583914155,-6435,,
2702580949,10583938527,2608649240,10583932092,-6435,10583932004,
2702831278,10584188857,2608899580,10584182410,-6447,,
2703081854,10584439433,2609150145,10584432953,-6480,,
2703332018,10584689596,2609400309,10584683106,-6490,,
2703582658,10584940237,2609650950,10584933716,-6521,,
2703833030,10585190608,2609901321,10585184086,-6522,,
2704083347,10585440926,2610151649,10585434415,-6511,,
2704333974,10585691552,2610402265,10585685030,-6522,,
2704584170,10585941749,2610652462,10585935227,-6522,,
2704602304,10585959883,2610670595,10585953360,-6523,10585953471,
2704852938,10586210517,2610921229,10586204022,-6495,,
2705103539,10586461117,2611171840,10586454661,-6456,,
2705354282,10586711861,2611422573,10586705423,-6438,,
2705604403,10586961982,2611672695,10586955573,-6409,,
2705854833,10587212412,2611923125,10587206002,-6410,,
2706105257,10587462836,2612173548,10587456425,-6411,,
2706356265,10587713843,2612424555,10587707433,-6410,,
2706606810,10587964389,2612675102,10587957979,-6410,,
2706625044,10587982622,2612693335,10587976212,-6410,10587976186,
2706875680,10588233259,2612943972,10588226842,-6417,,
2707126087,10588483665,2613194377,10588477242,-6423,,
2707376456,10588734035,2613444747,10588727605,-6430,,
2707626889,10588984468,2613695180,10588978043,-6425,,
2707877053,10589234631,2613945343,10589228196,-6435,,
2708127349,10589484928,2614195651,10589478504,-6424,,
2708377626,10589735205,2614445917,10589728769,-6436,,
2708628010,10589985588,2614696311,10589979163,-6425,,
2708646120,10590003698,2614714410,10589997263,-6435,10589997196,
2708896799,10590254379,2614965091,10590247927,-6452,,
2709147262,10590504840,2615215563,10590498382,-6458,,
2709397384,10590754962,2615465675,10590748489,-6473,,
2709647643,10591005222,2615715934,10590998722,-6500,,
2709897767,10591255345,2615966058,10591248845,-6500,,
2710147898,10591505477,2616216190,10591498977,-6500,,
2710398042,10591755621,2616466334,10591749121,-6500,,
2710648546,10592006124,2616716848,10591999635,-6489,,
2710666734,10592024312,2616735025,10592017812,-6500,10592017809,
2710917546,10592275126,2616985839,10592268625,-6501,,
2711167860,10592525448,2617236161,10592518947,-6501,,
2711418005,10592775583,2617486296,10592769082,-6501,,
2711668107,10593025686,2617736408,10593019194,-6492,,
2711918458,10593276037,2617986749,10593269535,-6502,,
2712168888,10593526466,2618237179,10593519964,-6502,,
2712419009,10593776587,2618487300,10593770085,-6502,,
2712669967,10594027555,2618738268,10594021053,-6502,,
2712688172,10594045750,2618756462,10594039248,-6502,10594039291,
2712939191,10594296770,2619007483,10594290280,-6490,,
2713189787,10594547365,2619258078,10594540896,-6469,,
2713440091,10594797670,2619508382,10594791202,-6468,,
2713691058,10595048637,2619759349,10595042180,-6457,,
2713941525,10595299103,2620009815,10595292646,-6457,,
2714192049,10595549628,2620260340,10595543171,-6457,,
2714442520,10595800099,2620510811,10595793641,-6458,,
2714692626,10596050205,2620760918,10596043748,-6457,,
2714710760,10596068339,2620779051,10596061882,-6457,10596061844,
2714960911,10596318490,2621029203,10596312024,-6466,,
2715211185,10596568763,2621279476,10596562288,-6475,,
2715461352,10596818931,2621529643,10596812447,-6484,,
2715711983,10597069561,2621780283,10597063078,-6483,,
2715962572,10597320150,2622030863,10597313657,-6493,,
2716212954,10597570533,2622281245,10597564040,-6493,,
2716463565,10597821144,2622531857,10597814651,-6493,,
2716714156,10598071734,2622782447,10598065241,-6493,,
2716732183,10598089771,2622800484,10598083278,-6493,10598083286,
2716982353,10598339933,2623050645,10598333445,-6488,,
2717233039,10598590618,2623301330,10598584135,-6483,,
2717483704,10598841283,2623551995,10598834805,-6478,,
2717734541,10599092130,2623802842,10599085657,-6473,,
2717985319,10599342898,2624053611,10599336425,-6473,,
2718236031,10599593609,2624304321,10599587136,-6473,,
2718486248,10599843827,2624554539,10599837354,-6473,,
2718736515,10600094104,2624804817,10600087631,-6473,,
2718754674,10600112252,2624822964,10600105779,-6473,10600105731,
2719004994,10600362573,2625073286,10600356089,-6484,,
2719255392,10600612982,2625323695,10600606486,-6496,,
2719505650,10600863229,2625573941,10600856721,-6508,,
2719755975,10601113554,2625824267,10601107035,-6519,,
2720006268,10601363846,2626074559,10601357327,-6519,,
2720256666,10601614245,2626324958,10601607726,-6519,,
2720506914,10601864493,2626575205,10601857974,-6519,,
2720757066,10602114645,2626825357,10602108126,-6519,,
2720775288,10602132866,2626843579,10602126357,-6509,10602126363,
2721026123,10602383703,2627094415,10602377188,-6515,,
2721276570,10602634149,2627344861,10602627637,-6512,,
2721527000,10602884579,2627595291,10602878073,-6506,,
2721777702,10603135281,2627845994,10603128779,-6502,,
2722028187,10603385766,2628096478,10603379264,-6502,,
2722278986,10603636564,2628347277,10603630062,-6502,,
2722529224,10603886803,2628597515,10603880301,-6502,,
2722779848,10604137427,2628848140,10604130925,-6502,,
2722797935,10604155513,2628866226,10604149011,-6502,10604148919,
2723048059,10604405648,2629116360,10604399123,-6525,,
2723298621,10604656199,2629366912,10604649651,-6548,,
2723548946,10604906525,2629617247,10604899964,-6561,,
2723799132,10605156711,2629867424,10605150118,-6593,,
2724049320,10605406899,2630117611,10605400305,-6594,,
2724299828,10605657406,2630368118,10605650813,-6593,,
2724549935,10605907514,2630618227,10605900921,-6593,,
2724800626,10606158216,2630868928,10606151623,-6593,,
2724818681,10606176270,2630886982,10606169677,-6593,10606169773,
2725069030,10606426608,2631137321,10606420042,-6566,,
2725319253,10606676832,2631387544,10606670292,-6540,,
2725569387,10606926966,2631637678,10606920453,-6513,,
2725820021,10607177600,2631888313,10607171115,-6485,,
2726070770,10607428349,2632139061,10607421864,-6485,,
2726321341,10607678920,2632389633,10607672435,-6485,,
2726571557,10607929136,2632639859,10607922662,-6474,,
2726821970,10608179549,2632890262,10608173064,-6485,,
2726840087,10608197665,2632908377,10608191180,-6485,10608191155,
2727090541,10608448119,2633158832,10608441628,-6491,,
2727340712,10608698290,2633409003,10608691804,-6486,,
2727591301,10608948880,2633659592,10608942388,-6492,,
2727841731,10609199310,2633910022,10609192802,-6508,,
2728091914,10609449492,2634160205,10609442984,-6508,,
2728342489,10609700067,2634410780,10609693559,-6508,,
2728592711,10609950289,2634661001,10609943781,-6508,,
2728843100,10610200679,2634911392,10610194171,-6508,,
2728861141,10610218719,2634929432,10610212211,-6508,10610212173,
2729111861,10610469439,2635180152,10610462932,-6507,,
2729362557,10610720135,2635430848,10610713607,-6528,,
2729612751,10610970330,2635681043,10610963793,-6537,,
2729863316,10611220895,2635931617,10611214360,-6535,,
2730113614,10611471193,2636181905,10611464647,-6546,,
2730364578,10611722157,2636432870,10611715613,-6544,,
2730614774,10611972353,2636683065,10611965808,-6545,,
2730865185,10612222764,2636933477,10612216219,-6545,,
2730883445,10612241023,2636951736,10612234478,-6545,10612234588,
2731133593,10612491172,2637201884,10612484654,-6518,,
2731383894,10612741473,2637452186,10612734984,-6489,,
2731634240,10612991819,2637702531,10612985357,-6462,,
2731884395,10613241974,2637952687,10613235541,-6433,,
2732134918,10613492498,2638203210,10613486065,-6433,,
2732385062,10613742641,2638453354,10613736208,-6433,,
2732635793,10613993372,2638704085,10613986939,-6433,,
2732886347,10614243935,2638954648,10614237503,-6432,,
2732904380,10614261958,2638972670,10614255525,-6433,10614255479,
2733154567,10614512157,2639222869,10614505711,-6446,,
2733405034,10614762612,2639473325,10614756157,-6455,,
2733655194,10615012773,2639723485,10615006306,-6467,,
2733905784,10615263364,2639974076,10615256887,-6477,,
2734155938,10615513516,2640224228,10615507039,-6477,,
2734406186,10615763765,2640474477,10615757288,-6477,,
2734656659,10616014237,2640724949,10616007760,-6477,,
2734907489,10616265078,2640975790,10616258600,-6478,,
2734925776,10616283354,2640994066,10616276877,-6477,10616276990,
2735176342,10616533921,2641244633,10616527473,-6448,,
2735426906,10616784485,2641495197,10616778076,-6409,,
2735677532,10617035110,2641745823,10617028720,-6390,,
2735927853,10617285432,2641996145,10617279070,-6362,,
2736178582,10617536160,2642246873,10617529798,-6362,,
2736428804,10617786394,2642497106,10617780032,-6362,,
2736679244,10618036823,2642747535,10618030461,-6362,,
2736929758,10618287337,2642998060,10618280986,-6351,,
2736947971,10618305550,2643016262,10618299187,-6363,10618299047,
2737198523,10618556102,2643266815,10618549705,-6397,,
2737449158,10618806736,2643517449,10618800304,-6432,,
2737699562,10619057140,2643767853,10619050673,-6467,,
2737950323,10619307902,2644018615,10619301401,-6501,,
2738200779,10619558357,2644269070,10619551856,-6501,,
2738451502,10619809081,2644519794,10619802580,-6501,,
2738701722,10620059301,2644770013,10620052800,-6501,,
2738952386,10620309965,2645020687,10620303474,-6491,,
2738970501,10620328079,2645038791,10620321578,-6501,10620321502,
2739220701,10620578279,2645288992,10620571759,-6520,,
2739471484,10620829062,2645539775,10620822533,-6529,,
2739721951,10621079530,2645790242,10621072972,-6558,,
2739972437,10621330016,2646040729,10621323440,-6576,,
2740223068,10621580646,2646291359,10621574070,-6576,,
2740473252,10621830830,2646541543,10621824264,-6566,,
2740723529,10622081108,2646791820,10622074532,-6576,,
2740973712,10622331290,2647042003,10622324714,-6576,,
2740991848,10622349427,2647060139,10622342850,-6577,10622342824,
2741242107,10622599685,2647310398,10622593102,-6583,,
2741492438,10622850017,2647560729,10622843427,-6590,,
2741742622,10623100201,2647810913,10623093605,-6596,,
2741993500,10623351079,2648061792,10623344479,-6600,,
2742243707,10623601286,2648311998,10623594685,-6601,,
2742493855,10623851434,2648562146,10623844833,-6601,,
2742744727,10624102306,2648813018,10624095704,-6602,,
2742994911,10624352490,2649063202,10624345889,-6601,,
2743013063,10624370642,2649081354,10624364040,-6602,10624364095,
2743263196,10624620774,2649331487,10624614186,-6588,,
2743513859,10624871438,2649582150,10624864864,-6574,,
2743763994,10625121573,2649832286,10625115013,-6560,,
2744014200,10625371779,2650082492,10625365235,-6544,,
2744264567,10625622146,2650332859,10625615601,-6545,,
2744514752,10625872330,2650583043,10625865785,-6545,,
2744765118,10626122697,2650833409,10626116152,-6545,,
2745015598,10626373177,2651083889,10626366632,-6545,,
2745033810,10626391389,2651102101,10626384844,-6545,10626384808,
2745284428,10626642007,2651352719,10626635451,-6556,,
2745534839,10626892418,2651603130,10626885855,-6563,,
2745785041,10627142619,2651853332,10627136048,-6571,,
2746035276,10627392866,2652103579,10627386287,-6579,,
2746285458,10627643037,2652353749,10627636457,-6580,,
2746535794,10627893374,2652604086,10627886795,-6579,,
2746786579,10628144157,2652854870,10628137578,-6579,,
2747037183,10628394761,2653105474,10628388182,-6579,,
2747055452,10628413030,2653123742,10628406450,-6580,10628406598,
2747305987,10628663566,2653374278,10628657025,-6541,,
2747556612,10628914191,2653624903,10628907686,-6505,,
2747807178,10629164756,2653875469,10629158289,-6467,,
2748057520,10629415110,2654125823,10629408681,-6429,,
2748307681,10629665260,2654375982,10629658840,-6420,,
2748557884,10629915462,2654626174,10629909032,-6430,,
2748808039,10630165617,2654876329,10630159187,-6430,,
2749058338,10630415917,2655126630,10630409487,-6430,,
2749076495,10630434074,2655144786,10630427643,-6431,10630427509,
2749326704,10630684283,2655394996,10630677819,-6464,,
2749577127,10630934705,2655645418,10630928208,-6497,,
2749827563,10631185142,2655895855,10631178612,-6530,,
2750077923,10631435501,2656146214,10631428938,-6563,,
2750328291,10631685870,2656396583,10631679307,-6563,,
2750578678,10631936257,2656646969,10631929693,-6564,,
2750829014,10632186593,2656897305,10632180030,-6563,,
2751079390,10632436968,2657147681,10632430405,-6563,,
2751097441,10632455019,2657165731,10632448456,-6563,10632448460,
2751347862,10632705440,2657416163,10632698889,-6551,,
2751598110,10632955688,2657666401,10632949128,-6560,,
2751848667,10633206246,2657916958,10633199688,-6558,,
2752099217,10633456795,2658167508,10633450238,-6557,,
2752349587,10633707165,2658417878,10633700619,-6546,,
2752600153,10633957732,2658668444,10633951174,-6558,,
2752850261,10634207840,2658918552,10634201283,-6557,,
2753101173,10634458752,2659169464,10634452195,-6557,,
2753119328,10634476907,2659187619,10634470350,-6557,10634470252,
2753369574,10634727153,2659437876,10634720582,-6571,,
2753619750,10634977328,2659688041,10634970723,-6605,,
2753870051,10635227629,2659938342,10635221000,-6629,,
2754120336,10635477914,2660188627,10635471272,-6642,,
2754370722,10635728301,2660439013,10635721648,-6653,,
2754621259,10635978838,2660689550,10635972184,-6654,,
2754871524,10636229103,2660939815,10636222450,-6653,,
2755121891,10636479469,2661190182,10636472816,-6653,,
2755139925,10636497504,2661208216,10636490850,-6654,10636490875,
2755390647,10636748226,2661458938,10636741577,-6649,,
2755640912,10636998490,2661709203,10636991849,-6641,,
2755891205,10637248784,2661959496,10637242150,-6634,,
2756141964,10637499542,2662210255,10637492915,-6627,,
2756392362,10637749941,2662460653,10637743314,-6627,,
2756642600,10638000179,2662710891,10637993551,-6628,,
2756893124,10638250702,2662961415,10638244075,-6627,,
2757143578,10638501156,2663211869,10638494529,-6627,,
2757161591,10638519169,2663229881,10638512542,-6627,10638512557,
2757411694,10638769272,2663479985,10638762649,-6623,,
2757662344,10639019923,2663730636,10639013304,-6619,,
2757912732,10639270310,2663981022,10639263696,-6614,,
2758163119,10639520697,2664231410,10639514087,-6610,,
2758413729,10639771308,2664482020,10639764698,-6610,,
2758664075,10640021654,2664732366,10640015043,-6611,,
2758914747,10640272325,2664983038,10640265715,-6610,,
2759165254,10640522833,2665233546,10640516223,-6610,,
2759183309,10640540887,2665251599,10640534277,-6610,10640534297,
2759433760,10640791339,2665502051,10640784734,-6605,,
2759684352,10641041931,2665752643,10641035331,-6600,,
2759934825,10641292404,2666003117,10641285811,-6593,,
2760185400,10641542979,2666253691,10641536401,-6578,,
2760435796,10641793375,2666504097,10641786797,-6578,,
2760686417,10642043996,2666754709,10642037408,-6588,,
2760936968,10642294547,2667005260,10642287959,-6588,,
2761187436,10642545015,2667255727,10642538426,-6589,,
2761205587,10642563165,2667273877,10642556577,-6588,10642556619,
2761456193,10642813772,2667524484,10642807194,-6578,,
2761706383,10643063972,2667774685,10643057406,-6566,,
2761957040,10643314618,2668025331,10643308063,-6555,,
2762207686,10643565264,2668275977,10643558720,-6544,,
2762458042,10643815620,2668526333,10643809076,-6544,,
2762708684,10644066262,2668776985,10644059729,-6533,,
2762959243,10644316822,2669027535,10644310279,-6543,,
2763209756,10644567345,2669278058,10644560801,-6544,,
2763227921,10644585500,2669296212,10644578955,-6545,10644578913,
2763478070,10644835649,2669546361,10644829093,-6556,,
2763728222,10645085802,2669796514,10645079237,-6565,,
2763978804,10645336383,2670047095,10645329807,-6576,,
2764229742,10645587321,2670298034,10645580736,-6585,,
2764480216,10645837795,2670548507,10645831209,-6586,,
2764730771,10646088350,2670799073,10646081775,-6575,,
2764981147,10646338726,2671049439,10646332141,-6585,,
2765231289,10646588868,2671299580,10646582283,-6585,,
2765249368,10646606946,2671317658,10646600361,-6585,10646600305,
2765499796,10646857374,2671568087,10646850775,-6599,,
2765750383,10647107961,2671818685,10647101360,-6601,,
2766000573,10647358152,2672068864,10647351526,-6626,,
2766250775,10647608354,2672319066,10647601715,-6639,,
2766500965,10647858544,2672569257,10647851905,-6639,,
2766751123,10648108702,2672819414,10648102063,-6639,,
2767001472,10648359051,2673069764,10648352412,-6639,,
2767252065,10648609643,2673320356,10648603004,-6639,,
2767270202,10648627780,2673338493,10648621141,-6639,10648621191,
2767520699,10648878278,2673588990,10648871651,-6627,,
2767771257,10649128836,2673839548,10649122221,-6615,,
2768021505,10649379094,2674089806,10649372493,-6601,,
2768271858,10649629436,2674340149,10649622848,-6588,,
2768522784,10649880363,2674591075,10649873774,-6589,,
2768772909,10650130488,2674841200,10650123900,-6588,,
2769023332,10650380911,2675091624,10650374323,-6588,,
2769273770,10650631349,2675342071,10650624771,-6578,,
2769291919,10650649498,2675360210,10650642909,-6589,10650642869,
2769542029,10650899608,2675610320,10650893010,-6598,,
2769792184,10651149763,2675860476,10651143155,-6608,,
2770042807,10651400386,2676111099,10651393769,-6617,,
2770293614,10651651192,2676361905,10651644565,-6627,,
2770543880,10651901458,2676612171,10651894831,-6627,,
2770794018,10652151597,2676862309,10652144980,-6617,,
2771044283,10652401862,2677112575,10652395235,-6627,,
2771294877,10652652455,2677363167,10652645828,-6627,,
2771313099,10652670678,2677381390,10652664050,-6628,10652664006,
2771563489,10652921068,2677631780,10652914430,-6638,,
2771813827,10653171405,2677882118,10653164756,-6649,,
2772064138,10653421716,2678132429,10653415056,-6660,,
2772314913,10653672492,2678383204,10653665822,-6670,,
2772565438,10653923016,2678633729,10653916346,-6670,,
2772816010,10654173589,2678884302,10654166919,-6670,,
2773066154,10654423733,2679134446,10654417064,-6669,,
2773316286,10654673864,2679384577,10654667205,-6659,,
2773334432,10654692011,2679402723,10654685341,-6670,10654685408,
2773584968,10654942547,2679653259,10654935894,-6653,,
2773835384,10655192963,2679903675,10655186327,-6636,,
2774085995,10655443574,2680154287,10655436957,-6617,,
2774336301,10655693879,2680404591,10655687278,-6601,,
2774586515,10655944094,2680654806,10655937493,-6601,,
2774836894,10656194472,2680905184,10656187871,-6601,,
2775087442,10656445022,2681155735,10656438421,-6601,,
2775337689,10656695268,2681405980,10656688666,-6602,,
2775356114,10656713693,2681424405,10656707091,-6602,10656707034,
2775606388,10656963967,2681674680,10656957351,-6616,,
2775856715,10657214294,2681925006,10657207664,-6630,,
2776107260,10657464839,2682175552,10657458195,-6644,,
2776357852,10657715431,2682426143,10657708774,-6657,,
2776607994,10657965572,2682676285,10657958915,-6657,,
2776858400,10658215978,2682926691,10658209321,-6657,,
2777108863,10658466443,2683177155,10658459786,-6657,,
2777359232,10658716811,2683427523,10658710154,-6657,,
2777377346,10658734924,2683445637,10658728267,-6657,10658728235,
2777627559,10658985138,2683695850,10658978471,-6667,,
2777877894,10659235473,2683946185,10659228800,-6673,,
2778128056,10659485635,2684196347,10659478954,-6681,,
2778378518,10659736097,2684446810,10659729409,-6688,,
2778629139,10659986718,2684697430,10659980029,-6689,,
2778879311,10660236889,2684947602,10660230201,-6688,,
2779129560,10660487139,2685197852,10660480452,-6687,,
2779379926,10660737505,2685448218,10660730817,-6688,,
2779397869,10660755447,2685466159,10660748759,-6688,10660748765,
2779648526,10661006105,2685716817,10660999419,-6686,,
2779898952,10661256530,2685967242,10661249846,-6684,,
2780149206,10661506785,2686217498,10661500104,-6681,,
2780399817,10661757395,2686468118,10661750726,-6669,,
2780650453,10662008032,2686718744,10662001351,-6681,,
2780900922,10662258500,2686969212,10662251820,-6680,,
2781151353,10662508943,2687219655,10662502263,-6680,,
2781401959,10662759538,2687470250,10662752857,-6681,,
2781420123,10662777701,2687488414,10662771021,-6680,10662771033,
2781670576,10663028155,2687738867,10663021477,-6678,,
2781921057,10663278635,2687989348,10663271961,-6674,,
2782171460,10663529039,2688239751,10663522368,-6671,,
2782421553,10663779132,2688489844,10663772465,-6667,,
2782671685,10664029264,2688739976,10664022597,-6667,,
2782921840,10664279419,2688990131,10664272752,-6667,,
2783172115,10664529694,2689240407,10664523027,-6667,,
2783422370,10664779949,2689490661,10664773282,-6667,,
2783440423,10664798001,2689508714,10664791334,-6667,10664791311,
2783690549,10665048128,2689758840,10665041455,-6673,,
2783941120,10665298699,2690009411,10665292021,-6678,,
2784191270,10665548848,2690259561,10665542165,-6683,,
2784441430,10665799019,2690509731,10665792330,-6689,,
2784691750,10666049328,2690760041,10666042650,-6678,,
2784941881,10666299470,2691010182,10666292781,-6689,,
2785192227,10666549816,2691260528,10666543127,-6689,,
2785443176,10666800754,2691511467,10666794075,-6679,,
2785461174,10666818752,2691529465,10666812063,-6689,10666812055,
2785711686,10667069265,2691779977,10667062573,-6692,,
2785962087,10667319667,2692030380,10667312975,-6692,,
2786212252,10667569831,2692280543,10667563136,-6695,,
2786462373,10667819952,2692530664,10667813255,-6697,,
2786712967,10668070545,2692781257,10668063849,-6696,,
2786963242,10668320821,2693031533,10668314125,-6696,,
2787214273,10668571862,2693282574,10668565166,-6696,,
2787465068,10668822657,2693533370,10668815961,-6696,,
2787483276,10668840854,2693551567,10668834158,-6696,10668834079,
2787733381,10669090959,2693801672,10669084242,-6717,,
2787983906,10669341485,2694052198,10669334749,-6736,,
2788234517,10669592107,2694302819,10669585351,-6756,,
2788484786,10669842365,2694553088,10669835601,-6764,,
2788734908,10670092486,2694803199,10670085712,-6774,,
2788985476,10670343055,2695053767,10670336290,-6765,,
2789235875,10670593453,2695304176,10670586690,-6763,,
2789486590,10670844180,2695554892,10670837406,-6774,,
2789504599,10670862177,2695572890,10670855403,-6774,10670855444,
2789754812,10671112390,2695823103,10671105625,-6765,,
2790005042,10671362622,2696073334,10671355868,-6754,,
2790255551,10671613140,2696323853,10671606397,-6743,,
2790505963,10671863542,2696574255,10671856821,-6721,,
2790756115,10672113694,2696824406,10672106962,-6732,,
2791006305,10672363883,2697074596,10672357151,-6732,,
2791256531,10672614109,2697324822,10672607387,-6722,,
2791507003,10672864593,2697575305,10672857860,-6733,,
2791525118,10672882696,2697593408,10672875964,-6732,10672875986,
2791775797,10673133376,2697844088,10673126648,-6728,,
2792026354,10673383934,2698094647,10673377213,-6721,,
2792276497,10673634076,2698344788,10673627361,-6715,,
2792526691,10673884270,2698594993,10673877571,-6699,,
2792777206,10674134785,2698845497,10674128075,-6710,,
2793027674,10674385252,2699095965,10674378543,-6709,,
2793277829,10674635408,2699346121,10674628699,-6709,,
2793528152,10674885731,2699596444,10674879022,-6709,,
2793546193,10674903771,2699614483,10674897062,-6709,10674897078,
2793796528,10675154106,2699864819,10675147401,-6705,,
2794046846,10675404426,2700115139,10675397725,-6701,,
2794297031,10675654620,2700365333,10675647925,-6695,,
2794547415,10675904993,2700615706,10675898301,-6692,,
2794797962,10676155540,2700866252,10676148848,-6692,,
2795048151,10676405730,2701116442,10676399037,-6693,,
2795298361,10676655940,2701366662,10676649258,-6682,,
2795548659,10676906237,2701616950,10676899545,-6692,,
2795566843,10676924421,2701635133,10676917729,-6692,10676917729,
2795817247,10677174826,2701885538,10677168133,-6693,,
2796067927,10677425506,2702136219,10677418815,-6691,,
2796318566,10677676145,2702386857,10677669454,-6691,,
2796569170,10677926749,2702637461,10677920059,-6690,,
2796819557,10678177136,2702887848,10678170446,-6690,,
2797069779,10678427357,2703138070,10678420667,-6690,,
2797320075,10678677654,2703388367,10678670974,-6680,,
2797570486,10678928065,2703638777,10678921375,-6690,,
2797588611,10678946189,2703656902,10678939499,-6690,10678939428,
2797838823,10679196402,2703907114,10679189693,-6709,,
2798089422,10679447002,2704157714,10679440276,-6726,,
2798339754,10679697333,2704408055,10679690600,-6733,,
2798590326,10679947905,2704658617,10679941145,-6760,,
2798840848,10680198427,2704909139,10680191666,-6761,,
2799091432,10680449010,2705159723,10680442250,-6760,,
2799341881,10680699460,2705410173,10680692700,-6760,,
2799592571,10680950149,2705660862,10680943389,-6760,,
2799610757,10680968336,2705679048,10680961575,-6761,10680961590,
2799861336,10681218915,2705929627,10681212158,-6757,,
2800112208,10681469787,2706180500,10681463034,-6753,,
2800362697,10681720287,2706431000,10681713538,-6749,,
2800612912,10681970491,2706681203,10681963746,-6745,,
2800863648,10682221226,2706931939,10682214482,-6744,,
2801113876,10682471454,2707182167,10682464710,-6744,,
2801364030,10682721619,2707432331,10682714875,-6744,,
2801614397,10682971976,2707682688,10682965232,-6744,,
2801632460,10682990039,2707700751,10682983294,-6745,10682983289,
2801882922,10683240501,2707951213,10683233765,-6736,,
2802133398,10683490977,2708201689,10683484230,-6747,,
2802384140,10683741719,2708452432,10683734972,-6747,,
2802634574,10683992153,2708702865,10683985404,-6749,,
2802885268,10684242847,2708953560,10684236109,-6738,,
2803135598,10684493177,2709203899,10684486438,-6739,,
2803385846,10684743425,2709454137,10684736677,-6748,,
2803636453,10684994032,2709704744,10684987294,-6738,,
2803654504,10685012083,2709722795,10685005334,-6749,10685005323,
2803904807,10685262385,2709973098,10685255644,-6741,,
2804154941,10685512520,2710223232,10685505766,-6754,,
2804405839,10685763429,2710474141,10685756674,-6755,,
2804656601,10686014180,2710724892,10686007421,-6759,,
2804906814,10686264392,2710975105,10686257634,-6758,,
2805157565,10686515144,2711225856,10686508385,-6759,,
2805407953,10686765543,2711476255,10686758785,-6758,,
2805658422,10687016001,2711726713,10687009242,-6759,,
2805676684,10687034262,2711744975,10687027504,-6758,10687027491,
2805927258,10687284847,2711995559,10687278086,-6761,,
2806178211,10687535800,2712246513,10687529036,-6764,,
2806428886,10687786465,2712497178,10687779699,-6766,,
2806679070,10688036648,2712747360,10688029879,-6769,,
2806929191,10688286769,2712997482,10688280000,-6769,,
2807179791,10688537370,2713248082,10688530601,-6769,,
2807430011,10688787590,2713498303,10688780821,-6769,,
2807680338,10689037917,2713748630,10689031148,-6769,,
2807698504,10689056083,2713766805,10689049323,-6760,10689049268,
2807949058,10689306637,2714017349,10689299856,-6781,,
2808199269,10689556847,2714267560,10689550055,-6792,,
2808449924,10689807514,2714518226,10689800712,-6802,,
2808700232,10690057811,2714768523,10690051007,-6804,,
2808950809,10690308387,2715019099,10690301574,-6813,,
2809201645,10690559223,2715269936,10690552410,-6813,,
2809452059,10690809649,2715520361,10690802836,-6813,,
2809702200,10691059779,2715770491,10691052976,-6803,,
2809720422,10691078000,2715788713,10691071187,-6813,10691071291,
2809970821,10691328400,2716039113,10691321612,-6788,,
2810221033,10691578612,2716289324,10691571850,-6762,,
2810471247,10691828826,2716539538,10691822090,-6736,,
2810722118,10692079697,2716790409,10692072988,-6709,,
2810972464,10692330043,2717040755,10692323334,-6709,,
2811223080,10692580658,2717291371,10692573950,-6708,,
2811473462,10692831040,2717541753,10692824332,-6708,,
2811724077,10693081656,2717792369,10693074948,-6708,,
2811742158,10693099737,2717810449,10693093028,-6709,10693093028,
2811992488,10693350067,2718060780,10693343359,-6708,,
2812242620,10693600198,2718310911,10693593490,-6708,,
2812493031,10693850610,2718561332,10693843912,-6698,,
2812743150,10694100729,2718811442,10694094022,-6707,,
2812993490,10694351068,2719061781,10694344361,-6707,,
2813243600,10694601179,2719311891,10694594471,-6708,,
2813493932,10694851521,2719562234,10694844815,-6706,,
2813744280,10695101858,2719812571,10695095151,-6707,,
2813762424,10695120002,2719830714,10695113295,-6707,10695113331,
2814013061,10695370640,2720081353,10695363942,-6698,,
2814263239,10695620818,2720331531,10695614140,-6678,,
2814513385,10695870964,2720581677,10695864285,-6679,,
2814763926,10696121504,2720832217,10696114846,-6658,,
2815014050,10696371638,2721082351,10696364969,-6669,,
2815264422,10696622001,2721332713,10696615341,-6660,,
2815514741,10696872320,2721583032,10696865650,-6670,,
2815765646,10697123224,2721833937,10697116565,-6659,,
2815783784,10697141363,2721852075,10697134693,-6670,10697134662,
2816034139,10697391718,2722102430,10697385040,-6678,,
2816284344,10697641922,2722352635,10697635238,-6684,,
2816534651,10697892230,2722602942,10697885538,-6692,,
2816784767,10698142346,2722853058,10698135646,-6700,,
2817035495,10698393074,2723103787,10698386376,-6698,,
2817286463,10698644042,2723354764,10698637352,-6690,,
2817537116,10698894695,2723605407,10698887996,-6699,,
2817787413,10699144992,2723855705,10699138293,-6699,,
2817805551,10699163130,2723873842,10699156430,-6700,10699156389,
2818056205,10699413784,2724124496,10699407084,-6700,,
2818306690,10699664270,2724374982,10699657550,-6720,,
2818556816,10699914395,2724625107,10699907665,-6730,,
2818807175,10700164754,2724875466,10700158015,-6739,,
2819057361,10700414940,2725125653,10700408201,-6739,,
2819307799,10700665378,2725376090,10700658639,-6739,,
2819558299,10700915888,2725626601,10700909149,-6739,,
2819808571,10701166150,2725876872,10701159421,-6729,,
2819826589,10701184167,2725894879,10701177428,-6739,10701177405,
2820077004,10701434582,2726145295,10701427838,-6744,,
2820327611,10701685190,2726395902,10701678440,-6750,,
2820577965,10701935554,2726646266,10701928799,-6755,,
2820828328,10702185906,2726896629,10702179156,-6750,,
2821079036,10702436615,2727147328,10702429855,-6760,,
2821329632,10702687210,2727397923,10702680450,-6760,,
2821580179,10702937758,2727648470,10702930997,-6761,,
2821830627,10703188206,2727898918,10703181446,-6760,,
2821848878,10703206457,2727917169,10703199697,-6760,10703199656,
2822099095,10703456673,2728167386,10703449903,-6770,,
2822349369,10703706948,2728417671,10703700179,-6769,,
2822599735,10703957324,2728668037,10703950536,-6788,,
2822850046,10704207624,2728918337,10704200825,-6799,,
2823100716,10704458296,2729169009,10704451497,-6799,,
2823350851,10704708440,2729419153,10704701641,-6799,,
2823601327,10704958906,2729669618,10704952107,-6799,,
2823851436,10705209015,2729919727,10705202216,-6799,,
2823869442,10705227020,2729937732,10705220221,-6799,10705220271,
2824119918,10705477496,2730188209,10705470710,-6786,,
2824370134,10705727712,2730438425,10705720939,-6773,,
2824620328,10705977907,2730688620,10705971147,-6760,,
2824870647,10706228225,2730938937,10706221478,-6747,,
2825121154,10706478733,2731189446,10706471987,-6746,,
2825371604,10706729183,2731439895,10706722435,-6748,,
2825621809,10706979388,2731690101,10706972641,-6747,,
2825872423,10707230002,2731940714,10707223255,-6747,,
2825890517,10707248105,2731958818,10707241358,-6747,10707241340,
2826140653,10707498231,2732208944,10707491483,-6748,,
2826391117,10707748696,2732459418,10707741956,-6740,,
2826641683,10707999262,2732709975,10707992512,-6750,,
2826891997,10708249575,2732960288,10708242822,-6753,,
2827142354,10708499943,2733210656,10708493190,-6753,,
2827393031,10708750609,2733461322,10708743867,-6742,,
2827643174,10709000754,2733711466,10708994000,-6754,,
2827893296,10709250875,2733961598,10709244132,-6743,,
2827911334,10709268912,2733979625,10709262159,-6753,10709262115,
2828162065,10709519644,2734230356,10709512878,-6766,,
2828412273,10709769852,2734480564,10709763076,-6776,,
2828662443,10710020022,2734730734,10710013236,-6786,,
2828912693,10710270272,2734980984,10710263475,-6797,,
2829163578,10710521157,2735231869,10710514361,-6796,,
2829413813,10710771392,2735482104,10710764596,-6796,,
2829663934,10711021513,2735732226,10711014717,-6796,,
2829914829,10711272408,2735983120,10711265611,-6797,,
2829932988,10711290566,2736001279,10711283770,-6796,10711283805,
2830183846,10711541424,2736252137,10711534636,-6788,,
2830434177,10711791756,2736502480,10711784989,-6767,,
2830684285,10712041864,2736752577,10712035096,-6768,,
2830935042,10712292621,2737003333,10712285860,-6761,,
2831185516,10712543105,2737253818,10712536346,-6759,,
2831435679,10712793258,2737503971,10712786508,-6750,,
2831686013,10713043592,2737754305,10713036833,-6759,,
2831936682,10713294261,2738004973,10713287501,-6760,,
2831954709,10713312288,2738023000,10713305527,-6761,10713305498,
2832204941,10713562519,2738273232,10713555752,-6767,,
2832455073,10713812652,2738523364,10713805878,-6774,,
2832705692,10714063271,2738773984,10714056491,-6780,,
2832955836,10714313415,2739024127,10714306627,-6788,,
2833206749,10714564328,2739275040,10714557539,-6789,,
2833457332,10714814911,2739525624,10714808123,-6788,,
2833707587,10715065176,2739775888,10715058388,-6788,,
2833957716,10715315295,2740026007,10715308507,-6788,,
2833975818,10715333396,2740044109,10715326608,-6788,10715326631,
2834226349,10715583928,2740294640,10715577144,-6784,,
2834477011,10715834590,2740545302,10715827814,-6776,,
2834727871,10716085450,2740796162,10716078690,-6760,,
2834978384,10716335963,2741046675,10716329199,-6764,,
2835228859,10716586447,2741297160,10716579684,-6763,,
2835479037,10716836615,2741547328,10716829851,-6764,,
2835729597,10717087175,2741797888,10717080411,-6764,,
2835980085,10717337664,2742048376,10717330900,-6764,,
2835998222,10717355801,2742066513,10717349036,-6765,10717349024,
2836248374,10717605953,2742316665,10717599185,-6768,,
2836498857,10717856435,2742567148,10717849665,-6770,,
2836749193,10718106772,2742817485,10718100000,-6772,,
2836999714,10718357293,2743068006,10718350518,-6775,,
2837250035,10718607613,2743318337,10718600849,-6764,,
2837501076,10718858655,2743569367,10718851879,-6776,,
2837751628,10719109207,2743819919,10719102432,-6775,,
2838001841,10719359419,2744070132,10719352644,-6775,,
2838019951,10719377529,2744088241,10719370754,-6775,10719370724,
2838270437,10719628015,2744338728,10719621232,-6783,,
2838521044,10719878622,2744589335,10719871831,-6791,,
2838771229,10720128818,2744839530,10720122020,-6798,,
2839021457,10720379035,2745089758,10720372241,-6794,,
2839272244,10720629823,2745340535,10720623018,-6805,,
2839522664,10720880242,2745590965,10720873448,-6794,,
2839773042,10721130631,2745841343,10721123827,-6804,,
2840023518,10721381098,2746091810,10721374294,-6804,,
2840041610,10721399188,2746109900,10721392383,-6805,10721392410,
2840292444,10721650023,2746360735,10721643224,-6799,,
2840542891,10721900469,2746611182,10721893679,-6790,,
2840793018,10722150597,2746861310,10722143814,-6783,,
2841043354,10722400944,2747111657,10722394168,-6776,,
2841293552,10722651131,2747361853,10722644365,-6766,,
2841543969,10722901548,2747612260,10722894771,-6777,,
2841794141,10723151731,2747862443,10723144955,-6776,,
2842044699,10723402279,2748112992,10723395504,-6775,,
2842062782,10723420360,2748131072,10723413584,-6776,10723413591,
2842313060,10723670639,2748381351,10723663864,-6775,,
2842563534,10723921113,2748631825,10723914341,-6772,,
2842814304,10724171893,2748882606,10724165124,-6769,,
2843064874,10724422453,2749133175,10724415696,-6757,,
2843315244,10724672822,2749383535,10724666066,-6756,,
2843565418,10724922996,2749633709,10724916229,-6767,,
2843815659,10725173238,2749883950,10725166470,-6768,,
2844066280,10725423860,2750134573,10725417093,-6767,,
2844084503,10725442082,2750152794,10725435314,-6768,10725435302,
2844334962,10725692541,2750403253,10725685771,-6770,,
2844585351,10725942929,2750653642,10725936156,-6773,,
2844835743,10726193322,2750904035,10726186547,-6775,,
2845086172,10726443751,2751154463,10726436983,-6768,,
2845336433,10726694011,2751404724,10726687233,-6778,,
2845586744,10726944323,2751655035,10726937544,-6779,,
2845837167,10727194746,2751905459,10727187968,-6778,,
2846087326,10727444906,2752155619,10727438128,-6778,,
2846105489,10727463067,2752173779,10727456289,-6778,10727456230,
2846355731,10727713320,2752424033,10727706528,-6792,,
2846606004,10727963583,2752674295,10727956777,-6806,,
2846856501,10728214079,2752924792,10728207258,-6821,,
2847106616,10728464195,2753174908,10728457360,-6835,,
2847357018,10728714596,2753425309,10728707761,-6835,,
2847607521,10728965100,2753675812,10728958264,-6836,,
2847857909,10729215498,2753926211,10729208663,-6835,,
2848108666,10729466245,2754176958,10729459411,-6834,,
2848126805,10729484383,2754195095,10729477547,-6836,10729477525,
2848377297,10729734877,2754445589,10729728037,-6840,,
2848627466,10729985044,2754695757,10729978198,-6846,,
2848877670,10730235259,2754945971,10730228408,-6851,,
2849128222,10730485801,2755196513,10730478945,-6856,,
2849378393,10730735983,2755446695,10730729126,-6857,,
2849628823,10730986402,2755697114,10730979546,-6856,,
2849879293,10731236872,2755947594,10731230026,-6846,,
2850129806,10731487385,2756198098,10731480529,-6856,,
2850147896,10731505475,2756216187,10731498618,-6857,10731498662,
2850398074,10731755653,2756466375,10731748818,-6835,,
2850648416,10732005995,2756716707,10731999160,-6835,,
2850899009,10732256597,2756967310,10732249775,-6822,,
2851149408,10732506987,2757217699,10732500176,-6811,,
2851399917,10732757496,2757468208,10732750695,-6801,,
2851650176,10733007755,2757718467,10733000944,-6811,,
2851900484,10733258063,2757968776,10733251253,-6810,,
2852151133,10733508711,2758219424,10733501901,-6810,,
2852169292,10733526870,2758237583,10733520059,-6811,10733520022,
2852419869,10733777447,2758488160,10733770626,-6821,,
2852670040,10734027619,2758738331,10734020789,-6830,,
2852920575,10734278154,2758988867,10734271316,-6838,,
2853170740,10734528318,2759239031,10734521472,-6846,,
2853421528,10734779107,2759489820,10734772261,-6846,,
2853672098,10735029676,2759740389,10735022830,-6846,,
2853922847,10735280425,2759991148,10735273590,-6835,,
2854173616,10735531195,2760241907,10735524349,-6846,,
2854191739,10735549317,2760260029,10735542471,-6846,10735542503,
2854442138,10735799717,2760510430,10735792878,-6839,,
2854692678,10736050256,2760760969,10736043426,-6830,,
2854943397,10736300975,2761011688,10736294163,-6812,,
2855193602,10736551181,2761261893,10736544368,-6813,,
2855443872,10736801451,2761512164,10736794638,-6813,,
2855694227,10737051806,2761762519,10737044993,-6813,,
2855944828,10737302407,2762013119,10737295604,-6803,,
2856195251,10737552841,2762263553,10737546028,-6813,,
2856213513,10737571091,2762281804,10737564278,-6813,10737564139,
2856464433,10737822012,2762532734,10737815174,-6838,,
2856714791,10738072370,2762783082,10738065488,-6882,,
2856965434,10738323013,2763033725,10738316095,-6918,,
2857215807,10738573386,2763284098,10738566434,-6952,,
2857466406,10738823984,2763534697,10738817044,-6940,,
2857716512,10739074091,2763784803,10739067139,-6952,,
2857967149,10739324727,2764035440,10739317776,-6951,,
2858217531,10739575109,2764285822,10739568158,-6951,,
2858235713,10739593291,2764304004,10739586340,-6951,10739586468,
2858485895,10739843474,2764554187,10739836554,-6920,,
2858736484,10740094062,2764804775,10740087175,-6887,,
2858987139,10740344718,2765055430,10740337862,-6856,,
2859237248,10740594827,2765305539,10740588005,-6822,,
2859487501,10740845079,2765555792,10740838267,-6812,,
2859738139,10741095718,2765806431,10741088896,-6822,,
2859989100,10741346678,2766057391,10741339866,-6812,,
2860239413,10741596992,2766307705,10741590170,-6822,,
2860257651,10741615230,2766325942,10741608407,-6823,10741608398,
2860508366,10741865945,2766576657,10741859120,-6825,,
2860758841,10742116420,2766827132,10742109592,-6828,,
2861009393,10742366972,2767077684,10742360143,-6829,,
2861259784,10742617363,2767328075,10742610532,-6831,,
2861510153,10742867732,2767578444,10742860902,-6830,,
2861760274,10743117853,2767828565,10743111033,-6820,,
2862010488,10743368067,2768078779,10743361237,-6830,,
2862260630,10743618208,2768328921,10743611378,-6830,,
2862278602,10743636181,2768346893,10743629350,-6831,10743629306,
2862529205,10743886784,2768597496,10743879942,-6842,,
2862779711,10744137290,2768848002,10744130438,-6852,,
2863029992,10744387571,2769098284,10744380709,-6862,,
2863280171,10744637749,2769348462,10744630876,-6873,,
2863530591,10744888169,2769598882,10744881296,-6873,,
2863781185,10745138763,2769849475,10745131890,-6873,,
2864031458,10745389037,2770099750,10745382164,-6873,,
2864281676,10745639254,2770349967,10745632381,-6873,,
2864299734,10745657313,2770368025,10745650439,-6874,10745650479,
2864550207,10745907785,2770618498,10745900922,-6863,,
2864800411,10746158000,2770868712,10746151147,-6853,,
2865051164,10746408743,2771119456,10746401901,-6842,,
2865301348,10746658927,2771369639,10746652094,-6833,,
2865551797,10746909375,2771620088,10746902543,-6832,,
2865802263,10747159841,2771870565,10747153020,-6821,,
2866052842,10747410421,2772121133,10747403598,-6823,,
2866303277,10747660855,2772371568,10747654023,-6832,,
2866321417,10747678995,2772389708,10747672163,-6832,10747672176,
2866571927,10747929505,2772640218,10747922676,-6829,,
2866822281,10748179860,2772890572,10748173034,-6826,,
2867072716,10748430296,2773141009,10748423474,-6822,,
2867323102,10748680680,2773391392,10748673862,-6818,,
2867573610,10748931188,2773641901,10748924370,-6818,,
2867824486,10749182065,2773892777,10749175247,-6818,,
2868075060,10749432639,2774143351,10749425820,-6819,,
2868325279,10749682857,2774393570,10749676039,-6818,,
2868343433,10749701012,2774411724,10749694193,-6819,10749694153,
2868593789,10749951367,2774662080,10749944539,-6828,,
2868844047,10750201626,2774912339,10750194788,-6838,,
2869094366,10750451945,2775162658,10750445099,-6846,,
2869344561,10750702150,2775412862,10750695293,-6857,,
2869595096,10750952675,2775663387,10750945818,-6857,,
2869845253,10751202831,2775913544,10751195974,-6857,,
2870096144,10751453722,2776164435,10751446865,-6857,,
2870346657,10751704235,2776414948,10751697378,-6857,,
2870364863,10751722441,2776433154,10751715594,-6847,10751715521,
2870615058,10751972637,2776683349,10751965763,-6874,,
2870865910,10752223489,2776934201,10752216601,-6888,,
2871116267,10752473847,2777184559,10752466944,-6903,,
2871366667,10752724246,2777434958,10752717328,-6918,,
2871616830,10752974409,2777685121,10752967491,-6918,,
2871866949,10753224528,2777935240,10753217610,-6918,,
2872117124,10753474702,2778185415,10753467784,-6918,,
2872367799,10753725378,2778436090,10753718459,-6919,,
2872385962,10753743540,2778454252,10753736622,-6918,10753736680,
2872636160,10753993739,2778704451,10753986836,-6903,,
2872886582,10754244161,2778954874,10754237273,-6888,,
2873137010,10754494590,2779205302,10754487717,-6873,,
2873387173,10754744752,2779455464,10754737894,-6858,,
2873637798,10754995377,2779706090,10754988519,-6858,,
2873887951,10755245530,2779956242,10755238672,-6858,,
2874138870,10755496449,2780207161,10755489590,-6859,,
2874389281,10755746859,2780457571,10755740001,-6858,,
2874407344,10755764922,2780475634,10755758064,-6858,10755758008,
2874657931,10756015510,2780726222,10756008638,-6872,,
2874908332,10756265911,2780976624,10756259025,-6886,,
2875158830,10756516409,2781227122,10756509510,-6899,,
2875409676,10756767255,2781477967,10756760342,-6913,,
2875660208,10757017787,2781728499,10757010874,-6913,,
2875910423,10757268001,2781978714,10757261088,-6913,,
2876160726,10757518305,2782229017,10757511391,-6914,,
2876410956,10757768534,2782479247,10757761621,-6913,,
2876429029,10757786607,2782497320,10757779694,-6913,10757779720,
2876679287,10758036865,2782747578,10758029958,-6907,,
2876929633,10758287212,2782997924,10758280311,-6901,,
2877180649,10758538228,2783248940,10758531334,-6894,,
2877430757,10758788346,2783499058,10758781460,-6886,,
2877681077,10759038656,2783749368,10759031769,-6887,,
2877931223,10759288802,2783999514,10759281916,-6886,,
2878181561,10759539140,2784249852,10759532253,-6887,,
2878431723,10759789302,2784500014,10759782416,-6886,,
2878449863,10759807442,2784518154,10759800555,-6887,10759800516,
2878700265,10760057843,2784768556,10760050947,-6896,,
2878950906,10760308485,2785019197,10760301578,-6907,,
2879201474,10760559053,2785269765,10760552138,-6915,,
2879451820,10760809410,2785520122,10760802486,-6924,,
2879702232,10761059811,2785770523,10761052887,-6924,,
2879952961,10761310539,2786021252,10761303615,-6924,,
2880203240,10761560819,2786271531,10761553905,-6914,,
2880454195,10761811774,2786522486,10761804850,-6924,,
2880472320,10761829898,2786540611,10761822974,-6924,10761822988,
2880722470,10762080049,2786790762,10762073129,-6920,,
2880972602,10762330180,2787040893,10762323264,-6916,,
2881223334,10762580912,2787291625,10762574000,-6912,,
2881473468,10762831046,2787541759,10762824138,-6908,,
2881723809,10763081387,2787792100,10763074479,-6908,,
2881973993,10763331572,2788042285,10763324674,-6898,,
2882224882,10763582461,2788293173,10763575553,-6908,,
2882475263,10763832842,2788543554,10763825933,-6909,,
2882493355,10763850933,2788561645,10763844025,-6908,10763843982,
2882743870,10764101448,2788812161,10764094530,-6918,,
2882994380,10764351969,2789062681,10764345040,-6929,,
2883244872,10764602462,2789313174,10764595523,-6939,,
2883495070,10764852659,2789563371,10764845710,-6949,,
2883745407,10765102986,2789813698,10765096037,-6949,,
2883995591,10765353170,2790063882,10765346230,-6940,,
2884245774,10765603353,2790314066,10765596404,-6949,,
2884496221,10765853799,2790564512,10765846850,-6949,,
2884514310,10765871889,2790582601,10765864939,-6950,10765864998,
2884764570,10766122149,2790832861,10766115225,-6924,,
2885015086,10766372665,2791083387,10766365756,-6909,,
2885265372,10766622951,2791333663,10766616057,-6894,,
2885515679,10766873258,2791583970,10766866368,-6890,,
2885765876,10767123454,2791834167,10767116565,-6889,,
2886016193,10767373772,2792084495,10767366893,-6879,,
2886267199,10767624788,2792335500,10767617899,-6889,,
2886517800,10767875378,2792586091,10767868489,-6889,,
2886535824,10767893402,2792604115,10767886513,-6889,10767886474,
2886785993,10768143571,2792854284,10768136672,-6899,,
2887036791,10768394370,2793105083,10768387462,-6908,,
2887287619,10768645198,2793355911,10768638282,-6916,,
2887537827,10768895415,2793606128,10768888489,-6926,,
2887788117,10769145696,2793856409,10769138770,-6926,,
2888038863,10769396442,2794107165,10769389526,-6916,,
2888289020,10769646598,2794357321,10769639682,-6916,,
2888539250,10769896828,2794607541,10769889902,-6926,,
2888557330,10769914908,2794625621,10769907982,-6926,10769907898,
2888807561,10770165139,2794875851,10770158192,-6947,,
2889058284,10770415864,2795126576,10770408897,-6967,,
2889308622,10770666201,2795376914,10770659214,-6987,,
2889558929,10770916508,2795627230,10770909509,-6999,,
2889809047,10771166625,2795877338,10771159617,-7008,,
2890059471,10771417050,2796127762,10771410042,-7008,,
2890309585,10771667175,2796377887,10771660166,-7009,,
2890560360,10771917938,2796628651,10771910930,-7008,,
2890578433,10771936011,2796646724,10771929003,-7008,10771929090,
2890828688,10772186267,2796896979,10772179281,-6986,,
2891079024,10772436604,2797147316,10772429640,-6964,,
2891329839,10772687418,2797398131,10772680476,-6942,,
2891580371,10772937950,2797648662,10772931031,-6919,,
2891831154,10773188733,2797899445,10773181814,-6919,,
2892081757,10773439336,2798150059,10773432427,-6909,,
2892332137,10773689716,2798400428,10773682797,-6919,,
2892582373,10773939952,2798650664,10773933033,-6919,,
2892600580,10773958158,2798668870,10773951239,-6919,10773951276,
2892850967,10774208545,2798919258,10774201636,-6909,,
2893101381,10774458969,2799169682,10774452070,-6899,,
2893351757,10774709335,2799420048,10774702445,-6890,,
2893602355,10774959934,2799670646,10774953054,-6880,,
2893853166,10775210745,2799921457,10775203864,-6881,,
2894103435,10775461014,2800171727,10775454135,-6879,,
2894354140,10775711719,2800422431,10775704839,-6880,,
2894604363,10775961942,2800672654,10775955072,-6870,,
2894622728,10775980306,2800691018,10775973426,-6880,10775973309,
2894873279,10776230857,2800941570,10776223948,-6909,,
2895123607,10776481196,2801191909,10776474258,-6938,,
2895373791,10776731370,2801442082,10776724403,-6967,,
2895624481,10776982060,2801692782,10776975075,-6985,,
2895875080,10777232659,2801943371,10777225664,-6995,,
2896125468,10777483047,2802193760,10777476053,-6994,,
2896375906,10777733484,2802444197,10777726489,-6995,,
2896626826,10777984405,2802695117,10777977420,-6985,,
2896645072,10778002650,2802713363,10777995655,-6995,10777995715,
2896895951,10778253530,2802964242,10778246549,-6981,,
2897146087,10778503666,2803214378,10778496700,-6966,,
2897396580,10778754158,2803464871,10778747209,-6949,,
2897646986,10779004565,2803715287,10778997640,-6925,,
2897897457,10779255035,2803965747,10779248101,-6934,,
2898147665,10779505244,2804215957,10779498310,-6934,,
2898398414,10779755993,2804466705,10779749059,-6934,,
2898648533,10780006111,2804716824,10779999177,-6934,,
2898666626,10780024205,2804734917,10780017270,-6935,10780017270,
2898917169,10780274748,2804985460,10780267814,-6934,,
2899167925,10780525505,2805236217,10780518571,-6934,,
2899418075,10780775653,2805486366,10780768720,-6933,,
2899668621,10781026199,2805736912,10781019266,-6933,,
2899919135,10781276713,2805987426,10781269780,-6933,,
2900170029,10781527608,2806238321,10781520675,-6933,,
2900420301,10781777880,2806488592,10781770947,-6933,,
2900670462,10782028040,2806738753,10782021107,-6933,,
2900688663,10782046241,2806756953,10782039308,-6933,10782039199,
2900938918,10782296497,2807007209,10782289537,-6960,,
2901189452,10782547042,2807257755,10782540055,-6987,,
2901439620,10782797199,2807507911,10782790186,-7013,,
2901690168,10783047747,2807758459,10783040718,-7029,,
2901940863,10783298441,2808009153,10783291401,-7040,,
2902191109,10783548688,2808259401,10783541648,-7040,,
2902441382,10783798971,2808509684,10783791931,-7040,,
2902691936,10784049515,2808760227,10784042475,-7040,,
2902710036,10784067614,2808778326,10784060574,-7040,10784060665,
2902960275,10784317854,2809028566,10784310837,-7017,,
2903210584,10784568163,2809278875,10784561170,-6993,,
2903460792,10784818371,2809529083,10784811400,-6971,,
2903710949,10785068527,2809779240,10785061580,-6947,,
2903961414,10785318993,2810029705,10785312046,-6947,,
2904211725,10785569304,2810280017,10785562357,-6947,,
2904461909,10785819488,2810530200,10785812540,-6948,,
2904712083,10786069661,2810780373,10786062714,-6947,,
2904730284,10786087862,2810798575,10786080915,-6947,10786080880,
2904980636,10786338215,2811048927,10786331258,-6957,,
2905231075,10786588664,2811299377,10786581699,-6965,,
2905481621,10786839200,2811549912,10786832227,-6973,,
2905732295,10787089875,2811800588,10787082894,-6981,,
2905982467,10787340046,2812050759,10787333066,-6980,,
2906233029,10787590618,2812301330,10787583637,-6981,,
2906483213,10787840792,2812551504,10787833811,-6981,,
2906733431,10788091010,2812801722,10788084039,-6971,,
2906751488,10788109066,2812819778,10788102085,-6981,10788102064,
2907002053,10788359631,2813070344,10788352646,-6985,,
2907252642,10788610231,2813320944,10788603241,-6990,,
2907502766,10788860344,2813571057,10788853349,-6995,,
2907752861,10789110440,2813821152,10789103439,-7001,,
2908003455,10789361034,2814071747,10789354034,-7000,,
2908253874,10789611463,2814322175,10789604463,-7000,,
2908504128,10789861707,2814572419,10789854707,-7000,,
2908754680,10790112258,2814822971,10790105258,-7000,,
2908772761,10790130339,2814841052,10790123339,-7000,10790123355,
2909023232,10790380810,2815091523,10790373815,-6995,,
2909273789,10790631368,2815342080,10790624376,-6992,,
2909523959,10790881538,2815592251,10790874552,-6986,,
2909774751,10791132330,2815843043,10791125348,-6982,,
2910025004,10791382583,2816093305,10791375610,-6973,,
2910275525,10791633104,2816343817,10791626122,-6982,,
2910525960,10791883539,2816594251,10791876557,-6982,,
2910776156,10792133735,2816844447,10792126753,-6982,,
2910794400,10792151978,2816862690,10792144996,-6982,10792145001,
2911045384,10792402962,2817113675,10792395981,-6981,,
2911295796,10792653375,2817364098,10792646406,-6969,,
2911546253,10792903831,2817614544,10792896853,-6978,,
2911796360,10793153938,2817864650,10793146962,-6976,,
2912046834,10793404412,2818115125,10793397436,-6976,,
2912297263,10793654842,2818365565,10793647876,-6966,,
2912547454,10793905032,2818615745,10793898056,-6976,,
2912798349,10794155928,2818866640,10794148962,-6966,,
2912816416,10794173994,2818884707,10794167018,-6976,10794166967,
2913066695,10794424274,2819134987,10794417284,-6990,,
2913316840,10794674418,2819385131,10794667416,-7002,,
2913566959,10794924538,2819635250,10794917524,-7014,,
2913817157,10795174736,2819885448,10795167709,-7027,,
2914068201,10795425781,2820136493,10795418755,-7026,,
2914318394,10795675972,2820386685,10795668946,-7026,,
2914568996,10795926575,2820637287,10795919548,-7027,,
2914819363,10796176942,2820887655,10796169916,-7026,,
2914837519,10796195097,2820905809,10796188071,-7026,10796188154,
2915087742,10796445321,2821156033,10796438315,-7006,,
2915337889,10796695469,2821406182,10796688486,-6983,,
2915588522,10796946101,2821656813,10796939139,-6962,,
2915838632,10797196210,2821906923,10797189269,-6941,,
2916088996,10797446575,2822157287,10797439633,-6942,,
2916339646,10797697225,2822407937,10797690284,-6941,,
2916590192,10797947770,2822658483,10797940829,-6941,,
2916840324,10798197903,2822908615,10798190961,-6942,,
2916858509,10798216087,2822926799,10798209146,-6941,10798209133,
2917109428,10798467007,2823177720,10798460063,-6944,,
2917360004,10798717582,2823428295,10798710644,-6938,,
2917610326,10798967905,2823678617,10798960955,-6950,,
2917860530,10799218109,2823928821,10799211155,-6954,,
2918110824,10799468402,2824179114,10799461449,-6953,,
2918361111,10799718690,2824429402,10799711736,-6954,,
2918611363,10799968941,2824679654,10799961988,-6953,,
2918861541,10800219120,2824929832,10800212167,-6953,,
2918879674,10800237252,2824947965,10800230299,-6953,10800230226,
2919130191,10800487770,2825198483,10800480799,-6971,,
2919380358,10800737937,2825448649,10800730947,-6990,,
2919630773,10800988351,2825699063,10800981344,-7007,,
2919880883,10801238461,2825949174,10801231437,-7024,,
2920131432,10801489011,2826199723,10801481987,-7024,,
2920382321,10801739899,2826450612,10801732875,-7024,,
2920632565,10801990143,2826700856,10801983119,-7024,,
2920882997,10802240575,2826951288,10802233551,-7024,,
2920901221,10802258799,2826969511,10802251775,-7024,10802251836,
2921151728,10802509308,2827220020,10802502300,-7008,,
2921402260,10802759839,2827470551,10802752847,-6992,,
2921652701,10803010279,2827720992,10803003302,-6977,,
2921902937,10803260515,2827971228,10803253554,-6961,,
2922153137,10803510716,2828221428,10803503755,-6961,,
2922403418,10803760998,2828471710,10803754036,-6962,,
2922653743,10804011322,2828722035,10804004361,-6961,,
2922904289,10804261868,2828972581,10804254907,-6961,,
2922922413,10804279991,2828990704,10804273030,-6961,10804272912,
2923172689,10804530268,2829240980,10804523277,-6991,,
2923423158,10804780737,2829491449,10804773726,-7011,,
2923673527,10805031106,2829741818,10805024057,-7049,,
2923924389,10805281968,2829992680,10805274889,-7079,,
2924174560,10805532139,2830242851,10805525061,-7078,,
2924424723,10805782312,2830493025,10805775234,-7078,,
2924674968,10806032547,2830743259,10806025469,-7078,,
2924925544,10806283123,2830993835,10806276044,-7079,,
2924943608,10806301187,2831011899,10806294109,-7078,10806294173,
2925193811,10806551391,2831262103,10806544329,-7062,,
2925443982,10806801561,2831512274,10806794515,-7046,,
2925694643,10807052222,2831762934,10807045192,-7030,,
2925944813,10807302392,2832013105,10807295380,-7012,,
2926195640,10807553219,2832263931,10807546207,-7012,,
2926446006,10807803585,2832514298,10807796573,-7012,,
2926696710,10808054288,2832765001,10808047276,-7012,,
2926947181,10808304760,2833015472,10808297748,-7012,,
2926965350,10808322929,2833033641,10808315917,-7012,10808315907,
2927215626,10808573205,2833283917,10808566190,-7015,,
2927466081,10808823660,2833534373,10808816644,-7016,,
2927716193,10809073772,2833784484,10809066754,-7018,,
2927966784,10809324363,2834035075,10809317343,-7020,,
2928217029,10809574607,2834285320,10809567587,-7020,,
2928467572,10809825161,2834535874,10809818142,-7019,,
2928717983,10810075562,2834786274,10810068552,-7010,,
2928968449,10810326028,2835036740,10810319007,-7021,,
2928986518,10810344096,2835054809,10810337076,-7020,10810337023,
2929236957,10810594536,2835305248,10810587502,-7034,,
2929487183,10810844762,2835555475,10810837717,-7045,,
2929737486,10811095064,2835805776,10811088005,-7059,,
2929987620,10811345199,2836055912,10811338127,-7072,,
2930238013,10811595592,2836306304,10811588519,-7073,,
2930488226,10811845805,2836556517,10811838733,-7072,,
2930738891,10812096470,2836807182,10812089398,-7072,,
2930989257,10812346836,2837057548,10812339764,-7072,,
2931007367,10812364945,2837075657,10812357873,-7072,10812357844,
2931257961,10812615540,2837326252,10812608459,-7081,,
2931508334,10812865913,2837576625,10812858825,-7088,,
2931758685,10813116264,2837826987,10813109182,-7082,,
2932008860,10813366439,2838077151,10813359339,-7100,,
2932259244,10813616823,2838327535,10813609723,-7100,,
2932510006,10813867584,2838578297,10813860484,-7100,,
2932760372,10814117950,2838828674,10814110861,-7089,,
2933010639,10814368217,2839078930,10814361117,-7100,,
2933028793,10814386371,2839097084,10814379271,-7100,10814379376,
2933278950,10814636528,2839347241,10814629455,-7073,,
2933529086,10814886665,2839597377,10814879619,-7046,,
2933779782,10815137361,2839848073,10815130342,-7019,,
2934030200,10815387779,2840098492,10815380786,-6993,,
2934280848,10815638426,2840349139,10815631433,-6993,,
2934531738,10815889316,2840600029,10815882323,-6993,,
2934782578,10816140157,2840850869,10816133164,-6993,,
2935032709,10816390288,2841101000,10816383294,-6994,,
2935050836,10816408414,2841119127,10816401421,-6993,10816401370,
2935300966,10816658545,2841369257,10816651538,-7007,,
2935551836,10816909414,2841620127,10816902396,-7018,,
2935801995,10817159574,2841870286,10817152553,-7021,,
2936052545,10817410124,2842120836,10817403080,-7044,,
2936303116,10817660695,2842371407,10817653652,-7043,,
2936553659,10817911238,2842621950,10817904195,-7043,,
2936804271,10818161861,2842872573,10818154817,-7044,,
2937054437,10818412016,2843122728,10818404972,-7044,,
2937072627,10818430205,2843140917,10818423162,-7043,10818423140,
2937323037,10818680616,2843391328,10818673568,-7048,,
2937573374,10818930953,2843641665,10818923899,-7054,,
2937824144,10819181722,2843892435,10819174675,-7047,,
2938074688,10819432267,2844142979,10819425204,-7063,,
2938325120,10819682699,2844393411,10819675636,-7063,,
2938575692,10819933271,2844643983,10819926208,-7063,,
2938826001,10820183580,2844894292,10820176517,-7063,,
2939076358,10820433937,2845144649,10820426873,-7064,,
2939094629,10820452207,2845162920,10820445144,-7063,10820445191,
2939345569,10820703148,2845413860,10820696096,-7052,,
2939595913,10820953491,2845664204,10820946452,-7039,,
2939846277,10821203856,2845914568,10821196838,-7018,,
2940096565,10821454144,2846164857,10821447129,-7015,,
2940346745,10821704323,2846415036,10821697319,-7004,,
2940597453,10821955032,2846665744,10821948016,-7016,,
2940847595,10822205174,2846915887,10822198159,-7015,,
2941098062,10822455641,2847166353,10822448626,-7015,,
2941116053,10822473632,2847184344,10822466617,-7015,10822466585,
2941366442,10822724021,2847434733,10822716999,-7022,,
2941616767,10822974345,2847685058,10822967315,-7030,,
2941867167,10823224756,2847935468,10823217719,-7037,,
2942117744,10823475323,2848186036,10823468278,-7045,,
2942368697,10823726277,2848436989,10823719231,-7046,,
2942619113,10823976692,2848687404,10823969647,-7045,,
2942869458,10824227037,2848937749,10824219992,-7045,,
2943119949,10824477528,2849188240,10824470483,-7045,,
2943137984,10824495562,2849206274,10824488517,-7045,10824488462,
2943388144,10824745723,2849456435,10824738665,-7058,,
2943639176,10824996754,2849707467,10824989683,-7071,,
2943889535,10825247114,2849957827,10825240029,-7085,,
2944139651,10825497231,2850207943,10825490133,-7098,,
2944390136,10825747715,2850458427,10825740617,-7098,,
2944640287,10825997866,2850708578,10825990768,-7098,,
2944890615,10826248194,2850958906,10826241096,-7098,,
2945141086,10826498664,2851209377,10826491566,-7098,,
2945159171,10826516749,2851227461,10826509651,-7098,10826509620,
2945409450,10826767029,2851477752,10826759935,-7094,,
2945659855,10827017433,2851728145,10827010321,-7112,,
2945910407,10827267985,2851978698,10827260866,-7119,,
2946160549,10827518129,2852228842,10827511002,-7127,,
2946410983,10827768573,2852479285,10827761446,-7127,,
2946661762,10828019341,2852730053,10828012213,-7128,,
2946912178,10828269757,2852980469,10828262630,-7127,,
2947162801,10828520380,2853231092,10828513252,-7128,,
2947180911,10828538489,2853249201,10828531362,-7127,10828531396,
2947431478,10828789057,2853499769,10828781938,-7119,,
2947682501,10829040080,2853750792,10829032970,-7110,,
2947933055,10829290634,2854001346,10829283534,-7100,,
2948183475,10829541054,2854251766,10829533963,-7091,,
2948433900,10829791489,2854502202,10829784398,-7091,,
2948684419,10830041998,2854752711,10830034907,-7091,,
2948934976,10830292555,2855003267,10830285463,-7092,,
2949185501,10830543079,2855253792,10830535988,-7091,,
2949203616,10830561195,2855271907,10830554103,-7092,10830554094,
2949453828,10830811408,2855522120,10830804314,-7094,,
2949703940,10831061519,2855772232,10831054434,-7085,,
2949954127,10831311705,2856022418,10831304608,-7097,,
2950204326,10831561906,2856272618,10831554807,-7099,,
2950454667,10831812246,2856522958,10831805147,-7099,,
2950704823,10832062402,2856773114,10832055303,-7099,,
2950955039,10832312618,2857023330,10832305518,-7100,,
2951205609,10832563188,2857273900,10832556088,-7100,,
2951223779,10832581357,2857292069,10832574258,-7099,10832574335,
2951473983,10832831562,2857542275,10832824483,-7079,,
2951724155,10833081734,2857792446,10833074674,-7060,,
2951974779,10833332358,2858043070,10833325317,-7041,,
2952225172,10833582751,2858293464,10833575731,-7020,,
2952475307,10833832886,2858543608,10833825876,-7010,,
2952725492,10834083070,2858793783,10834076050,-7020,,
2952976396,10834333975,2859044687,10834326955,-7020,,
2953226588,10834584167,2859294880,10834577147,-7020,,
2953244761,10834602340,2859313052,10834595319,-7021,10834595170,
2953495086,10834852665,2859563378,10834845607,-7058,,
2953745242,10835102821,2859813533,10835095725,-7096,,
2953995901,10835353479,2860064192,10835346348,-7131,,
2954246100,10835603679,2860314392,10835596511,-7168,,
2954496421,10835854009,2860564722,10835846841,-7168,,
2954746997,10836104575,2860815288,10836097407,-7168,,
2954997495,10836355074,2861065797,10836347916,-7158,,
2955247620,10836605209,2861315921,10836598041,-7168,,
2955265676,10836623254,2861333967,10836616086,-7168,10836616134,
2955516122,10836873711,2861584423,10836866554,-7157,,
2955766569,10837124147,2861834860,10837117003,-7144,,
2956017138,10837374717,2862085430,10837367585,-7132,,
2956267464,10837625043,2862335756,10837617924,-7119,,
2956517660,10837875249,2862585961,10837868130,-7119,,
2956767781,10838125359,2862836072,10838118240,-7119,,
2957018517,10838376096,2863086808,10838368976,-7120,,
2957268911,10838626500,2863337212,10838619380,-7120,,
2957287026,10838644604,2863355316,10838637485,-7119,10838637502,
2957537217,10838894796,2863605508,10838887681,-7115,,
2957787569,10839145148,2863855861,10839138037,-7111,,
2958038018,10839395597,2864106309,10839388491,-7106,,
2958288243,10839645833,2864356546,10839638732,-7101,,
2958538437,10839896015,2864606738,10839888924,-7091,,
2958788869,10840146447,2864857160,10840139346,-7101,,
2959039403,10840396982,2865107694,10840389880,-7102,,
2959290082,10840647671,2865358384,10840640570,-7101,,
2959308201,10840665779,2865376491,10840658677,-7102,10840658672,
2959558766,10840916355,2865627068,10840909253,-7102,,
2959809185,10841166764,2865877477,10841159661,-7103,,
2960059305,10841416884,2866127597,10841409780,-7104,,
2960309899,10841667479,2866378191,10841660374,-7105,,
2960560005,10841917594,2866628306,10841910489,-7105,,
2960810464,10842168042,2866878754,10842160937,-7105,,
2961060877,10842418456,2867129168,10842411350,-7106,,
2961311221,10842668800,2867379513,10842661705,-7095,,
2961329404,10842686982,2867397694,10842679877,-7105,10842679884,
2961580180,10842937758,2867648471,10842930665,-7093,,
2961830572,10843188150,2867898862,10843181049,-7101,,
2962081192,10843438770,2868149483,10843431671,-7099,,
2962331340,10843688920,2868399632,10843681824,-7096,,
2962582262,10843939841,2868650554,10843932745,-7096,,
2962832754,10844190332,2868901045,10844183236,-7096,,
2963083149,10844440728,2869151440,10844433631,-7097,,
2963333273,10844690861,2869401574,10844683765,-7096,,
2963351379,10844708957,2869419669,10844701861,-7096,10844701821,
2963601558,10844959137,2869669849,10844952031,-7106,,
2963851685,10845209264,2869919976,10845202149,-7115,,
2964102316,10845459895,2870170607,10845452771,-7124,,
2964352700,10845710279,2870420992,10845703145,-7134,,
2964602925,10845960514,2870671227,10845953380,-7134,,
2964853050,10846210628,2870921341,10846203494,-7134,,
2965103166,10846460745,2871171468,10846453622,-7123,,
2965353505,10846711083,2871421796,10846703949,-7134,,
2965371537,10846729115,2871439827,10846721980,-7135,10846722073,
2965621893,10846979472,2871690185,10846972361,-7111,,
2965872081,10847229659,2871940372,10847222571,-7088,,
2966122721,10847480300,2872191013,10847473237,-7063,,
2966373261,10847730840,2872441553,10847723800,-7040,,
2966624255,10847981844,2872692556,10847974804,-7040,,
2966874750,10848232329,2872943052,10848225300,-7029,,
2967124991,10848482569,2873193282,10848475529,-7040,,
2967375969,10848733548,2873444260,10848726507,-7041,,
2967394088,10848751667,2873462379,10848744626,-7041,10848744564,
2967644763,10849002342,2873713055,10848995286,-7056,,
2967895294,10849252872,2873963585,10849245801,-7071,,
2968146219,10849503798,2874214510,10849496722,-7076,,
2968396829,10849754408,2874465120,10849747307,-7101,,
2968647039,10850004618,2874715331,10849997517,-7101,,
2968897558,10850255136,2874965849,10850248035,-7101,,
2969147840,10850505419,2875216132,10850498318,-7101,,
2969397963,10850755541,2875466264,10850748450,-7091,,
2969416095,10850773673,2875484386,10850766572,-7101,10850766547,
2969666613,10851024192,2875734905,10851017085,-7107,,
2969917046,10851274625,2875985337,10851267511,-7114,,
2970167582,10851525160,2876235873,10851518042,-7118,,
2970418115,10851775694,2876486406,10851768570,-7124,,
2970668437,10852026016,2876736729,10852018892,-7124,,
2970918643,10852276222,2876986934,10852269098,-7124,,
2971169057,10852526637,2877237349,10852519513,-7124,,
2971419407,10852776985,2877487698,10852769861,-7124,,
2971437617,10852795196,2877505908,10852788071,-7125,10852788154,
2971687755,10853045334,2877756058,10853038241,-7093,,
2971938375,10853295954,2878006667,10853288872,-7082,,
2972188971,10853546550,2878257263,10853539489,-7061,,
2972439133,10853796712,2878507435,10853789683,-7029,,
2972689658,10854047237,2878757949,10854040197,-7040,,
2972940136,10854297715,2879008427,10854290685,-7030,,
2973190525,10854548104,2879258817,10854541064,-7040,,
2973441268,10854798846,2879509559,10854791806,-7040,,
2973459644,10854817222,2879527934,10854810182,-7040,10854810153,
2973710227,10855067805,2879778528,10855060768,-7037,,
2973960800,10855318379,2880029091,10855311324,-7055,,
2974210960,10855568539,2880279251,10855561478,-7061,,
2974461502,10855819081,2880529793,10855812014,-7067,,
2974711707,10856069286,2880779998,10856062219,-7067,,
2974962223,10856319802,2881030514,10856312735,-7067,,
2975212464,10856570043,2881280756,10856562976,-7067,,
2975462853,10856820432,2881531144,10856813365,-7067,,
2975481028,10856838607,2881549319,10856831540,-7067,10856831491,
2975731140,10857088729,2881799441,10857081650,-7079,,
2975981691,10857339269,2882049982,10857332179,-7090,,
2976232159,10857589738,2882300450,10857582635,-7103,,
2976482335,10857839914,2882550626,10857832799,-7115,,
2976732522,10858090102,2882800814,10858082988,-7114,,
2976982951,10858340529,2883051242,10858333415,-7114,,
2977233487,10858591067,2883301780,10858583953,-7114,,
2977483944,10858841523,2883552236,10858834409,-7114,,
2977502041,10858859619,2883570331,10858852505,-7114,10858852456,
2977752186,10859109765,2883820478,10859102639,-7126,,
2978002875,10859360453,2884071166,10859353316,-7137,,
2978252995,10859610574,2884321286,10859603435,-7139,,
2978503407,10859860986,2884571698,10859853824,-7162,,
2978753948,10860111538,2884822250,10860104376,-7162,,
2979004665,10860362244,2885072956,10860355083,-7161,,
2979255173,10860612762,2885323475,10860605601,-7161,,
2979505338,10860862917,2885573640,10860855767,-7150,,
2979523431,10860881009,2885591722,10860873848,-7161,10860873789,
2979773908,10861131486,2885842199,10861124321,-7165,,
2980024425,10861382003,2886092716,10861374813,-7190,,
2980274902,10861632480,2886343193,10861625275,-7205,,
2980525224,10861882803,2886593515,10861875583,-7220,,
2980775945,10862133523,2886844236,10862126304,-7219,,
2981026210,10862383789,2887094501,10862376570,-7219,,
2981276497,10862634075,2887344788,10862626856,-7219,,
2981527010,10862884589,2887595301,10862877370,-7219,,
2981545227,10862902806,2887613518,10862895586,-7220,10862895617,
2981795853,10863153432,2887864154,10863146231,-7201,,
2982046513,10863404092,2888114804,10863396889,-7203,,
2982297546,10863655124,2888365837,10863647929,-7195,,
2982548118,10863905697,2888616409,10863898509,-7188,,
2982798403,10864155982,2888866695,10864148795,-7187,,
2983048634,10864406213,2889116925,10864399026,-7187,,
2983299237,10864656816,2889367528,10864649629,-7187,,
2983549654,10864907233,2889617945,10864900045,-7188,,
2983567694,10864925273,2889635985,10864918086,-7187,10864918147,
2983818074,10865175652,2889886365,10865168490,-7162,,
2984068536,10865426114,2890136827,10865418958,-7156,,
2984319111,10865676690,2890387402,10865669549,-7141,,
2984569557,10865927135,2890637848,10865920011,-7124,,
2984820294,10866177873,2890888585,10866170748,-7125,,
2985070683,10866428261,2891138974,10866421147,-7114,,
2985321332,10866678911,2891389624,10866671787,-7124,,
2985572043,10866929622,2891640334,10866922497,-7125,,
2985590224,10866947802,2891658515,10866940678,-7124,10866940660,
2985840592,10867198171,2891908883,10867191042,-7129,,
2986091575,10867449154,2892159867,10867442022,-7132,,
2986341991,10867699570,2892410282,10867692434,-7136,,
2986592119,10867949698,2892660410,10867942558,-7140,,
2986842691,10868200269,2892910982,10868193129,-7140,,
2987092835,10868450414,2893161137,10868443285,-7129,,
2987343197,10868700776,2893411489,10868693636,-7140,,
2987593629,10868951207,2893661920,10868944078,-7129,,
2987611687,10868969265,2893679978,10868962125,-7140,10868962086,
2987862084,10869219663,2893930376,10869212524,-7139,,
2988112329,10869469908,2894180621,10869462759,-7149,,
2988362897,10869720475,2894431188,10869713307,-7168,,
2988613381,10869970960,2894681672,10869963783,-7177,,
2988863524,10870221103,2894931815,10870213936,-7167,,
2989113904,10870471494,2895182206,10870464317,-7177,,
2989364500,10870722078,2895432790,10870714901,-7177,,
2989614916,10870972494,2895683207,10870965317,-7177,,
2989633254,10870990832,2895701544,10870983655,-7177,10870983606,
2989883929,10871241507,2895952220,10871234318,-7189,,
2990134047,10871491626,2896202339,10871484425,-7201,,
2990384221,10871741799,2896452511,10871734598,-7201,,
2990634349,10871991928,2896702640,10871984703,-7225,,
2990884612,10872242191,2896952903,10872234966,-7225,,
2991134731,10872492309,2897203021,10872485085,-7224,,
2991385140,10872742719,2897453432,10872735495,-7224,,
2991635267,10872992846,2897703558,10872985622,-7224,,
2991653312,10873010890,2897721602,10873003666,-7224,10873003733,
2991903503,10873261081,2897971803,10873253883,-7198,,
2992153786,10873511366,2898222079,10873504177,-7189,,
2992403963,10873761543,2898472255,10873754370,-7173,,
2992654733,10874012312,2898723034,10874005167,-7145,,
2992905054,10874262633,2898973345,10874255477,-7156,,
2993155236,10874512815,2899223527,10874505660,-7155,,
2993405415,10874762994,2899473707,10874755839,-7155,,
2993655627,10875013206,2899723918,10875006050,-7156,,
2993673724,10875031302,2899742015,10875024147,-7155,10875024105,
2993924275,10875281853,2899992566,10875274687,-7166,,
2994174879,10875532458,2900243171,10875525282,-7176,,
2994425568,10875783147,2900493859,10875775960,-7187,,
2994675952,10876033532,2900744244,10876026336,-7196,,
2994926439,10876284018,2900994730,10876276821,-7197,,
2995176616,10876534194,2901244906,10876526998,-7196,,
2995427383,10876784962,2901495674,10876777776,-7186,,
2995677648,10877035227,2901745939,10877028031,-7196,,
2995695637,10877053215,2901763928,10877046019,-7196,10877046054,
2995945768,10877303346,2902014059,10877296160,-7186,,
2996196360,10877553940,2902264652,10877546763,-7177,,
2996446632,10877804211,2902514933,10877797052,-7159,,
2996697071,10878054650,2902765373,10878047501,-7149,,
2996947322,10878304901,2903015624,10878297752,-7149,,
2997198198,10878555777,2903266489,10878548618,-7159,,
2997448617,10878806206,2903516918,10878799047,-7159,,
2997699094,10879056683,2903767396,10879049524,-7159,,
2997717216,10879074795,2903785507,10879067636,-7159,10879067605,
2997967595,10879325173,2904035886,10879318007,-7166,,
2998217855,10879575434,2904286147,10879568262,-7172,,
2998468404,10879825994,2904536706,10879818812,-7182,,
2998718924,10880076503,2904787216,10880069325,-7178,,
2998969289,10880326868,2905037580,10880319680,-7188,,
2999219829,10880577408,2905288120,10880570220,-7188,,
2999470231,10880827811,2905538523,10880820622,-7189,,
2999721051,10881078630,2905789342,10881071442,-7188,,
2999739138,10881096717,2905807429,10881089529,-7188,10881089535,
2999989387,10881346965,2906057678,10881339779,-7186,,
3000239644,10881597223,2906307936,10881590039,-7184,,
3000490030,10881847609,2906558322,10881840427,-7182,,
3000740282,10882097860,2906808573,10882090680,-7180,,
3000990904,10882348482,2907059195,10882341302,-7180,,
3001241173,10882598752,2907309465,10882591572,-7180,,
3001491774,10882849363,2907560075,10882842183,-7180,,
3001741920,10883099499,2907810212,10883092319,-7180,,
3001760149,10883117727,2907828440,10883110547,-7180,10883110540,
3002010229,10883367808,2908078520,10883360626,-7182,,
3002260436,10883618015,2908328728,10883610831,-7184,,
3002510603,10883868182,2908578895,10883860997,-7185,,
3002761270,10884118859,2908829572,10884111673,-7186,,
3003011372,10884368951,2909079663,10884361775,-7176,,
3003261994,10884619573,2909330285,10884612386,-7187,,
3003512207,10884869786,2909580499,10884862600,-7186,,
3003762554,10885120144,2909830856,10885112958,-7186,,
3003780685,10885138263,2909848975,10885131077,-7186,10885131045,
3004031124,10885388702,2910099415,10885381508,-7194,,
3004281387,10885638966,2910349678,10885631764,-7202,,
3004531691,10885889270,2910599992,10885882071,-7199,,
3004781842,10886139421,2910850133,10886132205,-7216,,
3005032621,10886390200,2911100912,10886382983,-7217,,
3005282995,10886640574,2911351286,10886633357,-7217,,
3005533619,10886891208,2911601921,10886883992,-7216,,
3005784435,10887142015,2911852727,10887134799,-7216,,
3005802417,10887159996,2911870708,10887152779,-7217,10887152779,
3006052620,10887410199,2912120911,10887402982,-7217,,
3006302912,10887660490,2912371203,10887653285,-7205,,
3006553365,10887910944,2912621667,10887903738,-7206,,
3006803749,10888161328,2912872041,10888154114,-7214,,
3007054159,10888411738,2913122450,10888404522,-7216,,
3007304747,10888662325,2913373038,10888655110,-7215,,
3007554978,10888912556,2913623279,10888905352,-7204,,
3007805922,10889163500,2913874213,10889156286,-7214,,
3007823930,10889181508,2913892221,10889174293,-7215,10889174286,
3008074292,10889431871,2914142583,10889424663,-7208,,
3008324712,10889682290,2914393002,10889675071,-7219,,
3008575071,10889932659,2914643372,10889925439,-7220,,
3008825689,10890183278,2914893991,10890176057,-7221,,
3009075882,10890433461,2915144173,10890426240,-7221,,
3009326465,10890684044,2915394756,10890676823,-7221,,
3009577277,10890934856,2915645568,10890927635,-7221,,
3009827663,10891185242,2915895954,10891178021,-7221,,
3009845900,10891203478,2915914191,10891196257,-7221,10891196233,
3010096104,10891453683,2916164395,10891446454,-7229,,
3010347055,10891704633,2916415345,10891697400,-7233,,
3010597631,10891955210,2916665923,10891947971,-7239,,
3010847873,10892205463,2916916175,10892198219,-7244,,
3011098387,10892455965,2917166678,10892448731,-7234,,
3011348771,10892706350,2917417062,10892699105,-7245,,
3011599127,10892956706,2917667419,10892949473,-7233,,
3011849362,10893206941,2917917654,10893199697,-7244,,
3011867585,10893225163,2917935876,10893217919,-7244,10893217967,
3012118374,10893475953,2918186665,10893468721,-7232,,
3012369047,10893726626,2918437338,10893719407,-7219,,
3012619212,10893976790,2918687503,10893969583,-7207,,
3012869347,10894226926,2918937639,10894219732,-7194,,
3013119915,10894477494,2919188206,10894470300,-7194,,
3013370024,10894727602,2919438315,10894720408,-7194,,
3013620854,10894978432,2919689145,10894971238,-7194,,
3013871279,10895228868,2919939581,10895221674,-7194,,
3013889324,10895246902,2919957614,10895239708,-7194,10895239642,
3014139559,10895497138,2920207850,10895489927,-7211,,
3014390506,10895748085,2920458797,10895740859,-7226,,
3014640672,10895998250,2920708962,10895991019,-7231,,
3014891173,10896248761,2920959474,10896241504,-7257,,
3015141552,10896499131,2921209843,10896491872,-7259,,
3015391752,10896749331,2921460043,10896742073,-7258,,
3015642415,10896999994,2921710706,10896992735,-7259,,
3015892782,10897250361,2921961074,10897243103,-7258,,
3015910806,10897268384,2921979096,10897261125,-7259,10897261130,
3016161343,10897518923,2922229635,10897511666,-7257,,
3016411518,10897769097,2922479810,10897761842,-7255,,
3016662295,10898019873,2922730586,10898012619,-7254,,
3016912874,10898270453,2922981166,10898263201,-7252,,
3017163216,10898520795,2923231508,10898513543,-7252,,
3017413810,10898771388,2923482101,10898764136,-7252,,
3017664204,10899021783,2923732495,10899014531,-7252,,
3017914655,10899272245,2923982958,10899264993,-7252,,
3017932658,10899290237,2924000949,10899282984,-7253,10899282964,
3018183097,10899540676,2924251389,10899533418,-7258,,
3018433436,10899791014,2924501727,10899783752,-7262,,
3018683817,10900041395,2924752108,10900034128,-7267,,
3018934335,10900291925,2925002638,10900284654,-7271,,
3019184853,10900542431,2925253144,10900535160,-7271,,
3019435456,10900793035,2925503748,10900785764,-7271,,
3019685808,10901043387,2925754109,10901036126,-7261,,
3019936379,10901293968,2926004680,10901286697,-7271,,
3019954499,10901312077,2926022789,10901304805,-7272,10901304894,
3020205329,10901562908,2926273621,10901555660,-7248,,
3020455746,10901813325,2926524037,10901806099,-7226,,
3020706275,10902063853,2926774566,10902056650,-7203,,
3020957034,10902314622,2927025335,10902307442,-7180,,
3021207298,10902564877,2927275590,10902557696,-7181,,
3021457741,10902815319,2927526032,10902808138,-7181,,
3021708081,10903065671,2927776384,10903058490,-7181,,
3021958269,10903315848,2928026560,10903308666,-7182,,
3021976323,10903333901,2928044614,10903326720,-7181,10903326567,
3022226536,10903584115,2928294827,10903576895,-7220,,
3022476968,10903834547,2928545259,10903827291,-7256,,
3022727138,10904084717,2928795429,10904077423,-7294,,
3022977904,10904335483,2929046195,10904328151,-7332,,
3023228134,10904585713,2929296426,10904578381,-7332,,
3023478325,10904835904,2929546617,10904828572,-7332,,
3023728691,10905086270,2929796982,10905078937,-7333,,
3023979087,10905336666,2930047379,10905329334,-7332,,
3023997308,10905354886,2930065599,10905347554,-7332,10905347620,
3024247856,10905605435,2930316148,10905598119,-7316,,
3024498329,10905855907,2930566620,10905848609,-7298,,
3024749105,10906106683,2930817395,10906099402,-7281,,
3024999432,10906357011,2931067723,10906349745,-7266,,
3025249630,10906607210,2931317923,10906599945,-7265,,
3025500038,10906857616,2931568329,10906850351,-7265,,
3025750563,10907108142,2931818854,10907100877,-7265,,
3026000856,10907358435,2932069148,10907351170,-7265,,
3026019028,10907376606,2932087318,10907369341,-7265,10907369346,
3026269266,10907626844,2932337556,10907619591,-7253,,
3026519923,10907877501,2932588214,10907870239,-7262,,
3026770131,10908127709,2932838421,10908120449,-7260,,
3027020565,10908378144,2933088856,10908370886,-7258,,
3027271267,10908628847,2933339559,10908621589,-7258,,
3027521780,10908879358,2933590071,10908872100,-7258,,
3027772143,10909129721,2933840434,10909122463,-7258,,
3028022356,10909379935,2934090647,10909372677,-7258,,
3028040461,10909398040,2934108752,10909390781,-7259,10909390725,
3028290694,10909648273,2934358985,10909641001,-7272,,
3028541049,10909898628,2934609340,10909891341,-7287,,
3028791857,10910149436,2934860149,10910142137,-7299,,
3029042156,10910399735,2935110447,10910392422,-7313,,
3029292537,10910650116,2935360829,10910642803,-7313,,
3029542644,10910900223,2935610935,10910892909,-7314,,
3029793296,10911150875,2935861587,10911143562,-7313,,
3030043889,10911401468,2936112190,10911394165,-7303,,
3030062119,10911419698,2936130410,10911412384,-7314,10911412498,
3030312239,10911669817,2936380530,10911662532,-7285,,
3030562618,10911920197,2936630909,10911912941,-7256,,
3030812818,10912170397,2936881110,10912163170,-7227,,
3031063447,10912421026,2937131739,10912413828,-7198,,
3031313965,10912671544,2937382257,10912664346,-7198,,
3031564322,10912921901,2937632613,10912914703,-7198,,
3031814451,10913172029,2937882742,10913164831,-7198,,
3032064619,10913422198,2938132910,10913414999,-7199,,
3032082787,10913440365,2938151077,10913433166,-7199,10913433075,
3032333524,10913691103,2938401816,10913683884,-7219,,
3032583664,10913941243,2938651955,10913934010,-7233,,
3032834672,10914192250,2938902963,10914184985,-7265,,
3033085261,10914442840,2939153553,10914435552,-7288,,
3033335788,10914693367,2939404080,10914686079,-7288,,
3033586268,10914943847,2939654559,10914936558,-7289,,
3033836876,10915194455,2939905167,10915187167,-7288,,
3034087321,10915444900,2940155613,10915437612,-7288,,
3034105432,10915463010,2940173722,10915455722,-7288,10915455713,
3034356016,10915713606,2940424318,10915706315,-7291,,
3034606247,10915963826,2940674538,10915956534,-7292,,
3034856780,10916214358,2940925071,10916207064,-7294,,
3035107252,10916464830,2941175543,10916457535,-7295,,
3035357630,10916715219,2941425931,10916707924,-7295,,
3035607923,10916965501,2941676214,10916958206,-7295,,
3035858291,10917215870,2941926582,10917208575,-7295,,
3036108400,10917465979,2942176691,10917458683,-7296,,
3036126531,10917484109,2942194821,10917476814,-7295,10917476763,
3036376773,10917734352,2942445074,10917727055,-7297,,
3036627156,10917984735,2942695447,10917977415,-7320,,
3036877838,10918235417,2942946129,10918228086,-7331,,
3037128018,10918485596,2943196319,10918478263,-7333,,
3037378173,10918735752,2943446464,10918728418,-7334,,
3037628356,10918985935,2943696658,10918978601,-7334,,
3037878815,10919236394,2943947106,10919229050,-7344,,
3038129193,10919486771,2944197484,10919479427,-7344,,
3038147305,10919504883,2944215595,10919497539,-7344,10919497655,
3038397583,10919755161,2944465874,10919747847,-7314,,
3038647777,10920005356,2944716068,10919998070,-7286,,
3038898135,10920255713,2944966426,10920248458,-7255,,
3039148530,10920506109,2945216822,10920498883,-7226,,
3039398962,10920756541,2945467253,10920749314,-7227,,
3039649123,10921006701,2945717414,10920999475,-7226,,
3039899936,10921257514,2945968227,10921250288,-7226,,
3040150343,10921507922,2946218634,10921500696,-7226,,
3040168471,10921526049,2946236762,10921518823,-7226,10921518727,
3040418650,10921776228,2946486941,10921768978,-7250,,
3040669185,10922026763,2946737476,10922019490,-7273,,
3040919381,10922276960,2946987672,10922269662,-7298,,
3041169590,10922527168,2947237881,10922519848,-7320,,
3041419822,10922777401,2947488114,10922770091,-7310,,
3041670392,10923027971,2947738693,10923020661,-7310,,
3041920591,10923278170,2947988883,10923270850,-7320,,
3042170793,10923528371,2948239084,10923521051,-7320,,
3042188920,10923546498,2948257211,10923539178,-7320,10923539251,
3042439024,10923796603,2948507315,10923789312,-7291,,
3042689672,10924047250,2948757963,10924039977,-7273,,
3042940226,10924297804,2949008517,10924290540,-7264,,
3043190938,10924548517,2949259230,10924541272,-7245,,
3043441923,10924799502,2949510214,10924792255,-7247,,
3043692104,10925049694,2949760406,10925042448,-7246,,
3043942585,10925300164,2950010876,10925292917,-7247,,
3044193151,10925550729,2950261442,10925543483,-7246,,
3044211441,10925569019,2950279732,10925561773,-7246,10925561836,
3044461685,10925819263,2950529976,10925812032,-7231,,
3044711860,10926069439,2950780151,10926062225,-7214,,
3044962169,10926319747,2951030459,10926312549,-7198,,
3045212476,10926570055,2951280767,10926562873,-7182,,
3045463218,10926820797,2951531509,10926813614,-7183,,
3045713578,10927071157,2951781869,10927063974,-7183,,
3045964091,10927321670,2952032382,10927314487,-7183,,
3046214391,10927571971,2952282683,10927564789,-7182,,
3046232663,10927590241,2952300953,10927583059,-7182,10927582902,
3046483326,10927840904,2952551617,10927833683,-7221,,
3046733461,10928091040,2952801752,10928083781,-7259,,
3046983931,10928341510,2953052223,10928334212,-7298,,
3047234978,10928592557,2953303269,10928585219,-7338,,
3047485741,10928843320,2953554032,10928835982,-7338,,
3047736085,10929093663,2953804376,10929086326,-7337,,
3047986576,10929344155,2954054868,10929336818,-7337,,
3048237372,10929594952,2954305664,10929587615,-7337,,
3048255448,10929613026,2954323738,10929605689,-7337,10929605693,
3048506231,10929863810,2954574523,10929856474,-7336,,
3048756440,10930114019,2954824731,10930106684,-7335,,
3049006951,10930364530,2955075242,10930357196,-7334,,
3049257390,10930614969,2955325681,10930607637,-7332,,
3049507582,10930865161,2955575874,10930857830,-7331,,
3049757699,10931115278,2955825990,10931107946,-7332,,
3050007966,10931365544,2956076257,10931358213,-7331,,
3050258230,10931615809,2956326521,10931608478,-7331,,
3050276398,10931633976,2956344689,10931626645,-7331,10931626692,
3050526946,10931884525,2956595237,10931877204,-7321,,
3050777090,10932134669,2956845381,10932127361,-7308,,
3051027630,10932385209,2957095921,10932377913,-7296,,
3051277747,10932635326,2957346038,10932628043,-7283,,
3051528112,10932885690,2957596403,10932878407,-7283,,
3051778281,10933135860,2957846572,10933128576,-7284,,
3052028736,10933386315,2958097028,10933379032,-7283,,
3052278945,10933636525,2958347237,10933629242,-7283,,
3052297033,10933654612,2958365324,10933647328,-7284,10933647307,
3052547217,10933904795,2958615508,10933897516,-7279,,
3052797596,10934155175,2958865887,10934147881,-7294,,
3053047923,10934405501,2959116214,10934398214,-7287,,
3053298097,10934655675,2959366388,10934648372,-7303,,
3053548439,10934906018,2959616730,10934898715,-7303,,
3053799103,10935156682,2959867394,10935149378,-7304,,
3054049570,10935407149,2960117861,10935399845,-7304,,
3054300254,10935657833,2960368546,10935650530,-7303,,
3054318282,10935675860,2960386572,10935668557,-7303,10935668500,
3054568668,10935926247,2960636959,10935918929,-7318,,
3054819007,10936176585,2960887298,10936169253,-7332,,
3055069625,10936427204,2961137916,10936419858,-7346,,
3055319920,10936677498,2961388211,10936670139,-7359,,
3055570117,10936927695,2961638408,10936920336,-7359,,
3055820438,10937178017,2961888729,10937170658,-7359,,
3056070767,10937428346,2962139059,10937420987,-7359,,
3056321837,10937679416,2962390139,10937672067,-7349,,
3056339931,10937697509,2962408222,10937690150,-7359,10937690172,
3056590395,10937947974,2962658686,10937940619,-7355,,
3056840713,10938198291,2962909004,10938190943,-7348,,
3057091165,10938448744,2963159456,10938441402,-7342,,
3057341561,10938699140,2963409852,10938691803,-7337,,
3057591694,10938949273,2963659986,10938941937,-7336,,
3057841892,10939199470,2963910182,10939192134,-7336,,
3058092485,10939450064,2964160777,10939442728,-7336,,
3058342862,10939700441,2964411153,10939693114,-7327,,
3058360981,10939718559,2964429272,10939711223,-7336,10939711207,
3058611321,10939968899,2964679612,10939961558,-7341,,
3058861754,10940219332,2964930045,10940211988,-7344,,
3059111979,10940469559,2965180271,10940462211,-7348,,
3059362772,10940720351,2965431063,10940713000,-7351,,
3059613222,10940970801,2965681514,10940963460,-7341,,
3059863789,10941221368,2965932080,10941214017,-7351,,
3060114718,10941472296,2966183009,10941464945,-7351,,
3060365310,10941722889,2966433601,10941715547,-7342,,
3060383381,10941740959,2966451671,10941733607,-7352,10941733645,
3060633479,10941991057,2966701770,10941983715,-7342,,
3060883662,10942241240,2966951953,10942233908,-7332,,
3061134119,10942491697,2967202410,10942484375,-7322,,
3061384386,10942741964,2967452677,10942734652,-7312,,
3061634721,10942992300,2967703012,10942984987,-7313,,
3061884875,10943242453,2967953166,10943235141,-7312,,
3062135192,10943492770,2968203483,10943485458,-7312,,
3062385369,10943742947,2968453670,10943735645,-7302,,
3062403474,10943761052,2968471764,10943753740,-7312,10943753664,
3062653578,10944011157,2968721869,10944003827,-7330,,
3062904318,10944261897,2968972609,10944254548,-7349,,
3063154890,10944512468,2969223181,10944505100,-7368,,
3063405005,10944762584,2969473296,10944755197,-7387,,
3063655335,10945012913,2969723626,10945005527,-7386,,
3063905431,10945263010,2969973723,10945255624,-7386,,
3064155620,10945513199,2970223912,10945505813,-7386,,
3064406437,10945764016,2970474729,10945756630,-7386,,
3064424521,10945782100,2970492812,10945774713,-7387,10945774714,
3064674914,10946032493,2970743205,10946025106,-7387,,
3064925273,10946282852,2970993564,10946275467,-7385,,
3065175990,10946533568,2971244281,10946526184,-7384,,
3065426574,10946784152,2971494865,10946776768,-7384,,
3065676885,10947034463,2971745176,10947027079,-7384,,
3065927394,10947284973,2971995685,10947277588,-7385,,
3066177980,10947535559,2972246271,10947528175,-7384,,
3066428871,10947786450,2972497163,10947779066,-7384,,
3066446980,10947804558,2972515271,10947797174,-7384,10947797172,
3066697152,10948054731,2972765443,10948047346,-7385,,
3066947508,10948305087,2973015799,10948297701,-7386,,
3067198484,10948556063,2973266775,10948548678,-7385,,
3067448930,10948806520,2973517232,10948799135,-7385,,
3067699676,10949057254,2973767967,10949049869,-7385,,
3067950054,10949307633,2974018345,10949300247,-7386,,
3068200536,10949558114,2974268827,10949550729,-7385,,
3068450919,10949808498,2974519211,10949801113,-7385,,
3068469105,10949826683,2974537396,10949819298,-7385,10949819334,
3068719215,10950076794,2974787506,10950069419,-7375,,
3068969452,10950327031,2975037743,10950319664,-7367,,
3069219846,10950577425,2975288138,10950570070,-7355,,
3069470021,10950827600,2975538313,10950820253,-7347,,
3069720168,10951077746,2975788459,10951070399,-7347,,
3069970277,10951327856,2976038569,10951320509,-7347,,
3070220858,10951578436,2976289149,10951571089,-7347,,
3070471933,10951829512,2976540224,10951822164,-7348,,
3070490032,10951847611,2976558323,10951840264,-7347,10951840236,
3070740702,10952098280,2976808993,10952090927,-7353,,
3070990870,10952348449,2977059161,10952341089,-7360,,
3071241410,10952598989,2977309702,10952591624,-7365,,
3071491905,10952849483,2977560195,10952842110,-7373,,
3071742493,10953100071,2977810784,10953092698,-7373,,
3071992910,10953350489,2978061201,10953343116,-7373,,
3072243343,10953600922,2978311645,10953593559,-7363,,
3072493926,10953851505,2978562217,10953844132,-7373,,
3072511998,10953869576,2978580289,10953862203,-7373,10953862179,
3072762430,10954120008,2978830721,10954112630,-7378,,
3073013061,10954370639,2979081352,10954363255,-7384,,
3073263269,10954620848,2979331561,10954613460,-7388,,
3073513495,10954871074,2979581786,10954863679,-7395,,
3073763683,10955121262,2979831974,10955113866,-7396,,
3074014152,10955371731,2980082443,10955364336,-7395,,
3074264760,10955622338,2980333062,10955614954,-7384,,
3074514982,10955872561,2980583273,10955865165,-7396,,
3074533179,10955890757,2980601469,10955883362,-7395,10955883370,
3074783740,10956141319,2980852031,10956133937,-7382,,
3075034097,10956391676,2981102388,10956384286,-7390,,
3075284981,10956642560,2981353273,10956635173,-7387,,
3075535108,10956892687,2981603399,10956885302,-7385,,
3075785474,10957143052,2981853764,10957135667,-7385,,
3076035950,10957393529,2982104241,10957386144,-7385,,
3076286108,10957643697,2982354409,10957636312,-7385,,
3076536233,10957893811,2982604524,10957886426,-7385,,
3076554490,10957912069,2982622781,10957904683,-7386,10957904648,
3076805024,10958162603,2982873315,10958155209,-7394,,
3077055406,10958412985,2983123697,10958405582,-7403,,
3077305906,10958663485,2983374198,10958656076,-7409,,
3077556518,10958914097,2983624809,10958906678,-7419,,
3077806760,10959164339,2983875051,10959156919,-7420,,
3078057516,10959415095,2984125807,10959407676,-7419,,
3078307979,10959665567,2984376280,10959658148,-7419,,
3078558622,10959916201,2984626913,10959908782,-7419,,
3078576782,10959934361,2984645073,10959926941,-7420,10959926947,
3078826984,10960184563,2984895275,10960177144,-7419,,
3079077189,10960434768,2985145480,10960427351,-7417,,
3079327711,10960685291,2985396003,10960677877,-7414,,
3079578305,10960935884,2985646608,10960928483,-7401,,
3079828689,10961186277,2985896990,10961178866,-7411,,
3080079223,10961436801,2986147514,10961429389,-7412,,
3080330182,10961687771,2986398484,10961680359,-7412,,
3080580690,10961938268,2986648981,10961930856,-7412,,
3080598845,10961956424,2986667136,10961949011,-7413,10961948966,
3080849702,10962207280,2986917993,10962199867,-7413,,
3081100356,10962457934,2987168647,10962450500,-7434,,
3081350933,10962708513,2987419226,10962701068,-7445,,
3081601141,10962958719,2987669432,10962951263,-7456,,
3081851277,10963208856,2987919568,10963201410,-7446,,
3082101833,10963459411,2988170124,10963451955,-7456,,
3082352457,10963710046,2988420758,10963702590,-7456,,
3082602591,10963960170,2988670882,10963952713,-7457,,
3082620708,10963978286,2988688998,10963970829,-7457,10963970933,
3082870881,10964228470,2988939183,10964221040,-7430,,
3083121488,10964479067,2989189779,10964471662,-7405,,
3083371752,10964729331,2989440043,10964721954,-7377,,
3083622005,10964979584,2989690296,10964972232,-7352,,
3083872134,10965229713,2989940426,10965222362,-7351,,
3084122803,10965480381,2990191094,10965473030,-7351,,
3084372985,10965730564,2990441276,10965723212,-7352,,
3084623557,10965981136,2990691848,10965973784,-7352,,
3084641671,10965999249,2990709961,10965991898,-7351,10965991867,
3084891956,10966249535,2990960248,10966242176,-7359,,
3085142411,10966499990,2991210702,10966492624,-7366,,
3085392880,10966750459,2991461172,10966743086,-7373,,
3085643041,10967000619,2991711332,10966993238,-7381,,
3085893449,10967251028,2991961741,10967243647,-7381,,
3086143608,10967501187,2992211899,10967493806,-7381,,
3086394248,10967751826,2992462549,10967744455,-7371,,
3086644502,10968002081,2992712793,10967994710,-7371,,
3086662624,10968020202,2992730915,10968012821,-7381,10968012789,
3086913202,10968270781,2992981493,10968263392,-7389,,
3087163883,10968521461,2993232174,10968514064,-7397,,
3087414463,10968772042,2993482755,10968764638,-7404,,
3087664888,10969022467,2993733179,10969015055,-7412,,
3087915051,10969272630,2993983342,10969265218,-7412,,
3088165624,10969523203,2994233915,10969515791,-7412,,
3088416279,10969773868,2994484580,10969766456,-7412,,
3088666409,10970023987,2994734700,10970016575,-7412,,
3088684447,10970042026,2994752738,10970034613,-7413,10970034651,
3088934741,10970292320,2995003033,10970284917,-7403,,
3089184902,10970542480,2995253193,10970535087,-7393,,
3089435245,10970792834,2995503547,10970785451,-7383,,
3089685411,10971042990,2995753703,10971035617,-7373,,
3089935550,10971293129,2996003841,10971285756,-7373,,
3090186177,10971543755,2996254468,10971536382,-7373,,
3090436620,10971794198,2996504922,10971786836,-7362,,
3090687489,10972045067,2996755780,10972037694,-7373,,
3090705637,10972063215,2996773927,10972055841,-7374,10972055789,
3090955791,10972313369,2997024082,10972305983,-7386,,
3091206330,10972563908,2997274620,10972556509,-7399,,
3091456624,10972814213,2997524926,10972806801,-7412,,
3091707014,10973064592,2997775304,10973057168,-7424,,
3091957346,10973314926,2998025638,10973307502,-7424,,
3092207833,10973565412,2998276124,10973557988,-7424,,
3092458135,10973815714,2998526426,10973808290,-7424,,
3092708693,10974066272,2998776984,10974058848,-7424,,
3092727026,10974084604,2998795317,10974077180,-7424,10974077265,
3092977921,10974335499,2999046212,10974328096,-7403,,
3093228188,10974585767,2999296480,10974578387,-7380,,
3093478580,10974836159,2999546872,10974828801,-7358,,
3093728729,10975086308,2999797021,10975078970,-7338,,
3093979339,10975336917,3000047629,10975329579,-7338,,
3094229762,10975587340,3000298053,10975580002,-7338,,
3094479942,10975837531,3000548244,10975830193,-7338,,
3094730529,10976088107,3000798820,10976080769,-7338,,
3094748692,10976106270,3000816983,10976098932,-7338,10976098850,
3094998993,10976356571,3001067284,10976349212,-7359,,
3095249659,10976607239,3001317951,10976599860,-7379,,
3095499933,10976857521,3001568234,10976850123,-7398,,
3095750141,10977107720,3001818432,10977100300,-7420,,
3096000369,10977357947,3002068660,10977350528,-7419,,
3096250694,10977608272,3002318985,10977600853,-7419,,
3096501261,10977858840,3002569562,10977851431,-7409,,
3096752113,10978109691,3002820404,10978102272,-7419,,
3096770213,10978127791,3002838504,10978120372,-7419,10978120340,
3097020665,10978378244,3003088956,10978370816,-7428,,
3097270879,10978628458,3003339171,10978621024,-7434,,
3097521815,10978879404,3003590117,10978871962,-7442,,
3097772310,10979129889,3003840601,10979122440,-7449,,
3098022580,10979380158,3004090871,10979372709,-7449,,
3098273139,10979630718,3004341430,10979623268,-7450,,
3098523375,10979880964,3004591676,10979873515,-7449,,
3098773544,10980131122,3004841835,10980123673,-7449,,
3098791659,10980149237,3004859950,10980141788,-7449,10980141813,
3099041750,10980399329,3005110041,10980391885,-7444,,
3099292186,10980649764,3005360477,10980642328,-7436,,
3099542403,10980899982,3005610695,10980892553,-7429,,
3099793008,10981150586,3005861299,10981143163,-7423,,
3100043347,10981400926,3006111638,10981393502,-7424,,
3100293772,10981651352,3006362064,10981643929,-7423,,
3100544335,10981901914,3006612626,10981894491,-7423,,
3100794701,10982152280,3006862992,10982144856,-7424,,
3100812847,10982170425,3006881137,10982163002,-7423,10982162964,
3101063425,10982421004,3007131716,10982413571,-7433,,
3101313531,10982671109,3007381822,10982663668,-7441,,
3101564441,10982922020,3007632733,10982914570,-7450,,
3101814569,10983172148,3007882860,10983164688,-7460,,
3102065362,10983422940,3008133653,10983415481,-7459,,
3102316269,10983673849,3008384561,10983666390,-7459,,
3102566470,10983924049,3008634762,10983916590,-7459,,
3102816617,10984174196,3008884919,10984166747,-7449,,
3102834797,10984192375,3008903088,10984184916,-7459,10984184960,
3103085266,10984442845,3009153568,10984435406,-7439,,
3103335674,10984693253,3009403966,10984685816,-7437,,
3103586052,10984943631,3009654344,10984936205,-7426,,
3103836659,10985194238,3009904950,10985186823,-7415,,
3104086853,10985444432,3010155144,10985437028,-7404,,
3104337184,10985694764,3010405477,10985687350,-7414,,
3104587509,10985945088,3010655800,10985937674,-7414,,
3104837966,10986195545,3010906257,10986188131,-7414,,
3104856087,10986213665,3010924377,10986206251,-7414,10986206160,
3105106753,10986464332,3011175044,10986456895,-7437,,
3105356890,10986714469,3011425181,10986707020,-7449,,
3105607197,10986964786,3011675498,10986957305,-7481,,
3105857336,10987214915,3011925627,10987207411,-7504,,
3106107671,10987465249,3012175962,10987457746,-7503,,
3106358033,10987715612,3012426324,10987708109,-7503,,
3106608935,10987966514,3012677227,10987959011,-7503,,
3106859286,10988216864,3012927577,10988209361,-7503,,
3106877669,10988235247,3012945959,10988227744,-7503,10988227860,
3107127809,10988485388,3013196100,10988477924,-7464,,
3107377910,10988735489,3013446201,10988728054,-7435,,
3107628271,10988985849,3013696562,10988978434,-7415,,
3107879098,10989236677,3013947389,10989229292,-7385,,
3108129340,10989486919,3014197631,10989479534,-7385,,
3108379630,10989737209,3014447931,10989729833,-7376,,
3108629921,10989987500,3014698212,10989980115,-7385,,
3108880090,10990237668,3014948381,10990230293,-7375,,
3108898226,10990255804,3014966517,10990248419,-7385,10990248365,
3109148612,10990506191,3015216904,10990498793,-7398,,
3109398746,10990756324,3015467048,10990748924,-7400,,
3109648916,10991006495,3015717207,10990999081,-7414,,
3109899661,10991257240,3015967952,10991249802,-7438,,
3110150149,10991507728,3016218440,10991500291,-7437,,
3110400461,10991758040,3016468763,10991750613,-7427,,
3110651066,10992008644,3016719367,10992001218,-7426,,
3110901757,10992259336,3016970058,10992251908,-7428,,
3110919933,10992277511,3016988223,10992270074,-7437,10992269968,
3111170481,10992528059,3017238772,10992520595,-7464,,
3111420961,10992778539,3017489252,10992771050,-7489,,
3111671244,10993028822,3017739535,10993021307,-7515,,
3111921692,10993279281,3017989993,10993271740,-7541,,
3112172069,10993529648,3018240360,10993522107,-7541,,
3112422475,10993780054,3018490766,10993772513,-7541,,
3112672967,10994030546,3018741269,10994023016,-7530,,
3112923459,10994281038,3018991750,10994273497,-7541,,
3112941605,10994299184,3019009896,10994291642,-7542,10994291695,
3113192049,10994549628,3019260340,10994542099,-7529,,
3113442477,10994800056,3019510768,10994792540,-7516,,
3113692840,10995050419,3019761142,10995042929,-7490,,
3113943577,10995301156,3020011868,10995293669,-7487,,
3114193720,10995551299,3020262011,10995543811,-7488,,
3114443833,10995801412,3020512124,10995793925,-7487,,
3114694424,10996052003,3020762716,10996044516,-7487,,
3114944790,10996302368,3021013080,10996294881,-7487,,
3114962971,10996320549,3021031261,10996313062,-7487,10996313035,
3115213063,10996570642,3021281354,10996563160,-7482,,
3115463568,10996821147,3021531860,10996813648,-7499,,
3115713997,10997071576,3021782299,10997064081,-7495,,
3115964582,10997322161,3022032884,10997314660,-7501,,
3116214802,10997572381,3022283093,10997564868,-7513,,
3116465253,10997822832,3022533544,10997815319,-7513,,
3116715960,10998073549,3022784262,10998066037,-7512,,
3116966097,10998323685,3023034398,10998316173,-7512,,
3116984184,10998341762,3023052474,10998334250,-7512,10998334288,
3117234672,10998592251,3023302963,10998584747,-7504,,
3117485265,10998842844,3023553557,10998835351,-7493,,
3117735748,10999093327,3023804040,10999085844,-7483,,
3117986282,10999343860,3024054583,10999336397,-7463,,
3118236783,10999594361,3024305074,10999586888,-7473,,
3118487391,10999844970,3024555683,10999837497,-7473,,
3118737517,11000095095,3024805818,11000087633,-7462,,
3118988112,11000345690,3025056403,11000338232,-7458,,
3119006355,11000363934,3025074646,11000356460,-7474,11000356449,
3119257047,11000614626,3025325338,11000607149,-7477,,
3119507607,11000865185,3025575897,11000857707,-7478,,
3119758287,11001115876,3025826589,11001108396,-7480,,
3120008682,11001366261,3026076973,11001358778,-7483,,
3120259359,11001616938,3026327651,11001609455,-7483,,
3120509479,11001867058,3026577770,11001859575,-7483,,
3120759638,11002117216,3026827928,11002109733,-7483,,
3121010122,11002367711,3027078424,11002360228,-7483,,
3121028384,11002385962,3027096674,11002378479,-7483,11002378483,
3121278996,11002636575,3027347287,11002629092,-7483,,
3121529170,11002886749,3027597461,11002879269,-7480,,
3121779637,11003137216,3027847939,11003129748,-7468,,
3122030195,11003387784,3028098497,11003380307,-7477,,
3122280735,11003638314,3028349026,11003630836,-7478,,
3122531230,11003888808,3028599521,11003881331,-7477,,
3122781354,11004138932,3028849644,11004131455,-7477,,
3123031507,11004389086,3029099798,11004381608,-7478,,
3123049613,11004407191,3029117904,11004399714,-7477,11004399699,
3123300056,11004657635,3029368348,11004650155,-7480,,
3123550277,11004907856,3029618568,11004900372,-7484,,
3123800595,11005158174,3029868886,11005150686,-7488,,
3124050801,11005408379,3030119092,11005400888,-7491,,
3124301349,11005658928,3030369641,11005651437,-7491,,
3124551963,11005909542,3030620254,11005902050,-7492,,
3124802129,11006159708,3030870420,11006152217,-7491,,
3125052557,11006410136,3031120848,11006402644,-7492,,
3125070682,11006428260,3031138973,11006420769,-7491,11006420738,
3125321129,11006678709,3031389422,11006671210,-7499,,
3125571429,11006929008,3031639720,11006921511,-7497,,
3125821932,11007179510,3031890233,11007172006,-7504,,
3126072037,11007429616,3032140328,11007422095,-7521,,
3126322449,11007680028,3032390740,11007672507,-7521,,
3126572733,11007930311,3032641024,11007922790,-7521,,
3126823205,11008180784,3032891497,11008173263,-7521,,
3127073340,11008430919,3033141631,11008423398,-7521,,
3127091518,11008449096,3033159809,11008441575,-7521,11008441550,
3127341968,11008699548,3033410260,11008692020,-7528,,
3127592519,11008950098,3033660810,11008942565,-7533,,
3127842841,11009200419,3033911132,11009192880,-7539,,
3128093389,11009450967,3034161680,11009443422,-7545,,
3128343910,11009701489,3034412201,11009693944,-7545,,
3128594885,11009952464,3034663176,11009944919,-7545,,
3128845051,11010202630,3034913342,11010195085,-7545,,
3129095785,11010453363,3035164076,11010445818,-7545,,
3129114013,11010471592,3035182304,11010464046,-7546,11010464154,
3129364601,11010722181,3035432893,11010714663,-7518,,
3129614726,11010972315,3035683027,11010964824,-7491,,
3129865395,11011222974,3035933687,11011215511,-7463,,
3130115551,11011473130,3036183843,11011465694,-7436,,
3130366153,11011723732,3036434444,11011716305,-7427,,
3130616528,11011974107,3036684820,11011966671,-7436,,
3130866888,11012224476,3036935189,11012217040,-7436,,
3131117333,11012474912,3037185625,11012467476,-7436,,
3131135487,11012493066,3037203778,11012485629,-7437,11012485578,
3131385779,11012743359,3037454071,11012735910,-7449,,
3131636158,11012993736,3037704448,11012986274,-7462,,
3131886514,11013244093,3037954815,11013236628,-7465,,
3132136649,11013494228,3038204941,11013486742,-7486,,
3132387021,11013744600,3038455313,11013737114,-7486,,
3132637429,11013995008,3038705721,11013987522,-7486,,
3132887684,11014245273,3038955986,11014237787,-7486,,
3133138223,11014495801,3039206514,11014488315,-7486,,
3133156348,11014513927,3039224639,11014506440,-7487,11014506364,
3133406834,11014764413,3039475126,11014756908,-7505,,
3133657764,11015015342,3039726055,11015007818,-7524,,
3133908299,11015265877,3039976590,11015258346,-7531,,
3134158789,11015516368,3040227080,11015508806,-7562,,
3134408914,11015766493,3040477205,11015758932,-7561,,
3134659079,11016016658,3040727370,11016009097,-7561,,
3134909503,11016267093,3040977805,11016259532,-7561,,
3135159762,11016517340,3041228053,11016509779,-7561,,
3135177875,11016535453,3041246166,11016527892,-7561,11016527886,
3135428259,11016785838,3041496551,11016778275,-7563,,
3135678746,11017036324,3041747037,11017028770,-7554,,
3135929122,11017286711,3041997424,11017279146,-7565,,
3136179284,11017536863,3042247575,11017529307,-7556,,
3136430037,11017787616,3042498328,11017780049,-7567,,
3136680127,11018037706,3042748419,11018030140,-7566,,
3136930562,11018288142,3042998854,11018280575,-7567,,
3137180739,11018538318,3043249044,11018530766,-7552,,
3137198836,11018556414,3043267127,11018548848,-7566,11018548835,
3137449202,11018806781,3043517494,11018799212,-7569,,
3137699366,11019056945,3043767657,11019049374,-7571,,
3137949615,11019307194,3044017917,11019299630,-7564,,
3138200092,11019557671,3044268383,11019550094,-7577,,
3138450665,11019808243,3044518955,11019800666,-7577,,
3138700861,11020058440,3044769153,11020050863,-7577,,
3138951243,11020308832,3045019545,11020301255,-7577,,
3139201578,11020559157,3045269869,11020551579,-7578,,
3139219601,11020577179,3045287891,11020569602,-7577,11020569607,
3139469930,11020827509,3045538222,11020819934,-7575,,
3139720194,11021077772,3045788485,11021070210,-7562,,
3139970557,11021328135,3046038858,11021320573,-7562,,
3140220715,11021578294,3046289016,11021570734,-7560,,
3140471030,11021828609,3046539321,11021821039,-7570,,
3140721192,11022078770,3046789483,11022071200,-7570,,
3140971545,11022329123,3047039846,11022321563,-7560,,
3141221707,11022579285,3047289998,11022571715,-7570,,
3141239938,11022597516,3047308228,11022589946,-7570,11022589926,
3141490400,11022847978,3047558691,11022840403,-7575,,
3141740584,11023098163,3047808875,11023090583,-7580,,
3141991075,11023348654,3048059367,11023341070,-7584,,
3142241462,11023599041,3048309753,11023591453,-7588,,
3142492021,11023849599,3048560312,11023842011,-7588,,
3142743000,11024100578,3048811291,11024092990,-7588,,
3142993172,11024350751,3049061474,11024343174,-7577,,
3143244003,11024601582,3049312294,11024594004,-7578,,
3143262150,11024619728,3049330440,11024612140,-7588,11024612173,
3143512795,11024870373,3049581086,11024862793,-7580,,
3143762910,11025120488,3049831200,11025112917,-7571,,
3144013784,11025371362,3050082075,11025363800,-7562,,
3144263885,11025621464,3050332177,11025613911,-7553,,
3144514776,11025872354,3050583067,11025864801,-7553,,
3144765145,11026122724,3050833437,11026115181,-7543,,
3145015469,11026373048,3051083760,11026365494,-7554,,
3145265680,11026623258,3051333971,11026615705,-7553,,
3145283788,11026641366,3051352078,11026633813,-7553,11026633764,
3145534369,11026891947,3051602660,11026884383,-7564,,
3145785281,11027142861,3051853574,11027135285,-7576,,
3146035471,11027393050,3052103762,11027385471,-7579,,
3146286333,11027643912,3052354625,11027636313,-7599,,
3146536910,11027894488,3052605201,11027886888,-7600,,
3146787399,11028144977,3052855700,11028137387,-7590,,
3147037959,11028395538,3053106251,11028387938,-7600,,
3147288708,11028646287,3053356999,11028638686,-7601,,
3147307065,11028664643,3053375356,11028657043,-7600,11028657152,
3147557554,11028915134,3053625846,11028907560,-7574,,
3147807669,11029165248,3053875971,11029157712,-7536,,
3148058618,11029416197,3054126909,11029408679,-7518,,
3148308963,11029666543,3054377256,11029659053,-7490,,
3148559562,11029917141,3054627853,11029909651,-7490,,
3148809874,11030167452,3054878165,11030159973,-7479,,
3149060114,11030417693,3055128405,11030410203,-7490,,
3149310630,11030668209,3055378921,11030660719,-7490,,
3149328687,11030686265,3055396977,11030678775,-7490,11030678651,
3149579228,11030936818,3055647530,11030929297,-7521,,
3149829799,11031187378,3055898090,11031179825,-7553,,
3150080234,11031437813,3056148525,11031430231,-7582,,
3150330716,11031688295,3056399008,11031680683,-7612,,
3150580855,11031938434,3056649146,11031930821,-7613,,
3150831476,11032189055,3056899767,11032181442,-7613,,
3151081652,11032439231,3057149943,11032431629,-7602,,
3151332041,11032689619,3057400332,11032682007,-7612,,
3151350182,11032707761,3057418473,11032700148,-7613,11032700177,
3151600400,11032957978,3057668690,11032950373,-7605,,
3151850774,11033208354,3057919066,11033200756,-7598,,
3152100976,11033458555,3058169267,11033450974,-7581,,
3152351395,11033708975,3058419687,11033701393,-7582,,
3152601647,11033959226,3058669939,11033951644,-7582,,
3152851948,11034209527,3058920239,11034201945,-7582,,
3153102538,11034460117,3059170829,11034452534,-7583,,
3153352647,11034710225,3059420937,11034702654,-7571,,
3153370802,11034728380,3059439093,11034720798,-7582,11034720789,
3153621364,11034978943,3059689655,11034971358,-7585,,
3153871760,11035229339,3059940051,11035221751,-7588,,
3154121893,11035479471,3060190184,11035471883,-7588,,
3154372601,11035730181,3060440894,11035722591,-7590,,
3154623047,11035980626,3060691339,11035973036,-7590,,
3154873266,11036230845,3060941557,11036223255,-7590,,
3155123814,11036481404,3061192116,11036473814,-7590,,
3155374562,11036732141,3061442854,11036724551,-7590,,
3155392660,11036750238,3061460951,11036742648,-7590,11036742659,
3155643176,11037000755,3061711467,11036993167,-7588,,
3155893278,11037250857,3061961569,11037243274,-7583,,
3156143494,11037501073,3062211785,11037493492,-7581,,
3156393640,11037751219,3062461932,11037743642,-7577,,
3156644068,11038001646,3062712359,11037994069,-7577,,
3156894618,11038252197,3062962909,11038244619,-7578,,
3157145440,11038503019,3063213731,11038495442,-7577,,
3157396046,11038753624,3063464337,11038746047,-7577,,
3157414391,11038771970,3063482682,11038764392,-7578,11038764521,
3157664808,11039022387,3063733099,11039014842,-7545,,
3157915070,11039272648,3063983361,11039265136,-7512,,
3158165238,11039522817,3064233529,11039515337,-7480,,
3158415562,11039773151,3064483864,11039765704,-7447,,
3158665915,11040023494,3064734207,11040016047,-7447,,
3158916556,11040274135,3064984847,11040266687,-7448,,
3159167078,11040524657,3065235369,11040517209,-7448,,
3159417306,11040774884,3065485596,11040767437,-7447,,
3159435411,11040792989,3065503702,11040785542,-7447,11040785367,
3159685617,11041043195,3065753908,11041035704,-7491,,
3159935742,11041293321,3066004033,11041285796,-7525,,
3160186388,11041543967,3066254680,11041536389,-7578,,
3160436608,11041794187,3066504900,11041786566,-7621,,
3160687426,11042045005,3066755717,11042037383,-7622,,
3160938186,11042295764,3067006477,11042288143,-7621,,
3161188532,11042546122,3067256834,11042538501,-7621,,
3161439152,11042796730,3067507443,11042789109,-7621,,
3161457286,11042814865,3067525577,11042807243,-7622,11042807250,
3161707729,11043065307,3067776019,11043057687,-7620,,
3161958077,11043315655,3068026368,11043308037,-7618,,
3162208302,11043565881,3068276593,11043558265,-7616,,
3162458954,11043816533,3068527245,11043808920,-7613,,
3162709359,11044066938,3068777650,11044059325,-7613,,
3162959766,11044317344,3069028057,11044309731,-7613,,
3163209940,11044567519,3069278232,11044559906,-7613,,
3163460543,11044818121,3069528834,11044810508,-7613,,
3163478718,11044836296,3069547009,11044828683,-7613,11044828645,
3163728817,11045086396,3069797109,11045078773,-7623,,
3163979191,11045336769,3070047482,11045329137,-7632,,
3164229503,11045587082,3070297795,11045579441,-7641,,
3164479804,11045837383,3070548096,11045829733,-7650,,
3164729938,11046087528,3070798240,11046079877,-7651,,
3164980604,11046338183,3071048895,11046330533,-7650,,
3165231146,11046588735,3071299447,11046581085,-7650,,
3165481617,11046839196,3071549908,11046831545,-7651,,
3165499962,11046857541,3071568253,11046849890,-7651,11046850023,
3165750476,11047108055,3071818767,11047100437,-7618,,
3166000645,11047358224,3072068936,11047350639,-7585,,
3166251564,11047609143,3072319855,11047601593,-7550,,
3166502155,11047859734,3072570446,11047852218,-7516,,
3166752509,11048110087,3072820800,11048102571,-7516,,
3167003022,11048360601,3073071313,11048353085,-7516,,
3167253277,11048610855,3073321568,11048603339,-7516,,
3167503869,11048861447,3073572160,11048853931,-7516,,
3167522104,11048879683,3073590395,11048872166,-7517,11048872095,
3167772371,11049129950,3073840662,11049122415,-7535,,
3168023245,11049380824,3074091537,11049373283,-7541,,
3168273465,11049631044,3074341756,11049623475,-7569,,
3168523592,11049881171,3074591883,11049873594,-7577,,
3168773720,11050131299,3074842011,11050123712,-7587,,
3169024031,11050381610,3075092322,11050374035,-7575,,
3169274396,11050631975,3075342687,11050624389,-7586,,
3169525013,11050882592,3075593304,11050875006,-7586,,
3169543123,11050900702,3075611414,11050893115,-7587,11050893136,
3169793581,11051151160,3075861872,11051143578,-7582,,
3170043910,11051401499,3076112212,11051393924,-7575,,
3170294582,11051652162,3076362874,11051644592,-7570,,
3170544753,11051902332,3076613044,11051894768,-7564,,
3170795397,11052152976,3076863688,11052145412,-7564,,
3171045919,11052403498,3077114211,11052395944,-7554,,
3171296373,11052653951,3077364664,11052646387,-7564,,
3171546514,11052904093,3077614815,11052896538,-7555,,
3171564679,11052922257,3077632970,11052914693,-7564,11052914514,
3171815175,11053172754,3077883467,11053165145,-7609,,
3172065545,11053423123,3078133835,11053415479,-7644,,
3172316060,11053673640,3078384352,11053665942,-7698,,
3172566277,11053923855,3078634568,11053916113,-7742,,
3172816861,11054174440,3078885153,11054166698,-7742,,
3173067229,11054424807,3079135520,11054417065,-7742,,
3173317417,11054674996,3079385708,11054667254,-7742,,
3173567927,11054925506,3079636228,11054917774,-7732,,
3173586128,11054943706,3079654419,11054935964,-7742,11054936029,
3173837033,11055194612,3079905324,11055186885,-7727,,
3174087195,11055444773,3080155485,11055437063,-7710,,
3174337465,11055695045,3080405758,11055687352,-7693,,
3174587774,11055945352,3080656076,11055937687,-7665,,
3174838265,11056195843,3080906556,11056188167,-7676,,
3175089021,11056446599,3081157312,11056438923,-7676,,
3175339887,11056697465,3081408178,11056689789,-7676,,
3175590690,11056948269,3081658982,11056940593,-7676,,
3175608816,11056966394,3081677107,11056958718,-7676,11056958718,
3175859167,11057216746,3081927458,11057209070,-7676,,
3176109496,11057467074,3082177787,11057459399,-7675,,
3176360044,11057717623,3082428335,11057709948,-7675,,
3176611015,11057968593,3082679316,11057960929,-7664,,
3176861423,11058219002,3082929714,11058211328,-7674,,
3177111668,11058469247,3083179959,11058461573,-7674,,
3177362101,11058719681,3083430393,11058712007,-7674,,
3177612281,11058969860,3083680583,11058962196,-7664,,
3177630432,11058988010,3083698723,11058980336,-7674,11058980367,
3177880626,11059238205,3083948917,11059230537,-7668,,
3178131237,11059488816,3084199539,11059481168,-7648,,
3178381580,11059739158,3084449871,11059731508,-7650,,
3178631966,11059989545,3084700268,11059981913,-7632,,
3178882722,11060240300,3084951013,11060232658,-7642,,
3179133504,11060491083,3085201805,11060483451,-7632,,
3179384248,11060741827,3085452540,11060734185,-7642,,
3179634584,11060992164,3085702876,11060984522,-7642,,
3179652775,11061010353,3085721066,11061002711,-7642,11061002753,
3179903221,11061260800,3085971513,11061253168,-7632,,
3180153610,11061511189,3086221912,11061503578,-7611,,
3180403707,11061761285,3086472008,11061753685,-7600,,
3180654495,11062012074,3086722787,11062004475,-7599,,
3180904628,11062262206,3086972919,11062254607,-7599,,
3181155056,11062512635,3087223347,11062505036,-7599,,
3181405182,11062762761,3087473474,11062755162,-7599,,
3181655681,11063013260,3087723972,11063005661,-7599,,
3181673814,11063031392,3087742104,11063023793,-7599,11063023777,
3181923980,11063281559,3087992271,11063273956,-7603,,
3182174865,11063532443,3088243156,11063524847,-7596,,
3182425257,11063782835,3088493547,11063775235,-7600,,
3182675741,11064033330,3088744043,11064025717,-7613,,
3182926147,11064283725,3088994438,11064276112,-7613,,
3183176657,11064534236,3089244948,11064526622,-7614,,
3183427316,11064784895,3089495608,11064777282,-7613,,
3183677465,11065035043,3089745756,11065027430,-7613,,
3183695754,11065053333,3089764045,11065045719,-7614,11065045730,
3183946011,11065303590,3090014302,11065295979,-7611,,
3184196259,11065553838,3090264550,11065546230,-7608,,
3184446472,11065804051,3090514763,11065796446,-7605,,
3184696961,11066054539,3090765252,11066046938,-7601,,
3184947391,11066304970,3091015683,11066297369,-7601,,
3185197890,11066555468,3091266181,11066547867,-7601,,
3185448741,11066806330,3091517042,11066798729,-7601,,
3185699401,11067056980,3091767692,11067049379,-7601,,
3185717502,11067075080,3091785793,11067067479,-7601,11067067408,
3185967898,11067325477,3092036189,11067317859,-7618,,
3186218709,11067576288,3092287000,11067568651,-7637,,
3186468970,11067826548,3092537261,11067818905,-7643,,
3186719096,11068076674,3092787387,11068069004,-7670,,
3186969342,11068326932,3093037644,11068319261,-7671,,
3187220124,11068577702,3093288415,11068570032,-7670,,
3187470595,11068828184,3093538897,11068820514,-7670,,
3187720899,11069078478,3093789191,11069070808,-7670,,
3187739031,11069096609,3093807321,11069088938,-7671,11069088918,
3187989231,11069346810,3094057522,11069339135,-7675,,
3188239683,11069597261,3094307973,11069589581,-7680,,
3188489996,11069847575,3094558287,11069839889,-7686,,
3188740140,11070097718,3094808431,11070090029,-7689,,
3188990725,11070348304,3095059016,11070340615,-7689,,
3189241287,11070598876,3095309588,11070591187,-7689,,
3189491883,11070849461,3095560173,11070841772,-7689,,
3189742066,11071099645,3095810357,11071091966,-7679,,
3189760164,11071117743,3095828455,11071110054,-7689,11071110109,
3190010762,11071368341,3096079054,11071360666,-7675,,
3190261282,11071618861,3096329583,11071611209,-7652,,
3190511399,11071868978,3096579690,11071861331,-7647,,
3190761957,11072119536,3096830248,11072111904,-7632,,
3191012206,11072369785,3097080497,11072362153,-7632,,
3191262379,11072619958,3097330681,11072612336,-7622,,
3191512540,11072870118,3097580831,11072862486,-7632,,
3191762653,11073120232,3097830944,11073112599,-7633,,
3191780758,11073138337,3097849049,11073130704,-7633,11073130653,
3192030886,11073388465,3098099177,11073380820,-7645,,
3192281501,11073639080,3098349793,11073631423,-7657,,
3192532244,11073889823,3098600535,11073882153,-7670,,
3192782361,11074139940,3098850652,11074132257,-7683,,
3193033297,11074390876,3099101588,11074383193,-7683,,
3193283474,11074641053,3099351766,11074633371,-7682,,
3193533971,11074891550,3099602262,11074883868,-7682,,
3193784492,11075142071,3099852783,11075134388,-7683,,
3193802563,11075160141,3099870853,11075152458,-7683,11075152455,
3194053070,11075410648,3100121361,11075402966,-7682,,
3194303584,11075661173,3100371886,11075653490,-7683,,
3194554059,11075911637,3100622350,11075903954,-7683,,
3194804490,11076162068,3100872781,11076154384,-7684,,
3195055031,11076412610,3101123323,11076404926,-7684,,
3195305281,11076662870,3101373582,11076655186,-7684,,
3195555754,11076913333,3101624045,11076905648,-7685,,
3195805966,11077163545,3101874258,11077155861,-7684,,
3195824045,11077181624,3101892336,11077173940,-7684,11077173892,
3196074308,11077431887,3102142599,11077424190,-7697,,
3196324772,11077682350,3102393073,11077674652,-7698,,
3196575164,11077932742,3102643454,11077925023,-7719,,
3196825349,11078182927,3102893640,11078175207,-7720,,
3197076005,11078433583,3103144296,11078425853,-7730,,
3197326625,11078684204,3103394917,11078676474,-7730,,
3197577224,11078934803,3103645515,11078927073,-7730,,
3197827757,11079185335,3103896048,11079177605,-7730,,
3197846317,11079203895,3103914608,11079196165,-7730,11079196147,
3198096508,11079454086,3104164799,11079446351,-7735,,
3198347047,11079704636,3104415348,11079696897,-7739,,
3198597170,11079954748,3104665461,11079947005,-7743,,
3198847354,11080204933,3104915645,11080197185,-7748,,
3199097498,11080455077,3105165789,11080447330,-7747,,
3199347672,11080705251,3105415963,11080697504,-7747,,
3199597833,11080955412,3105666135,11080947675,-7737,,
3199848644,11081206223,3105916936,11081198476,-7747,,
3199866722,11081224300,3105935013,11081216553,-7747,11081216578,
3200117227,11081474805,3106185517,11081467065,-7740,,
3200367820,11081725400,3106436112,11081717667,-7733,,
3200618326,11081975904,3106686617,11081968178,-7726,,
3200868676,11082226254,3106936967,11082218534,-7720,,
3201119131,11082476710,3107187422,11082468990,-7720,,
3201369266,11082726845,3107437558,11082719125,-7720,,
3201620102,11082977680,3107688393,11082969960,-7720,,
3201870900,11083228478,3107939191,11083220758,-7720,,
3201888936,11083246514,3107957226,11083238794,-7720,11083238765,
3202139126,11083496705,3108207417,11083488977,-7728,,
3202389827,11083747407,3108458120,11083739674,-7733,,
3202640415,11083997993,3108708706,11083990253,-7740,,
3202890768,11084248347,3108959060,11084240610,-7737,,
3203140892,11084498470,3109209183,11084490723,-7747,,
3203391527,11084749106,3109459819,11084741359,-7747,,
3203641727,11084999306,3109710018,11084991559,-7747,,
3203892309,11085249887,3109960600,11085242140,-7747,,
3203910554,11085268132,3109978845,11085260385,-7747,11085260416,
3204161079,11085518658,3110229370,11085510918,-7740,,
3204411246,11085768826,3110479539,11085761095,-7731,,
3204661806,11086019384,3110730097,11086011661,-7723,,
3204911950,11086269528,3110980241,11086261813,-7715,,
3205162944,11086520522,3111231235,11086512807,-7715,,
3205413173,11086770752,3111481474,11086763047,-7705,,
3205663406,11087020984,3111731697,11087013269,-7715,,
3205913581,11087271160,3111981872,11087263445,-7715,,
3205931895,11087289473,3112000186,11087281758,-7715,11087281776,
3206182223,11087539801,3112250514,11087532090,-7711,,
3206432535,11087790115,3112500827,11087782409,-7706,,
3206682946,11088040525,3112751237,11088032824,-7701,,
3206933463,11088291042,3113001754,11088283346,-7696,,
3207183646,11088541225,3113251937,11088533528,-7697,,
3207434192,11088791771,3113502493,11088784085,-7686,,
3207684617,11089042196,3113752918,11089034510,-7686,,
3207934855,11089292434,3114003146,11089284737,-7697,,
3207953002,11089310580,3114021292,11089302884,-7696,11089302828,
3208203412,11089560990,3114271703,11089553280,-7710,,
3208453875,11089811454,3114522167,11089803731,-7723,,
3208704485,11090062063,3114772776,11090054326,-7737,,
3208955198,11090312776,3115023488,11090305026,-7750,,
3209205441,11090563019,3115273732,11090555269,-7750,,
3209455550,11090813129,3115523841,11090805388,-7741,,
3209706233,11091063813,3115774525,11091056063,-7750,,
3209956689,11091314268,3116024981,11091306518,-7750,,
3209974750,11091332328,3116043040,11091324578,-7750,11091324546,
3210225054,11091582633,3116293345,11091574873,-7760,,
3210475596,11091833175,3116543887,11091825409,-7766,,
3210725937,11092083515,3116794228,11092075741,-7774,,
3210976320,11092333899,3117044611,11092326118,-7781,,
3211226508,11092584086,3117294799,11092576305,-7781,,
3211476633,11092834211,3117544924,11092826430,-7781,,
3211726802,11093084391,3117795104,11093076610,-7781,,
3211977149,11093334727,3118045440,11093326946,-7781,,
3211995301,11093352880,3118063592,11093345099,-7781,11093345148,
3212245961,11093603540,3118314253,11093595772,-7768,,
3212496167,11093853746,3118564459,11093845991,-7755,,
3212746289,11094103867,3118814580,11094096136,-7731,,
3212996847,11094354426,3119065138,11094346696,-7730,,
3213246970,11094604548,3119315260,11094596818,-7730,,
3213497406,11094854985,3119565698,11094847255,-7730,,
3213747903,11095105491,3119816204,11095097761,-7730,,
3213998579,11095356157,3120066870,11095348427,-7730,,
3214016766,11095374345,3120085057,11095366614,-7731,11095366631,
3214266923,11095624502,3120335214,11095616774,-7728,,
3214517677,11095875256,3120585968,11095867534,-7722,,
3214768052,11096125631,3120836344,11096117924,-7707,,
3215018159,11096375737,3121086450,11096368025,-7712,,
3215268570,11096626149,3121336862,11096618437,-7712,,
3215518692,11096876271,3121586983,11096868568,-7703,,
3215769737,11097127316,3121838039,11097119614,-7702,,
3216019970,11097377548,3122088261,11097369836,-7712,,
3216038147,11097395725,3122106438,11097388013,-7712,11097387928,
3216288668,11097646246,3122356959,11097638512,-7734,,
3216539128,11097896706,3122607419,11097888952,-7754,,
3216789443,11098147021,3122857734,11098139246,-7775,,
3217039576,11098397155,3123107867,11098389358,-7797,,
3217289871,11098647450,3123358162,11098639654,-7796,,
3217540767,11098898355,3123609068,11098890559,-7796,,
3217790975,11099148563,3123859276,11099140767,-7796,,
3218041115,11099398694,3124109406,11099390898,-7796,,
3218059361,11099416940,3124127652,11099409143,-7797,11099409282,
3218309847,11099667426,3124378138,11099659675,-7751,,
3218560356,11099917945,3124628658,11099910219,-7726,,
3218810537,11100168127,3124878839,11100160436,-7691,,
3219061102,11100418681,3125129393,11100411025,-7656,,
3219311421,11100668999,3125379712,11100661343,-7656,,
3219562007,11100919597,3125630309,11100911941,-7656,,
3219812191,11101169769,3125880493,11101162124,-7645,,
3220062614,11101420192,3126130904,11101412536,-7656,,
3220080724,11101438302,3126149015,11101430646,-7656,11101430602,
3220331044,11101688623,3126399336,11101680955,-7668,,
3220581270,11101938849,3126649561,11101931171,-7678,,
3220831798,11102189377,3126900089,11102181687,-7690,,
3221082755,11102440334,3127151046,11102432635,-7699,,
3221333181,11102690760,3127401472,11102683061,-7699,,
3221583672,11102941261,3127651973,11102933561,-7700,,
3221834214,11103191792,3127902505,11103184093,-7699,,
3222084432,11103442010,3128152723,11103434321,-7689,,
3222102444,11103460022,3128170735,11103452323,-7699,11103452217,
3222352912,11103710492,3128421204,11103702767,-7725,,
3222603404,11103960983,3128671696,11103953232,-7751,,
3222853584,11104211163,3128921875,11104203386,-7777,,
3223104003,11104461582,3129172294,11104453779,-7803,,
3223354248,11104711826,3129422538,11104704023,-7803,,
3223605153,11104962732,3129673454,11104954939,-7793,,
3223855620,11105213198,3129923911,11105205395,-7803,,
3224106209,11105463787,3130174500,11105455984,-7803,,
3224124451,11105482029,3130192741,11105474225,-7804,11105474245,
3224375003,11105732583,3130443295,11105724785,-7798,,
3224625290,11105982869,3130693581,11105975076,-7793,,
3224876276,11106233854,3130944566,11106226067,-7787,,
3225126594,11106484172,3131194885,11106476390,-7782,,
3225377171,11106734750,3131445462,11106726967,-7783,,
3225627263,11106984852,3131695565,11106977070,-7782,,
3225878011,11107235590,3131946303,11107227808,-7782,,
3226128347,11107485926,3132196638,11107478144,-7782,,
3226146371,11107503949,3132214661,11107496167,-7782,11107496199,
3226396844,11107754423,3132465136,11107746650,-7773,,
3226647119,11108004698,3132715421,11107996944,-7754,,
3226898127,11108255706,3132966418,11108247949,-7757,,
3227148770,11108506349,3133217061,11108498601,-7748,,
3227399175,11108756754,3133467467,11108749006,-7748,,
3227649616,11109007205,3133717918,11108999457,-7748,,
3227899727,11109257306,3133968019,11109249558,-7748,,
3228150267,11109507845,3134218558,11109500097,-7748,,
3228168370,11109525949,3134236661,11109518200,-7749,11109518134,
3228418900,11109776479,3134487192,11109768715,-7764,,
3228669079,11110026668,3134737380,11110018886,-7782,,
3228919254,11110276833,3134987545,11110269036,-7797,,
3229170126,11110527705,3135238417,11110519892,-7813,,
3229420753,11110778332,3135489044,11110770519,-7813,,
3229671673,11111029252,3135739965,11111021439,-7813,,
3229922117,11111279695,3135990408,11111271882,-7813,,
3230172455,11111530044,3136240756,11111522231,-7813,,
3230190695,11111548274,3136258986,11111540460,-7814,11111540610,
3230441018,11111798596,3136509309,11111790820,-7776,,
3230691681,11112049270,3136759983,11112041533,-7737,,
3230942255,11112299834,3137010546,11112292135,-7699,,
3231192540,11112550119,3137260842,11112542468,-7651,,
3231443076,11112800655,3137511368,11112792993,-7662,,
3231693669,11113051258,3137761970,11113043596,-7662,,
3231943862,11113301441,3138012153,11113293779,-7662,,
3232194158,11113551748,3138262460,11113544086,-7662,,
3232212269,11113569848,3138280560,11113562185,-7663,11113562024,
3232462391,11113819970,3138530682,11113812268,-7702,,
3232712522,11114070101,3138780824,11114062369,-7732,,
3232962705,11114320284,3139030996,11114312501,-7783,,
3233212817,11114570396,3139281109,11114562584,-7812,,
3233463075,11114820654,3139531367,11114812833,-7821,,
3233713843,11115071422,3139782134,11115063600,-7822,,
3233964415,11115321994,3140032707,11115314172,-7822,,
3234215062,11115572640,3140283353,11115564828,-7812,,
3234233175,11115590753,3140301466,11115582931,-7822,11115582974,
3234483467,11115841046,3140551758,11115833233,-7813,,
3234733963,11116091542,3140802265,11116083751,-7791,,
3234984568,11116342147,3141052859,11116334357,-7790,,
3235234929,11116592508,3141303221,11116584740,-7768,,
3235485230,11116842810,3141553523,11116835032,-7778,,
3235735659,11117093247,3141803960,11117085469,-7778,,
3235985842,11117343421,3142054133,11117335643,-7778,,
3236236121,11117593699,3142304411,11117585921,-7778,,
3236254356,11117611934,3142322646,11117604155,-7779,11117604120,
3236504870,11117862448,3142573160,11117854662,-7786,,
3236755274,11118112852,3142823565,11118105057,-7795,,
3237005404,11118362983,3143073695,11118355179,-7804,,
3237255953,11118613532,3143324244,11118605719,-7813,,
3237506383,11118863972,3143574685,11118856160,-7812,,
3237756566,11119114145,3143824858,11119106333,-7812,,
3238006870,11119364449,3144075161,11119356637,-7812,,
3238257079,11119614657,3144325370,11119606845,-7812,,
3238275173,11119632751,3144343464,11119624939,-7812,11119624965,
3238525747,11119883326,3144594038,11119875520,-7806,,
3238776068,11120133647,3144844359,11120125849,-7798,,
3239026538,11120384117,3145094830,11120376326,-7791,,
3239276708,11120634286,3145344999,11120626502,-7784,,
3239526913,11120884521,3145595233,11120876737,-7784,,
3239777612,11121135192,3145845904,11121127407,-7785,,
3240028150,11121385729,3146096441,11121377945,-7784,,
3240278371,11121635950,3146346662,11121628166,-7784,,
3240296489,11121654067,3146364780,11121646283,-7784,11121646292,
3240547275,11121904854,3146615566,11121897084,-7770,,
3240797399,11122154988,3146865700,11122147210,-7778,,
3241047571,11122405149,3147115862,11122397373,-7776,,
3241297682,11122655261,3147365974,11122647488,-7773,,
3241548273,11122905862,3147616574,11122898089,-7773,,
3241798411,11123155990,3147866702,11123148217,-7773,,
3242049399,11123406978,3148117690,11123399205,-7773,,
3242299821,11123657399,3148368112,11123649626,-7773,,
3242317971,11123675549,3148386261,11123667776,-7773,11123667658,
3242568876,11123926454,3148637167,11123918652,-7802,,
3242819046,11124176625,3148887348,11124168804,-7821,,
3243069547,11124427125,3149137838,11124419265,-7860,,
3243320092,11124677670,3149388383,11124669781,-7889,,
3243570448,11124928037,3149638750,11124920148,-7889,,
3243820679,11125178268,3149888981,11125170379,-7889,,
3244070797,11125428376,3150139088,11125420486,-7890,,
3244321057,11125678635,3150389348,11125670746,-7889,,
3244338990,11125696569,3150407281,11125688679,-7890,11125688701,
3244589559,11125947138,3150657850,11125939254,-7884,,
3244839858,11126197447,3150908160,11126189570,-7877,,
3245090233,11126447811,3151158524,11126439939,-7872,,
3245340617,11126698196,3151408908,11126690329,-7867,,
3245590893,11126948472,3151659184,11126940605,-7867,,
3245841120,11127198699,3151909411,11127190833,-7866,,
3246091466,11127449045,3152159757,11127441179,-7866,,
3246342128,11127699707,3152410419,11127691840,-7867,,
3246360167,11127717745,3152428457,11127709878,-7867,11127709938,
3246610270,11127967849,3152678561,11127959998,-7851,,
3246861044,11128218622,3152929335,11128210797,-7825,,
3247111437,11128469016,3153179728,11128461196,-7820,,
3247361988,11128719567,3153430280,11128711762,-7805,,
3247612211,11128969790,3153680513,11128961995,-7795,,
3247862786,11129220375,3153931087,11129212570,-7805,,
3248112897,11129470476,3154181188,11129462670,-7806,,
3248363049,11129720628,3154431341,11129712833,-7795,,
3248381239,11129738818,3154449530,11129731013,-7805,11129730939,
3248631490,11129989069,3154699781,11129981246,-7823,,
3248881853,11130239432,3154950145,11130231592,-7840,,
3249132642,11130490221,3155200933,11130482361,-7860,,
3249383520,11130741099,3155451812,11130733222,-7877,,
3249633891,11130991479,3155702192,11130983603,-7876,,
3249884251,11131241830,3155952543,11131233954,-7876,,
3250135239,11131492818,3156203530,11131484941,-7877,,
3250386040,11131743619,3156454331,11131735741,-7878,,
3250404160,11131761738,3156472451,11131753861,-7877,11131753916,
3250654601,11132012180,3156722892,11132004315,-7865,,
3250904825,11132262415,3156973127,11132254564,-7851,,
3251155169,11132512748,3157223460,11132504912,-7836,,
3251405753,11132763332,3157474045,11132755511,-7821,,
3251656159,11133013737,3157724449,11133005916,-7821,,
3251906320,11133263899,3157974612,11133256078,-7821,,
3252157012,11133514590,3158225303,11133506780,-7810,,
3252407638,11133765216,3158475929,11133757395,-7821,,
3252425794,11133783372,3158494084,11133775551,-7821,11133775562,
3252676385,11134033963,3158744676,11134026145,-7818,,
3252926584,11134284173,3158994886,11134276358,-7815,,
3253177139,11134534718,3159245430,11134526905,-7813,,
3253427483,11134785061,3159495774,11134777252,-7809,,
3253677613,11135035191,3159745904,11135027382,-7809,,
3253927794,11135285373,3159996085,11135277564,-7809,,
3254178132,11135535710,3160246423,11135527901,-7809,,
3254428657,11135786236,3160496949,11135778428,-7808,,
3254446819,11135804397,3160515110,11135796588,-7809,11135796584,
3254697000,11136054579,3160765291,11136046768,-7811,,
3254947148,11136304727,3161015440,11136296916,-7811,,
3255197358,11136554936,3161265649,11136547124,-7812,,
3255447951,11136805530,3161516242,11136797718,-7812,,
3255698809,11137056388,3161767101,11137048576,-7812,,
3255949358,11137306947,3162017660,11137299135,-7812,,
3256199591,11137557169,3162267882,11137549357,-7812,,
3256449897,11137807477,3162518189,11137799665,-7812,,
3256467979,11137825557,3162536270,11137817745,-7812,11137817700,
3256718196,11138075774,3162786487,11138067950,-7824,,
3256968952,11138326540,3163037253,11138318705,-7835,,
3257219114,11138576693,3163287405,11138568848,-7845,,
3257469956,11138827534,3163538247,11138819678,-7856,,
3257720285,11139077863,3163788576,11139070007,-7856,,
3257970464,11139328042,3164038755,11139320186,-7856,,
3258220638,11139578217,3164288930,11139570361,-7856,,
3258471393,11139828972,3164539685,11139821117,-7855,,
3258489583,11139847161,3164557874,11139839305,-7856,11139839303,
3258739832,11140097411,3164808123,11140089553,-7858,,
3258990413,11140347992,3165058705,11140340135,-7857,,
3259241027,11140598606,3165309319,11140590749,-7857,,
3259491357,11140848936,3165559659,11140841090,-7846,,
3259741784,11141099372,3165810085,11141091515,-7857,,
3259992590,11141350169,3166060881,11141342312,-7857,,
3260243048,11141600627,3166311339,11141592769,-7858,,
3260493500,11141851079,3166561792,11141843222,-7857,,
3260511572,11141869150,3166579863,11141861293,-7857,11141861265,
3260762168,11142119747,3166830459,11142111881,-7866,,
3261012985,11142370563,3167081276,11142362692,-7871,,
3261263355,11142620933,3167331646,11142613055,-7878,,
3261513978,11142871557,3167582269,11142863673,-7884,,
3261764595,11143122174,3167832886,11143114290,-7884,,
3262015106,11143372684,3168083397,11143364800,-7884,,
3262265495,11143623073,3168333786,11143615189,-7884,,
3262515964,11143873543,3168584266,11143865669,-7874,,
3262534033,11143891611,3168602324,11143883727,-7884,11143883738,
3262784270,11144141850,3168852562,11144133969,-7881,,
3263034560,11144392140,3169102852,11144384262,-7878,,
3263284737,11144642315,3169353028,11144634441,-7874,,
3263534878,11144892457,3169603170,11144884586,-7871,,
3263785374,11145142953,3169853666,11145135082,-7871,,
3264035536,11145393126,3170103838,11145385254,-7872,,
3264285818,11145643396,3170354109,11145635525,-7871,,
3264536283,11145893862,3170604574,11145886001,-7861,,
3264554451,11145912029,3170622742,11145904158,-7871,11145904160,
3264804879,11146162458,3170873170,11146154586,-7872,,
3265055532,11146413111,3171123823,11146405241,-7870,,
3265306238,11146663817,3171374539,11146655958,-7859,,
3265556615,11146914194,3171624906,11146906326,-7868,,
3265807012,11147164592,3171875304,11147156724,-7868,,
3266057643,11147415222,3172125934,11147407354,-7868,,
3266308043,11147665622,3172376345,11147657765,-7857,,
3266558794,11147916374,3172627086,11147908506,-7868,,
3266576872,11147934450,3172645163,11147926582,-7868,11147926618,
3266827137,11148184716,3172895428,11148176867,-7849,,
3267077379,11148434957,3173145670,11148427108,-7849,,
3267327702,11148685291,3173396004,11148677451,-7840,,
3267578278,11148935857,3173646569,11148928026,-7831,,
3267828990,11149186568,3173897281,11149178738,-7830,,
3268079472,11149437051,3174147763,11149429221,-7830,,
3268330113,11149687692,3174398405,11149679873,-7819,,
3268580504,11149938082,3174648795,11149930252,-7830,,
3268598690,11149956268,3174666981,11149948438,-7830,11149948353,
3268849058,11150206637,3174917350,11150198785,-7852,,
3269099638,11150457217,3175167929,11150449343,-7874,,
3269350215,11150707793,3175418517,11150699910,-7883,,
3269600431,11150958009,3175668722,11150950095,-7914,,
3269850783,11151208361,3175919073,11151200447,-7914,,
3270100968,11151458547,3176169259,11151450633,-7914,,
3270351373,11151708952,3176419664,11151701038,-7914,,
3270601630,11151959209,3176669921,11151951295,-7914,,
3270619715,11151977294,3176688006,11151969380,-7914,11151969376,
3270870112,11152227691,3176938403,11152219787,-7904,,
3271120286,11152477865,3177188578,11152469950,-7915,,
3271370496,11152728075,3177438787,11152720158,-7917,,
3271620894,11152978473,3177689185,11152970556,-7917,,
3271871062,11153228642,3177939354,11153220726,-7916,,
3272121451,11153479030,3178189742,11153471114,-7916,,
3272372239,11153729818,3178440531,11153721913,-7905,,
3272623179,11153980758,3178691470,11153972842,-7916,,
3272641266,11153998845,3178709557,11153990928,-7917,11153990920,
3272891889,11154249468,3178960180,11154241549,-7919,,
3273142507,11154500086,3179210798,11154492165,-7921,,
3273393331,11154750910,3179461622,11154742988,-7922,,
3273643710,11155001288,3179712001,11154993365,-7923,,
3273894020,11155251599,3179962311,11155243675,-7924,,
3274144340,11155501919,3180212631,11155493995,-7924,,
3274394946,11155752525,3180463237,11155744601,-7924,,
3274645569,11156003147,3180713870,11155995234,-7913,,
3274663660,11156021239,3180731951,11156013315,-7924,11156013383,
3274913900,11156271479,3180982192,11156263574,-7905,,
3275164249,11156521827,3181232540,11156513938,-7889,,
3275414651,11156772230,3181482943,11156764359,-7871,,
3275664866,11157022445,3181733157,11157014591,-7854,,
3275915007,11157272586,3181983298,11157264732,-7854,,
3276165162,11157522741,3182233453,11157514887,-7854,,
3276415468,11157773047,3182483759,11157765193,-7854,,
3276665652,11158023230,3182733943,11158015376,-7854,,
3276683720,11158041298,3182752010,11158033444,-7854,11158033383,
3276934178,11158291756,3183002479,11158283898,-7858,,
3277184362,11158541940,3183252653,11158534066,-7874,,
3277434779,11158792358,3183503071,11158784460,-7898,,
3277685036,11159042615,3183753327,11159034702,-7913,,
3277935679,11159293268,3184003980,11159285355,-7913,,
3278186378,11159543956,3184254679,11159536053,-7903,,
3278437208,11159794787,3184505499,11159786874,-7913,,
3278687533,11160045111,3184755835,11160037209,-7902,,
3278705759,11160063338,3184774050,11160055425,-7913,11160055517,
3278956535,11160314113,3185024836,11160306234,-7879,,
3279207293,11160564872,3185275595,11160557017,-7855,,
3279457777,11160815356,3185526069,11160807513,-7843,,
3279707903,11161065483,3185776195,11161057664,-7819,,
3279958215,11161315794,3186026506,11161307975,-7819,,
3280208339,11161565918,3186276630,11161558099,-7819,,
3280459075,11161816653,3186527366,11161808834,-7819,,
3280709243,11162066832,3186777544,11162059013,-7819,,
3280727307,11162084886,3186795598,11162077066,-7820,11162076934,
3280977695,11162335284,3187045997,11162327431,-7853,,
3281227894,11162585473,3187296185,11162577586,-7887,,
3281478653,11162836232,3187546944,11162828314,-7918,,
3281728975,11163086554,3187797276,11163078614,-7940,,
3281979643,11163337233,3188047945,11163329282,-7951,,
3282230018,11163587596,3188298309,11163579646,-7950,,
3282480330,11163837909,3188548621,11163829959,-7950,,
3282730441,11164088020,3188798732,11164080080,-7940,,
3282748457,11164106035,3188816747,11164098085,-7950,11164098084,
3282998944,11164356523,3189067236,11164348584,-7939,,
3283249095,11164606673,3189317386,11164598734,-7939,,
3283499844,11164857424,3189568137,11164849475,-7949,,
3283750004,11165107583,3189818295,11165099633,-7950,,
3284000183,11165357773,3190068485,11165349824,-7949,,
3284250336,11165607915,3190318627,11165599966,-7949,,
3284500699,11165858278,3190568990,11165850328,-7950,,
3284750800,11166108379,3190819091,11166100429,-7950,,
3284768821,11166126400,3190837112,11166118450,-7950,11166118491,
3285018948,11166376526,3191087239,11166368587,-7939,,
3285269397,11166626975,3191337688,11166619047,-7928,,
3285519809,11166877388,3191588101,11166869470,-7918,,
3285770775,11167128354,3191839076,11167120457,-7897,,
3286021586,11167379165,3192089877,11167371258,-7907,,
3286272332,11167629911,3192340623,11167622003,-7908,,
3286522451,11167880030,3192590742,11167872122,-7908,,
3286772800,11168130379,3192841091,11168122482,-7897,,
3286790753,11168148331,3192859044,11168140424,-7907,11168140397,
3287041243,11168398822,3193109534,11168390917,-7905,,
3287291752,11168649331,3193360044,11168641410,-7921,,
3287542647,11168900226,3193610938,11168892298,-7928,,
3287793119,11169150697,3193861410,11169142764,-7933,,
3288043629,11169401218,3194111931,11169393285,-7933,,
3288294126,11169651704,3194362417,11169643771,-7933,,
3288544754,11169902332,3194613045,11169894399,-7933,,
3288795170,11170152749,3194863461,11170144815,-7934,,
3288813192,11170170770,3194881483,11170162837,-7933,11170162854,
3289064039,11170421619,3195132331,11170413690,-7929,,
3289314658,11170672237,3195382949,11170664313,-7924,,
3289565002,11170922580,3195633293,11170914672,-7908,,
3289815560,11171173139,3195883851,11171165224,-7915,,
3290065853,11171423432,3196134144,11171415518,-7914,,
3290316086,11171673664,3196384377,11171665750,-7914,,
3290566538,11171924117,3196634829,11171916203,-7914,,
3290816913,11172174492,3196885204,11172166577,-7915,,
3290834926,11172192504,3196903216,11172184590,-7914,11172184592,
3291085861,11172443440,3197154152,11172435527,-7913,,
3291336127,11172693706,3197404418,11172685793,-7913,,
3291586668,11172944246,3197654959,11172936335,-7911,,
3291837166,11173194744,3197905457,11173186834,-7910,,
3292087382,11173444961,3198155673,11173437051,-7910,,
3292338123,11173695701,3198406414,11173687791,-7910,,
3292588620,11173946199,3198656912,11173938289,-7910,,
3292839320,11174196898,3198907611,11174188988,-7910,,
3292857681,11174215259,3198925972,11174207349,-7910,11174207428,
3293108149,11174465738,3199176451,11174457848,-7890,,
3293358317,11174715896,3199426619,11174708038,-7858,,
3293609336,11174966915,3199677627,11174959066,-7849,,
3293860010,11175217589,3199928301,11175209760,-7829,,
3294111024,11175468613,3200179326,11175460784,-7829,,
3294361707,11175719286,3200430009,11175711467,-7819,,
3294612140,11175969718,3200680431,11175961889,-7829,,
3294862530,11176220109,3200930832,11176212291,-7818,,
3294880549,11176238127,3200948840,11176230298,-7829,11176230129,
3295131190,11176488769,3201199481,11176480897,-7872,,
3295381939,11176739517,3201450230,11176731603,-7914,,
3295632341,11176989920,3201700632,11176981964,-7956,,
3295882778,11177240357,3201951069,11177232360,-7997,,
3296133022,11177490601,3202201314,11177482604,-7997,,
3296383418,11177740996,3202451708,11177732999,-7997,,
3296633703,11177991282,3202701994,11177983285,-7997,,
3296884231,11178241810,3202952522,11178233813,-7997,,
3296902451,11178260029,3202970741,11178252032,-7997,11178252142,
3297152750,11178510329,3203221042,11178502360,-7969,,
3297403187,11178760767,3203471479,11178752826,-7941,,
3297653474,11179011052,3203721765,11179003139,-7913,,
3297903618,11179261197,3203971909,11179253312,-7885,,
3298154417,11179511997,3204222709,11179504112,-7885,,
3298404544,11179762123,3204472835,11179754238,-7885,,
3298655045,11180012624,3204723336,11180004739,-7885,,
3298905562,11180263141,3204973854,11180255256,-7885,,
3298923618,11180281196,3204991909,11180273311,-7885,11180273194,
3299174245,11180531824,3205242537,11180523909,-7915,,
3299424480,11180782059,3205492772,11180774115,-7944,,
3299674944,11181032533,3205743246,11181024561,-7972,,
3299925165,11181282744,3205993456,11181274742,-8002,,
3300175381,11181532961,3206243683,11181524970,-7991,,
3300426324,11181783903,3206494615,11181775902,-8001,,
3300676643,11182034221,3206744934,11182026220,-8001,,
3300926988,11182284567,3206995279,11182276566,-8001,,
3300945176,11182302754,3207013467,11182294753,-8001,11182294805,
3301195537,11182553116,3207263839,11182545137,-7979,,
3301446386,11182803966,3207514678,11182795991,-7975,,
3301696880,11183054458,3207765171,11183046496,-7962,,
3301947400,11183304979,3208015692,11183297031,-7948,,
3302197835,11183555423,3208266136,11183547475,-7948,,
3302448548,11183806127,3208516839,11183798178,-7949,,
3302698881,11184056460,3208767172,11184048512,-7948,,
3302949118,11184306697,3209017409,11184298749,-7948,,
3302967112,11184324690,3209035403,11184316742,-7948,11184316687,
3303217500,11184575089,3209285801,11184567128,-7961,,
3303468000,11184825579,3209536292,11184817606,-7973,,
3303718546,11185076125,3209786837,11185068137,-7988,,
3303969245,11185326824,3210037536,11185318823,-8001,,
3304219349,11185576928,3210287641,11185568927,-8001,,
3304469801,11185827380,3210538092,11185819378,-8002,,
3304719898,11186077477,3210788189,11186069475,-8002,,
3304970428,11186328007,3211038719,11186320006,-8001,,
3304988564,11186346143,3211056855,11186338142,-8001,11186338132,
3305238766,11186596345,3211307067,11186588352,-7993,,
3305489331,11186846910,3211557623,11186838905,-8005,,
3305739588,11187097167,3211807880,11187089160,-8007,,
3305990139,11187347718,3212058430,11187339719,-7999,,
3306241039,11187598618,3212309330,11187590609,-8009,,
3306491605,11187849183,3212559896,11187841174,-8009,,
3306742013,11188099592,3212810304,11188091583,-8009,,
3306992397,11188349976,3213060688,11188341977,-7999,,
3307010505,11188368084,3213078796,11188360074,-8010,11188360099,
3307261042,11188618620,3213329344,11188610628,-7992,,
3307511847,11188869426,3213580138,11188861430,-7996,,
3307762395,11189119973,3213830685,11189111983,-7990,,
3308012618,11189370197,3214080909,11189362214,-7983,,
3308262915,11189620505,3214331218,11189612522,-7983,,
3308513230,11189870809,3214581522,11189862827,-7982,,
3308763686,11190121265,3214831977,11190113282,-7983,,
3309013926,11190371505,3215082217,11190363521,-7984,,
3309031964,11190389542,3215100255,11190381559,-7983,11190381571,
3309282284,11190639872,3215350585,11190631892,-7980,,
3309532929,11190890508,3215601220,11190882541,-7967,,
3309783562,11191141141,3215851854,11191133168,-7973,,
3310033812,11191391391,3216102103,11191383420,-7971,,
3310284041,11191641619,3216352332,11191633660,-7959,,
3310534202,11191891781,3216602494,11191883811,-7970,,
3310784736,11192142315,3216853037,11192134354,-7961,,
3311035609,11192393188,3217103900,11192385217,-7971,,
3311053696,11192411275,3217121987,11192403304,-7971,11192403261,
3311304591,11192662180,3217372892,11192654198,-7982,,
3311555171,11192912750,3217623463,11192904769,-7981,,
3311805989,11193163568,3217874280,11193155565,-8003,,
3312056583,11193414161,3218124874,11193406149,-8012,,
3312307187,11193664775,3218375488,11193656763,-8012,,
3312557398,11193914978,3218625691,11193906966,-8012,,
3312807750,11194165329,3218876041,11194157317,-8012,,
3313057969,11194415548,3219126260,11194407536,-8012,,
3313075985,11194433563,3219144275,11194425551,-8012,11194425534,
3313326482,11194684070,3219394783,11194676054,-8016,,
3313577371,11194934950,3219645662,11194926929,-8021,,
3313827677,11195185256,3219895968,11195177232,-8024,,
3314077942,11195435520,3220146233,11195427493,-8027,,
3314328087,11195685666,3220396379,11195677639,-8027,,
3314578711,11195936290,3220647003,11195928263,-8027,,
3314828999,11196186578,3220897290,11196178551,-8027,,
3315079562,11196437141,3221147854,11196429114,-8027,,
3315098362,11196455941,3221166653,11196447914,-8027,11196448290,
3315348923,11196706512,3221417224,11196698580,-7932,,
3315599305,11196956884,3221667596,11196949046,-7838,,
3315849887,11197207465,3221918178,11197199722,-7743,,
3316100090,11197457668,3222168381,11197450019,-7649,,
3316350564,11197708153,3222418866,11197700504,-7649,,
3316601057,11197958636,3222669349,11197950987,-7649,,
3316851182,11198208761,3222919473,11198201112,-7649,,
3317101992,11198459570,3223170283,11198451921,-7649,,
3317120038,11198477616,3223188328,11198469967,-7649,11198469646,
3317371078,11198728667,3223439380,11198720938,-7729,,
3317621244,11198978823,3223689535,11198971013,-7810,,
3317871574,11199229153,3223939865,11199221263,-7890,,
3318121826,11199479405,3224190117,11199471436,-7969,,
3318372341,11199729920,3224440643,11199721963,-7957,,
3318622683,11199980262,3224690974,11199972293,-7969,,
3318873288,11200230866,3224941579,11200222898,-7968,,
3319123829,11200481407,3225192120,11200473439,-7968,,
3319141858,11200499436,3225210149,11200491468,-7968,11200491422,
3319392372,11200749961,3225460673,11200741981,-7980,,
3319642575,11201000154,3225710866,11200992163,-7991,,
3319892716,11201250294,3225961017,11201242303,-7991,,
3320142934,11201500513,3226211225,11201492500,-8013,,
3320393110,11201750699,3226461412,11201742686,-8013,,
3320643401,11202000980,3226711692,11201992966,-8014,,
3320893556,11202251135,3226961848,11202243133,-8002,,
3321143934,11202501513,3227212225,11202493500,-8013,,
3321161916,11202519495,3227230207,11202511482,-8013,11202511439,
3321412473,11202770061,3227480774,11202762038,-8023,,
3321662740,11203020318,3227731031,11203012284,-8034,,
3321912914,11203270493,3227981205,11203262459,-8034,,
3322163169,11203520748,3228231460,11203512694,-8054,,
3322413528,11203771107,3228481819,11203763053,-8054,,
3322664092,11204021670,3228732383,11204013616,-8054,,
3322914322,11204271902,3228982614,11204263848,-8054,,
3323164860,11204522438,3229233151,11204514384,-8054,,
3323182990,11204540568,3229251281,11204532514,-8054,11204532489,
3323433277,11204790856,3229501579,11204782805,-8051,,
3323683646,11205041224,3229751937,11205033158,-8066,,
3323933885,11205291464,3230002176,11205283392,-8072,,
3324183989,11205541568,3230252290,11205533500,-8068,,
3324434281,11205791860,3230502573,11205783782,-8078,,
3324684762,11206042341,3230753053,11206034263,-8078,,
3324934907,11206292486,3231003198,11206284407,-8079,,
3325185288,11206542867,3231253579,11206534788,-8079,,
3325203409,11206560988,3231271700,11206552910,-8078,11206552909,
3325453594,11206811183,3231521896,11206803106,-8077,,
3325703689,11207061268,3231771981,11207053191,-8077,,
3325954023,11207311602,3232022314,11207303534,-8068,,
3326204834,11207562413,3232273125,11207554335,-8078,,
3326455269,11207812848,3232523561,11207804771,-8077,,
3326705970,11208063560,3232774273,11208055483,-8077,,
3326956891,11208314470,3233025183,11208306393,-8077,,
3327207330,11208564909,3233275621,11208556842,-8067,,
3327225508,11208583087,3233293799,11208575009,-8078,11208575034,
3327475710,11208833289,3233544011,11208825228,-8061,,
3327725829,11209083408,3233794120,11209075343,-8065,,
3327976316,11209333895,3234044607,11209325836,-8059,,
3328226469,11209584048,3234294761,11209575998,-8050,,
3328476718,11209834297,3234545010,11209826246,-8051,,
3328727056,11210084634,3234795347,11210076583,-8051,,
3328977286,11210334865,3235045577,11210326813,-8052,,
3329227741,11210585319,3235296032,11210577268,-8051,,
3329245973,11210603551,3235314263,11210595500,-8051,11210595658,
3329496289,11210853869,3235564581,11210845858,-8011,,
3329746866,11211104455,3235815167,11211096484,-7971,,
3329996978,11211354557,3236065269,11211346626,-7931,,
3330247526,11211605104,3236315827,11211597223,-7881,,
3330497667,11211855245,3236565958,11211847365,-7880,,
3330747982,11212105561,3236816274,11212097670,-7891,,
3330998311,11212355890,3237066602,11212347998,-7892,,
3331248615,11212606193,3237316905,11212598302,-7891,,
3331266752,11212624331,3237335043,11212616439,-7892,11212616264,
3331517005,11212874585,3237585297,11212866650,-7935,,
3331767409,11213124988,3237835700,11213117009,-7979,,
3332017880,11213375459,3238086171,11213367436,-8023,,
3332267996,11213625576,3238336288,11213617511,-8065,,
3332518595,11213876184,3238586896,11213868119,-8065,,
3332768879,11214126457,3238837169,11214118392,-8065,,
3333019310,11214376889,3239087601,11214368824,-8065,,
3333269537,11214627116,3239337838,11214619061,-8055,,
3333287863,11214645441,3239356154,11214637376,-8065,11214637318,
3333538021,11214895601,3239606313,11214887521,-8080,,
3333788520,11215146099,3239856811,11215138004,-8095,,
3334038915,11215396494,3240107206,11215388386,-8108,,
3334289705,11215647284,3240358006,11215639172,-8112,,
3334540295,11215897874,3240608586,11215889751,-8123,,
3334790941,11216148519,3240859231,11216140397,-8122,,
3335041084,11216398662,3241109375,11216390540,-8122,,
3335291537,11216649115,3241359828,11216640993,-8122,,
3335309550,11216667128,3241377841,11216659006,-8122,11216659058,
3335559840,11216917420,3241628132,11216909311,-8109,,
3335809963,11217167542,3241878255,11217159446,-8096,,
3336060423,11217418002,3242128714,11217409920,-8082,,
3336310600,11217668189,3242378901,11217660120,-8069,,
3336560798,11217918377,3242629089,11217910318,-8059,,
3336810947,11218168526,3242879238,11218160457,-8069,,
3337061298,11218418876,3243129589,11218410807,-8069,,
3337311949,11218669528,3243380251,11218661470,-8058,,
3337329972,11218687550,3243398263,11218679481,-8069,11218679460,
3337580548,11218938127,3243648840,11218930054,-8073,,
3337831115,11219188693,3243899406,11219180615,-8078,,
3338081329,11219438907,3244149620,11219430824,-8083,,
3338331513,11219689092,3244399815,11219681014,-8078,,
3338581699,11219939278,3244649990,11219931190,-8088,,
3338832327,11220189906,3244900618,11220181817,-8089,,
3339082730,11220440309,3245151021,11220432220,-8089,,
3339333204,11220690782,3245401495,11220682694,-8088,,
3339351252,11220708830,3245419542,11220700742,-8088,11220700748,
3339601443,11220959022,3245669735,11220950936,-8086,,
3339851983,11221209561,3245920274,11221201487,-8074,,
3340102587,11221460165,3246170878,11221452083,-8082,,
3340352974,11221710553,3246421265,11221702473,-8080,,
3340603272,11221960861,3246671573,11221952781,-8080,,
3340853448,11222211027,3246921739,11222202946,-8081,,
3341103579,11222461157,3247171870,11222453077,-8080,,
3341354111,11222711689,3247422401,11222703609,-8080,,
3341372256,11222729835,3247440547,11222721755,-8080,11222721792,
3341622753,11222980333,3247691045,11222972262,-8071,,
3341873110,11223230688,3247941401,11223222627,-8061,,
3342123530,11223481109,3248191822,11223473058,-8051,,
3342374128,11223731707,3248442419,11223723666,-8041,,
3342624719,11223982308,3248693021,11223974267,-8041,,
3342875433,11224233012,3248943724,11224224981,-8031,,
3343125959,11224483537,3249194250,11224475496,-8041,,
3343376196,11224733775,3249444487,11224725734,-8041,,
3343394216,11224751794,3249462507,11224743753,-8041,11224743760,
3343644339,11225001918,3249712630,11224993878,-8040,,
3343894488,11225252067,3249962780,11225244030,-8037,,
3344144596,11225502175,3250212888,11225494140,-8035,,
3344394930,11225752509,3250463221,11225744476,-8033,,
3344645219,11226002808,3250713521,11225994775,-8033,,
3344895946,11226253524,3250964237,11226245491,-8033,,
3345146780,11226504359,3251215071,11226496326,-8033,,
3345397323,11226754902,3251465615,11226746869,-8033,,
3345415463,11226773041,3251483754,11226765008,-8033,11226764961,
3345665930,11227023519,3251734232,11227015475,-8044,,
3345916068,11227273646,3251984359,11227265590,-8056,,
3346166337,11227523915,3252234628,11227515847,-8068,,
3346416783,11227774362,3252485074,11227766293,-8069,,
3346667096,11228024675,3252735388,11228016596,-8079,,
3346917659,11228275238,3252985951,11228267159,-8079,,
3347168181,11228525759,3253236472,11228517680,-8079,,
3347418830,11228776408,3253487121,11228768329,-8079,,
3347436911,11228794489,3253505202,11228786410,-8079,11228786374,
3347687651,11229045241,3253755953,11229037152,-8089,,
3347938251,11229295830,3254006542,11229287732,-8098,,
3348188649,11229546227,3254256940,11229538121,-8106,,
3348439511,11229797089,3254507802,11229788975,-8114,,
3348690218,11230047797,3254758509,11230039683,-8114,,
3348940766,11230298344,3255009057,11230290230,-8114,,
3349191107,11230548685,3255259398,11230540571,-8114,,
3349441595,11230799174,3255509886,11230791060,-8114,,
3349459729,11230817307,3255528020,11230809193,-8114,11230809234,
3349709925,11231067504,3255778217,11231059400,-8104,,
3349960239,11231317817,3256028530,11231309723,-8094,,
3350210881,11231568459,3256279172,11231560376,-8083,,
3350461057,11231818636,3256529348,11231810564,-8072,,
3350711705,11232069284,3256779996,11232061212,-8072,,
3350961913,11232319492,3257030204,11232311419,-8073,,
3351212022,11232569601,3257280314,11232561529,-8072,,
3351462565,11232820143,3257530856,11232812071,-8072,,
3351480681,11232838260,3257548972,11232830187,-8073,11232830180,
3351731148,11233088737,3257799449,11233080663,-8074,,
3351982016,11233339594,3258050307,11233331519,-8075,,
3352232564,11233590143,3258300855,11233582065,-8078,,
3352483015,11233840594,3258551307,11233832516,-8078,,
3352733116,11234090695,3258801408,11234082617,-8078,,
3352983776,11234341355,3259052067,11234333277,-8078,,
3353234095,11234591673,3259302386,11234583595,-8078,,
3353484569,11234842148,3259552860,11234834070,-8078,,
3353502726,11234860305,3259571017,11234852226,-8079,11234852174,
3353753355,11235110944,3259821656,11235102853,-8091,,
3354004227,11235361805,3260072518,11235353701,-8104,,
3354254462,11235612041,3260322753,11235603924,-8117,,
3354504830,11235862409,3260573122,11235854280,-8129,,
3354755604,11236113193,3260823905,11236105064,-8129,,
3355006209,11236363788,3261074500,11236355659,-8129,,
3355256377,11236613956,3261324668,11236605827,-8129,,
3355507054,11236864632,3261575345,11236856503,-8129,,
3355525201,11236882779,3261593491,11236874650,-8129,11236874594,
3355775786,11237133375,3261844088,11237125232,-8143,,
3356025972,11237383551,3262094263,11237375395,-8156,,
3356276387,11237633965,3262344677,11237625795,-8170,,
3356526903,11237884483,3262595196,11237876300,-8183,,
3356777097,11238134687,3262845399,11238126504,-8183,,
3357027435,11238385014,3263095726,11238376831,-8183,,
3357278060,11238635639,3263346352,11238627456,-8183,,
3357528415,11238885994,3263596706,11238877811,-8183,,
3357546500,11238904078,3263614791,11238895895,-8183,11238895953,
3357796601,11239154180,3263864893,11239146011,-8169,,
3358047020,11239404598,3264115311,11239396444,-8154,,
3358297152,11239654730,3264365443,11239646591,-8139,,
3358547629,11239905209,3264615922,11239897085,-8124,,
3358798001,11240155580,3264866292,11240147455,-8125,,
3359048975,11240406553,3265117266,11240398429,-8124,,
3359299478,11240657057,3265367769,11240648933,-8124,,
3359550193,11240907771,3265618484,11240899647,-8124,,
3359568215,11240925793,3265636505,11240917669,-8124,11240917674,
3359818552,11241176131,3265886844,11241168009,-8122,,
3360068648,11241426227,3266136939,11241418107,-8120,,
3360318806,11241676400,3266387113,11241668282,-8118,,
3360568943,11241926522,3266637235,11241918405,-8117,,
3360819107,11242176696,3266887408,11242168579,-8117,,
3361069255,11242426844,3267137557,11242418727,-8117,,
3361319852,11242677430,3267388143,11242669313,-8117,,
3361570160,11242927739,3267638452,11242919622,-8117,,
3361588220,11242945798,3267656511,11242937681,-8117,11242937675,
3361838433,11243196011,3267906724,11243187892,-8119,,
3362088731,11243446321,3268157033,11243438201,-8120,,
3362338864,11243696442,3268407155,11243688321,-8121,,
3362589341,11243946920,3268657633,11243938798,-8122,,
3362839909,11244197487,3268908200,11244189365,-8122,,
3363090870,11244448449,3269159172,11244440337,-8112,,
3363340993,11244698571,3269409284,11244690449,-8122,,
3363591334,11244948912,3269659625,11244940790,-8122,,
3363609316,11244966894,3269677606,11244958772,-8122,11244958778,
3363859659,11245217249,3269927961,11245209128,-8121,,
3364110182,11245467761,3270178473,11245459652,-8109,,
3364360954,11245718533,3270429245,11245710417,-8116,,
3364611326,11245968914,3270679627,11245960800,-8114,,
3364861540,11246219128,3270929841,11246211014,-8114,,
3365111649,11246469228,3271179940,11246461114,-8114,,
3365362025,11246719604,3271430316,11246711490,-8114,,
3365612410,11246969989,3271680702,11246961875,-8114,,
3365630523,11246988101,3271698813,11246979987,-8114,11246979888,
3365881082,11247238660,3271949373,11247230521,-8139,,
3366131183,11247488761,3272199474,11247480598,-8163,,
3366381589,11247739167,3272449891,11247730990,-8177,,
3366632447,11247990025,3272700738,11247981813,-8212,,
3366882590,11248240169,3272950881,11248231956,-8213,,
3367133289,11248490867,3273201579,11248482655,-8212,,
3367383448,11248741027,3273451739,11248732815,-8212,,
3367633756,11248991335,3273702047,11248983122,-8213,,
3367651844,11249009423,3273720135,11249001210,-8213,11249001281,
3367902082,11249259671,3273970383,11249251475,-8196,,
3368152306,11249509884,3274220597,11249501707,-8177,,
3368402505,11249760084,3274470796,11249751925,-8159,,
3368652978,11250010557,3274721269,11250002416,-8141,,
3368903379,11250260957,3274971680,11250252827,-8130,,
3369153692,11250511271,3275221983,11250503130,-8141,,
3369404399,11250761978,3275472690,11250753837,-8141,,
3369654514,11251012093,3275722805,11251003953,-8140,,
3369672588,11251030166,3275740879,11251022026,-8140,11251022053,
3369922718,11251280297,3275991009,11251272164,-8133,,
3370173491,11251531070,3276241782,11251522944,-8126,,
3370424187,11251781766,3276492478,11251773658,-8108,,
3370674737,11252032316,3276743028,11252024204,-8112,,
3370925208,11252282787,3276993510,11252274686,-8101,,
3371175701,11252533280,3277243992,11252525169,-8111,,
3371426275,11252783853,3277494566,11252775742,-8111,,
3371676707,11253034286,3277744998,11253026175,-8111,,
3371695084,11253052662,3277763374,11253044551,-8111,11253044413,
3371945489,11253303078,3278013791,11253294933,-8145,,
3372195672,11253553250,3278263963,11253545071,-8179,,
3372446747,11253804326,3278515039,11253796114,-8212,,
3372696936,11254054514,3278765227,11254046267,-8247,,
3372947430,11254305009,3279015731,11254296772,-8237,,
3373197573,11254555152,3279265864,11254546905,-8247,,
3373448367,11254805955,3279516668,11254797708,-8247,,
3373698725,11255056304,3279767017,11255048057,-8247,,
3373716736,11255074314,3279785026,11255066067,-8247,11255066206,
3373967374,11255324953,3280035675,11255316751,-8202,,
3374217767,11255575345,3280286058,11255567168,-8177,,
3374468169,11255825747,3280536470,11255817616,-8131,,
3374718389,11256075967,3280786680,11256067861,-8106,,
3374968994,11256326582,3281037295,11256318476,-8106,,
3375219359,11256576937,3281287650,11256568831,-8106,,
3375469913,11256827492,3281538204,11256819396,-8096,,
3375720202,11257077781,3281788493,11257069675,-8106,,
3375738226,11257095805,3281806517,11257087698,-8107,11257087681,
3375988558,11257346147,3282056860,11257338037,-8110,,
3376239012,11257596591,3282307303,11257588477,-8114,,
3376489409,11257846988,3282557701,11257838871,-8117,,
3376739931,11258097520,3282808232,11258089398,-8122,,
3376990494,11258348073,3283058796,11258339961,-8112,,
3377240606,11258598184,3283308897,11258590062,-8122,,
3377491014,11258848592,3283559305,11258840470,-8122,,
3377741201,11259098780,3283809492,11259090657,-8123,,
3377759379,11259116957,3283827670,11259108835,-8122,11259108860,
3378009691,11259367270,3284077983,11259359154,-8116,,
3378260098,11259617676,3284328389,11259609567,-8109,,
3378510693,11259868273,3284578985,11259860171,-8102,,
3378760904,11260118482,3284829195,11260110386,-8096,,
3379011051,11260368629,3285079342,11260360533,-8096,,
3379261265,11260618843,3285329556,11260610747,-8096,,
3379512149,11260869727,3285580440,11260861631,-8096,,
3379762465,11261120054,3285830767,11261111958,-8096,,
3379780714,11261138292,3285849005,11261130196,-8096,11261130193,
3380031283,11261388861,3286099584,11261380774,-8087,,
3380281602,11261639181,3286349893,11261631083,-8098,,
3380532137,11261889716,3286600429,11261881618,-8098,,
3380782290,11262139868,3286850581,11262131781,-8087,,
3381032629,11262390219,3287100931,11262382121,-8098,,
3381282820,11262640398,3287351111,11262632300,-8098,,
3381533237,11262890816,3287601528,11262882718,-8098,,
3381783375,11263140954,3287851676,11263132866,-8088,,
3381801310,11263158888,3287869601,11263150790,-8098,11263150751,
3382051443,11263409022,3288119734,11263400913,-8109,,
3382301733,11263659311,3288370024,11263651193,-8118,,
3382551934,11263909512,3288620225,11263901385,-8127,,
3382802425,11264160004,3288870716,11264151867,-8137,,
3383052593,11264410171,3289120895,11264402046,-8125,,
3383303185,11264660763,3289371476,11264652627,-8136,,
3383553882,11264911461,3289622174,11264903326,-8135,,
3383804530,11265162108,3289872821,11265153972,-8136,,
3383823359,11265180938,3289891650,11265172801,-8137,11265173073,
3384073531,11265431109,3290141822,11265423041,-8068,,
3384323880,11265681459,3290392172,11265673459,-8000,,
3384574318,11265931896,3290642609,11265923965,-7931,,
3384825177,11266182756,3290893478,11266174903,-7853,,
3385075574,11266433152,3291143865,11266425289,-7863,,
3385326373,11266683951,3291394664,11266676088,-7863,,
3385576775,11266934355,3291645068,11266926492,-7863,,
3385827191,11267184770,3291895483,11267176907,-7863,,
3385845228,11267202806,3291913519,11267194943,-7863,11267194630,
3386095498,11267453077,3292163789,11267445134,-7943,,
3386345627,11267703206,3292413918,11267695185,-8021,,
3386595740,11267953319,3292664031,11267945221,-8098,,
3386846302,11268203881,3292914594,11268195706,-8175,,
3387096501,11268454080,3293164792,11268445905,-8175,,
3387346796,11268704375,3293415087,11268696200,-8175,,
3387596981,11268954561,3293665273,11268946386,-8175,,
3387847319,11269204897,3293915620,11269196732,-8165,,
3387865509,11269223088,3293933800,11269214913,-8175,11269214994,
3388115631,11269473210,3294183922,11269465054,-8156,,
3388366083,11269723672,3294434384,11269715537,-8135,,
3388616529,11269974108,3294684820,11269965995,-8113,,
3388866882,11270224461,3294935173,11270216369,-8092,,
3389117543,11270475122,3295185834,11270467030,-8092,,
3389368072,11270725650,3295436363,11270717558,-8092,,
3389618542,11270976122,3295686834,11270968030,-8092,,
3389868652,11271226241,3295936954,11271218149,-8092,,
3389886734,11271244312,3295955025,11271236220,-8092,11271236138,
3390137309,11271494888,3296205610,11271486785,-8103,,
3390388157,11271745746,3296456458,11271737612,-8134,,
3390638271,11271995849,3296706562,11271987695,-8154,,
3390888632,11272246211,3296956923,11272238048,-8163,,
3391138793,11272496372,3297207085,11272488199,-8173,,
3391389493,11272747071,3297457784,11272738898,-8173,,
3391640026,11272997605,3297708317,11272989432,-8173,,
3391890686,11273248265,3297958978,11273240092,-8173,,
3391908830,11273266409,3297977121,11273258236,-8173,11273258198,
3392158993,11273516572,3298227295,11273508401,-8171,,
3392409318,11273766907,3298477620,11273758716,-8191,,
3392659800,11274017379,3298728091,11274009178,-8201,,
3392910555,11274268133,3298978846,11274259924,-8209,,
3393161076,11274518655,3299229368,11274510447,-8208,,
3393411585,11274769164,3299479876,11274760955,-8209,,
3393662376,11275019954,3299730667,11275011745,-8209,,
3393912680,11275270259,3299980971,11275262050,-8209,,
3393930833,11275288412,3299999124,11275280202,-8210,11275280141,
3394181469,11275539048,3300249761,11275530823,-8225,,
3394432079,11275789658,3300500370,11275781418,-8240,,
3394682621,11276040199,3300750912,11276031945,-8254,,
3394932844,11276290422,3301001135,11276282153,-8269,,
3395183238,11276540828,3301251541,11276532559,-8269,,
3395433868,11276791446,3301502159,11276783177,-8269,,
3395684256,11277041835,3301752547,11277033565,-8270,,
3395934867,11277292445,3302003158,11277284176,-8269,,
3395953082,11277310661,3302021373,11277302391,-8270,11277302444,
3396203231,11277560819,3302271532,11277552563,-8256,,
3396453975,11277811554,3302522267,11277803312,-8242,,
3396704438,11278062017,3302772730,11278053789,-8228,,
3396954588,11278312167,3303022879,11278303952,-8215,,
3397204895,11278562484,3303273197,11278554269,-8215,,
3397455384,11278812963,3303523675,11278804747,-8216,,
3397705816,11279063394,3303774107,11279055179,-8215,,
3397956242,11279313821,3304024533,11279305616,-8205,,
3397974461,11279332039,3304042751,11279323824,-8215,11279323810,
3398224899,11279582478,3304293191,11279574261,-8217,,
3398475244,11279832822,3304543535,11279824601,-8221,,
3398725658,11280083237,3304793949,11280075013,-8224,,
3398975878,11280333457,3305044169,11280325230,-8227,,
3399226208,11280583787,3305294500,11280575560,-8227,,
3399476392,11280833971,3305544683,11280825743,-8228,,
3399726535,11281084114,3305794827,11281075887,-8227,,
3399976885,11281334464,3306045176,11281326237,-8227,,
3399994959,11281352538,3306063250,11281344311,-8227,11281344336,
3400245208,11281602787,3306313500,11281594566,-8221,,
3400495643,11281853222,3306563935,11281845008,-8214,,
3400746523,11282104102,3306814814,11282095895,-8207,,
3400997030,11282354609,3307065321,11282346408,-8201,,
3401247873,11282605453,3307316165,11282597252,-8201,,
3401498661,11282856240,3307566952,11282848050,-8190,,
3401749344,11283106923,3307817636,11283098723,-8200,,
3401999495,11283357074,3308067786,11283348874,-8200,,
3402017512,11283375090,3308085802,11283366890,-8200,11283366887,
3402267791,11283625370,3308336083,11283617171,-8199,,
3402517929,11283875508,3308586220,11283867307,-8201,,
3402768502,11284126081,3308836793,11284117880,-8201,,
3403019283,11284376862,3309087574,11284368661,-8201,,
3403269897,11284627476,3309338189,11284619276,-8200,,
3403520238,11284877818,3309588531,11284869617,-8201,,
3403770622,11285128201,3309838913,11285120000,-8201,,
3404021016,11285378595,3310089307,11285370394,-8201,,
3404039174,11285396752,3310107465,11285388551,-8201,11285388503,
3404289713,11285647292,3310358005,11285639080,-8212,,
3404539834,11285897412,3310608124,11285889188,-8224,,
3404790535,11286148114,3310858826,11286139877,-8237,,
3405040690,11286398269,3311108981,11286390022,-8247,,
3405291025,11286648615,3311359327,11286640367,-8248,,
3405541142,11286898721,3311609433,11286890474,-8247,,
3405791364,11287148943,3311859655,11287140695,-8248,,
3406041727,11287399306,3312110019,11287391059,-8247,,
3406059795,11287417373,3312128086,11287409126,-8247,11287409135,
3406310218,11287667796,3312378509,11287659551,-8245,,
3406560564,11287918144,3312628856,11287909902,-8242,,
3406810841,11288168420,3312879132,11288160181,-8239,,
3407061173,11288418752,3313129465,11288410515,-8237,,
3407311530,11288669109,3313379822,11288660872,-8237,,
3407562079,11288919658,3313630370,11288911420,-8238,,
3407812723,11289170301,3313881014,11289162064,-8237,,
3408063251,11289420829,3314131542,11289412592,-8237,,
3408081431,11289439009,3314149721,11289430772,-8237,11289430741,
3408331700,11289689289,3314400002,11289681044,-8245,,
3408582076,11289939656,3314650368,11289931404,-8252,,
3408832244,11290189823,3314900535,11290181564,-8259,,
3409082429,11290440008,3315150721,11290431742,-8266,,
3409333407,11290690985,3315401698,11290682719,-8266,,
3409583627,11290941205,3315651918,11290932939,-8266,,
3409834469,11291192058,3315902771,11291183792,-8266,,
3410084790,11291442368,3316153081,11291434102,-8266,,
3410102783,11291460361,3316171074,11291452095,-8266,11291452136,
3410353088,11291710678,3316421391,11291702423,-8255,,
3410603407,11291960987,3316671700,11291952743,-8244,,
3410853599,11292211177,3316921890,11292202944,-8233,,
3411103789,11292461368,3317172080,11292453145,-8223,,
3411354516,11292712105,3317422818,11292703882,-8223,,
3411604836,11292962415,3317673127,11292954191,-8224,,
3411854979,11293212558,3317923270,11293204335,-8223,,
3412105112,11293462691,3318173403,11293454468,-8223,,
3412123133,11293480711,3318191423,11293472488,-8223,11293472504,
3412373426,11293731005,3318441728,11293722797,-8208,,
3412624002,11293981582,3318692294,11293973368,-8214,,
3412874337,11294231915,3318942628,11294223706,-8209,,
3413124914,11294482493,3319193205,11294474287,-8206,,
3413375908,11294733487,3319444210,11294725292,-8195,,
3413626319,11294983898,3319694620,11294975703,-8195,,
3413876838,11295234417,3319945129,11295226212,-8205,,
3414127220,11295484798,3320195510,11295476593,-8205,,
3414145909,11295503488,3320214200,11295495282,-8206,11295495526,
3414396487,11295754065,3320464778,11295745920,-8145,,
3414646973,11296004553,3320715265,11295996469,-8084,,
3414897106,11296254685,3320965397,11296246663,-8022,,
3415147597,11296505176,3321215888,11296497216,-7960,,
3415398004,11296755582,3321466295,11296747622,-7960,,
3415648343,11297005921,3321716644,11296997971,-7950,,
3415898586,11297256165,3321966877,11297248204,-7961,,
3416149056,11297506635,3322217347,11297498674,-7961,,
3416167103,11297524682,3322235394,11297516721,-7961,11297516444,
3416417264,11297774843,3322485555,11297766812,-8031,,
3416667892,11298025471,3322736184,11298017373,-8098,,
3416918222,11298275800,3322986513,11298267633,-8167,,
3417168807,11298526386,3323237098,11298518150,-8236,,
3417419035,11298776613,3323487335,11298768387,-8226,,
3417669325,11299026904,3323737616,11299018668,-8236,,
3417919455,11299277034,3323987746,11299268798,-8236,,
3418170051,11299527630,3324238342,11299519393,-8237,,
3418188044,11299545623,3324256335,11299537386,-8237,11299537383,
3418438676,11299796254,3324506967,11299788016,-8238,,
3418689062,11300046641,3324757353,11300038402,-8239,,
3418939406,11300296984,3325007697,11300288746,-8238,,
3419189848,11300547427,3325258139,11300539188,-8239,,
3419440014,11300797593,3325508306,11300789355,-8238,,
3419690469,11301048048,3325758760,11301039810,-8238,,
3419940628,11301298207,3326008919,11301289969,-8238,,
3420191219,11301548798,3326259510,11301540559,-8239,,
3420209350,11301566928,3326277640,11301558690,-8238,11301558607,
3420459953,11301817532,3326528244,11301809273,-8259,,
3420710620,11302068199,3326778911,11302059920,-8279,,
3420960784,11302318362,3327029075,11302310063,-8299,,
3421211042,11302568621,3327279333,11302560301,-8320,,
3421461654,11302819233,3327529945,11302810914,-8319,,
3421711819,11303069398,3327780110,11303061079,-8319,,
3421962035,11303319613,3328030326,11303311294,-8319,,
3422212602,11303570181,3328280894,11303561862,-8319,,
3422230673,11303588251,3328298964,11303579932,-8319,11303579981,
3422480862,11303838441,3328549153,11303830133,-8308,,
3422731282,11304088861,3328799573,11304080566,-8295,,
3422981882,11304339460,3329050173,11304331179,-8281,,
3423232482,11304590060,3329300773,11304581791,-8269,,
3423482901,11304840479,3329551191,11304832210,-8269,,
3423733407,11305090986,3329801698,11305082717,-8269,,
3423983629,11305341207,3330051920,11305332938,-8269,,
3424234258,11305591837,3330302549,11305583567,-8270,,
3424252356,11305609934,3330320647,11305601665,-8269,11305601721,
3424502625,11305860203,3330570916,11305851948,-8255,,
3424753181,11306110760,3330821472,11306102520,-8240,,
3425003545,11306361134,3331071847,11306352908,-8226,,
3425254125,11306611704,3331322416,11306603493,-8211,,
3425504277,11306861856,3331572568,11306853644,-8212,,
3425754643,11307112221,3331822934,11307104010,-8211,,
3426005019,11307362608,3332073321,11307354397,-8211,,
3426255162,11307612740,3332323453,11307604529,-8211,,
3426273180,11307630758,3332341471,11307622547,-8211,11307622457,
3426523442,11307881021,3332591733,11307872787,-8234,,
3426773948,11308131527,3332842239,11308123271,-8256,,
3427024331,11308381910,3333092633,11308373642,-8268,,
3427275043,11308632622,3333343334,11308624322,-8300,,
3427525158,11308882736,3333593449,11308874447,-8289,,
3427775422,11309133001,3333843713,11309124701,-8300,,
3428025520,11309383099,3334093812,11309374799,-8300,,
3428276486,11309634065,3334344777,11309625764,-8301,,
3428294471,11309652049,3334362762,11309643749,-8300,11309643786,
3428544900,11309902479,3334613191,11309894188,-8291,,
3428795296,11310152875,3334863587,11310144594,-8281,,
3429045422,11310403001,3335113724,11310394739,-8262,,
3429295989,11310653568,3335364290,11310645316,-8252,,
3429546279,11310903857,3335614570,11310895595,-8262,,
3429796700,11311154279,3335864992,11311146027,-8252,,
3430047188,11311404777,3336115490,11311396515,-8262,,
3430297526,11311655104,3336365817,11311646842,-8262,,
3430315578,11311673157,3336383869,11311664895,-8262,11311664977,
3430566086,11311923666,3336634378,11311915425,-8241,,
3430816398,11312173977,3336884689,11312165757,-8220,,
3431066600,11312424178,3337134891,11312415979,-8199,,
3431316770,11312674349,3337385061,11312666171,-8178,,
3431567070,11312924649,3337635361,11312916471,-8178,,
3431817426,11313175005,3337885717,11313166837,-8168,,
3432068236,11313425815,3338136527,11313417637,-8178,,
3432318726,11313676305,3338387017,11313668127,-8178,,
3432336793,11313694372,3338405084,11313686193,-8179,11313686017,
3432587178,11313944757,3338655470,11313936535,-8222,,
3432837516,11314195095,3338905807,11314186828,-8267,,
3433087959,11314445538,3339156250,11314437227,-8311,,
3433338637,11314696227,3339406939,11314687874,-8353,,
3433589046,11314946625,3339657337,11314938272,-8353,,
3433839156,11315196735,3339907447,11315188382,-8353,,
3434090083,11315447661,3340158374,11315439308,-8353,,
3434340426,11315698016,3340408728,11315689663,-8353,,
3434358401,11315715979,3340426692,11315707626,-8353,11315707636,
3434608917,11315966496,3340677209,11315958146,-8350,,
3434859142,11316216721,3340927433,11316208383,-8338,,
3435109483,11316467061,3341177774,11316458716,-8345,,
3435359683,11316717262,3341427975,11316708920,-8342,,
3435610256,11316967835,3341678547,11316959493,-8342,,
3435860663,11317218242,3341928954,11317209900,-8342,,
3436111150,11317468729,3342179441,11317460387,-8342,,
3436361262,11317718851,3342429563,11317710509,-8342,,
3436379292,11317736871,3342447583,11317728528,-8343,11317728542,
3436629662,11317987241,3342697953,11317978913,-8328,,
3436880630,11318238209,3342948921,11318229874,-8335,,
3437130951,11318488530,3343199242,11318480198,-8332,,
3437381788,11318739376,3343450089,11318731050,-8326,,
3437632518,11318990098,3343700810,11318981771,-8327,,
3437882779,11319240357,3343951070,11319232030,-8327,,
3438133096,11319490675,3344201388,11319482348,-8327,,
3438383331,11319740910,3344451622,11319732583,-8327,,
3438401383,11319758961,3344469673,11319750634,-8327,11319750594,
3438651664,11320009242,3344719955,11320000906,-8336,,
3438901796,11320259375,3344970087,11320251029,-8346,,
3439152752,11320510331,3345221043,11320501976,-8355,,
3439402866,11320760445,3345471158,11320752081,-8364,,
3439653327,11321010906,3345721619,11321002542,-8364,,
3439904186,11321261765,3345972477,11321253400,-8365,,
3440154532,11321512111,3346222823,11321503745,-8366,,
3440404992,11321762571,3346473283,11321754206,-8365,,
3440423085,11321780663,3346491375,11321772298,-8365,11321772357,
3440673529,11322031107,3346741820,11322022757,-8350,,
3440924055,11322281633,3346992346,11322273299,-8334,,
3441174337,11322531916,3347242628,11322523596,-8320,,
3441424736,11322782316,3347493029,11322774012,-8304,,
3441675358,11323032937,3347743649,11323024643,-8294,,
3441925961,11323283539,3347994252,11323275235,-8304,,
3442176359,11323533937,3348244650,11323525633,-8304,,
3442426609,11323784189,3348494901,11323775885,-8304,,
3442444624,11323802202,3348512915,11323793898,-8304,11323793964,
3442695609,11324053188,3348763900,11324044900,-8288,,
3442946396,11324303975,3349014687,11324295704,-8271,,
3443196830,11324554408,3349265120,11324546155,-8253,,
3443447032,11324804612,3349515324,11324796376,-8236,,
3443697435,11325055014,3349765726,11325046777,-8237,,
3443948038,11325305617,3350016329,11325297381,-8236,,
3444198437,11325556016,3350266728,11325547779,-8237,,
3444448824,11325806403,3350517116,11325798167,-8236,,
3444466944,11325824522,3350535234,11325816286,-8236,11325816174,
3444717525,11326075104,3350785816,11326066841,-8263,,
3444967720,11326325299,3351036011,11326317008,-8291,,
3445218091,11326575670,3351286382,11326567350,-8320,,
3445468312,11326825891,3351536613,11326817554,-8337,,
3445718991,11327076569,3351787282,11327068223,-8346,,
3445969558,11327327136,3352037858,11327318800,-8336,,
3446220220,11327577798,3352288511,11327569452,-8346,,
3446470369,11327827959,3352538671,11327819613,-8346,,
3446488408,11327845986,3352556698,11327837640,-8346,11327837694,
3446738772,11328096351,3352807064,11328088018,-8333,,
3446989338,11328346916,3353057629,11328338597,-8319,,
3447239476,11328597055,3353307767,11328588750,-8305,,
3447490416,11328847995,3353558707,11328839714,-8281,,
3447740762,11329098341,3353809063,11329090060,-8281,,
3447990996,11329348574,3354059287,11329340283,-8291,,
3448241120,11329598699,3354309411,11329590408,-8291,,
3448491525,11329849104,3354559817,11329840813,-8291,,
3448509593,11329867171,3354577883,11329858880,-8291,11329858855,
3448759959,11330117538,3354828250,11330109239,-8299,,
3449010367,11330367946,3355078658,11330359641,-8305,,
3449260894,11330618473,3355329185,11330610163,-8310,,
3449511060,11330868638,3355579351,11330860323,-8315,,
3449761386,11331118965,3355829677,11331110649,-8316,,
3450011593,11331369172,3356079884,11331360856,-8316,,
3450261770,11331619349,3356330061,11331611034,-8315,,
3450512043,11331869622,3356580334,11331861317,-8305,,
3450530101,11331887680,3356598392,11331879365,-8315,11331879269,
3450780434,11332138013,3356848726,11332129674,-8339,,
3451031232,11332388811,3357099523,11332380448,-8363,,
3451281407,11332638986,3357349698,11332630600,-8386,,
3451532195,11332889773,3357600486,11332881364,-8409,,
3451782316,11333139895,3357850607,11333131486,-8409,,
3452032619,11333390197,3358100909,11333381788,-8409,,
3452282891,11333640471,3358351183,11333632061,-8410,,
3452533927,11333891506,3358602218,11333883097,-8409,,
3452552031,11333909609,3358620322,11333901200,-8409,11333901264,
3452802594,11334160183,3358870896,11334151789,-8394,,
3453052963,11334410542,3359121254,11334402164,-8378,,
3453303373,11334660951,3359371664,11334652591,-8360,,
3453553779,11334911359,3359622071,11334903015,-8344,,
3453804368,11335161966,3359872678,11335153622,-8344,,
3454054727,11335412306,3360123018,11335403962,-8344,,
3454304908,11335662487,3360373199,11335654143,-8344,,
3454555217,11335912796,3360623508,11335904451,-8345,,
3454573334,11335930913,3360641625,11335922569,-8344,11335922520,
3454823640,11336181219,3360891941,11336172873,-8346,,
3455074195,11336431773,3361142486,11336423405,-8368,,
3455324533,11336682112,3361392824,11336673732,-8380,,
3455575091,11336932671,3361643384,11336924280,-8391,,
3455825664,11337183243,3361893966,11337174862,-8381,,
3456075979,11337433558,3362144270,11337425167,-8391,,
3456326761,11337684340,3362395052,11337675949,-8391,,
3456577230,11337934809,3362645521,11337926428,-8381,,
3456595466,11337953045,3362663757,11337944654,-8391,11337944708,
3456845917,11338203496,3362914209,11338195128,-8368,,
3457096087,11338453666,3363164379,11338445302,-8364,,
3457346206,11338703785,3363414497,11338695436,-8349,,
3457596741,11338954320,3363665033,11338945986,-8334,,
3457847229,11339204807,3363915520,11339196472,-8335,,
3458097913,11339455492,3364166205,11339447157,-8335,,
3458348564,11339706143,3364416855,11339697808,-8335,,
3458599275,11339956854,3364667577,11339948529,-8325,,
3458617664,11339975242,3364685955,11339966907,-8335,11339966865,
3458868631,11340226209,3364936922,11340217863,-8346,,
3459119173,11340476752,3365187464,11340468395,-8357,,
3459369776,11340727354,3365438067,11340718987,-8367,,
3459619962,11340977541,3365688253,11340969165,-8376,,
3459870428,11341228007,3365938720,11341219631,-8376,,
3460120565,11341478143,3366188856,11341469767,-8376,,
3460371001,11341728580,3366439292,11341720203,-8377,,
3460621477,11341979057,3366689770,11341970681,-8376,,
3460639506,11341997084,3366707796,11341988708,-8376,11341988706,
3460890085,11342247664,3366958376,11342239287,-8377,,
3461140655,11342498233,3367208946,11342489857,-8376,,
3461390814,11342748393,3367459105,11342740017,-8376,,
3461641644,11342999223,3367709935,11342990857,-8366,,
3461891998,11343249577,3367960289,11343241201,-8376,,
3462142549,11343500127,3368210840,11343491751,-8376,,
3462393145,11343750724,3368461447,11343742358,-8366,,
3462643787,11344001366,3368712079,11343992991,-8375,,
3462661762,11344019341,3368730053,11344010964,-8377,11344010959,
3462912130,11344269708,3368980420,11344261330,-8378,,
3463163065,11344520644,3369231356,11344512264,-8380,,
3463413563,11344771142,3369481854,11344762763,-8379,,
3463663720,11345021299,3369732012,11345012919,-8380,,
3463914196,11345271775,3369982487,11345263395,-8380,,
3464164379,11345521958,3370232670,11345513578,-8380,,
3464414484,11345772063,3370482776,11345763683,-8380,,
3464665058,11346022637,3370733350,11346014257,-8380,,
3464683113,11346040692,3370751404,11346032311,-8381,11346032286,
3464933405,11346290984,3371001696,11346282597,-8387,,
3465183856,11346541434,3371252147,11346533041,-8393,,
3465434032,11346791611,3371502323,11346783212,-8399,,
3465684522,11347042101,3371752823,11347033706,-8395,,
3465934880,11347292458,3372003171,11347284054,-8404,,
3466185679,11347543258,3372253970,11347534863,-8395,,
3466435867,11347793446,3372504169,11347785052,-8394,,
3466686110,11348043690,3372754402,11348035286,-8404,,
3466704218,11348061797,3372772509,11348053392,-8405,11348053405,
3466954678,11348312257,3373022969,11348303854,-8403,,
3467204787,11348562377,3373273089,11348553979,-8398,,
3467455101,11348812680,3373523392,11348804286,-8394,,
3467705581,11349063171,3373773883,11349054781,-8390,,
3467955959,11349313538,3374024250,11349305148,-8390,,
3468206138,11349563716,3374274429,11349555326,-8390,,
3468456414,11349813993,3374524705,11349805603,-8390,,
3468706813,11350064392,3374775104,11350056001,-8391,,
3468724797,11350082376,3374793088,11350073985,-8391,11350073953,
3468974940,11350332518,3375043231,11350324130,-8388,,
3469225215,11350582793,3375293506,11350574387,-8406,,
3469475607,11350833186,3375543898,11350824773,-8413,,
3469725743,11351083322,3375794045,11351074911,-8411,,
3469976168,11351333746,3376044459,11351325325,-8421,,
3470226352,11351583931,3376294643,11351575509,-8422,,
3470476817,11351834395,3376545107,11351825974,-8421,,
3470727169,11352084758,3376795471,11352076337,-8421,,
3470745165,11352102744,3376813456,11352094322,-8422,11352094286,
3470995869,11352353447,3377064159,11352345017,-8430,,
3471246288,11352603866,3377314579,11352595427,-8439,,
3471496471,11352854050,3377564762,11352845601,-8449,,
3471746721,11353104300,3377815022,11353095854,-8446,,
3471997183,11353354762,3378065474,11353346305,-8457,,
3472247758,11353605337,3378316049,11353596881,-8456,,
3472497977,11353855556,3378566268,11353847099,-8457,,
3472748267,11354105846,3378816559,11354097390,-8456,,
3472766298,11354123876,3378834589,11354115420,-8456,11354115470,
3473016984,11354374562,3379085275,11354366118,-8444,,
3473267570,11354625148,3379335861,11354616717,-8431,,
3473517755,11354875334,3379586046,11354866926,-8408,,
3473768075,11355125654,3379836366,11355117259,-8395,,
3474018278,11355375856,3380086569,11355367462,-8394,,
3474268553,11355626132,3380336844,11355617727,-8405,,
3474518709,11355876287,3380587000,11355867882,-8405,,
3474769576,11356127165,3380837877,11356118760,-8405,,
3474787775,11356145353,3380856065,11356136947,-8406,11356136938,
3475037929,11356395508,3381106220,11356387100,-8408,,
3475288215,11356645793,3381356506,11356637384,-8409,,
3475538908,11356896487,3381607200,11356888076,-8411,,
3475789216,11357146795,3381857508,11357138382,-8413,,
3476039672,11357397251,3382107963,11357388837,-8414,,
3476290114,11357647693,3382358406,11357639280,-8413,,
3476540804,11357898383,3382609106,11357889980,-8403,,
3476791622,11358149201,3382859914,11358140788,-8413,,
3476809583,11358167161,3382877873,11358158748,-8413,11358158747,
3477060146,11358417725,3383128437,11358409312,-8413,,
3477310511,11358668089,3383378802,11358659676,-8413,,
3477560932,11358918511,3383629223,11358910109,-8402,,
3477811386,11359168965,3383879687,11359160562,-8403,,
3478061571,11359419150,3384129862,11359410737,-8413,,
3478311737,11359669316,3384380028,11359660904,-8412,,
3478562307,11359919886,3384630608,11359911484,-8402,,
3478813062,11360170641,3384881363,11360162239,-8402,,
3478831226,11360188805,3384899517,11360180392,-8413,11360180383,
3479081673,11360439251,3385149964,11360430836,-8415,,
3479332615,11360690194,3385400906,11360681777,-8417,,
3479583084,11360940662,3385651375,11360932243,-8419,,
3479833682,11361191261,3385901974,11361182841,-8420,,
3480084692,11361442271,3386152983,11361433851,-8420,,
3480334866,11361692445,3386403157,11361684035,-8410,,
3480585291,11361942870,3386653583,11361934451,-8419,,
3480835648,11362193227,3386903939,11362184807,-8420,,
3480853626,11362211204,3386921917,11362202784,-8420,11362202838,
3481103913,11362461492,3387172204,11362453086,-8406,,
3481354146,11362711725,3387422438,11362703333,-8392,,
3481604471,11362962050,3387672762,11362953672,-8378,,
3481854696,11363212275,3387922988,11363203911,-8364,,
3482105015,11363462593,3388173306,11363454229,-8364,,
3482355217,11363712796,3388423508,11363704432,-8364,,
3482605821,11363963400,3388674113,11363955036,-8364,,
3482856398,11364213977,3388924689,11364205613,-8364,,
3482874394,11364231973,3388942685,11364223609,-8364,11364223526,
3483124864,11364482443,3389193155,11364474057,-8386,,
3483375159,11364732738,3389443451,11364724333,-8405,,
3483625574,11364983154,3389693866,11364974728,-8426,,
3483875712,11365233301,3389944013,11365224856,-8445,,
3484126150,11365483729,3390194441,11365475284,-8445,,
3484376272,11365733850,3390444562,11365725405,-8445,,
3484627157,11365984735,3390695448,11365976290,-8445,,
3484877651,11366235240,3390945952,11366226795,-8445,,
3484895639,11366253217,3390963930,11366244772,-8445,11366244746,
3485146201,11366503780,3391214492,11366495328,-8452,,
3485396649,11366754228,3391464940,11366745770,-8458,,
3485647057,11367004637,3391715349,11366996173,-8464,,
3485897291,11367254870,3391965582,11367246410,-8460,,
3486147905,11367505483,3392216196,11367497013,-8470,,
3486398526,11367756105,3392466818,11367747635,-8470,,
3486648791,11368006369,3392717082,11367997899,-8470,,
3486898952,11368256532,3392967244,11368248062,-8470,,
3486916915,11368274494,3392985206,11368266024,-8470,11368265969,
3487167231,11368524810,3393235522,11368516327,-8483,,
3487417867,11368775446,3393486158,11368766948,-8498,,
3487667976,11369025555,3393736268,11369017045,-8510,,
3487918700,11369276279,3393986992,11369267756,-8523,,
3488169062,11369526640,3394237352,11369518117,-8523,,
3488419255,11369776833,3394487546,11369768310,-8523,,
3488669668,11370027247,3394737959,11370018723,-8524,,
3488920322,11370277901,3394988614,11370269378,-8523,,
3488938416,11370295995,3395006707,11370287471,-8524,11370287514,
3489188682,11370546261,3395256973,11370537749,-8512,,
3489439239,11370796817,3395507530,11370788316,-8501,,
3489690141,11371047720,3395758433,11371039230,-8490,,
3489940503,11371298082,3396008795,11371289603,-8479,,
3490191130,11371548709,3396259421,11371540229,-8480,,
3490441327,11371798905,3396509618,11371790426,-8479,,
3490691432,11372049011,3396759723,11372040531,-8480,,
3490941553,11372299132,3397009844,11372290653,-8479,,
3490959573,11372317151,3397027863,11372308672,-8479,11372308694,
3491209669,11372567247,3397277960,11372558774,-8473,,
3491460277,11372817855,3397528568,11372809388,-8467,,
3491710549,11373068129,3397778841,11373059668,-8461,,
3491960733,11373318313,3398029025,11373309858,-8455,,
3492211403,11373568982,3398279694,11373560526,-8456,,
3492461557,11373819136,3398529848,11373810680,-8456,,
3492711673,11374069251,3398779964,11374060796,-8455,,
3492962251,11374319831,3399030543,11374311376,-8455,,
3492980265,11374337844,3399048556,11374329388,-8456,11374329366,
3493230613,11374588192,3399298904,11374579731,-8461,,
3493481020,11374838598,3399549311,11374830132,-8466,,
3493731340,11375088919,3399799631,11375080447,-8472,,
3493981486,11375339065,3400049777,11375330588,-8477,,
3494232156,11375589735,3400300447,11375581259,-8476,,
3494482676,11375840255,3400550967,11375831778,-8477,,
3494733159,11376090738,3400801450,11376082261,-8477,,
3494983543,11376341122,3401051834,11376332646,-8476,,
3495001682,11376359261,3401069973,11376350785,-8476,11376350769,
3495251913,11376609491,3401320204,11376601012,-8479,,
3495502010,11376859589,3401570302,11376851106,-8483,,
3495752854,11377110433,3401821146,11377101947,-8486,,
3496003469,11377361048,3402071761,11377352558,-8490,,
3496253687,11377611266,3402321978,11377602776,-8490,,
3496503832,11377861411,3402572123,11377852920,-8491,,
3496754069,11378111647,3402822359,11378103157,-8490,,
3497004266,11378361845,3403072558,11378353355,-8490,,
3497022222,11378379800,3403090512,11378371310,-8490,11378371342,
3497272452,11378630031,3403340743,11378621550,-8481,,
3497522745,11378880324,3403591036,11378871851,-8473,,
3497773071,11379130650,3403841362,11379122186,-8464,,
3498023668,11379381247,3404091959,11379372791,-8456,,
3498274011,11379631590,3404342303,11379623134,-8456,,
3498524446,11379882024,3404592737,11379873568,-8456,,
3498774853,11380132431,3404843144,11380123975,-8456,,
3499025556,11380383135,3405093847,11380374679,-8456,,
3499043648,11380401227,3405111939,11380392770,-8457,11380392809,
3499293908,11380651487,3405362199,11380643039,-8448,,
3499544144,11380901722,3405612435,11380893285,-8437,,
3499795000,11381152579,3405863291,11381144152,-8427,,
3500045678,11381403256,3406113969,11381394851,-8405,,
3500295863,11381653442,3406364154,11381645025,-8417,,
3500546321,11381903900,3406614613,11381895484,-8416,,
3500796913,11382154492,3406865204,11382146076,-8416,,
3501047134,11382404712,3407115425,11382396296,-8416,,
3501065086,11382422664,3407133377,11382414248,-8416,11382414162,
3501315747,11382673325,3407384038,11382664887,-8438,,
3501566011,11382923590,3407634302,11382915131,-8459,,
3501816887,11383174465,3407885178,11383165985,-8480,,
3502067147,11383424725,3408135449,11383416235,-8490,,
3502318009,11383675587,3408386300,11383667086,-8501,,
3502568912,11383926491,3408637203,11383917990,-8501,,
3502819269,11384176848,3408887560,11384168346,-8502,,
3503069514,11384427093,3409137805,11384418602,-8491,,
3503087569,11384445147,3409155860,11384436646,-8501,11384436685,
3503337688,11384695267,3409405979,11384686785,-8482,,
3503588293,11384945872,3409656584,11384937391,-8481,,
3503838828,11385196407,3409907119,11385187935,-8472,,
3504089240,11385446819,3410157531,11385438358,-8461,,
3504339466,11385697044,3410407767,11385688593,-8451,,
3504590368,11385947947,3410658659,11385939486,-8461,,
3504840489,11386198068,3410908780,11386189606,-8462,,
3505090819,11386448398,3411159120,11386439946,-8452,,
3505108847,11386466426,3411177138,11386457964,-8462,11386457918,
3505359473,11386717052,3411427764,11386708589,-8463,,
3505609633,11386967213,3411677925,11386958729,-8484,,
3505860022,11387217602,3411928314,11387209107,-8495,,
3506110412,11387467990,3412178702,11387459494,-8496,,
3506360779,11387718368,3412429080,11387709862,-8506,,
3506610899,11387968477,3412679189,11387959971,-8506,,
3506861478,11388219057,3412929770,11388210551,-8506,,
3507112231,11388469810,3413180522,11388461314,-8496,,
3507130253,11388487832,3413198544,11388479325,-8507,11388479350,
3507380655,11388738233,3413448946,11388729733,-8500,,
3507630971,11388988550,3413699262,11388980057,-8493,,
3507881140,11389238719,3413949431,11389230243,-8476,,
3508131680,11389489258,3414199971,11389480778,-8480,,
3508381878,11389739457,3414450170,11389730977,-8480,,
3508632133,11389989711,3414700424,11389981231,-8480,,
3508882254,11390239833,3414950546,11390231353,-8480,,
3509132672,11390490261,3415200973,11390481781,-8480,,
3509150787,11390508365,3415219078,11390499885,-8480,11390499894,
3509401408,11390758997,3415469710,11390750519,-8478,,
3509651633,11391009213,3415719926,11391000738,-8475,,
3509902706,11391260284,3415971007,11391251822,-8462,,
3510153259,11391510848,3416221560,11391502378,-8470,,
3510403752,11391761331,3416472043,11391752861,-8470,,
3510654158,11392011737,3416722449,11392003267,-8470,,
3510904419,11392262008,3416972721,11392253538,-8470,,
3511154561,11392512140,3417222853,11392503670,-8470,,
3511172627,11392530205,3417240917,11392521734,-8471,11392521717,
3511423213,11392780791,3417491504,11392772317,-8474,,
3511673567,11393031146,3417741859,11393022669,-8477,,
3511923822,11393281401,3417992114,11393272919,-8482,,
3512174552,11393532131,3418242843,11393523645,-8486,,
3512425437,11393783016,3418493728,11393774529,-8487,,
3512675953,11394033532,3418744244,11394025046,-8486,,
3512926116,11394283695,3418994408,11394275209,-8486,,
3513177029,11394534609,3419245321,11394526123,-8486,,
3513195201,11394552779,3419263491,11394544293,-8486,11394544228,
3513445336,11394802915,3419513627,11394794413,-8502,,
3513695502,11395053081,3419763793,11395044564,-8517,,
3513946140,11395303719,3420014431,11395295186,-8533,,
3514196496,11395554074,3420264787,11395545525,-8549,,
3514446659,11395804237,3420514950,11395795688,-8549,,
3514697151,11396054730,3420765443,11396046182,-8548,,
3514947773,11396305351,3421016064,11396296802,-8549,,
3515197928,11396555507,3421266219,11396546958,-8549,,
3515215967,11396573546,3421284258,11396564997,-8549,11396565055,
3515466337,11396823916,3421534629,11396815382,-8534,,
3515717000,11397074578,3421785290,11397066059,-8519,,
3515967125,11397324704,3422035416,11397316199,-8505,,
3516217445,11397575023,3422285736,11397566544,-8479,,
3516467765,11397825344,3422536057,11397816855,-8489,,
3516718268,11398075847,3422786560,11398067358,-8489,,
3516968787,11398326365,3423037078,11398317876,-8489,,
3517219559,11398577137,3423287850,11398568648,-8489,,
3517237697,11398595275,3423305988,11398586786,-8489,11398586731,
3517487863,11398845442,3423556154,11398836938,-8504,,
3517737983,11399095563,3423806275,11399087046,-8517,,
3517988208,11399345787,3424056500,11399337257,-8530,,
3518238375,11399595953,3424306665,11399587410,-8543,,
3518488743,11399846321,3424557034,11399837778,-8543,,
3518738892,11400096471,3424807184,11400087928,-8543,,
3518989242,11400346821,3425057533,11400338278,-8543,,
3519239641,11400597219,3425307932,11400588676,-8543,,
3519257721,11400615299,3425326012,11400606756,-8543,11400606777,
3519508030,11400865608,3425576321,11400857070,-8538,,
3519758214,11401115793,3425826505,11401107271,-8522,,
3520008372,11401365950,3426076663,11401357424,-8526,,
3520258869,11401616448,3426327160,11401607926,-8522,,
3520509213,11401866792,3426577504,11401858270,-8522,,
3520759726,11402117306,3426828018,11402108785,-8521,,
3521009860,11402367438,3427078151,11402358928,-8510,,
3521260025,11402617603,3427328315,11402609082,-8521,,
3521278227,11402635806,3427346518,11402627284,-8522,11402627198,
3521528388,11402885967,3427596679,11402877423,-8544,,
3521778692,11403136271,3427846983,11403127706,-8565,,
3522028791,11403386370,3428097082,11403377784,-8586,,
3522279185,11403636764,3428347476,11403628158,-8606,,
3522529359,11403886937,3428597650,11403878331,-8606,,
3522779834,11404137412,3428848125,11404128806,-8606,,
3523030011,11404387590,3429098302,11404378983,-8607,,
3523280634,11404638213,3429348925,11404629617,-8596,,
3523298808,11404656387,3429367099,11404647780,-8607,11404647890,
3523549345,11404906924,3429617636,11404898345,-8579,,
3523799457,11405157036,3429867749,11405148485,-8551,,
3524049596,11405407175,3430117887,11405398652,-8523,,
3524299936,11405657515,3430368239,11405649031,-8484,,
3524550338,11405907917,3430618629,11405899421,-8496,,
3524801096,11406158675,3430869387,11406150180,-8495,,
3525051352,11406408930,3431119643,11406400435,-8495,,
3525301842,11406659430,3431370143,11406650935,-8495,,
3525319949,11406677528,3431388240,11406669032,-8496,11406669000,
3525570529,11406928108,3431638820,11406919605,-8503,,
3525821260,11407178838,3431889551,11407170327,-8511,,
3526071815,11407429394,3432140117,11407420887,-8507,,
3526322179,11407679758,3432390470,11407671241,-8517,,
3526572314,11407929892,3432640605,11407921366,-8526,,
3526822688,11408180267,3432890979,11408171741,-8526,,
3527073120,11408430699,3433141411,11408422173,-8526,,
3527323702,11408681281,3433391993,11408672755,-8526,,
3527341837,11408699415,3433410127,11408690889,-8526,11408690851,
3527592499,11408950078,3433660790,11408941543,-8535,,
3527842973,11409200552,3433911264,11409192008,-8544,,
3528093495,11409451073,3434161786,11409442520,-8553,,
3528343880,11409701469,3434412182,11409692907,-8562,,
3528594209,11409951787,3434662500,11409943225,-8562,,
3528844590,11410202168,3434912881,11410193606,-8562,,
3529094944,11410452523,3435163246,11410443971,-8552,,
3529345244,11410702823,3435413535,11410694271,-8552,,
3529363679,11410721258,3435431970,11410712696,-8562,11410712790,
3529614030,11410971609,3435682321,11410963072,-8537,,
3529864577,11411222156,3435932868,11411213643,-8513,,
3530115204,11411472782,3436183495,11411464303,-8479,,
3530365369,11411722947,3436433670,11411714491,-8456,,
3530615878,11411973457,3436684169,11411965001,-8456,,
3530865992,11412223571,3436934283,11412215104,-8467,,
3531116079,11412473658,3437184371,11412465192,-8466,,
3531366572,11412724161,3437434874,11412715695,-8466,,
3531384720,11412742298,3437453010,11412733832,-8466,11412733728,
3531634912,11412992490,3437703203,11412983998,-8492,,
3531885386,11413242965,3437953677,11413234448,-8517,,
3532136095,11413493673,3438204386,11413485130,-8543,,
3532386228,11413743806,3438454519,11413735238,-8568,,
3532637034,11413994613,3438705326,11413986045,-8568,,
3532887172,11414244751,3438955464,11414236183,-8568,,
3533137763,11414495342,3439206064,11414486784,-8558,,
3533388352,11414745931,3439456644,11414737363,-8568,,
3533406333,11414763912,3439474624,11414755343,-8569,11414755342,
3533656448,11415014026,3439724739,11415005458,-8568,,
3533906553,11415264131,3439974844,11415255563,-8568,,
3534157366,11415514944,3440225657,11415506376,-8568,,
3534407488,11415765066,3440475779,11415756498,-8568,,
3534657654,11416015233,3440725946,11416006665,-8568,,
3534907808,11416265387,3440976099,11416256818,-8569,,
3535158205,11416515784,3441226496,11416507216,-8568,,
3535408394,11416765973,3441476686,11416757405,-8568,,
3535426219,11416783797,3441494510,11416775229,-8568,11416775263,
3535676564,11417034142,3441744855,11417025583,-8559,,
3535927116,11417284695,3441995407,11417276145,-8550,,
3536177602,11417535180,3442245893,11417526639,-8541,,
3536428135,11417785713,3442496426,11417777181,-8532,,
3536678422,11418036001,3442746713,11418027469,-8532,,
3536928990,11418286569,3442997281,11418278036,-8533,,
3537179978,11418537557,3443248269,11418529024,-8533,,
3537430214,11418787792,3443498505,11418779260,-8532,,
3537448235,11418805814,3443516526,11418797282,-8532,11418797210,
3537698808,11419056387,3443767100,11419047838,-8549,,
3537949173,11419306752,3444017465,11419298185,-8567,,
3538199813,11419557392,3444268104,11419548807,-8585,,
3538450436,11419808014,3444518737,11419799422,-8592,,
3538700662,11420058241,3444768953,11420049638,-8603,,
3538950889,11420308468,3445019180,11420299876,-8592,,
3539201756,11420559335,3445270047,11420550733,-8602,,
3539452342,11420809921,3445520634,11420801319,-8602,,
3539470260,11420827838,3445538551,11420819236,-8602,11420819284,
3539720932,11421078511,3445789224,11421069920,-8591,,
3539971472,11421329051,3446039764,11421320473,-8578,,
3540222234,11421579812,3446290525,11421571247,-8565,,
3540472370,11421829959,3446540672,11421821406,-8553,,
3540722650,11422080229,3446790941,11422071676,-8553,,
3540972981,11422330561,3447041273,11422322007,-8554,,
3541223092,11422580671,3447291383,11422572117,-8554,,
3541473252,11422830831,3447541544,11422822278,-8553,,
3541491308,11422848886,3447559598,11422840333,-8553,11422840301,
3541741435,11423099015,3447809727,11423090454,-8561,,
3541992026,11423349605,3448060317,11423341035,-8570,,
3542242469,11423600047,3448310760,11423591471,-8576,,
3542492671,11423850260,3448560972,11423841676,-8584,,
3542742934,11424100513,3448811226,11424091929,-8584,,
3542993756,11424351335,3449062047,11424342751,-8584,,
3543244268,11424601846,3449312559,11424593262,-8584,,
3543495001,11424852590,3449563303,11424844007,-8583,,
3543512958,11424870537,3449581249,11424861952,-8585,11424861901,
3543763426,11425121005,3449831717,11425112408,-8597,,
3544013586,11425371165,3450081877,11425362556,-8609,,
3544263740,11425621318,3450332031,11425612696,-8622,,
3544513931,11425871510,3450582222,11425862876,-8634,,
3544764442,11426122021,3450832733,11426113387,-8634,,
3545014612,11426372191,3451082903,11426363556,-8635,,
3545265461,11426623040,3451333752,11426614406,-8634,,
3545515578,11426873157,3451583870,11426864523,-8634,,
3545533572,11426891151,3451601863,11426882516,-8635,11426882525,
3545784169,11427141748,3451852460,11427133117,-8631,,
3546034469,11427392047,3452102760,11427383418,-8629,,
3546284659,11427642237,3452352950,11427633611,-8626,,
3546535186,11427892764,3452603477,11427884141,-8623,,
3546785381,11428142960,3452853673,11428134336,-8624,,
3547035517,11428393095,3453103808,11428384471,-8624,,
3547285711,11428643289,3453354012,11428634675,-8614,,
3547536115,11428893694,3453604406,11428885069,-8625,,
3547554152,11428911731,3453622443,11428903107,-8624,11428903168,
3547804540,11429162118,3453872831,11429153509,-8609,,
3548054790,11429412368,3454123081,11429403775,-8593,,
3548305001,11429662580,3454373303,11429654014,-8566,,
3548555194,11429912773,3454623485,11429904211,-8562,,
3548805434,11430163013,3454873725,11430154451,-8562,,
3549055662,11430413240,3455123953,11430404679,-8561,,
3549305854,11430663432,3455374145,11430654871,-8561,,
3549556794,11430914372,3455625085,11430905811,-8561,,
3549574800,11430932378,3455643091,11430923817,-8561,11430923819,
3549825176,11431182755,3455893467,11431174204,-8551,,
3550075931,11431433510,3456144222,11431424949,-8561,,
3550326151,11431683729,3456394452,11431675180,-8549,,
3550576371,11431933949,3456644662,11431925391,-8558,,
3550826692,11432184271,3456894983,11432175713,-8558,,
3551076849,11432434428,3457145140,11432425870,-8558,,
3551327079,11432684658,3457395370,11432676099,-8559,,
3551577413,11432934992,3457645704,11432926433,-8559,,
3551595855,11432953433,3457664146,11432944875,-8558,11432944622,
3551846185,11433203764,3457914486,11433195152,-8612,,
3552096654,11433454233,3458164945,11433445549,-8684,,
3552347270,11433704849,3458415561,11433696101,-8748,,
3552597804,11433955382,3458666095,11433946572,-8810,,
3552848216,11434205794,3458916507,11434196984,-8810,,
3553098564,11434456143,3459166855,11434447332,-8811,,
3553348884,11434706463,3459417176,11434697654,-8809,,
3553599144,11434956723,3459667435,11434947923,-8800,,
3553617252,11434974831,3459685543,11434966020,-8811,11434966179,
3553867570,11435225149,3459935861,11435216379,-8770,,
3554118029,11435475608,3460186320,11435466878,-8730,,
3554368480,11435726058,3460436771,11435717368,-8690,,
3554618688,11435976267,3460686979,11435967617,-8650,,
3554868889,11436226468,3460937181,11436217818,-8650,,
3555119189,11436476768,3461187481,11436468118,-8650,,
3555369654,11436727232,3461437945,11436718582,-8650,,
3555620598,11436978177,3461688889,11436969526,-8651,,
3555638615,11436996193,3461706906,11436987543,-8650,11436987569,
3555889152,11437246740,3461957453,11437238096,-8644,,
3556139291,11437496870,3462207582,11437488233,-8637,,
3556390133,11437747722,3462458434,11437739092,-8630,,
3556640497,11437998075,3462708788,11437989452,-8623,,
3556890937,11438248516,3462959228,11438239892,-8624,,
3557141164,11438498742,3463209455,11438490119,-8623,,
3557391711,11438749290,3463460002,11438740667,-8623,,
3557642089,11438999667,3463710380,11438991044,-8623,,
3557660092,11439017670,3463728383,11439009047,-8623,11439009045,
3557910329,11439267909,3463978621,11439259284,-8625,,
3558160929,11439518508,3464229220,11439509884,-8624,,
3558411692,11439769281,3464479994,11439760657,-8624,,
3558662172,11440019750,3464730462,11440011126,-8624,,
3558912601,11440270189,3464980902,11440261565,-8624,,
3559162939,11440520518,3465231230,11440511893,-8625,,
3559413552,11440771141,3465481854,11440762517,-8624,,
3559664193,11441021772,3465732484,11441013148,-8624,,
3559682215,11441039793,3465750506,11441031169,-8624,11441031133,
3559932506,11441290095,3466000808,11441281462,-8633,,
3560182646,11441540225,3466250937,11441531583,-8642,,
3560433031,11441790610,3466501323,11441781960,-8650,,
3560683641,11442041220,3466751933,11442032561,-8659,,
3560934039,11442291618,3467002330,11442282959,-8659,,
3561184412,11442541991,3467252704,11442533332,-8659,,
3561434753,11442792332,3467503044,11442783673,-8659,,
3561684858,11443042436,3467753149,11443033777,-8659,,
3561702890,11443060469,3467771181,11443051809,-8660,11443051808,
3561953468,11443311046,3468021759,11443302387,-8659,,
3562204327,11443561906,3468272619,11443553247,-8659,,
3562454841,11443812420,3468523132,11443803761,-8659,,
3562705619,11444063198,3468773911,11444054539,-8659,,
3562955832,11444313412,3469024124,11444304753,-8659,,
3563206440,11444564019,3469274731,11444555370,-8649,,
3563456642,11444814221,3469524944,11444805572,-8649,,
3563707386,11445064965,3469775677,11445056306,-8659,,
3563725415,11445082994,3469793706,11445074335,-8659,11445074321,
3563975694,11445333273,3470043985,11445324611,-8662,,
3564225847,11445583435,3470294148,11445574770,-8665,,
3564476454,11445834043,3470544755,11445825375,-8668,,
3564727025,11446084604,3470795317,11446075933,-8671,,
3564977627,11446335216,3471045928,11446326544,-8672,,
3565227899,11446585478,3471296191,11446576807,-8671,,
3565478062,11446835641,3471546353,11446826970,-8671,,
3565728385,11447085964,3471796676,11447077292,-8672,,
3565746347,11447103925,3471814638,11447095254,-8671,11447095239,
3565996775,11447354355,3472065067,11447345681,-8674,,
3566247520,11447605100,3472315812,11447596423,-8677,,
3566497693,11447855272,3472565985,11447846592,-8680,,
3566748268,11448105848,3472816560,11448097164,-8684,,
3566998870,11448356450,3473067162,11448347766,-8684,,
3567249526,11448607105,3473317818,11448598422,-8683,,
3567499664,11448857243,3473567955,11448848559,-8684,,
3567750092,11449107670,3473818383,11449098986,-8684,,
3567768735,11449126313,3473837026,11449117629,-8684,11449117944,
3568018946,11449376524,3474087237,11449367919,-8605,,
3568269156,11449626746,3474337458,11449618220,-8526,,
3568519715,11449877294,3474588006,11449868847,-8447,,
3568770185,11450127764,3474838476,11450119396,-8368,,
3569020519,11450378097,3475088810,11450369739,-8358,,
3569270713,11450628292,3475339004,11450619923,-8369,,
3569521332,11450878911,3475589624,11450870543,-8368,,
3569771580,11451129158,3475839871,11451120790,-8368,,
3569789941,11451147519,3475858232,11451139151,-8368,11451138641,
3570040099,11451397677,3476108389,11451389182,-8495,,
3570290940,11451648519,3476359241,11451639906,-8613,,
3570541118,11451898696,3476609409,11451889946,-8750,,
3570791890,11452149480,3476860192,11452140604,-8876,,
3571042039,11452399628,3477110340,11452390752,-8876,,
3571292253,11452649843,3477360556,11452640967,-8876,,
3571542651,11452900229,3477610942,11452891353,-8876,,
3571793159,11453150737,3477861450,11453141861,-8876,,
3571811739,11453169318,3477880030,11453160442,-8876,11453160624,
3572061994,11453419573,3478130295,11453410752,-8821,,
3572312332,11453669912,3478380624,11453661127,-8785,,
3572563080,11453920670,3478631382,11453911932,-8738,,
3572813571,11454171149,3478881862,11454162457,-8692,,
3573064342,11454421921,3479132633,11454413228,-8693,,
3573314460,11454672038,3479382761,11454663356,-8682,,
3573564717,11454922296,3479633008,11454913604,-8692,,
3573814834,11455172413,3479883125,11455163730,-8683,,
3573832839,11455190418,3479901130,11455181725,-8693,11455181774,
3574083525,11455441104,3480151816,11455432425,-8679,,
3574333915,11455691494,3480402206,11455682826,-8668,,
3574584447,11455942026,3480652738,11455933371,-8655,,
3574834669,11456192247,3480902960,11456183605,-8642,,
3575084854,11456442432,3481153145,11456433790,-8642,,
3575335142,11456692721,3481403433,11456684079,-8642,,
3575585759,11456943337,3481654050,11456934695,-8642,,
3575835949,11457193528,3481904240,11457184886,-8642,,
3575853900,11457211478,3481922191,11457202836,-8642,11457202796,
3576104325,11457461903,3482172616,11457453250,-8653,,
3576354537,11457712115,3482422828,11457703463,-8652,,
3576604939,11457962529,3482673241,11457953857,-8672,,
3576855258,11458212837,3482923549,11458204155,-8682,,
3577105436,11458463015,3483173727,11458454333,-8682,,
3577355596,11458713175,3483423887,11458704493,-8682,,
3577606135,11458963713,3483674426,11458955032,-8681,,
3577856343,11459213921,3483924633,11459205240,-8681,,
3577874451,11459232029,3483942741,11459223348,-8681,11459223320,
3578124723,11459482302,3484193014,11459473615,-8687,,
3578374867,11459732446,3484443158,11459723762,-8684,,
3578625898,11459983477,3484694190,11459974778,-8699,,
3578876233,11460233812,3484944525,11460225105,-8707,,
3579126399,11460483977,3485194689,11460475270,-8707,,
3579377271,11460734859,3485445572,11460726152,-8707,,
3579627505,11460985084,3485695807,11460976388,-8696,,
3579878110,11461235699,3485946411,11461226992,-8707,,
3579896247,11461253825,3485964538,11461245118,-8707,11461245207,
3580146684,11461504263,3486214975,11461495578,-8685,,
3580397129,11461754708,3486465420,11461746044,-8664,,
3580647309,11462004887,3486715600,11461996247,-8640,,
3580897735,11462255313,3486966026,11462246696,-8617,,
3581148098,11462505676,3487216389,11462497059,-8617,,
3581398280,11462755859,3487466571,11462747242,-8617,,
3581649061,11463006650,3487717363,11462998033,-8617,,
3581899416,11463256994,3487967707,11463248377,-8617,,
3581917560,11463275139,3487985851,11463266522,-8617,11463266401,
3582167921,11463525500,3488236212,11463516851,-8649,,
3582418054,11463775633,3488486345,11463766956,-8677,,
3582668756,11464026335,3488737048,11464017629,-8706,,
3582919310,11464276888,3488987600,11464268152,-8736,,
3583169674,11464527253,3489237966,11464518517,-8736,,
3583419770,11464777349,3489488061,11464768612,-8737,,
3583669963,11465027542,3489738255,11465018806,-8736,,
3583920068,11465277646,3489988358,11465268910,-8736,,
3583938062,11465295640,3490006352,11465286904,-8736,11465286906,
3584189060,11465546638,3490257351,11465537903,-8735,,
3584439553,11465797131,3490507844,11465788397,-8734,,
3584690378,11466047957,3490758670,11466039225,-8732,,
3584940560,11466298139,3491008852,11466289407,-8732,,
3585191130,11466548709,3491259421,11466539977,-8732,,
3585441569,11466799148,3491509860,11466790415,-8733,,
3585692565,11467050154,3491760866,11467041422,-8732,,
3585943030,11467300609,3492011321,11467291877,-8732,,
3585961007,11467318585,3492029298,11467309853,-8732,11467309849,
3586211399,11467568977,3492279690,11467560243,-8734,,
3586461765,11467819344,3492530056,11467810610,-8734,,
3586712816,11468070395,3492781108,11468061660,-8735,,
3586962980,11468320558,3493031271,11468311823,-8735,,
3587213492,11468571071,3493281783,11468562336,-8735,,
3587463878,11468821456,3493532169,11468812721,-8735,,
3587714575,11469072153,3493782865,11469063418,-8735,,
3587965061,11469322640,3494033352,11469313904,-8736,,
3587983063,11469340641,3494051353,11469331906,-8735,11469331955,
3588233181,11469590759,3494301472,11469582036,-8723,,
3588484221,11469841799,3494552512,11469833089,-8710,,
3588734521,11470092100,3494802813,11470083403,-8697,,
3588984705,11470342284,3495052996,11470333600,-8684,,
3589235293,11470592871,3495303584,11470584187,-8684,,
3589485588,11470843166,3495553879,11470834482,-8684,,
3589735704,11471093282,3495804005,11471084608,-8674,,
3589986552,11471344131,3496054843,11471335447,-8684,,
3590004607,11471362186,3496072898,11471353501,-8685,11471353543,
3590254846,11471612425,3496323137,11471603751,-8674,,
3590505167,11471862746,3496573458,11471854083,-8663,,
3590755497,11472113075,3496823799,11472104434,-8641,,
3591005679,11472363258,3497073980,11472354627,-8631,,
3591256116,11472613695,3497324407,11472605053,-8642,,
3591506454,11472864032,3497574745,11472855391,-8641,,
3591756655,11473114235,3497824947,11473105594,-8641,,
3592006814,11473364393,3498075116,11473355763,-8630,,
3592024919,11473382497,3498093210,11473373856,-8641,11473373849,
3592275312,11473632890,3498343603,11473624246,-8644,,
3592525482,11473883061,3498593773,11473874416,-8645,,
3592775669,11474133248,3498843960,11474124602,-8646,,
3593026024,11474383603,3499094315,11474374956,-8647,,
3593276444,11474634023,3499344735,11474625376,-8647,,
3593527036,11474884614,3499595327,11474875967,-8647,,
3593777280,11475134859,3499845572,11475126212,-8647,,
3594027834,11475385424,3500096137,11475376777,-8647,,
3594045930,11475403508,3500114220,11475394861,-8647,11475394811,
3594296140,11475653719,3500364431,11475645058,-8661,,
3594546305,11475903883,3500614595,11475895211,-8672,,
3594797044,11476154623,3500865336,11476145940,-8683,,
3595047816,11476405405,3501116118,11476396710,-8695,,
3595298411,11476655989,3501366702,11476647294,-8695,,
3595548532,11476906110,3501616834,11476897426,-8684,,
3595799161,11477156741,3501867454,11477148046,-8695,,
3596049283,11477406862,3502117574,11477398167,-8695,,
3596067422,11477425001,3502135713,11477416306,-8695,11477416348,
3596317983,11477675562,3502386274,11477666887,-8675,,
3596568590,11477926169,3502636881,11477917496,-8673,,
3596819142,11478176721,3502887434,11478168059,-8662,,
3597069777,11478427356,3503138068,11478418705,-8651,,
3597319876,11478677469,3503388181,11478668818,-8651,,
3597570510,11478928089,3503638802,11478919438,-8651,,
3597820882,11479178461,3503889173,11479169810,-8651,,
3598071576,11479429165,3504139877,11479420514,-8651,,
3598089739,11479447317,3504158029,11479438665,-8652,11479438571,
3598339940,11479697519,3504408231,11479688843,-8676,,
3598590145,11479947734,3504658446,11479939035,-8699,,
3598840453,11480198032,3504908745,11480189311,-8721,,
3599090871,11480448450,3505159173,11480439716,-8734,,
3599341081,11480698660,3505409372,11480689926,-8734,,
3599591247,11480948826,3505659538,11480940081,-8745,,
3599842049,11481199628,3505910341,11481190884,-8744,,
3600093051,11481450630,3506161343,11481441887,-8743,,
3600111137,11481468715,3506179427,11481459971,-8744,11481459946,
3600361738,11481719316,3506430029,11481710566,-8750,,
3600612391,11481969969,3506680682,11481961213,-8756,,
3600863406,11482220985,3506931698,11482212224,-8761,,
3601113901,11482471479,3507182192,11482462712,-8767,,
3601364938,11482722517,3507433229,11482713750,-8767,,
3601615194,11482972772,3507683485,11482964005,-8767,,
3601865385,11483222964,3507933677,11483214197,-8767,,
3602115712,11483473291,3508184003,11483464524,-8767,,
3602133892,11483491471,3508202183,11483482703,-8768,11483482729,
3602384432,11483742011,3508452723,11483733249,-8762,,
3602634920,11483992499,3508703211,11483983755,-8744,,
3602885369,11484242947,3508953660,11484234201,-8746,,
3603135643,11484493221,3509203934,11484484491,-8730,,
3603386141,11484743731,3509454443,11484734991,-8740,,
3603636925,11484994505,3509705217,11484985765,-8740,,
3603887551,11485245130,3509955843,11485236391,-8739,,
3604137927,11485495506,3510206219,11485486766,-8740,,
3604155941,11485513519,3510224231,11485504779,-8740,11485504788,
3604406454,11485764033,3510474746,11485755295,-8738,,
3604656571,11486014150,3510724862,11486005425,-8725,,
3604906758,11486264348,3510975060,11486255616,-8732,,
3605157175,11486514754,3511225467,11486506024,-8730,,
3605407650,11486765229,3511475942,11486756499,-8730,,
3605658088,11487015667,3511726380,11487006937,-8730,,
3605908295,11487265874,3511976587,11487257145,-8729,,
3606158825,11487516404,3512227117,11487507674,-8730,,
3606176947,11487534525,3512245237,11487525794,-8731,11487525786,
3606427061,11487784639,3512495351,11487775906,-8733,,
3606677923,11488035502,3512746215,11488026768,-8734,,
3606928125,11488285704,3512996417,11488276969,-8735,,
3607178572,11488536151,3513246864,11488527414,-8737,,
3607429310,11488786889,3513497602,11488778152,-8737,,
3607679804,11489037383,3513748095,11489028646,-8737,,
3607929987,11489287567,3513998279,11489278830,-8737,,
3608180709,11489538289,3514249002,11489529552,-8737,,
3608198865,11489556443,3514267155,11489547706,-8737,11489547690,
3608449247,11489806826,3514517550,11489798095,-8731,,
3608699675,11490057254,3514767966,11490048509,-8745,,
3608949873,11490307452,3515018164,11490298704,-8748,,
3609200048,11490557627,3515268350,11490548886,-8741,,
3609450277,11490807856,3515518569,11490799106,-8750,,
3609700724,11491058303,3515769016,11491049553,-8750,,
3609951347,11491308926,3516019638,11491300175,-8751,,
3610202224,11491559803,3516270516,11491551052,-8751,,
3610220292,11491577871,3516288583,11491569120,-8751,11491569170,
3610470884,11491828467,3516539180,11491819729,-8738,,
3610721610,11492079189,3516789901,11492070464,-8725,,
3610971812,11492329391,3517040104,11492320679,-8712,,
3611221916,11492579494,3517290207,11492570795,-8699,,
3611472455,11492830034,3517540746,11492821345,-8689,,
3611722833,11493080413,3517791125,11493071714,-8699,,
3611973258,11493330837,3518041549,11493322137,-8700,,
3612223428,11493581006,3518291718,11493572307,-8699,,
3612241491,11493599069,3518309782,11493590370,-8699,11493590300,
3612491706,11493849295,3518560007,11493840578,-8717,,
3612742064,11494099643,3518810356,11494090909,-8734,,
3612992510,11494350089,3519060802,11494341339,-8750,,
3613242914,11494600492,3519311205,11494591724,-8768,,
3613493245,11494850824,3519561537,11494842056,-8768,,
3613743402,11495100980,3519811693,11495092212,-8768,,
3613993564,11495351142,3520061855,11495342374,-8768,,
3614244560,11495602139,3520312851,11495593371,-8768,,
3614262635,11495620213,3520330925,11495611445,-8768,11495611462,
3614513620,11495871198,3520581911,11495862434,-8764,,
3614763900,11496121480,3520832193,11496112721,-8759,,
3615014469,11496372049,3521082761,11496363295,-8754,,
3615264835,11496622414,3521333126,11496613663,-8751,,
3615515429,11496873007,3521583720,11496864257,-8750,,
3615766071,11497123650,3521834362,11497114910,-8740,,
3616016567,11497374146,3522084869,11497365406,-8740,,
3616267090,11497624668,3522335381,11497615918,-8750,,
3616285105,11497642683,3522353396,11497633933,-8750,11497633914,
3616535714,11497893292,3522604005,11497884537,-8755,,
3616786001,11498143580,3522854293,11498134820,-8760,,
3617036433,11498394026,3523104739,11498385262,-8764,,
3617286853,11498644432,3523355144,11498635663,-8769,,
3617537179,11498894758,3523605470,11498885989,-8769,,
3617787367,11499144946,3523855658,11499136188,-8758,,
3618038123,11499395712,3524106425,11499386944,-8768,,
3618288621,11499646200,3524356913,11499637432,-8768,,
3618306741,11499664319,3524375032,11499655551,-8768,11499655539,
3618556972,11499914551,3524625263,11499905780,-8771,,
3618807413,11500164992,3524875705,11500156219,-8773,,
3619057993,11500415572,3525126294,11500406805,-8767,,
3619308588,11500666167,3525376889,11500657398,-8769,,
3619559017,11500916595,3525627308,11500907816,-8779,,
3619809242,11501166821,3525877533,11501158042,-8779,,
3620059497,11501417086,3526127798,11501408307,-8779,,
3620310113,11501667692,3526378404,11501658923,-8769,,
3620328170,11501685748,3526396461,11501676969,-8779,11501677021,
3620578444,11501936023,3526646735,11501927257,-8766,,
3620829183,11502186772,3526897485,11502178020,-8752,,
3621079588,11502437178,3527147890,11502428439,-8739,,
3621329717,11502687296,3527398008,11502678571,-8725,,
3621580686,11502938264,3527648977,11502929539,-8725,,
3621831294,11503188873,3527899585,11503180148,-8725,,
3622081697,11503439285,3528149998,11503430560,-8725,,
3622331977,11503689556,3528400268,11503680830,-8726,,
3622350302,11503707880,3528418592,11503699155,-8725,11503698949,
3622600826,11503958405,3528669117,11503949627,-8778,,
3622851237,11504208816,3528919539,11504199997,-8819,,
3623101845,11504459435,3529170147,11504450555,-8880,,
3623352125,11504709704,3529420417,11504700774,-8930,,
3623602862,11504960440,3529671153,11504951510,-8930,,
3623853101,11505210690,3529921402,11505201760,-8930,,
3624103915,11505461494,3530172206,11505452563,-8931,,
3624354478,11505712057,3530422779,11505703137,-8920,,
3624372708,11505730286,3530440999,11505721356,-8930,11505721529,
3624623196,11505980775,3530691488,11505971888,-8887,,
3624873767,11506231346,3530942059,11506222503,-8843,,
3625124351,11506481930,3531192642,11506473131,-8799,,
3625374463,11506732042,3531442754,11506723286,-8756,,
3625624666,11506982245,3531692957,11506973489,-8756,,
3625874845,11507232424,3531943137,11507223669,-8755,,
3626125403,11507482981,3532193694,11507474225,-8756,,
3626375570,11507733148,3532443860,11507724392,-8756,,
3626393725,11507751303,3532462016,11507742547,-8756,11507742564,
3626643823,11508001402,3532712114,11507992650,-8752,,
3626894475,11508252054,3532962767,11508243307,-8747,,
3627144555,11508502144,3533212856,11508493401,-8743,,
3627394930,11508752508,3533463221,11508743770,-8738,,
3627645501,11509003079,3533713792,11508994341,-8738,,
3627895855,11509253434,3533964146,11509244705,-8729,,
3628145986,11509503565,3534214277,11509494826,-8739,,
3628396508,11509754087,3534464799,11509745348,-8739,,
3628414652,11509772231,3534482943,11509763492,-8739,11509763409,
3628665086,11510022665,3534733377,11510013905,-8760,,
3628915366,11510272944,3534983667,11510264174,-8770,,
3629165588,11510523167,3535233879,11510514367,-8800,,
3629415883,11510773461,3535484174,11510764641,-8820,,
3629666578,11511024156,3535734869,11511015336,-8820,,
3629917368,11511274947,3535985659,11511266127,-8820,,
3630167960,11511525539,3536236252,11511516719,-8820,,
3630418621,11511776200,3536486913,11511767380,-8820,,
3630436847,11511794426,3536505138,11511785605,-8821,11511785618,
3630687442,11512045020,3536755733,11512036202,-8818,,
3630938046,11512295635,3537006347,11512286821,-8814,,
3631188705,11512546284,3537257007,11512537484,-8800,,
3631439160,11512796739,3537507461,11512787942,-8797,,
3631689541,11513047119,3537757831,11513038313,-8806,,
3631939855,11513297434,3538008146,11513288628,-8806,,
3632190445,11513548024,3538258736,11513539217,-8807,,
3632440613,11513798192,3538508915,11513789397,-8795,,
3632458746,11513816324,3538527037,11513807518,-8806,11513807523,
3632709189,11514066769,3538777481,11514057964,-8805,,
3632959725,11514317314,3539028026,11514308511,-8803,,
3633209898,11514567487,3539278200,11514558686,-8801,,
3633460255,11514817834,3539528546,11514809034,-8800,,
3633710362,11515067940,3539778653,11515059141,-8799,,
3633960654,11515318233,3540028945,11515309434,-8799,,
3634211091,11515568670,3540279382,11515559881,-8789,,
3634461413,11515818991,3540529704,11515810192,-8799,,
3634479716,11515837295,3540548007,11515828495,-8800,11515828449,
3634730033,11516087612,3540798325,11516078802,-8810,,
3634980417,11516337996,3541048708,11516329174,-8822,,
3635230722,11516588301,3541299013,11516579468,-8833,,
3635481495,11516839074,3541549786,11516830230,-8844,,
3635731839,11517089418,3541800131,11517080574,-8844,,
3635982233,11517339811,3542050524,11517330967,-8844,,
3636232426,11517590005,3542300718,11517581161,-8844,,
3636483038,11517840617,3542551329,11517831772,-8845,,
3636501153,11517858731,3542569444,11517849887,-8844,11517849895,
3636751507,11518109087,3542819799,11518100245,-8842,,
3637001665,11518359244,3543069957,11518350416,-8828,,
3637252031,11518609620,3543320333,11518600783,-8837,,
3637502156,11518859735,3543570447,11518850900,-8835,,
3637752503,11519110082,3543820794,11519101247,-8835,,
3638002834,11519360413,3544071125,11519351579,-8834,,
3638253862,11519611451,3544322164,11519602617,-8834,,
3638504304,11519861883,3544572595,11519853049,-8834,,
3638522476,11519880055,3544590767,11519871220,-8835,11519871286,
3638773449,11520131029,3544841742,11520122211,-8818,,
3639023782,11520381361,3545092074,11520372560,-8801,,
3639273967,11520631545,3545342258,11520622761,-8784,,
3639524087,11520881666,3545592378,11520872899,-8767,,
3639774406,11521131985,3545842697,11521123218,-8767,,
3640024784,11521382363,3546093075,11521373596,-8767,,
3640275444,11521633033,3546343745,11521624266,-8767,,
3640525648,11521883226,3546593938,11521874459,-8767,,
3640543640,11521901218,3546611931,11521892451,-8767,11521892367,
3640794355,11522151934,3546862647,11522143145,-8789,,
3641044482,11522402061,3547112774,11522393252,-8809,,
3641295119,11522652698,3547363421,11522643878,-8820,,
3641545651,11522903230,3547613942,11522894380,-8850,,
3641796101,11523153680,3547864392,11523144830,-8850,,
3642046449,11523404028,3548114740,11523395178,-8850,,
3642297378,11523654957,3548365669,11523646107,-8850,,
3642547872,11523905451,3548616163,11523896601,-8850,,
3642565956,11523923534,3548634247,11523914684,-8850,11523914692,
3642816255,11524173834,3548884547,11524164986,-8848,,
3643066363,11524423952,3549134665,11524415106,-8846,,
3643316784,11524674362,3549385075,11524665519,-8843,,
3643567318,11524924897,3549635609,11524916055,-8842,,
3643817529,11525175107,3549885819,11525166266,-8841,,
3644068484,11525426073,3550136785,11525417231,-8842,,
3644318649,11525676227,3550386940,11525667386,-8841,,
3644568751,11525926330,3550637042,11525917488,-8842,,
3644586797,11525944375,3550655088,11525935534,-8841,11525935526,
3644837109,11526194688,3550905400,11526185845,-8843,,
3645087273,11526444852,3551155565,11526436007,-8845,,
3645337594,11526695173,3551405885,11526686326,-8847,,
3645587767,11526945346,3551656058,11526936508,-8838,,
3645838701,11527196280,3551906993,11527187432,-8848,,
3646088964,11527446543,3552157255,11527437694,-8849,,
3646339226,11527696804,3552407517,11527687967,-8837,,
3646589363,11527946942,3552657655,11527938094,-8848,,
3646607506,11527965084,3552675796,11527956236,-8848,11527956144,
3646857668,11528215247,3552925959,11528206376,-8871,,
3647108311,11528465890,3553176603,11528456997,-8893,,
3647358867,11528716446,3553427158,11528707531,-8915,,
3647609434,11528967012,3553677735,11528958084,-8928,,
3647860125,11529217715,3553928427,11529208777,-8938,,
3648110783,11529468362,3554179074,11529459424,-8938,,
3648360953,11529718532,3554429244,11529709593,-8939,,
3648611764,11529969353,3554680066,11529960415,-8938,,
3648629811,11529987389,3554698102,11529978451,-8938,11529978570,
3648879984,11530237562,3554948274,11530228654,-8908,,
3649130690,11530488268,3555198991,11530479400,-8868,,
3649381505,11530739083,3555449795,11530730246,-8837,,
3649631823,11530989413,3555700125,11530980595,-8818,,
3649882287,11531239866,3555950578,11531231048,-8818,,
3650133136,11531490715,3556201437,11531481907,-8808,,
3650383544,11531741123,3556451835,11531732305,-8818,,
3650633660,11531991239,3556701952,11531982421,-8818,,
3650651763,11532009342,3556720054,11532000523,-8819,11532000493,
3650902235,11532259814,3556970526,11532250987,-8827,,
3651152357,11532509946,3557220659,11532501113,-8833,,
3651402854,11532760433,3557471145,11532751592,-8841,,
3651653121,11533010710,3557721422,11533001863,-8847,,
3651903324,11533260903,3557971615,11533252056,-8847,,
3652153963,11533511552,3558222264,11533502705,-8847,,
3652404289,11533761868,3558472591,11533753032,-8836,,
3652654811,11534012390,3558723102,11534003553,-8837,,
3652672888,11534030467,3558741179,11534021619,-8848,11534021567,
3652923453,11534281032,3558991744,11534272171,-8861,,
3653173924,11534531514,3559242226,11534522641,-8873,,
3653424363,11534781941,3559492654,11534773055,-8886,,
3653674600,11535032189,3559742901,11535023291,-8898,,
3653925219,11535282798,3559993511,11535273900,-8898,,
3654175388,11535532967,3560243679,11535524069,-8898,,
3654425920,11535783498,3560494211,11535774600,-8898,,
3654676101,11536033689,3560744402,11536024791,-8898,,
3654694276,11536051855,3560762567,11536042956,-8899,11536042998,
3654944887,11536302465,3561013178,11536293588,-8877,,
3655195501,11536553080,3561263793,11536544203,-8877,,
3655446085,11536803664,3561514376,11536794798,-8866,,
3655696902,11537054481,3561765193,11537045625,-8856,,
3655947017,11537304595,3562015308,11537295740,-8855,,
3656197415,11537554994,3562265717,11537546149,-8845,,
3656447832,11537805411,3562516123,11537796556,-8855,,
3656698002,11538055580,3562766293,11538046725,-8855,,
3656716190,11538073768,3562784480,11538064913,-8855,11538064918,
3656966590,11538324169,3563034881,11538315316,-8853,,
3657217008,11538574597,3563285309,11538565745,-8852,,
3657467711,11538825289,3563536002,11538816440,-8849,,
3657718517,11539076096,3563786808,11539067247,-8849,,
3657968699,11539326278,3564036990,11539317429,-8849,,
3658219046,11539576625,3564287348,11539567787,-8838,,
3658469353,11539826931,3564537644,11539818083,-8848,,
3658719561,11540077140,3564787852,11540068292,-8848,,
3658737827,11540095405,3564806118,11540086557,-8848,11540086514,
3658988118,11540345697,3565056409,11540336839,-8858,,
3659238500,11540596089,3565306802,11540587220,-8869,,
3659488986,11540846565,3565557278,11540837686,-8879,,
3659739524,11541097103,3565807816,11541088215,-8888,,
3659990076,11541347665,3566058378,11541338776,-8889,,
3660240270,11541597849,3566308571,11541588970,-8879,,
3660490598,11541848177,3566558889,11541839288,-8889,,
3660740917,11542098496,3566809208,11542089607,-8889,,
3660758980,11542116558,3566827271,11542107669,-8889,11542107638,
3661009260,11542366839,3567077552,11542357942,-8897,,
3661259826,11542617405,3567328128,11542608510,-8895,,
3661510293,11542867882,3567578594,11542858970,-8912,,
3661761147,11543118726,3567829439,11543109807,-8919,,
3662011318,11543368897,3568079609,11543359977,-8920,,
3662262092,11543619671,3568330384,11543610752,-8919,,
3662512696,11543870275,3568580988,11543861367,-8908,,
3662763055,11544120634,3568831346,11544111715,-8919,,
3662781100,11544138679,3568849391,11544129759,-8920,11544129829,
3663031419,11544388998,3569099710,11544380095,-8903,,
3663281527,11544639105,3569349818,11544630221,-8884,,
3663531785,11544889364,3569600076,11544880497,-8867,,
3663782168,11545139748,3569850461,11545130900,-8848,,
3664032923,11545390511,3570101224,11545381663,-8848,,
3664283454,11545641033,3570351746,11545632185,-8848,,
3664534030,11545891608,3570602321,11545882760,-8848,,
3664784213,11546141792,3570852504,11546132944,-8848,,
3664802400,11546159979,3570870691,11546151130,-8849,11546151075,
3665052524,11546410103,3571120815,11546401251,-8852,,
3665303536,11546661115,3571371827,11546652239,-8876,,
3665553832,11546911411,3571622123,11546902522,-8889,,
3665804077,11547161656,3571872368,11547152754,-8902,,
3666054497,11547412076,3572122789,11547403185,-8891,,
3666305462,11547663051,3572373764,11547654149,-8902,,
3666556152,11547913730,3572624442,11547904828,-8902,,
3666806523,11548164103,3572874815,11548155201,-8902,,
3666824615,11548182194,3572892906,11548173291,-8903,11548173239,
3667074791,11548432370,3573143082,11548423455,-8915,,
3667325034,11548682613,3573393326,11548673685,-8928,,
3667575231,11548932810,3573643522,11548923869,-8941,,
3667825806,11549183385,3573894097,11549174431,-8954,,
3668076008,11549433587,3574144299,11549424644,-8943,,
3668326416,11549683995,3574394708,11549675042,-8953,,
3668576741,11549934319,3574645032,11549925366,-8953,,
3668827214,11550184793,3574895506,11550175841,-8952,,
3668845408,11550202986,3574913698,11550194033,-8953,11550194058,
3669095574,11550453152,3575163865,11550444216,-8936,,
3669345986,11550703566,3575414278,11550694625,-8941,,
3669596198,11550953777,3575664490,11550944844,-8933,,
3669846350,11551203929,3575914641,11551195013,-8916,,
3670096932,11551454511,3576165223,11551445584,-8927,,
3670347256,11551704834,3576415547,11551695908,-8926,,
3670597375,11551954954,3576665666,11551946028,-8926,,
3670847627,11552205206,3576915919,11552196280,-8926,,
3670865788,11552223367,3576934079,11552214440,-8927,11552214355,
3671116341,11552473919,3577184632,11552464972,-8947,,
3671366940,11552724519,3577435232,11552715551,-8968,,
3671617173,11552974752,3577685464,11552965762,-8990,,
3671867874,11553225453,3577936165,11553216442,-9011,,
3672118841,11553476419,3578187131,11553467409,-9010,,
3672369627,11553727206,3578437919,11553718196,-9010,,
3672619830,11553977409,3578688121,11553968398,-9011,,
3672870392,11554227971,3578938684,11554218961,-9010,,
3672888386,11554245965,3578956677,11554236954,-9011,11554237012,
3673138676,11554496254,3579206967,11554487258,-8996,,
3673389648,11554747227,3579457939,11554738245,-8982,,
3673639895,11554997474,3579708186,11554988508,-8966,,
3673890747,11555248326,3579959038,11555239385,-8941,,
3674141313,11555498892,3580209604,11555489940,-8952,,
3674391604,11555749183,3580459896,11555740233,-8950,,
3674641831,11555999410,3580710123,11555990459,-8951,,
3674892476,11556250066,3580960778,11556241115,-8951,,
3674910583,11556268162,3580978874,11556259210,-8952,11556259280,
3675161026,11556518604,3581229317,11556509671,-8933,,
3675411561,11556769140,3581479853,11556760225,-8915,,
3675662010,11557019589,3581730302,11557010692,-8897,,
3675912192,11557269771,3581980483,11557260891,-8880,,
3676162871,11557520450,3582231163,11557511570,-8880,,
3676413251,11557770830,3582481543,11557761951,-8879,,
3676663752,11558021330,3582732043,11558012450,-8880,,
3676914168,11558271747,3582982469,11558262877,-8870,,
3676932349,11558289928,3583000640,11558281047,-8881,11558280951,
3677182537,11558540116,3583250828,11558531211,-8905,,
3677432687,11558790266,3583500978,11558781338,-8928,,
3677682785,11559040364,3583751076,11559031412,-8952,,
3677933211,11559290789,3584001502,11559281814,-8975,,
3678183715,11559541294,3584252006,11559532319,-8975,,
3678434355,11559791934,3584502647,11559782959,-8975,,
3678684942,11560042520,3584753233,11560033545,-8975,,
3678935368,11560292947,3585003659,11560283972,-8975,,
3678953370,11560310949,3585021661,11560301973,-8976,11560302021,
3679203981,11560561560,3585272272,11560552596,-8964,,
3679454259,11560811839,3585522551,11560802888,-8951,,
3679704558,11561062136,3585772849,11561053198,-8938,,
3679954713,11561312302,3586023014,11561303376,-8926,,
3680205072,11561562650,3586273363,11561553724,-8926,,
3680455259,11561812838,3586523551,11561803912,-8926,,
3680705522,11562063101,3586773813,11562054175,-8926,,
3680955786,11562313365,3587024088,11562304449,-8916,,
3680973778,11562331356,3587042069,11562322430,-8926,11562322361,
3681224094,11562581672,3587292385,11562572729,-8943,,
3681474540,11562832119,3587542832,11562823160,-8959,,
3681725112,11563082691,3587793403,11563073715,-8976,,
3681975458,11563333037,3588043749,11563324043,-8994,,
3682225787,11563583365,3588294078,11563574372,-8993,,
3682476274,11563833853,3588544565,11563824860,-8993,,
3682726597,11564084175,3588794888,11564075182,-8993,,
3682977431,11564335010,3589045722,11564326017,-8993,,
3682995588,11564353166,3589063878,11564344173,-8993,11564344189,
3683245796,11564603375,3589314087,11564594386,-8989,,
3683496024,11564853603,3589564316,11564844619,-8984,,
3683746530,11565104109,3589814821,11565095130,-8979,,
3683997032,11565354611,3590065323,11565345636,-8975,,
3684247523,11565605102,3590315814,11565596127,-8975,,
3684498482,11565856061,3590566773,11565847086,-8975,,
3684749199,11566106777,3590817490,11566097802,-8975,,
3684999459,11566357037,3591067750,11566348062,-8975,,
3685017393,11566374972,3591085684,11566365996,-8976,11566365979,
3685267841,11566625420,3591336132,11566616440,-8980,,
3685518081,11566875659,3591586372,11566866685,-8974,,
3685768573,11567126151,3591836864,11567117163,-8988,,
3686018743,11567376321,3592087034,11567367330,-8991,,
3686269099,11567626678,3592337390,11567617687,-8991,,
3686520031,11567877610,3592588322,11567868619,-8991,,
3686770852,11568128431,3592839144,11568119440,-8991,,
3687021057,11568378636,3593089348,11568369645,-8991,,
3687039167,11568396745,3593107458,11568387754,-8991,11568387768,
3687289420,11568646999,3593357711,11568638011,-8988,,
3687539860,11568897439,3593608151,11568888464,-8975,,
3687790275,11569147854,3593858566,11569138874,-8980,,
3688040656,11569398235,3594108947,11569389258,-8977,,
3688291050,11569648629,3594359342,11569639653,-8976,,
3688541168,11569898747,3594609459,11569889771,-8976,,
3688791402,11570148980,3594859693,11570140004,-8976,,
3689041577,11570399156,3595109868,11570390180,-8976,,
3689059832,11570417410,3595128122,11570408433,-8977,11570408497,
3689310241,11570667819,3595378532,11570658860,-8959,,
3689560427,11570918006,3595628719,11570909063,-8943,,
3689810806,11571168386,3595879098,11571159459,-8927,,
3690061388,11571418966,3596129679,11571410055,-8911,,
3690311898,11571669476,3596380189,11571660565,-8911,,
3690562099,11571919678,3596630390,11571910767,-8911,,
3690812264,11572169843,3596880555,11572160932,-8911,,
3691062853,11572420432,3597131144,11572411520,-8912,,
3691080902,11572438481,3597149193,11572429570,-8911,11572429473,
3691331108,11572688687,3597399399,11572679750,-8937,,
3691581785,11572939363,3597650076,11572930404,-8959,,
3691832325,11573189905,3597900617,11573180921,-8984,,
3692082955,11573440533,3598151246,11573431527,-9006,,
3692333485,11573691073,3598401786,11573682067,-9006,,
3692583750,11573941340,3598652052,11573932334,-9006,,
3692834733,11574192322,3598903035,11574183316,-9006,,
3693084963,11574442542,3599153255,11574433536,-9006,,
3693103028,11574460606,3599171318,11574451600,-9006,11574451643,
3693353327,11574710905,3599421618,11574701910,-8995,,
3693603496,11574961085,3599671797,11574952100,-8985,,
3693854202,11575211781,3599922494,11575202809,-8972,,
3694104410,11575461989,3600172701,11575453028,-8961,,
3694355003,11575712581,3600423293,11575703620,-8961,,
3694605471,11575963049,3600673773,11575954099,-8950,,
3694856071,11576213649,3600924373,11576204699,-8950,,
