Current Real Time,Local Server Time,Hardware Clock Time,Software Clock Time,Error,Remote Est Time,
4229174244,11677455,1278373,1278375,-10399080,,
4229195978,11699190,1300109,1300112,-10399078,11700510,
4229674245,12177448,1778373,11726800,-450648,,
4230174246,12677440,2278374,12678782,1342,,
4230221423,12724616,2325552,12725959,1343,12726069,
4230674247,13177433,2778375,13178885,1452,,
4231174248,13677424,3278376,13678897,1473,,
4231242980,13746156,3347109,13747629,1473,13745243,
4231674249,14177417,3778377,14176840,-577,,
4232174250,14677409,4278378,14676515,-894,,
4232267399,14770558,4371528,14769664,-894,14773516,
4232674252,15177403,4778379,15179652,2249,,
4233174254,15677396,5278382,15680372,2976,,
4233293874,15797014,5398002,15799993,2979,15800843,
4233674256,16177390,5778383,16181022,3632,,
4234174257,16677382,6278385,16681228,3846,,
4234317442,16820566,6421570,16824414,3848,16823008,
4234674258,17177375,6778385,17180227,2852,,
4235174259,17677368,7278387,17679826,2458,,
4235341346,17844452,7445474,17846914,2462,17846890,
4235674261,18177361,7778388,18179814,2453,,
4236174263,18677354,8278391,18679809,2455,,
4236362953,18866042,8467081,18868500,2458,18865839,
4236674265,19177348,8778392,19178155,807,,
4237174266,19677340,9278393,19677154,-186,,
4237390231,19893303,9494360,19893120,-183,19897442,
4237674267,20177333,9778395,20179611,2278,,
4238174269,20677326,10278396,20681481,4155,,
4238414554,20917607,10518682,20921766,4159,20920394,
4238674270,21177319,10778397,21180770,3451,,
4239174271,21677311,11278399,21680113,2802,,
4239437467,21940503,11541595,21943310,2807,21942463,
4239674272,22177305,11778400,22179714,2409,,
4240174273,22677296,12278400,22679271,1975,,
4240467870,22970889,12571998,22972869,1980,22976710,
4240674274,23177289,12778402,23180858,3569,,
4241174275,23677281,13278403,23683117,5836,,
4241487085,23990086,13591213,23995928,5842,23990276,
4241674276,24177275,13778404,24181002,3727,,
4242174277,24677266,14278405,24677470,204,,
4242508255,25011240,14612384,25011450,210,25012239,
4242674279,25177260,14778407,25177734,474,,
4243174280,25677252,15278408,25678265,1013,,
4243536622,26039589,15640750,26040608,1019,26044230,
4243674281,26177245,15778408,26179262,2017,,
4244174282,26677238,16278410,26681892,4654,,
4244557961,27060910,16662089,27065571,4661,27061529,
4244674283,27177230,16778411,27180952,3722,,
4245174284,27677222,17278412,27677854,632,,
4245577077,28080009,17681205,28080648,639,28080244,
4245674285,28177215,17778413,28177775,560,,
4246174287,28677208,18278415,28677455,247,,
4246596711,29099625,18700839,29099879,254,29099655,
4246674288,29177202,18778416,29177422,220,,
4247174289,29677194,19278417,29677236,42,,
4247622235,30125133,19726364,30125183,50,30126867,
4247674290,30177187,19778418,30177411,224,,
4248174291,30677178,20278419,30678924,1746,,
4248656098,31158977,20760226,31160732,1755,31166251,
4248674292,31177171,20778420,31179124,1953,,
4249174293,31677164,21278421,31684448,7284,,
4249679691,32182554,21783819,32189847,7293,32184921,
4249679698,32182561,21783826,32189853,7292,,
4250179699,32682552,22283827,32684931,2379,,
4250701286,33204131,22805414,33206519,2388,33205426,
4250701293,33204138,22805421,33206525,2387,,
4251201295,33704131,23305422,33705437,1306,,
4251725448,34228275,23829576,34229590,1315,34230970,
4251725455,34228282,23829583,34229596,1314,,
4252225457,34728275,24329585,34730981,2706,,
4252751184,35253993,24855312,35256708,2715,35257444,
4252751191,35254000,24855319,35256714,2714,,
4253251193,35753994,25355320,35757455,3461,,
4253774853,36277645,25878981,36281115,3470,36280069,
4253774860,36277652,25878988,36281121,3469,,
4254274862,36777646,26378990,36780080,2434,,
4254798800,37301575,26902928,37304019,2444,37303831,
4254798863,37301638,26902991,37304080,2442,,
4255298864,37801631,27402992,37803897,2266,,
4255823518,38326276,27927646,38328552,2276,38328318,
4255823525,38326283,27927653,38328558,2275,,
4256323527,38826276,28427654,38828327,2051,,
4256847445,39350186,28951573,39352247,2061,39352490,
4256847452,39350193,28951581,39352252,2059,,
4257347454,39850185,29451582,39852500,2315,,
4257870646,40373368,29974774,40375693,2325,40374360,
4257870652,40373375,29974781,40375699,2324,,
4258370653,40873368,30474781,40874370,1002,,
4258897242,41399947,31001370,41400959,1012,41403643,
4258897286,41399991,31001414,41401003,1012,,
4259397288,41899985,31501416,41903691,3706,,
4259920131,42422820,32024260,42426535,3715,42422059,
4259920138,42422827,32024267,42426541,3714,,
4260420139,42922818,32524267,42922069,-749,,
4260943754,43446425,33047883,43445684,-741,43448767,
4260943761,43446432,33047890,43445691,-741,,
4261443763,43946425,33547891,43948778,2353,,
4261969687,44472341,34073815,44474703,2362,44475940,
4261969694,44472348,34073823,44474708,2360,,
4262469695,44972339,34573823,44975949,3610,,
4262969696,45472332,35073823,45475950,3618,,
4262989758,45492394,35093887,45496013,3619,45492842,
4263469697,45972325,35573825,45972911,586,,
4263969698,46472318,36073826,46472785,467,,
4264012772,46515390,36116900,46515859,469,46517322,
4264469699,46972309,36573827,46974125,1816,,
4264969700,47472302,37073828,47474252,1950,,
4265037868,47540470,37141997,47542423,1953,47543844,
4265469701,47972294,37573829,47975485,3191,,
4265969703,48472288,38073831,48475683,3395,,
4266068063,48570646,38172191,48574043,3397,48575461,
4266469704,48972280,38573832,48976824,4544,,
4266969706,49472274,39073834,49477107,4833,,
4267091827,49594394,39195955,49599228,4834,49596695,
4267469709,49972268,39573836,49975196,2928,,
4267969711,50472262,40073839,50474580,2318,,
4268115882,50618430,40220010,50620752,2322,50620523,
4268469712,50972255,40573840,50974422,2167,,
4268969713,51472247,41073841,51474356,2109,,
4269137888,51640420,41242016,51642532,2112,51641820,
4269469715,51972241,41573843,51973886,1645,,
4269969716,52472233,42073844,52473649,1416,,
4270161666,52664180,42265794,52665600,1420,52666548,
4270469718,52972226,42573845,52974236,2010,,
4270969719,53472219,43073846,53474602,2383,,
4271185362,53687858,43289490,53690246,2388,53690234,
4271469720,53972212,43573848,53974599,2387,,
4271969721,54472204,44073849,54474596,2392,,
4272206885,54709365,44311014,54711761,2396,54710707,
4272469722,54972196,44573850,54974043,1847,,
4272969724,55472190,45073852,55473547,1357,,
4273231892,55734355,45336022,55735719,1364,55736103,
4273469725,55972182,45573852,55973732,1550,,
4273969726,56472175,46073854,56473939,1764,,
4274253817,56756261,46357945,56758030,1769,56757553,
4274469727,56972167,46573854,56973734,1567,,
4274969728,57472160,47073855,57473466,1306,,
4275273178,57775605,47377306,57776917,1312,57775835,
4275469729,57972153,47573857,57973043,890,,
4275969730,58472145,48073858,58472389,244,,
4276294344,58796754,48398473,58797004,250,58796082,
4276469731,58972138,48573859,58972066,-72,,
4276969733,59472131,49073861,59471472,-659,,
4277314962,59817355,49419090,59816702,-653,59818032,
4277469734,59972124,49573862,59971886,-238,,
4277969735,60472117,50073863,60472808,691,,
4278339224,60841598,50443352,60842297,699,60844030,
4278469736,60972109,50573864,60973262,1153,,
4278969738,61472103,51073866,61474547,2444,,
4279360117,61862475,51464245,61864926,2451,61863393,
4279469739,61972094,51573866,61974211,2117,,
4279969740,62472088,52073868,62473019,931,,
4280386501,62888841,52490629,62889780,939,62892591,
4280469741,62972079,52573868,62973487,1408,,
4280969742,63472072,53073869,63475834,3762,,
4281408044,63910366,53512172,63914136,3770,63911105,
4281469743,63972064,53573871,63975461,3397,,
4281969745,64472058,54073873,64472809,751,,
4282435259,64937566,54539389,64938325,759,64941697,
4282469746,64972051,54573875,64973042,991,,
4282969747,65472043,55073875,65476187,4144,,
4283462659,65964946,55566787,65969100,4154,65965653,
4283469748,65972035,55573875,65976138,4103,,
4283969750,66472029,56073878,66472746,717,,
4284482964,66985234,56587092,66985960,726,66985949,
4284482970,66985241,56587098,66985965,724,,
4284982971,67485234,57087099,67485959,725,,
4285482973,67985226,57587100,67985960,734,,
4285520191,68022444,57624321,68023181,737,68029686,
4285982974,68485220,58087103,68491989,6769,,
4286482975,68985212,58587103,68992474,7262,,
4286541701,69043936,58645829,69051200,7264,69045062,
4286982977,69485205,59087105,69487060,1855,,
4287482978,69985198,59587106,69986342,1144,,
4287561393,70063611,59665521,70064756,1145,70063723,
4287982979,70485190,60087107,70485473,283,,
4288482981,70985184,60587109,70985313,129,,
4288585098,71087299,60689227,71087432,133,71087775,
4288982982,71485177,61087110,71485590,413,,
4289482984,71985169,61587111,71985662,493,,
4289606517,72108700,61710645,72109195,495,72109018,
4289982985,72485162,62087113,72485532,370,,
4290482987,72985156,62587115,72985491,335,,
4290630536,73132702,62734664,73133040,338,73134919,
4290982988,73485148,63087115,73486817,1669,,
4291482989,73985140,63587116,73987374,2234,,
4291654520,74156668,63758648,74158905,2237,74158901,
4291982991,74485134,64087119,74487375,2241,,
4292482993,74985127,64587121,74987376,2249,,
4292678618,75180749,64782746,75183001,2252,75183061,
4292982995,75485121,65087123,75487415,2294,,
4293482996,75985113,65587123,75987441,2328,,
4293699533,76201647,65803662,76203979,2332,76202748,
4293982997,76485107,66087125,76486745,1638,,
4294482998,76985098,66587126,76986215,1117,,
4294723088,77225185,66827217,77226305,1120,77227462,
4294982999,77485091,67087127,77486818,1727,,
4295483001,77985084,67587129,77987377,2293,,
4295745173,78247253,67849301,78249550,2297,78247652,
4295983002,78485077,68087130,78486476,1399,,
4296483004,78985070,68587132,78985485,415,,
4296768522,79270584,68872651,79271004,420,79272674,
4296983006,79485064,69087134,79486204,1140,,
4297483007,79985056,69587134,79987161,2105,,
4297791476,80293521,69895604,80295631,2110,80295809,
4297983009,80485050,70087137,80487233,2183,,
4298483011,80985044,70587139,80987347,2303,,
4298815786,81317813,70919915,81320122,2309,81320482,
4298983012,81485037,71087140,81487467,2430,,
4299483014,81985029,71587142,81987712,2683,,
4299849492,82351501,71953620,82354191,2690,82358686,
4299983015,82485023,72087143,82488914,3891,,
4300483016,82985015,72587144,82992213,7198,,
4300870720,83372712,72974848,83379918,7206,83372470,
4300983017,83485007,73087145,83490540,5533,,
4301483019,83985000,73587146,83984771,-229,,
4301895366,84397340,73999494,84397118,-222,84397696,
4301983020,84484993,74087148,84484873,-120,,
4302483021,84984985,74587148,84985353,368,,
4302915618,85417576,75019746,85417951,375,85418247,
4302983022,85484979,75087150,85485394,415,,
4303483024,85984971,75587152,85985655,684,,
4303936022,86437962,76040151,86438654,692,86438842,
4303983027,86484966,76087154,86485675,709,,
4304483028,86984958,76587155,86985849,891,,
4304963385,87465307,77067513,87466207,900,87469561,
4304983029,87484953,77087159,87485985,1032,,
4305483030,87984943,77587158,87989209,4266,,
4305987105,88489009,78091233,88493284,4275,88491387,
4305987144,88489049,78091273,88493321,4272,,
4306487145,88989042,78591274,88991430,2388,,
4309207392,91709244,81311522,91711680,2436,90610680,
4309207407,91709258,81311537,91711647,2389,,
4309707409,92209250,81811537,91110699,-1098551,,
4310227257,92729090,82331385,91630548,-1098542,92729160,
4310227266,92729099,82331394,91630581,-1098518,,
4310727268,93229092,82831396,93229173,81,,
4311248353,93750169,83352481,93750259,90,93751231,
4311248360,93750176,83352488,93750265,89,,
4311748361,94250169,83852489,94251240,1071,,
4312248362,94750160,84352490,94751241,1081,,
4312272395,94774194,84376524,94775275,1081,94776662,
4312748363,95250153,84852491,95252564,2411,,
4313248365,95750146,85352493,95752633,2487,,
4313297782,95799562,85401910,95802051,2489,95801214,
4313748366,96250140,85852494,96251882,1742,,
4314248368,96750132,86352496,96751802,1670,,
4314318303,96820067,86422431,96821738,1671,96820719,
4314748369,97250125,86852497,97250929,804,,
4315248370,97750117,87352497,97750788,671,,
4315341655,97843401,87445783,97844074,673,97845973,
4315748371,98250111,87852499,98252337,2226,,
4316248372,98750103,88352500,98752692,2589,,
4316366805,98868534,88470934,98871126,2592,98871600,
4316748373,99250096,88852501,99253056,2960,,
4317248375,99750088,89352503,99753171,3083,,
4317393097,99894808,89497225,99897894,3086,99898629,
4317748376,100250081,89852503,100253696,3615,,
4318248377,100750073,90352504,100753910,3837,,
4318419029,100920723,90523157,100924564,3841,100924431,
4318748378,101250066,90852505,101253826,3760,,
4319248379,101750059,91352507,101753784,3725,,
4319439032,101940709,91543161,101944439,3730,101940706,
4319748380,102250052,91852508,102251477,1425,,
4320248382,102750044,92352510,102750059,15,,
4320465999,102967658,92570127,102967677,19,102968409,
4320748383,103250037,92852510,103250475,438,,
4321248385,103750030,93352513,103750797,767,,
4321485965,103987606,93590093,103988378,772,103988220,
4321748387,104250024,93852515,104250717,693,,
4322248389,104750017,94352517,104750646,629,,
4322506551,105008176,94610679,105008809,633,105007875,
4322748391,105250011,94852519,105250197,186,,
4323248393,105750004,95352521,105749719,-285,,
4323528085,106029692,95632213,106029412,-280,106030436,
4323748394,106249997,95852522,106250171,174,,
4324248396,106749990,96352523,106750748,758,,
4324549310,107050900,96653438,107051663,763,107052235,
4324748398,107249984,96852526,107250978,994,,
4325248400,107749978,97352528,107751328,1350,,
4325570402,108071974,97674530,108073330,1356,108073347,
4325748401,108249970,97852529,108251335,1365,,
4326248402,108749962,98352530,108751349,1387,,
4326595236,109096791,98699364,109098184,1393,109099776,
4326748404,109249956,98852531,109251839,1883,,
4327248406,109749949,99352534,109752947,2998,,
4327618850,110120388,99722978,110123392,3004,110122868,
4327748408,110249943,99852536,110252812,2869,,
4328248409,110749936,100352538,110752429,2493,,
4328648732,111150251,100752860,111152751,2500,111155806,
4328748411,111249929,100852539,111253039,3110,,
4329248412,111749921,101352539,111755488,5567,,
4329672358,112173861,101776486,112179435,5574,112176356,
4329748413,112249914,101852541,112255019,5105,,
4330248415,112749907,102352543,112752414,2507,,
4330693374,113194858,102797502,113197374,2516,113195943,
4330748417,113249901,102852545,113252259,2358,,
4331248418,113749894,103352546,113750990,1096,,
4331725569,114227037,103829697,114228141,1104,114226804,
4331748421,114249889,103852551,114250933,1044,,
4332248423,114749881,104352551,114749660,-221,,
4332751286,115252735,104855414,115252523,-212,115256065,
4332751326,115252776,104855454,115252563,-213,,
4333251327,115752768,105355455,115756108,3340,,
4333772230,116273663,105876358,116277012,3349,116274679,
4333772237,116273669,105876365,116277018,3349,,
4334272239,116773663,106376366,116774690,1027,,
4334795801,117297217,106899930,117298253,1036,117299636,
4334795809,117297224,106899937,117298259,1035,,
4335295811,117797217,107399939,117799647,2430,,
4335819680,118321077,107923808,118323516,2439,118323678,
4335819687,118321084,107923815,118323523,2439,,
4336319688,118821078,108423816,118823689,2611,,
4336843680,119345061,108947809,119347681,2620,119347667,
4336843688,119345068,108947816,119347688,2620,,
4337343690,119845061,109447818,119847679,2618,,
4337873918,120375281,109978048,120377909,2628,120379731,
4337873933,120375296,109978063,120377922,2626,,
4338373935,120875289,110478063,120879751,4462,,
4338948629,121449974,111052759,121454448,4474,121452641,
4338948644,121449990,111052775,121454461,4471,,
4339448645,121949981,111552773,121952659,2678,,
4339974897,122476225,112079025,122478912,2687,122478841,
4339974904,122476232,112079032,122478918,2686,,
4340474905,122976223,112579033,122978851,2628,,
4341000168,123501478,113104296,123504115,2637,123504627,
4341000176,123501486,113104304,123504121,2635,,
4341500177,124001478,113604304,124004638,3160,,
4342000178,124501470,114104305,124504639,3169,,
4342023932,124525225,114128061,124528394,3169,124527804,
4342500180,125001464,114604308,125004081,2617,,
4343000181,125501456,115104309,125504054,2598,,
4343048121,125549395,115152249,125551994,2599,125552102,
4343500183,126001451,115604311,126004155,2704,,
4344000184,126501443,116104312,126504167,2724,,
4344071722,126572980,116175850,126575706,2726,126575441,
4344500185,127001435,116604313,127003944,2509,,
4345000186,127501427,117104314,127503907,2480,,
4345095701,127596942,117199829,127599423,2481,127599567,
4345500187,128001420,117604315,128004027,2607,,
4346000189,128501414,118104317,128504057,2643,,
4346119908,128621130,118224036,128623776,2646,128623764,
4346500191,129001407,118604319,129004051,2644,,
4347000193,129501400,119104321,129504051,2651,,
4347143475,129644680,119247603,129647334,2654,129647303,
4347500194,130001393,119604322,130004031,2638,,
4348000195,130501385,120104323,130504025,2640,,
4348167992,130669180,120272121,130671824,2644,130671799,
4348500196,131001379,120604324,131004012,2633,,
4349000199,131501372,121104326,131504007,2635,,
4349192476,131693647,121296604,131696285,2638,131696450,
4349500200,132001365,121604328,132004110,2745,,
4350000201,132501357,122104329,132504176,2819,,
4350212720,132713874,122316848,132716696,2822,132713792,
4350500202,133001351,122604330,133002509,1158,,
4351000203,133501342,123104330,133501276,-66,,
4351236838,133737974,123340967,133737913,-61,133740837,
4351500204,134001335,123604331,134002819,1484,,
4352000206,134501328,124104333,134504207,2879,,
4352264681,134765800,124368809,134768683,2883,134770419,
4352500208,135001322,124604336,135005027,3705,,
4353000209,135501315,125104337,135505948,4633,,
4353288880,135789981,125393009,135794621,4640,135792735,
4353500211,136001308,125604339,136005153,3845,,
4354000212,136501300,126104339,136504068,2768,,
4354318215,136819299,126422344,136822073,2774,136824123,
4354500213,137001293,126604341,137004816,3523,,
4355000214,137501286,127104342,137506124,4838,,
4355342187,137843252,127446315,137848098,4846,137845765,
4355500215,138001279,127604343,138005388,4109,,
4356000217,138501271,128104345,138503797,2526,,
4356365691,138866740,128469819,138869272,2532,138869081,
4356500219,139001265,128604347,139003748,2483,,
4357000222,139501259,129104349,139503614,2355,,
4357389197,139890229,129493325,139892590,2361,139892706,
4357500223,140001252,129604350,140003641,2389,,
4358000224,140501244,130104351,140503735,2491,,
4358510293,141011307,130614423,141013808,2501,141037203,
4358510309,141011322,130614439,141013821,2499,,
4359010310,141511313,131114437,141537222,25909,,
4359533497,142034492,131637625,142060410,25918,142035654,
4359533504,142034499,131637632,142060415,25916,,
4360033506,142534493,132137634,142535665,1172,,
4360559058,143060036,132663186,143061217,1181,143063669,
4360559065,143060043,132663193,143061223,1180,,
4361059066,143560034,133163194,143563678,3644,,
4361582639,144083599,133686768,144087252,3653,144086005,
4361582646,144083606,133686775,144087258,3652,,
4362082647,144583599,134186776,144586015,2416,,
4362605643,145106585,134709771,145109010,2425,145107823,
4362605650,145106592,134709778,145109016,2424,,
4363105652,145606585,135209780,145607835,1250,,
4363633824,146134748,135737952,146136007,1259,146137022,
4363633861,146134786,135737989,146136043,1257,,
4364133862,146634779,136237990,146637063,2284,,
4364657695,147158602,136761823,147160896,2294,147161169,
4364657702,147158609,136761830,147160902,2293,,
4365157703,147658602,137261831,147661179,2577,,
4365683988,148184879,137788117,148187465,2586,148188659,
4365683996,148184886,137788124,148187471,2585,,
4366183999,148684880,138288126,148688671,3791,,
4366710978,149211850,138815106,149215651,3801,149216140,
4366711017,149211890,138815146,149215689,3799,,
4367211018,149711882,139315145,149716182,4300,,
4367711019,150211874,139815147,150216183,4309,,
4367732815,150233671,139836944,150237980,4309,150235164,
4368211021,150711869,140315149,150713494,1625,,
4368711023,151211862,140815151,151213373,1511,,
4368758882,151259719,140863010,151261232,1513,151263498,
4369211025,151711856,141315153,151715427,3571,,
4369711026,152211847,141815154,152215644,3797,,
4369783581,152284401,141887709,152288199,3798,152287458,
4370211027,152711840,142315155,152715013,3173,,
4370711029,153211834,142815157,153214908,3074,,
4370804468,153305271,142908596,153308348,3077,153306290,
4371211031,153711828,143315159,153713239,1411,,
4371711033,154211820,143815161,154212857,1037,,
4371835962,154336748,143940091,154337789,1041,154340288,
4372211035,154711814,144315163,154714738,2924,,
4372711037,155211807,144815165,155215366,3559,,
4372855680,155356449,144959808,155360010,3561,155356639,
4373211039,155711801,145315167,155712974,1173,,
4373711040,156211793,145815168,156212001,208,,
4373876603,156377354,145980731,156377565,211,156378295,
4374211041,156711786,146315169,156712492,706,,
4374711042,157211778,146815170,157212735,957,,
4374900455,157401189,147004584,157402149,960,157403698,
4375211043,157711771,147315171,157713699,1928,,
4375711044,158211763,147815172,158214288,2525,,
4375920423,158421140,148024551,158423668,2528,158421835,
4376211045,158711756,148315173,158713225,1469,,
4376711047,159211749,148815175,159212461,712,,
4376948755,159449454,149052883,159450170,716,159454263,
4377211049,159711743,149315177,159714611,2868,,
4377711051,160211736,149815178,160216560,4824,,
4377972833,160473514,150076961,160478343,4829,160475448,
4378211052,160711729,150315180,160715183,3454,,
4378711053,161211722,150815182,161213671,1949,,
4378999082,161499746,151103210,161501700,1954,161503531,
4379211054,161711715,151315182,161714449,2734,,
4379711056,162211707,151815184,162215507,3800,,
4380020579,162521226,152124708,162525031,3805,162522113,
4380211058,162711701,152315186,162714397,2696,,
4380711060,163211694,152815187,163212595,901,,
4381043936,163544565,153148065,163545473,908,163547009,
4381211061,163711687,153315189,163713110,1423,,
4381711063,164211680,153815191,164214138,2458,,
4382071954,164572565,154176082,164575029,2464,164576914,
4382211064,164711674,154315192,164714664,2990,,
4382711065,165211665,154815193,165216028,4363,,
4383110845,165611440,155214975,165615811,4371,165606519,
4383211066,165711658,155315194,165714164,2506,,
4383711068,166211652,155815196,166206744,-4908,,
4384134560,166635137,156238689,166630237,-4900,166637859,
4384211069,166711644,156315197,166707911,-3733,,
4384711070,167211637,156815199,167214372,2735,,
4385153678,167654238,157257807,167656980,2742,167654733,
4385211071,167711629,157315198,167714113,2484,,
4385711073,168211623,157815201,168212130,507,,
4386176717,168677258,158280845,168677775,517,168678596,
4386211075,168711617,158315204,168712191,574,,
4386711077,169211610,158815205,169212959,1349,,
4387196483,169697008,159300612,169698365,1357,169697627,
4387211078,169711602,159315206,169712937,1335,,
4387711079,170211594,159815207,170212224,630,,
4388215818,170716326,160319946,170716964,638,170716676,
4388215825,170716333,160319954,170716969,636,,
4388715826,171216325,160819954,171216686,361,,
4389215827,171716317,161319955,171716686,369,,
4389236022,171736512,161340151,171736882,370,171737544,
4389715829,172216310,161819956,172217326,1016,,
4390215830,172716304,162319958,172717354,1050,,
4390262023,172762496,162366151,172763547,1051,172760151,
4390715831,173216296,162819959,173214275,-2021,,
4391215832,173716288,163319960,173713962,-2326,,
4391284354,173784809,163388482,173782485,-2324,173786472,
4391715833,174216280,163819961,174217406,1126,,
4392215834,174716273,164319962,174717954,1681,,
4392312147,174812585,164416275,174814268,1683,174816295,
4392715836,175216267,164819964,175219596,3329,,
4393215837,175716259,165319965,175719987,3728,,
4393335661,175836081,165439789,175839812,3731,175838621,
4393715838,176216251,165819965,176219084,2833,,
4394215839,176716244,166319966,176718801,2557,,
4394356742,176857144,166460870,176859705,2561,176858386,
4394715840,177216236,166819968,177217856,1620,,
4395215841,177716229,167319968,177717487,1258,,
4395381235,177881620,167485363,177882882,1262,177884488,
4395715843,178216222,167819971,178218565,2343,,
4396215845,178716217,168319973,178719100,2883,,
4396404412,178904780,168508541,178907668,2888,178907020,
4396715847,179216209,168819975,179218700,2491,,
4397215849,179716203,169319977,179718459,2256,,
4397425218,179925569,169529346,179927828,2259,179926743,
4397715850,180216195,169819978,180217830,1635,,
4398215851,180716189,170319979,180717378,1189,,
4398452225,180952559,170556354,180953752,1193,180956766,
4398715853,181216181,170819981,181218969,2788,,
4399215855,181716176,171319983,181720398,4222,,
4399476381,181976697,171580509,181980924,4227,181979466,
4399715857,182216169,171819985,182219702,3533,,
4400215859,182716163,172319987,182718946,2783,,
4400495911,182996209,172600039,182998999,2790,182996612,
4400715860,183216154,172819988,183217898,1744,,
4401215862,183716148,173319990,183716565,417,,
4401527532,184027812,173631660,184028236,424,184034289,
4401715864,184216141,173819992,184218847,2706,,
4402215865,184716135,174319993,184722625,6490,,
4402556620,185056883,174660748,185063380,6497,185062076,
4402715866,185216126,174819993,185222210,6084,,
4403215868,185716120,175319996,185721326,5206,,
4403581358,186081603,175685486,186086817,5214,186084007,
4403715870,186216113,175819997,186220572,4459,,
4404215871,186716107,176319999,186718523,2416,,
4404601639,187101868,176705767,187104291,2423,187102159,
4404715872,187216099,176820000,187218036,1937,,
4405215874,187716092,177320002,187716395,303,,
4405629460,188129672,177733588,188129982,310,188133613,
4405715875,188216085,177820003,188217024,939,,
4406215877,188716078,178320005,188720032,3954,,
4406653575,189153769,178757703,189157731,3962,189154254,
4406715878,189216070,178820006,189219598,3528,,
4407215879,189716063,179320007,189716559,496,,
4407675296,190175472,179779424,190175976,504,190174710,
4407715881,190216057,179820009,190216456,399,,
4408215883,190716051,180320011,190715300,-751,,
4408701384,191201543,180805512,191200801,-742,191204796,
4408715884,191216042,180820011,191215415,-627,,
4409215886,191716037,181320014,191719300,3263,,
4409723614,192223756,181827742,192227029,3273,192223555,
4409723621,192223763,181827749,192227035,3272,,
4410223623,192723755,182327751,192723566,-189,,
4410753162,193253286,182857290,193253106,-180,193254236,
4410753169,193253293,182857297,193253112,-181,,
4411253171,193753286,183357299,193754247,961,,
4411773921,194274028,183878049,194274998,970,194273881,
4411773928,194274035,183878056,194275004,969,,
4412273930,194774028,184378057,194773891,-137,,
4412802019,195302108,184906147,195301980,-128,195306898,
4412802026,195302115,184906154,195301987,-128,,
4413302028,195802109,185406156,195806910,4801,,
4413825617,196325688,185929745,196330499,4811,196328256,
4413825624,196325695,185929752,196330505,4810,,
4414325626,196825690,186429754,196828267,2577,,
4414845633,197345688,186949761,197348275,2587,197345775,
4414845640,197345695,186949768,197348281,2586,,
4415345642,197845687,187449770,197845786,99,,
4415867183,198367219,187971310,198367327,108,198368048,
4415867190,198367226,187971318,198367332,106,,
4416367191,198867220,188471319,198868059,839,,
4416887904,199387924,188992032,199388772,848,199389065,
4416887911,199387931,188992039,199388778,847,,
4417387912,199887923,189492040,199889075,1152,,
4417908809,200408812,190012939,200409975,1163,200409968,
4417908885,200408888,190013015,200410049,1161,,
4418408887,200908880,190513015,200910049,1169,,
4418932517,201432502,191036645,201433680,1178,201435142,
4418932524,201432509,191036652,201433686,1177,,
4419432526,201932503,191536654,201935154,2651,,
4419957936,202457904,192062064,202460564,2660,202460176,
4419957943,202457911,192062071,202460570,2659,,
4420457944,202957902,192562072,202960187,2285,,
4420978600,203478551,193082729,203480843,2292,203479532,
4420978607,203478558,193082736,203480848,2290,,
4421478608,203978549,193582736,203979541,992,,
4422011866,204511799,194115995,204512800,1001,204512148,
4422011874,204511807,194116002,204512807,1000,,
4422511875,205011799,194616003,205012158,359,,
4423043584,205543499,195147713,205543868,369,205548068,
4423043591,205543506,195147720,205543873,367,,
4423543592,206043498,195647719,206048077,4579,,
4424043593,206543490,196147721,206548078,4588,,
4424067863,206567760,196171991,206572349,4589,206569986,
4424543595,207043484,196647722,207045834,2350,,
4425043596,207543476,197147724,207545721,2245,,
4425092913,207592794,197197041,207595039,2245,207595177,
4425543598,208043471,197647726,208045849,2378,,
4426043600,208543463,198147727,208545865,2402,,
4426132042,208631905,198236172,208634311,2406,208642016,
4426543602,209043457,198647730,209052215,8758,,
4427043604,209543450,199147732,209553581,10131,,
4427158472,209658318,199262600,209668450,10132,209662235,
4427543606,210043444,199647734,210048798,5354,,
4428043607,210543437,200147735,210547373,3936,,
4428179995,210679823,200284124,210683761,3938,210680717,
4428543608,211043430,200647736,211045162,1732,,
4429043610,211543423,201147738,211544335,912,,
4429204840,211704651,201308969,211705565,914,211707832,
4429543612,212043416,201647740,212045873,2457,,
4430043613,212543409,202147741,212546606,3197,,
4430224261,212724053,202328389,212727255,3202,212724571,
4430543615,213043403,202647743,213044896,1493,,
4431043616,213543394,203147744,213543929,535,,
4431250353,213750128,203354481,213750666,538,213753988,
4431543617,214043387,203647745,214045879,2492,,
4432043619,214543381,204147747,214547257,3876,,
4432275986,214775744,204380114,214779624,3880,214779173,
4432543620,215043373,204647748,215047017,3644,,
4433043621,215543365,205147749,215546810,3445,,
4433296896,215796637,205401025,215800087,3450,215797946,
4433543623,216043360,205647751,216045757,2397,,
4434043625,216543352,206147753,216544677,1325,,
4434320508,216820232,206424636,216821561,1329,216822634,
4434543626,217043346,206647754,217045157,1811,,
4435043627,217543337,207147755,217545755,2418,,
4435342393,217842099,207446522,217844522,2423,217843768,
4435543628,218043330,207647756,218045453,2123,,
4436043629,218543322,208147757,218545005,1683,,
4436362010,218861699,208466138,218863387,1688,218862186,
4436543631,219043316,208647758,219044571,1255,,
4437043633,219543309,209147761,219543810,501,,
4437381298,219880970,209485426,219881476,506,219881389,
4437543634,220043303,209647762,220043784,481,,
4438043635,220543294,210147762,220543728,434,,
4438402179,220901832,210506307,220902272,440,220902767,
4438543637,221043288,210647765,221043870,582,,
4439043639,221543281,211147766,221544229,948,,
4439421974,221921611,211526102,221922565,954,221921830,
4439543640,222043274,211647768,222044050,776,,
4440043641,222543266,212147769,222543499,233,,
4440443743,222943363,212547871,222943602,239,222942555,
4440543642,223043260,212647770,223043290,30,,
4441043644,223543252,213147772,223542457,-795,,
4441464440,223964041,213568568,223963254,-787,223965031,
4441543646,224043246,213647774,224042740,-506,,
4442043648,224543240,214147776,224544241,1001,,
4442492301,224991886,214596430,224992896,1010,224993248,
4442543649,225043232,214647777,225044277,1045,,
4443043651,225543225,215147779,225544602,1377,,
4443512354,226011922,215616482,226013305,1383,226012774,
4443543653,226043219,215647781,226044569,1350,,
4444043655,226543212,216147782,226544077,865,,
4444533633,227033182,216637760,227034055,873,227034469,
4444543657,227043206,216647784,227044086,880,,
4445043658,227543199,217147786,227544497,1298,,
4445557067,228056600,217661196,228057906,1306,228058970,
4445557074,228056607,217661203,228057913,1306,,
4446057076,228556599,218161204,228558980,2381,,
4446576543,229076058,218680671,229078448,2390,229076568,
4446576550,229076065,218680678,229078453,2388,,
4447076551,229576057,219180679,229576578,521,,
4447600181,230099679,219704310,230100209,530,230102316,
4447600190,230099688,219704318,230100215,527,,
4448100191,230599680,220204319,230602328,2648,,
4448624695,231124175,220728823,231126832,2657,231127186,
4448624734,231124215,220728863,231126871,2656,,
4449124735,231624206,221228863,231627228,3022,,
4449624736,232124200,221728864,232127230,3030,,
4449648798,232148261,221752927,232151292,3031,232151009,
4450124738,232624192,222228866,232626965,2773,,
4450624739,233124186,222728868,233126952,2766,,
4450672553,233171998,222776681,233174766,2768,233174673,
4451124740,233624177,223228867,233626870,2693,,
4451624741,234124170,223728868,234126863,2693,,
4451696514,234195942,223800643,234198637,2695,234198377,
4452124742,234624163,224228870,234626645,2482,,
4452624743,235124156,224728871,235126609,2453,,
4452716178,235215588,224820306,235218044,2456,235216018,
4453124745,235624149,225228873,235624957,808,,
4453624747,236124142,225728875,236124589,447,,
4453739957,236239351,225844086,236239800,449,236241944,
4454124749,236624135,226228876,236626243,2108,,
4454624751,237124129,226728879,237126739,2610,,
4454763733,237263108,226867861,237265721,2613,237265771,
4455124753,237624123,227228881,237626778,2655,,
4455624755,238124116,227728883,238126795,2679,,
4455791931,238291289,227896059,238293971,2682,238293887,
4456124756,238624108,228228884,238626741,2633,,
4456624757,239124101,228728884,239126715,2614,,
4456815832,239315173,228919961,239317791,2618,239317850,
4457124758,239624093,229228886,239626754,2661,,
4457624759,240124087,229728887,240126779,2692,,
4457839562,240338886,229943691,240341582,2696,240341522,
4458124760,240624079,230228888,240626745,2666,,
4458624761,241124072,230728889,241126723,2651,,
4458863399,241362705,230967527,241365360,2655,241365355,
4459124763,241624064,231228891,241626723,2659,,
4459624765,242124058,231728893,242126723,2665,,
4459887347,242386635,231991475,242389306,2671,242389344,
4460124766,242624050,232228894,242626743,2693,,
4460624767,243124043,232728895,243126766,2723,,
4460906847,243406119,233010975,243408847,2728,243406505,
4461124769,243624036,233228897,243625748,1712,,
4461624770,244124029,233728898,244124430,401,,
4461926563,244425816,234030691,244426223,407,244426193,
4462124771,244624021,234228899,244624420,399,,
4462624773,245124016,234728901,245124406,390,,
4462959930,245459167,235064059,245459563,396,245466594,
4463124775,245624008,235228903,245626726,2718,,
4463624776,246124002,235728904,246131442,7440,,
4463984037,246483257,236088165,246490703,7446,246484624,
4464124778,246623994,236228906,246629732,5738,,
4464624779,247123987,236728907,247125368,1381,,
4465007743,247506945,237111871,247508333,1388,247509770,
4465124781,247623980,237228909,247625705,1725,,
4465624782,248123973,237728909,248126811,2838,,
4466028747,248527932,238132875,248530777,2845,248528822,
4466124783,248623966,238228911,248626437,2471,,
4466624785,249123959,238728913,249124862,903,,
4467052612,249551779,239156741,249552691,912,249554370,
4467124786,249623951,239228913,249625104,1153,,
4467624787,250123944,239728915,250126546,2602,,
4468096427,250595577,240200556,250598187,2610,250604997,
4468124790,250623939,240228920,250626938,2999,,
4468624792,251123932,240728919,251133363,9431,,
4469121828,251620959,241225956,251630400,9441,251624526,
4469124793,251623924,241228922,251633329,9405,,
4469624794,252123917,241728922,252127494,3577,,
4470148177,252647291,242252305,252650878,3587,252650499,
4470148184,252647298,242252312,252650884,3586,,
4470648186,253147291,242752314,253150510,3219,,
4471171827,253670923,243275955,253674151,3228,253673576,
4471171834,253670930,243275962,253674157,3227,,
4471671835,254170924,243775963,254173587,2663,,
4472198328,254697407,244302456,254700080,2673,254699003,
4472198366,254697446,244302494,254700117,2671,,
4472698368,255197438,244802495,255199045,1607,,
4473218178,255717240,245322306,255718856,1616,255717800,
4473218184,255717247,245322313,255718862,1615,,
4473718185,256217238,245822313,256217809,571,,
4474218186,256717231,246322314,256717810,579,,
4474243405,256742450,246347534,256743030,580,256745678,
4474718188,257217225,246822316,257220329,3104,,
4475218189,257717217,247322317,257720464,3247,,
4475266651,257765679,247370779,257768926,3247,257767859,
4475718191,258217210,247822319,258219503,2293,,
4476218192,258717204,248322320,258719402,2198,,
4476291069,258790078,248395197,258792279,2201,258793100,
4476718193,259217195,248822321,259220106,2911,,
4477218194,259717188,249322321,259720227,3039,,
4477314808,259813801,249418936,259816842,3041,259816408,
4477718195,260217180,249822323,260219879,2699,,
4478218196,260717173,250322323,260719797,2624,,
4478338539,260837514,250442669,260840143,2629,260840079,
4478718197,261217165,250822325,261219753,2588,,
4479218198,261717159,251322326,261719741,2582,,
4479357951,261856909,251462079,261859494,2585,261857374,
4479718199,262217151,251822327,262218215,1064,,
4480218200,262717144,252322328,262717624,480,,
4480377626,262876567,252481756,262877053,486,262876829,
4480718202,263217137,252822330,263217477,340,,
4481218203,263717129,253322331,263717408,279,,
4481397811,263896733,253501939,263897017,284,263897510,
4481718204,264217121,253822331,264217726,605,,
4482218205,264717114,254322333,264717906,792,,
4482417482,264916388,254521610,264917184,796,264916823,
4482718206,265217107,254822335,265217692,585,,
4483218207,265717099,255322335,265717551,452,,
4483438282,265937171,255542410,265937626,455,265938310,
4483718209,266217092,255822336,266217937,845,,
4484218211,266717086,256322339,266718241,1155,,
4484459010,266957881,256563139,266959042,1161,266958870,
4484718212,267217078,256822340,267218154,1076,,
4485218213,267717071,257322341,267718075,1004,,
4485484392,267983246,257588520,267984255,1009,267982903,
4485718215,268217064,257822343,268217446,382,,
4486218216,268717058,258322344,268716729,-329,,
4486510084,269008920,258614212,269008598,-322,269012208,
4486718217,269217050,258822345,269218233,1183,,
4487218219,269717043,259322346,269720345,3302,,
4487531214,270030033,259635343,270033341,3308,270029718,
4487718220,270217035,259822348,270218991,1956,,
4488218221,270717029,260322349,270716727,-302,,
4488568870,271067673,260673000,271067378,-295,271076950,
4488718222,271217020,260822349,271219585,2565,,
4489218223,271717013,261322351,271726305,9292,,
4489594383,272093167,261698512,272102466,9299,272095951,
4489718225,272217006,261822352,272224693,7687,,
4490218227,272717001,262322355,272719796,2795,,
4490620682,273119449,262724811,273122252,2803,273120910,
4490718228,273216992,262822356,273219535,2543,,
4491218230,273716987,263322358,273718460,1473,,
4491640825,274139574,263744953,274141055,1481,274140426,
4491718231,274216978,263822358,274218361,1383,,
4492218233,274716972,264322361,274717836,864,,
4492662068,275160800,264766197,275161672,872,275162094,
4492718234,275216964,264822362,275217882,918,,
4493218235,275716957,265322363,275718263,1306,,
4493686919,276185633,265791047,276186947,1314,276188822,
4493718238,276216954,265822370,276218387,1433,,
4494218240,276716945,266322368,276720146,3201,,
4494709908,277208604,266814036,277211813,3209,277211101,
4494718241,277216937,266822368,277220133,3196,,
4495218242,277716931,267322371,277719438,2507,,
4495733704,278232384,267837832,278234900,2516,278235038,
4495733711,278232391,267837839,278234906,2515,,
4496233713,278732384,268337841,278735050,2666,,
4496757906,279256568,268862034,279259243,2675,279259337,
4496757913,279256575,268862042,279259248,2673,,
4497257915,279756568,269362043,279759347,2779,,
4497788634,280287278,269892762,280290066,2788,280291544,
4497788641,280287285,269892769,280290071,2786,,
4498288642,280787278,270392770,280791555,4277,,
4498809116,281307743,270913244,281312029,4286,281308522,
4498809123,281307750,270913251,281312035,4285,,
4499309125,281807744,271413253,281808533,789,,
4499832829,282331438,271936957,282332237,799,282334260,
4499832836,282331445,271936964,282332243,798,,
4500332837,282831439,272436965,282834271,2832,,
4500856842,283355435,272960971,283358277,2842,283358202,
4500856849,283355442,272960978,283358282,2840,,
4501356850,283855433,273460978,283858212,2779,,
4501856851,284355426,273960979,284358212,2786,,
4501878275,284376849,273982403,284379636,2787,284378421,
4502356852,284855419,274460980,284857052,1633,,
4502856854,285355412,274960981,285357002,1590,,
4502902143,285400701,275006271,285402292,1591,285403349,
4503356856,285855406,275460984,285857968,2562,,
4503856857,286355399,275960985,286358065,2666,,
4503921521,286420061,276025649,286422730,2669,286420638,
4504356859,286855391,276460986,286856248,857,,
4504856861,287355385,276960989,287355980,595,,
4504945805,287444327,277049933,287444925,598,287447200,
4505356862,287855377,277460990,287857853,2476,,
4505856863,288355370,277960991,288358260,2890,,
4505967891,288466397,278072019,288469289,2892,288467346,
4506356864,288855363,278460992,288856752,1389,,
4506856866,289355357,278960994,289356324,967,,
4506998520,289497008,279102648,289497978,970,289503126,
4507356867,289855349,279460995,289860016,4667,,
4507856868,290355341,279960995,290361476,6135,,
4508022434,290520905,280126562,290527043,6138,290523371,
4508356870,290855334,280460998,290859023,3689,,
4508856872,291355328,280960999,291357810,2482,,
4509045709,291544161,281149837,291546648,2487,291546795,
4509356873,291855320,281461000,291857904,2584,,
4509856874,292355313,281961002,292357962,2649,,
4510071368,292569803,282175496,292572457,2654,292572806,
4510356876,292855306,282461003,292858164,2858,,
4510856877,293355299,282961005,293358317,3018,,
4511102187,293600605,283206316,293603628,3023,293598988,
4511356878,293855292,283461006,293855956,664,,
4511856879,294355285,283961007,294353682,-1603,,
4512127076,294625476,284231204,294623879,-1597,294628462,
4512356881,294855277,284461009,294855790,513,,
4512856882,295355271,284961010,295358271,3000,,
4513151175,295649559,285255304,295652565,3006,295652552,
4513356883,295855262,285461011,295858267,3005,,
4513856884,296355255,285961011,296358263,3008,,
4514185299,296683665,286289429,296686682,3017,296690583,
4514356886,296855248,286461014,296859604,4356,,
4514856887,297355242,286961015,297362173,6931,,
4515208828,297707177,287312957,297714115,6938,297709725,
4515356888,297855234,287461016,297860874,5640,,
4515856889,298355226,287961017,298357787,2561,,
4516245294,298743625,288349422,298746193,2568,298752530,
4516356890,298855218,288461018,298859203,3985,,
4516856892,299355212,288961020,299364130,8918,,
4517265344,299763658,289369472,299772583,8925,299764503,
4517356894,299855205,289461021,299862653,7448,,
4517856895,300355198,289961022,300356056,858,,
4518293819,300792115,290397948,300792982,867,300797324,
4518356896,300855190,290461023,300856604,1414,,
4518856897,301355183,290961025,301360404,5221,,
4519318417,301816696,291422546,301821925,5229,301819544,
4519356901,301855180,291461031,301860227,5047,,
4519856903,302355173,291961031,302358031,2858,,
4520337696,302835957,292441824,302838825,2868,302836516,
4520356904,302855164,292461032,302857942,2778,,
4520856906,303355159,292961034,303355727,568,,
4521363728,303861971,293467856,303862549,578,303863704,
4521363735,303861978,293467863,303862556,578,,
4521863736,304361972,293967864,304363715,1743,,
4522385469,304883696,294489597,304885448,1752,304883608,
4522385476,304883703,294489605,304885453,1750,,
4522885477,305383694,294989605,305383617,-77,,
4523414725,305912934,295518853,305912866,-68,305918421,
4523414766,305912975,295518894,305912905,-70,,
4523914768,306412968,296018895,306418465,5497,,
4524438146,306936338,296542274,306941844,5506,306938827,
4524438153,306936345,296542282,306941849,5504,,
4524938154,307436337,297042282,307438837,2500,,
4525438155,307936329,297542283,307938837,2508,,
4525463283,307961456,297567411,307963966,2510,307964880,
4525938157,308436322,298042285,308439710,3388,,
4526438159,308936316,298542287,308939758,3442,,
4526504388,309002546,298608519,309005991,3445,309013932,
4526938160,309436309,299042288,309446654,10345,,
4527438162,309936302,299542290,309947709,11407,,
4527542501,310040639,299646629,310052048,11409,310050354,
4527938164,310436295,300042292,310446372,10077,,
4528438165,310936288,300542293,310946020,9732,,
4528572881,311071002,300677010,311080737,9735,311077044,
4528938166,311436280,301042294,311443324,7044,,
4529438167,311936273,301542295,311942331,6058,,
4529597315,312095418,301701443,312101480,6062,312097810,
4529938169,312436266,302042297,312439833,3567,,
4530438171,312936260,302542298,312938668,2408,,
4530621328,313119416,302725459,313121830,2414,313122136,
4530938172,313436252,303042300,313438867,2615,,
4531438174,313936246,303542302,313938985,2739,,
4531646893,314144961,303751021,314147705,2744,314148710,
4531938176,314436239,304042304,314439574,3335,,
4532438178,314936234,304542306,314939999,3765,,
4532682563,315180615,304786693,315184387,3772,315189181,
4532938179,315436225,305042306,315442452,6227,,
4533438180,315936218,305542307,315944801,8583,,
4533708664,316206697,305812792,316215286,8589,316208848,
4533938182,316436211,306042310,316441850,5639,,
4534438184,316936205,306542312,316938370,2165,,
4534733065,317231082,306837194,317233252,2170,317233907,
4534938185,317436198,307042313,317438641,2443,,
4535438187,317936191,307542314,317939030,2839,,
4535754091,318252090,307858219,318254935,2845,318253466,
4535938188,318436184,308042316,318438492,2308,,
4536438190,318936177,308542318,318937567,1390,,
4536773613,319271595,308877741,319272991,1396,319272023,
4536938191,319436170,309042319,319437249,1079,,
4537438192,319936162,309542319,319936603,441,,
4537797204,320295169,309901332,320295616,447,320297836,
4537938194,320436155,310042322,320437231,1076,,
4538438196,320936150,310542324,320938830,2680,,
4538821820,321319767,310925950,321322457,2690,321322639,
4538938198,321436142,311042326,321438873,2731,,
4539438200,321936137,311542328,321939021,2884,,
4539850438,322348369,311954568,322351262,2893,322353236,
4539938202,322436129,312042329,322439369,3240,,
4540438204,322936123,312542332,322941005,4882,,
4540874683,323372595,312978811,323377485,4890,323375377,
4540938205,323436115,313042333,323440739,4624,,
4541438207,323936109,313542335,323938903,2794,,
4541897945,324395840,314002074,324398642,2802,324398467,
4541938212,324436107,314042343,324438898,2791,,
4542438214,324936100,314542342,324938737,2637,,
4542922162,325420040,315026291,325422686,2646,325422454,
4542938217,325436094,315042347,325438735,2641,,
4543438218,325936087,315542346,325938511,2424,,
4543942168,326440028,316046297,326442462,2434,326440717,
4543942177,326440037,316046306,326442470,2433,,
4544442178,326940029,316546305,326940729,700,,
4544973678,327471520,317077806,327472230,710,327476938,
4544973685,327471527,317077813,327472236,709,,
4545473687,327971520,317577815,327976949,5429,,
4545997502,328495326,318101630,328500765,5439,328497879,
4545997511,328495335,318101639,328500772,5437,,
4546497512,328995328,318601640,328997891,2563,,
4547021510,329519318,319125638,329521890,2572,329522087,
4547021644,329519452,319125773,329522022,2570,,
4547521646,330019444,319625774,330022225,2781,,
4548056143,330553933,320160271,330556723,2790,330562056,
4548056150,330553940,320160278,330556729,2789,,
4548556152,331053933,320660279,331062067,8134,,
4549082149,331579922,321186278,331588065,8143,331582618,
4549082156,331579929,321186285,331588071,8142,,
4549582158,332079922,321686286,332082629,2707,,
4550103853,332601608,322207982,332604325,2717,332603037,
4550103860,332601615,322207989,332604330,2715,,
4550603861,333101607,322707989,333103046,1439,,
4551127408,333625146,323231536,333626594,1448,333627859,
4551127415,333625153,323231543,333626600,1447,,
4551627416,334125146,323731544,334127870,2724,,
4552151383,334649103,324255511,334651837,2734,334652142,
4552151390,334649110,324255518,334651842,2732,,
4552651392,335149103,324755520,335152153,3050,,
4553174940,335672643,325279068,335675702,3059,335675220,
4553174947,335672650,325279075,335675708,3058,,
4553674948,336172642,325779076,336175230,2588,,
4554199113,336696799,326303242,336699396,2597,336699579,
4554199121,336696806,326303249,336699402,2596,,
4554699122,337196798,326803250,337199590,2792,,
4555222814,337720481,327326942,337723282,2801,337723087,
4555222821,337720488,327326949,337723288,2800,,
4555722823,338220482,327826950,338223098,2616,,
4556250947,338748598,328355076,338751224,2626,338753422,
4556250955,338748605,328355083,338751230,2625,,
4556750957,339248599,328855085,339253434,4835,,
4557291357,339788990,329395486,339793835,4845,339800127,
4557291412,339789044,329395540,339793887,4843,,
4557791414,340289038,329895542,340300185,11147,,
4558330150,340827766,330434279,340838923,11157,340836557,
4558330159,340827775,330434288,340838931,11156,,
4558830161,341327767,330934289,341336571,8804,,
4559354999,341852596,331459127,341861409,8813,341856133,
4559355008,341852605,331459136,341861417,8812,,
4559855010,342352600,331959138,342356146,3546,,
4560376506,342874086,332480634,342877643,3557,342875617,
4560376513,342874094,332480641,342877649,3555,,
4560876516,343374087,332980643,343375629,1542,,
4561400159,343897722,333504288,343899274,1552,343900574,
4561400168,343897731,333504297,343899282,1551,,
4561900169,344397724,334004297,344400586,2862,,
4562424534,344922080,334528662,344924952,2872,344925032,
4562424541,344922087,334528669,344924958,2871,,
4562924543,345422080,335028671,345425043,2963,,
4563448824,345946353,335552952,345949325,2972,345948889,
4563448831,345946359,335552959,345949330,2971,,
4563948832,346446351,336052959,346448898,2547,,
4564470419,346967929,336574547,346970485,2556,346969736,
4564470426,346967936,336574554,346970491,2555,,
4564970428,347467931,337074556,347469748,1817,,
4565510264,348007758,337614392,348009584,1826,348018396,
4565510272,348007765,337614400,348009590,1825,,
4566010273,348507758,338114401,348518408,10650,,
4566531088,349028564,338635216,349039223,10659,349029846,
4566531095,349028571,338635224,349039228,10657,,
4567031096,349528563,339135224,349529855,1292,,
4567551008,350048467,339655136,350049768,1301,350049242,
4567551045,350048504,339655174,350049805,1301,,
4568051047,350548496,340155175,350549283,787,,
4568571822,351069264,340675950,351070059,795,351070326,
4568571830,351069271,340675958,351070066,795,,
4569071831,351569263,341175958,351570337,1074,,
4569596986,352094410,341701114,352095493,1083,352097913,
4569596993,352094417,341701121,352095499,1082,,
4570096994,352594409,342201121,352597923,3514,,
4570619365,353116771,342723493,353120295,3524,353118498,
4570619372,353116778,342723500,353120301,3523,,
4571119373,353616771,343223502,353618509,1738,,
4571645466,354142854,343749594,354144602,1748,354146844,
4571645472,354142860,343749599,354144605,1745,,
4572145474,354642854,344249602,354646854,4000,,
4572669223,355166595,344773352,355170605,4010,355169324,
4572669232,355166604,344773360,355170612,4008,,
4573169234,355666597,345273362,355669338,2741,,
4573692793,356190147,345796921,356192897,2750,356192903,
4573692800,356190153,345796928,356192903,2750,,
4574192802,356690147,346296930,356692914,2767,,
4574717821,357215157,346821949,357217934,2777,357218409,
4574717828,357215164,346821956,357217940,2776,,
4575217830,357715159,347321958,357718420,3261,,
4575741300,358238620,347845428,358241891,3271,358241013,
4575741308,358238627,347845436,358241896,3269,,
4576241309,358738619,348345437,358741023,2404,,
4576765338,359262640,348869467,359265054,2414,359265403,
4576765346,359262647,348869474,359265060,2413,,
4577265347,359762641,349369475,359765415,2774,,
4577791708,360288992,349895836,360291775,2783,360293073,
4577791749,360289034,349895877,360291816,2782,,
4578291751,360789027,350395879,360793119,4092,,
4578815570,361312837,350919699,361316938,4101,361315558,
4578815577,361312844,350919706,361316943,4099,,
4579315578,361812837,351419706,361815568,2731,,
4579815579,362312828,351919707,362315569,2741,,
4579835828,362333078,351939956,362335818,2740,362334192,
4580315580,362812821,352419708,362814011,1190,,
4580815582,363312814,352919710,363313949,1135,,
4580860102,363357335,352964230,363358469,1134,363360460,
4581315584,363812808,353419712,363815767,2959,,
4581815586,364312802,353919714,364315947,3145,,
4581883552,364380767,353987681,364383913,3146,364383309,
4582315588,364812795,354419716,364815428,2633,,
4582815589,365312787,354919717,365315349,2562,,
4582908077,365405274,355012205,365407837,2563,365408496,
4583315590,365812780,355419717,365815889,3109,,
4583815592,366312774,355919720,366316013,3239,,
4583928978,366426158,356033107,366429401,3243,366427283,
4584315594,366812767,356419722,366814380,1613,,
4584815596,367312760,356919724,367313903,1143,,
4584962404,367459567,357066533,367460712,1145,367465906,
4585315597,367812753,357419725,367817574,4821,,
4585815598,368312745,357919725,368319101,6356,,
4585983749,368480894,358087877,368487252,6358,368482510,
4586315599,368812739,358419727,368815957,3218,,
4586815601,369312732,358919729,369314364,1632,,
4587007939,369505067,359112068,369506703,1636,369508119,
4587315602,369812724,359419730,369815237,2513,,
4587815603,370312716,359919731,370315784,3068,,
4588027676,370524786,360131804,370527857,3071,370525619,
4588315605,370812711,360419733,370814498,1787,,
4588815606,371312703,360919734,371313551,848,,
4589051561,371548654,361155690,371549507,853,371551513,
4589315607,371812695,361419735,371814611,1916,,
4589815609,372312688,361919736,372315562,2874,,
4590071430,372568505,362175558,372571384,2879,372569611,
4590315610,372812681,362419737,372814698,2017,,
4590815611,373312674,362919739,373313795,1121,,
4591109774,373606831,363213902,373607958,1127,373616912,
4591315612,373812667,363419740,373817482,4815,,
4591815614,374312659,363919741,374322754,10095,,
4592134538,374631579,364238666,374641679,10100,374633791,
4592315615,374812653,364419743,374819899,7246,,
4592815616,375312644,364919743,375314871,2227,,
4593155824,375652847,365259952,375655079,2232,375654452,
4593315617,375812638,365419745,375814672,2034,,
4593815618,376312629,365919746,376314248,1619,,
4594177927,376674933,366282056,376676558,1625,376676701,
4594315620,376812623,366419748,376814290,1667,,
4594815621,377312615,366919748,377314396,1781,,
4595197177,377694166,367301305,377695953,1787,377694758,
4595315622,377812608,367419749,377814114,1506,,
4595815624,378312601,367919752,378313207,606,,
4596232075,378729046,368336204,378729659,613,378736899,
4596315625,378812594,368419753,378814416,1822,,
4596815627,379312587,368919755,379320452,7865,,
4597253441,379750395,369357569,379758267,7872,379751841,
4597315629,379812581,369419757,379819656,7075,,
4597815630,380312573,369919757,380314032,1459,,
4598280012,380776948,370384140,380778415,1467,380781285,
4598315631,380812566,370419758,380814237,1671,,
4598815633,381312559,370919761,381316907,4348,,
4599303864,381800783,371407993,381805139,4356,381803639,
4599315634,381812552,371419762,381816872,4320,,
4599815635,382312545,371919764,382315412,2867,,
4600334540,382831442,372438669,382834318,2876,382833936,
4600334548,382831450,372438676,382834324,2874,,
4600834550,383331442,372938678,383333948,2506,,
4601354690,383851574,373458818,383854089,2515,383852348,
4601354697,383851581,373458825,383854095,2514,,
4601854698,384351574,373958826,384352358,784,,
4602375069,384871935,374479197,384872730,795,384872242,
4602375076,384871942,374479204,384872736,794,,
4602875077,385371934,374979205,385372252,318,,
4603398766,385895615,375502894,385895942,327,385898386,
4603398773,385895622,375502901,385895947,325,,
4603898775,386395615,376002903,386398396,2781,,
4604431443,386928274,376535571,386931065,2791,386934407,
4604431450,386928281,376535578,386931071,2790,,
4604931452,387428275,377035580,387434418,6143,,
4605450733,387947548,377554862,387953700,6152,387948131,
4605450740,387947555,377554869,387953705,6150,,
4605950741,388447547,378054869,388448141,594,,
4606450742,388947539,378554870,388948141,602,,
4606474616,388971412,378578744,388972016,604,388974223,
4606950743,389447531,379054871,389450247,2716,,
4607450745,389947525,379554872,389950354,2829,,
4607493783,389990562,379597911,389993392,2830,389991172,
4607950746,390447518,380054874,390448329,811,,
4608450748,390947512,380554876,390948139,627,,
4608515318,391012079,380619446,391012710,631,391013895,
4608950749,391447503,381054877,391449174,1671,,
4609450751,391947497,381554879,391949330,1833,,
4609537366,392034110,381641494,392035946,1836,392036330,
4609950753,392447490,382054880,392449652,2162,,
4610450755,392947485,382554883,392949721,2236,,
4610557577,393054304,382661705,393056544,2240,393055418,
4610950757,393447477,383054885,393448840,1363,,
4611450759,393947471,383554887,393948602,1131,,
4611588018,394084728,383692147,394085862,1134,394090731,
4611950761,394447465,384054889,394452138,4673,,
4612450762,394947457,384554890,394953476,6019,,
4612608263,395104956,384712391,395110978,6022,395105901,
4612950764,395447450,385054892,395450002,2552,,
4613450765,395947443,385554892,395948405,962,,
4613628032,396124707,385732160,396125673,966,396125546,
4613950766,396447435,386054893,396448326,891,,
4614450768,396947429,386554896,396948284,855,,
4614649537,397146195,386753666,397147054,859,397147716,
4614950769,397447422,387054897,397448685,1263,,
4615450771,397947415,387554899,397948951,1536,,
4615673081,398169721,387777209,398171262,1541,398172461,
4615950773,398447408,388054901,398449620,2212,,
4616450774,398947402,388554903,398950157,2755,,
4616708658,399205281,388812788,399208043,2762,399213765,
4616950775,399447393,389054902,399452929,5536,,
4617450777,399947388,389554905,399955888,8500,,
4617728011,400224617,389832140,400233123,8506,400225136,
4617950778,400447379,390054906,400452330,4951,,
4618450779,400947372,390554907,400947906,534,,
4618748178,401244767,390852306,401245306,539,401245715,
4618950780,401447364,391054907,401448073,709,,
4619450782,401947358,391554910,401948321,963,,
4619770029,402266600,391874157,402267569,969,402268517,
4619950784,402447351,392054912,402448667,1316,,
4620450785,402947345,392554913,402949275,1930,,
4620792034,403288588,392896162,403290525,1937,403290622,
4620950786,403447336,393054914,403449307,1971,,
4621450788,403947330,393554915,403949378,2048,,
4621817279,404313814,393921407,404315870,2056,404317348,
4621950790,404447323,394054918,404449775,2452,,
4622450792,404947318,394554920,404950863,3545,,
4622842963,405339481,394947091,405343035,3554,405341403,
4622950793,405447310,395054921,405450512,3202,,
4623450794,405947302,395554922,405949236,1934,,
4623865048,406361550,395969177,406363492,1942,406363517,
4623950796,406447296,396054924,406449243,1947,,
4624450797,406947288,396554925,406949267,1979,,
4624889394,407385877,396993522,407387865,1988,407389046,
4624950799,407447282,397054927,407449414,2132,,
4625450800,407947275,397554928,407950455,3180,,
4625913157,408409623,398017285,408412812,3189,408412216,
4625950801,408447267,398054930,408450412,3145,,
4626450803,408947261,398554931,408949864,2603,,
4626950828,409447277,399054957,409449890,2613,409457107,
4626950836,409447284,399054964,409449895,2611,,
4627450837,409947278,399554965,409957118,9840,,
4627974663,410471095,400078791,410480944,9849,410473879,
4627974670,410471102,400078798,410480950,9848,,
4628474672,410971094,400578799,410973890,2796,,
4629002930,411499344,401107059,411502149,2805,411504437,
4629002972,411499385,401107100,411502188,2803,,
4629502974,411999379,401607102,412004482,5103,,
4630022552,412518949,402126681,412524062,5113,412519501,
4630022562,412518958,402126690,412524069,5111,,
4630522563,413018950,402626691,413019513,563,,
4631046343,413542721,403150471,413543293,572,413545376,
4631046349,413542728,403150478,413543298,570,,
4631546350,414042720,403650478,414045385,2665,,
4632046351,414542713,404150479,414545386,2673,,
4632071242,414567604,404175371,414570279,2675,414570767,
4632546352,415042705,404650480,415045854,3149,,
4633046354,415542699,405150482,415545882,3183,,
4633095156,415591501,405199285,415594684,3183,415594207,
4633546355,416042692,405650484,416045456,2764,,
4634046356,416542684,406150485,416545410,2726,,
4634267296,416763622,406371427,416766354,2732,416705435,
4634546357,417042676,406650485,417011413,-31263,,
4635046358,417542668,407150486,417484501,-58167,,
4635305206,417801514,407409336,417743352,-58162,417810605,
4635546360,418042662,407650488,418016941,-25721,,
4636046361,418542654,408150489,418551762,9108,,
4636337932,418834221,408442061,418843334,9113,418838547,
4636546363,419042648,408650491,419049768,7120,,
4637046365,419542641,409150493,419546981,4340,,
4637363034,419859306,409467162,419863651,4345,419861599,
4637546366,420042634,409650494,420046230,3596,,
4638046367,420542626,410150495,420544934,2308,,
4638391237,420887492,410495365,420889805,2313,420892563,
4638546369,421042620,410650496,421045792,3172,,
4639046370,421542612,411150497,421547698,5086,,
4639415484,421911720,411519612,421916812,5092,421914906,
4639546372,422042606,411650500,422047201,4595,,
4640046374,422542599,412150502,422545798,3199,,
4640441831,422938050,412545959,422941256,3206,422941756,
4640546375,423042592,412650503,423045904,3312,,
4641046377,423542585,413150504,423546304,3719,,
4641465280,423961482,413569409,423965208,3726,423963020,
4641546378,424042578,413650506,424045949,3371,,
4642046379,424542570,414150507,424544120,1550,,
4642489146,424985330,414593274,424986888,1558,424987549,
4642546380,425042563,414650507,425044196,1633,,
4643046382,425542556,415150510,425544787,2231,,
4643518740,426014906,415622868,426017146,2240,426020674,
4643546388,426042556,415650518,426044990,2434,,
4644046389,426542546,416150516,426548325,5779,,
4644539247,427035397,416643375,427041184,5787,427036722,
4644546390,427042539,416650518,427048261,5722,,
4645046391,427542532,417150519,427543869,1337,,
4645559773,428055906,417663902,428057251,1345,428057189,
4645559780,428055913,417663909,428057257,1344,,
4646059781,428555904,418163909,428557198,1294,,
4646559782,429055897,418663909,429057199,1302,,
4646579828,429075943,418683958,429077248,1305,429076600,
4647059784,429555891,419163912,429556586,695,,
4647559785,430055884,419663913,430056561,677,,
4647603428,430099526,419707556,430100204,678,430098679,
4648059786,430555876,420163915,430555172,-704,,
4648559787,431055869,420663915,431055041,-828,,
4648622743,431118823,420726871,431117997,-826,431119438,
4649059788,431555860,421163916,431556303,443,,
4649559789,432055853,421663917,432056486,633,,
4649650438,432146500,421754566,432147135,635,432151399,
4650059790,432555846,422163919,432559981,4135,,
4650559791,433055838,422663918,433060754,4916,,
4650670222,433166268,422774350,433171186,4918,433166894,
4651059792,433555830,423163919,433557412,1582,,
4651559794,434055824,423663922,434056467,643,,
4651691081,434187109,423795209,434187755,646,434188668,
4652059795,434555816,424163923,434557144,1328,,
4652559796,435055809,424663924,435057384,1575,,
4652711587,435207598,424815715,435209176,1578,435207569,
4653059797,435555801,425163924,435556267,466,,
4653559799,436055796,425663927,436055783,-13,,
4653735546,436231539,425839674,436231530,-9,436234584,
4654059802,436555789,426163929,436557768,1979,,
4654559803,437055783,426663932,437058844,3061,,
4654759313,437255288,426863441,437258354,3066,437258248,
4655059805,437555776,427163933,437558783,3007,,
4655559806,438055768,427663934,438058743,2975,,
4655784554,438280512,427888682,438283492,2980,438283947,
4656059808,438555761,428163936,438558996,3235,,
4656559810,439055755,428663938,439059205,3450,,
4656811647,439307588,428915775,439311043,3455,439311856,
4657059811,439555747,429163939,439559611,3864,,
4657559813,440055741,429663941,440060023,4282,,
4657835652,440331576,429939780,440335863,4287,440334117,
4658059814,440555733,430163942,440559241,3508,,
4658559815,441055727,430663943,441058282,2555,,
4658862682,441358589,430966810,441361149,2560,441363260,
4659059817,441555720,431163945,441559116,3396,,
4659559819,442055713,431663947,442060400,4687,,
4659897550,442393439,432001679,442398132,4693,442401780,
4660059820,442555705,432163947,442561584,5879,,
4660559822,443055700,432663950,443064053,8353,,
4660919706,443415577,433023834,443423938,8361,443417650,
4661059823,443555692,433163951,443562293,6601,,
4661559824,444055684,433663952,444057770,2086,,
4661943295,444439149,434047424,444441242,2093,444441997,
4662059826,444555678,434163954,444557948,2270,,
4662559828,445055671,434663955,445058532,2861,,
4662967341,445463178,435071469,445466046,2868,445466242,
4663059830,445555665,435163958,445558570,2905,,
4663559831,446055657,435663959,446058735,3078,,
4663987141,446482959,436091269,446486045,3086,446483277,
4664059834,446555651,436163961,446558333,2682,,
4664559835,447055645,436663963,447055974,329,,
4665011101,447506902,437115229,447507240,338,447509735,
4665059836,447555637,437163965,447556217,580,,
4665559837,448055629,437663965,448058473,2844,,
4666030952,448526737,438135080,448529589,2852,448527517,
4666059839,448555622,438163967,448558355,2733,,
4666559840,449055615,438663967,449056407,792,,
4667051997,449547763,439156125,449548565,802,449548661,
4667059841,449555608,439163969,449556410,802,,
4667559842,450055600,439663969,450056508,908,,
4668075427,450571176,440179555,450572094,918,450573654,
4668075434,450571183,440179562,450572100,917,,
4668575435,451071175,440679563,451073664,2489,,
4669099153,451594886,441203282,451597383,2497,451597745,
4669099160,451594893,441203289,451597388,2495,,
4669599162,452094885,441703290,452097755,2870,,
4670120208,452615922,442224336,452618801,2879,452617323,
4670120215,452615930,442224343,452618807,2877,,
4670620217,453115923,442724345,453117334,1411,,
4671140766,453636464,443244894,453637884,1420,453637727,
4671140773,453636471,443244901,453637890,1419,,
4671640775,454136464,443744903,454137739,1275,,
4672164848,454660528,444268976,454661812,1284,454662076,
4672164855,454660535,444268983,454661817,1282,,
4672664856,455160528,444768984,455162086,1558,,
4673164857,455660520,445268985,455662086,1566,,
4673190536,455686198,445294664,455687765,1567,455689403,
4673664859,456160513,445768986,456163644,3131,,
4674164860,456660505,446268987,456663729,3224,,
4674216780,456712425,446320908,456715649,3224,456714302,
4674664861,457160499,446768989,457162526,2027,,
4675164862,457660490,447268989,457662386,1896,,
4675240417,457736044,447344545,457737941,1897,457738844,
4675664863,458160484,447768991,458163155,2671,,
4676164865,458660476,448268992,458663294,2818,,
4676263010,458758620,448367138,458761440,2820,458760866,
4676664866,459160469,448768994,459162837,2368,,
4677164868,459660463,449268996,459662726,2263,,
4677287294,459782886,449391422,459785152,2266,459785382,
4677664869,460160456,449768997,460162902,2446,,
4678164871,460660448,450268999,460662961,2513,,
4678313136,460808711,450417264,460811227,2516,460812212,
4678664872,461160441,450769000,461163657,3216,,
4679164873,461660433,451269001,461663951,3518,,
4679348081,461843639,451452209,461847160,3521,461851135,
4679664875,462160427,451769003,462166472,6045,,
4680164876,462660419,452269003,462667931,7512,,
4680376420,462871961,452480549,462879476,7515,462873376,
4680664877,463160412,452769005,463164415,4003,,
4681164878,463660404,453269005,463661835,1431,,
4681399979,463895501,453504107,463896937,1436,463898217,
4681664880,464160398,453769008,464162517,2119,,
4682164882,464660391,454269010,464663122,2731,,
4682428898,464924404,454533027,464927139,2735,464928466,
4682664883,465160384,454769011,465163750,3366,,
4683164884,465660377,455269012,465664453,4076,,
4683452706,465948195,455556834,465952276,4081,465951083,
4683664886,466160370,455769014,466163948,3578,,
4684164888,466660363,456269015,466663266,2903,,
4684473197,466968668,456577326,466971576,2908,466969991,
4684664889,467160356,456769017,467162658,2302,,
4685164890,467660348,457269018,467661685,1337,,
4685495346,467990799,457599474,467992142,1343,467990531,
4685664891,468160341,457769019,468161140,799,,
4686164893,468660334,458269021,468660080,-254,,
4686522209,469017645,458626337,469017397,-248,469020900,
4686664895,469160329,458769023,469161081,752,,
4687164896,469660321,459269024,469663588,3267,,
4687544258,470039676,459648386,470042951,3275,470041523,
4687664898,470160314,459769026,470163247,2933,,
4688164900,470660308,460269028,470662167,1859,,
4688564413,471059814,460668541,471061680,1866,471059963,
4688664902,471160302,460769030,471161824,1522,,
4689164903,471660294,461269031,471660455,161,,
4689591677,472087061,461695805,472087230,169,472091762,
4689664904,472160286,461769032,472161120,834,,
4690164906,472660279,462269033,472664993,4714,,
4690618315,473113682,462722443,473118403,4721,473117979,
4690664908,473160273,462769036,473164954,4681,,
4691164909,473660265,463269037,473664574,4309,,
4691639932,474135281,463744060,474139598,4317,474136886,
4691664910,474160260,463769040,474164441,4181,,
4692164912,474660251,464269040,474661867,1616,,
4692660310,475155642,464764438,475157266,1624,475155799,
4692664913,475160245,464769041,475161854,1609,,
4693164915,475660237,465269042,475660406,169,,
4693698479,476193793,465802608,476193972,179,476193919,
4693698488,476193802,465802616,476193979,177,,
4694198490,476693795,466302618,476693933,138,,
4694729220,477224517,466833348,477224663,146,477230759,
4694729228,477224524,466833355,477224670,146,,
4695229230,477724517,467333358,477730771,6254,,
4695750438,478245717,467854566,478251980,6263,478247544,
4695750447,478245726,467854575,478251987,6261,,
4696250449,478745720,468354577,478747558,1838,,
4696769635,479264896,468873763,479266744,1848,479265606,
4696769677,479264939,468873805,479266785,1846,,
4697269678,479764931,469373806,479765652,721,,
4697788939,480284184,469893067,480284913,729,480284884,
4697788946,480284191,469893075,480284918,727,,
4698288947,480784182,470393075,480784894,712,,
4698788948,481284175,470893076,481284894,719,,
4698808483,481303709,470912611,481304429,720,481304200,
4699288949,481784167,471393077,481784677,510,,
4699788951,482284161,471893079,482284671,510,,
4699827846,482323055,471931974,482323565,510,482323709,
4700288952,482784154,472393080,482784807,653,,
4700788953,483284147,472893082,483284819,672,,
4700847648,483342841,472951776,483343514,673,483343807,
4701288954,483784138,473393081,483785080,942,,
4701788955,484284132,473893083,484285117,985,,
4701874673,484369848,473978802,484370835,987,484371735,
4702288957,484784124,474393085,484785866,1742,,
4702788959,485284119,474893087,485286023,1904,,
4702894472,485389630,474998601,485391537,1907,485390550,
4703288960,485784110,475393088,485785246,1136,,
4703788962,486284104,475893090,486285041,937,,
4703923219,486418359,476027347,486419299,940,486423500,
4704288964,486784098,476393092,486788118,4020,,
4704788965,487284090,476893093,487289248,5158,,
4704953834,487448957,477057963,487454119,5162,487455308,
4705288967,487784084,477393095,487790050,5966,,
4705788969,488284077,477893097,488290445,6368,,
4705977425,488472530,478081553,488478901,6371,488475385,
4706288971,488784070,478393099,488788257,4187,,
4706788972,489284064,478893100,489286934,2870,,
4707000561,489495649,479104690,489498525,2876,489497616,
4707288973,489784055,479393101,489786412,2357,,
4707788975,490284049,479893103,490286032,1983,,
4708044652,490539721,480148780,490541710,1989,490552732,
4708288977,490784042,480393104,490791421,7379,,
4708788978,491284035,480893105,491297060,13025,,
4709065874,491560927,481170003,491573958,13031,491562619,
4709288979,491784027,481393107,491792003,7976,,
4709788980,492284021,481893108,492285727,1706,,
4710087517,492582552,482191645,492584264,1712,492584486,
4710288981,492784013,482393109,492785818,1805,,
4710788982,493284006,482893110,493285953,1947,,
4711110750,493605768,483214878,493607722,1954,493608498,
4711288984,493783998,483393111,493786232,2234,,
4711788985,494283991,483893113,494286735,2744,,
4712130600,494625600,484234728,494628350,2750,494626457,
4712288987,494783985,484393115,494786137,2152,,
4712788989,495283979,484893117,495284849,870,,
4713150350,495645333,485254478,495646210,877,495646185,
4713288990,495783970,485393118,495784842,872,,
4713788991,496283963,485893119,496284828,865,,
4714172659,496667625,486276787,496668497,872,496668331,
4714288992,496783955,486393120,496784791,836,,
4714788994,497283949,486893122,497284668,719,,
4715199272,497694221,487303400,497694947,726,497698583,
4715288996,497783942,487393124,497785323,1381,,
4715788998,498283936,487893126,498288311,4375,,
4716220840,498715770,488324968,498720154,4384,498716139,
4716289000,498783929,488393127,498787765,3836,,
4716789001,499283923,488893129,499284303,380,,
4717244625,499739538,489348753,499739927,389,499742569,
4717289003,499783917,489393133,499784541,624,,
4717789006,500283910,489893133,500286952,3042,,
4718264135,500759032,490368263,500762082,3050,500759887,
4718289007,500783903,490393135,500786843,2940,,
4718789008,501283895,490893136,501284761,866,,
4719320004,501814883,491424134,501815760,877,501805755,
4719320019,501814898,491424149,501815773,875,,
4719820020,502314889,491924148,502305774,-9115,,
4720343583,502838443,492447711,502829337,-9106,502841329,
4720343590,502838450,492447718,502829343,-9107,,
4720843591,503338443,492947719,503341339,2896,,
4721372498,503867342,493476626,503870247,2905,503872722,
4721372505,503867349,493476633,503870253,2904,,
4721872507,504367341,493976635,504372733,5392,,
4722397264,504892089,494501392,504897490,5401,504895566,
4722397271,504892096,494501399,504897496,5400,,
4722897272,505392089,495001399,505395576,3487,,
4723420930,505915739,495525059,505919236,3497,505918653,
4723420937,505915746,495525066,505919242,3496,,
4723920938,506415738,496025066,506418662,2924,,
4724445366,506940158,496549495,506943091,2933,506942676,
4724445374,506940166,496549502,506943098,2932,,
4724945375,507440158,497049503,507442688,2530,,
4725469469,507964243,497573597,507966782,2539,507967008,
4725469476,507964250,497573604,507966788,2538,,
4725969478,508464244,498073606,508467020,2776,,
4726489561,508984318,498593690,508987104,2786,508985225,
4726489570,508984327,498593699,508987111,2784,,
4726989571,509484319,499093699,509485237,918,,
4727489572,509984311,499593700,509985237,926,,
4727513543,510008282,499617671,510009209,927,510011245,
4727989574,510484304,500093702,510487179,2875,,
4728489575,510984298,500593703,510987279,2981,,
4728534834,511029555,500638962,511032537,2982,511031337,
4728989577,511484290,501093705,511486191,1901,,
4729489578,511984284,501593706,511986083,1799,,
4729554245,512048950,501658373,512050751,1801,512049575,
4729989580,512484277,502093708,512485062,785,,
4730489583,512984271,502593711,512984914,643,,
4730573971,513068657,502678099,513069302,645,513069537,
4730989585,513484264,503093713,513485114,850,,
4731489586,513984258,503593715,513985155,897,,
4731597099,514091769,503701227,514092668,899,514094710,
4731989589,514484251,504093717,514486761,2510,,
4732489591,514984245,504593719,514987203,2958,,
4732618161,515112814,504722290,515115774,2960,515114446,
4732989592,515484238,505093721,515486221,1983,,
4733489593,515984231,505593722,515985881,1650,,
4733638882,516133517,505743011,516135170,1653,516135257,
4733989594,516484223,506093722,516485945,1722,,
4734489596,516984217,506593725,516985974,1757,,
4734669286,517163904,506773415,517165664,1760,517167404,
4734989597,517484209,507093726,517487091,2882,,
4735489598,517984201,507593726,517987719,3518,,
4735692319,518186919,507796448,518190441,3522,518189826,
4735989601,518484195,508093729,518487357,3162,,
4736489602,518984188,508593730,518987111,2923,,
4736715609,519210192,508819738,519213120,2928,519212979,
4736989603,519484180,509093731,519487036,2856,,
4737489606,519984175,509593734,519986977,2802,,
4737734795,520229361,509838924,520232168,2807,520230319,
4737989608,520484168,510093736,520486038,1870,,
4738489610,520984163,510593738,520985136,973,,
4738759863,521254411,510863991,521255390,979,521258271,
4738989613,521484156,511093741,521486463,2307,,
4739489614,521984149,511593742,521988024,3875,,
4739783356,522277887,511887485,522281767,3880,522280863,
4739989617,522484143,512093745,522487655,3512,,
4740489618,522984137,512593747,522987129,2992,,
4740807014,523301528,512911143,523304525,2997,523304555,
4740989620,523484130,513093749,523487141,3011,,
4741489621,523984122,513593749,523987164,3042,,
4741831269,524325764,513935397,524328813,3049,524328989,
4741989623,524484116,514093751,524487222,3106,,
4742489624,524984108,514593752,524987346,3238,,
4742855454,525349933,514959583,525353177,3244,525352859,
4742989627,525484102,515093755,525487265,3163,,
4743489629,525984096,515593757,525987036,2940,,
4743882516,526376977,515986645,526379925,2948,526381816,
4743989632,526484091,516093761,526487447,3356,,
4744489635,526984085,516593763,526988937,4852,,
4744906271,527400715,517010400,527405575,4860,527403902,
4744989636,527484077,517093764,527488659,4582,,
4745489639,527984072,517593767,527987272,3200,,
4745927206,528421631,518031334,528424840,3209,528423401,
4745989640,528484064,518093768,528487093,3029,,
4746489643,528984060,518593771,528985842,1782,,
4746951461,529445870,519055589,529447660,1790,529449065,
4746989647,529484054,519093775,529485951,1897,,
4747489648,529984047,519593776,529987255,3208,,
4747979289,530473680,520083418,530476896,3216,530477752,
4747989649,530484039,520093777,530487270,3231,,
4748489650,530984033,520593778,530988116,4083,,
4749002280,531496653,521106408,531500746,4093,531499490,
4749002288,531496662,521106417,531500753,4091,,
4749502290,531996655,521606417,531999502,2847,,
4750023352,532517709,522127480,532520565,2856,532519270,
4750023359,532517716,522127487,532520571,2855,,
4750523360,533017708,522627488,533019281,1573,,
4751042385,533536725,523146514,533538307,1582,533537646,
4751042425,533536765,523146554,533538345,1580,,
4751542427,534036757,523646555,534037691,934,,
4752042428,534536750,524146556,534537692,942,,
4752062522,534556844,524166651,534557787,943,534558139,
4752542429,535036742,524646557,535038035,1293,,
4753042432,535536737,525146560,535538051,1314,,
4753081665,535575970,525185793,535577285,1315,535576863,
4753542434,536036731,525646563,536037668,937,,
4754042436,536536725,526146564,536537637,912,,
4754103605,536597891,526207733,536598806,915,536599978,
4754542437,537036716,526646565,537038669,1953,,
4755042439,537536711,527146568,537538816,2105,,
4755128116,537622385,527232244,537624493,2108,537626091,
4755542441,538036704,527646570,538040144,3440,,
4756042444,538536699,528146572,538540422,3723,,
4756156858,538651111,528260986,538654836,3725,538655071,
4756542446,539036692,528646574,539040606,3914,,
4757042449,539536686,529146577,539540664,3978,,
4757177585,539671820,529281714,539675801,3981,539673008,
4757542451,540036679,529646579,540038629,1950,,
4758042454,540536675,530146583,540537880,1205,,
4758203213,540697431,530307342,540698639,1208,540701224,
4758542455,541036667,530646583,541039636,2969,,
4759042456,541536660,531146585,541540471,3811,,
4759226533,541720733,531330662,541724548,3815,541723585,
4759542459,542036653,531646587,542039866,3213,,
4760042460,542536647,532146588,542539515,2868,,
4760245795,542739978,532349923,542742851,2873,542740792,
4760542461,543036638,532646589,543038296,1658,,
4761042463,543536632,533146591,543537462,830,,
4761268824,543762990,533372953,543763824,834,543764355,
4761542464,544036624,533646592,544037755,1131,,
4762042465,544536618,534146594,544537998,1380,,
4762292649,544786797,534396778,544788182,1385,544789658,
4762542466,545036609,534646594,545038737,2128,,
4763042468,545536604,535146596,545539480,2876,,
4763320341,545814472,535424469,545817353,2881,545819720,
4763542470,546036596,535646598,546040533,3937,,
4764042471,546536589,536146598,546541852,5263,,
4764341248,546835361,536445377,546840631,5270,546835863,
4764542472,547036582,536646601,547039935,3353,,
4765042475,547536577,537146603,547537093,516,,
4765368866,547862962,537472995,547863483,521,547864302,
4765542476,548036568,537646604,548037376,808,,
4766042477,548536561,538146605,548537915,1354,,
4766397978,548892056,538502107,548893417,1361,548892817,
4766542479,549036555,538646608,549037745,1190,,
4767042480,549536547,539146607,549537320,773,,
4767417196,549911257,539521324,549912037,780,549912134,
4767542481,550036540,539646609,550037347,807,,
4768042484,550536534,540146612,550537424,890,,
4768440653,550934697,540544781,550935594,897,550937684,
4768542486,551036528,540646615,551037851,1323,,
4769042488,551536522,541146616,551539522,3000,,
4769466297,551960323,541570426,551963332,3009,551962708,
4769542491,552036515,541646619,552039429,2914,,
4770042492,552536509,542146620,552538906,2397,,
4770487832,552981841,542591960,552984246,2405,552982560,
4770542493,553036500,542646621,553038722,2222,,
4771042495,553536495,543146623,553537226,731,,
4771508042,554002034,543612170,554002773,739,554003364,
4771542499,554036490,543646627,554037269,779,,
4772042501,554536484,544146630,554537826,1342,,
4772527779,555021752,544631907,555023104,1352,555022567,
4772542502,555036475,544646630,555037808,1333,,
4773042503,555536468,545146631,555537294,826,,
4773548157,556042113,545652285,556042948,835,556043050,
4773548165,556042122,545652294,556042954,832,,
4774048166,556542114,546152294,556543062,948,,
4774588767,557082706,546692895,557083663,957,557093713,
4774588776,557082714,546692904,557083671,957,,
4775088778,557582709,547192907,557593727,11018,,
4775624788,558118710,547728917,558129738,11028,558115415,
4775624796,558118717,547728923,558129743,11026,,
4776124798,558618711,548228927,558615428,-3283,,
4776652520,559146424,548756649,559143150,-3274,559151773,
4776652529,559146432,548756657,559143158,-3274,,
4777152531,559646427,549256659,559651787,5360,,
4777676660,560170547,549780788,560175916,5369,560173987,
4777676668,560170554,549780795,560175920,5366,,
4778176669,560670547,550280797,560673999,3452,,
4778700424,561194293,550804553,561197754,3461,561197628,
4778700431,561194300,550804560,561197759,3459,,
4779200433,561694294,551304561,561697639,3345,,
4779719624,562213475,551823752,562216830,3355,562214265,
4779719632,562213484,551823761,562216837,3353,,
4780219633,562713476,552323761,562714278,802,,
4780738930,563232765,552843059,563233576,811,563233594,
4780738940,563232775,552843069,563233583,808,,
4781238942,563732768,553343070,563733609,841,,
4781761047,564254864,553865175,564255714,850,564257281,
4781761081,564254898,553865209,564255747,849,,
4782261084,564754892,554365212,564757321,2429,,
4782784487,565278287,554888616,565280724,2437,565281302,
4782784636,565278436,554888765,565280874,2438,,
4783284637,565778427,555388765,565781455,3028,,
4783784638,566278420,555888766,566281455,3035,,
4783807665,566301447,555911794,566304484,3037,566304338,
4784284640,566778413,556388768,566781320,2907,,
4784784643,567278408,556888771,567281317,2909,,
4784827173,567320937,556931301,567323848,2911,567321914,
4785284644,567778400,557388772,567779552,1152,,
4785784645,568278394,557888774,568279391,997,,
4785851680,568345428,557955808,568346425,997,568347844,
4786284647,568778386,558388775,568780623,2237,,
4786784648,569278379,558888776,569280815,2436,,
4786873223,569366953,558977352,569369390,2437,569368741,
4787284649,569778372,559388778,569780284,1912,,
4787784650,570278364,559888778,570280170,1806,,
4787900503,570394215,560004631,570396024,1809,570399102,
4788284651,570778357,560388780,570782538,4181,,
4788784652,571278349,560888780,571283254,4905,,
4788922401,571416097,561026530,571421003,4906,571417392,
4789284655,571778343,561388783,571780641,2298,,
4789784657,572278338,561888785,572279651,1313,,
4789944931,572438609,562049060,572439926,1317,572441245,
4790284659,572778331,562388787,572780551,2220,,
4790784661,573278324,562888789,573280976,2652,,
4790976861,573470522,563080990,573473177,2655,573465267,
4791284662,573778317,563388790,573776109,-2208,,
4791784664,574278311,563888793,574273072,-5239,,
4791996652,574490295,564100780,574485060,-5235,574490946,
4792284666,574778304,564388794,574776466,-1838,,
4792784667,575278296,564888795,575278963,667,,
4793016857,575510482,565120985,575511154,672,575512020,
4793284668,575778289,565388796,575779429,1140,,
4793784670,576278283,565888798,576279836,1553,,
4794037104,576530713,566141233,576532270,1557,576531113,
4794284672,576778275,566388800,576779265,990,,
4794784675,577278270,566888803,577278686,416,,
4795060904,577554495,567165033,577554916,421,577553539,
4795284676,577778262,567388804,577778071,-191,,
4795784677,578278256,567888806,578277316,-940,,
4796084799,578578372,568188927,578577437,-935,578580945,
4796284679,578778248,568388806,578778719,471,,
4796784681,579278242,568888809,579280829,2587,,
4797108670,579602226,569212798,579604819,2593,579602705,
4797284682,579778235,569388810,579780087,1852,,
4797784683,580278227,569888811,580278720,493,,
4798130454,580623993,570234583,580624493,500,580626219,
4798284684,580778219,570388812,580779254,1035,,
4798784687,581278214,570888815,581280454,2240,,
4799150085,581643607,571254213,581645852,2245,581644874,
4799284689,581778208,571388817,581780192,1984,,
4799784691,582278202,571888819,582279483,1281,,
4800173879,582667382,572278007,582668671,1289,582670209,
4800284693,582778194,572388821,582779825,1631,,
4800784696,583278189,572888824,583281029,2840,,
4801199922,583693408,573304050,583696255,2847,583697445,
4801284698,583778183,573388826,583781233,3050,,
4801784700,584278177,573888829,584282227,4050,,
4802222843,584716311,574326970,584720368,4057,584719155,
4802284701,584778169,574388829,584782075,3906,,
4802784703,585278163,574888832,585281018,2855,,
4803245422,585738874,575349551,585741738,2864,585741062,
4803284705,585778156,575388833,585780965,2809,,
4803784707,586278149,575888835,586280350,2201,,
4804266833,586760268,576370961,586762476,2208,586762413,
4804284709,586778143,576388838,586780348,2205,,
4804784710,587278135,576888838,587280293,2158,,
4805290445,587783862,577394574,587786029,2167,587786909,
4805290453,587783869,577394581,587786035,2166,,
4805790455,588283863,577894583,588286921,3058,,
4806320594,588813994,578424723,588817062,3068,588820411,
4806320603,588814003,578424731,588817069,3066,,
4806820605,589313995,578924733,589320424,6429,,
4807341432,589834814,579445561,589841252,6438,589836412,
4807341441,589834822,579445569,589841258,6436,,
4807841442,590334816,579945571,590336425,1609,,
4808364128,590857493,580468256,590859111,1618,590860152,
4808364137,590857502,580468266,590859119,1617,,
4808864140,591357496,580968268,591360167,2671,,
4809389054,591882402,581493183,591885081,2679,591886335,
4809389062,591882410,581493190,591885087,2677,,
4809889063,592382402,581993191,592386347,3945,,
4810389064,592882394,582493192,592886347,3953,,
4810415855,592909186,582519984,592913140,3954,592914008,
4810889066,593382388,582993194,593387175,4787,,
4811389069,593882382,583493197,593887225,4843,,
4811436819,593930132,583540948,593934976,4844,593932114,
4811889071,594382375,583993199,594384642,2267,,
4812389073,594882370,584493201,594884371,2001,,
4812462378,594955672,584566506,594957676,2004,594958665,
4812889075,595382363,584993204,595385220,2857,,
4813389076,595882356,585493205,595885366,3010,,
4813485413,595978691,585589542,595981703,3012,595981579,
4813889078,596382349,585993207,596385270,2921,,
4814389080,596882342,586493208,596885248,2906,,
4814518446,597011706,586622575,597014616,2910,597019621,
4814889082,597382336,586993211,597388963,6627,,
4815389083,597882328,587493211,597890260,7932,,
4815541942,598035185,587646071,598043120,7935,598036658,
4815889084,598382320,587993212,598385776,3456,,
4816389086,598882314,588493214,598883805,1491,,
4816566483,599059709,588670612,599061203,1494,599062391,
4816889087,599382306,588993215,599384574,2268,,
4817389088,599882299,589493216,599884999,2700,,
4817588804,600082012,589692932,600084715,2703,600082649,
4817889091,600382293,589993219,600383762,1469,,
4818389093,600882288,590493221,600882941,653,,
4818612542,601105732,590716670,601106389,657,601108520,
4818889094,601382279,590993222,601384120,1841,,
4819389096,601882273,591493224,601885076,2803,,
4819634317,602127490,591738446,602130298,2808,602129399,
4819889097,602382265,591993225,602384620,2355,,
4820389099,602882260,592493227,602884184,1924,,
4820666487,603159643,592770615,603161572,1929,603166562,
4820889100,603382252,592993228,603386407,4155,,
4821389102,603882245,593493230,603889180,6935,,
4821691162,604184300,593795290,604191240,6940,604187626,
4821889104,604382239,593993232,604387750,5511,,
4822389105,604882232,594493233,604885570,3338,,
4822719439,605212559,594823567,605215905,3346,605217574,
4822889107,605382224,594993235,605386138,3914,,
4823389108,605882218,595493236,605887246,5028,,
4823753473,606246575,595857601,606251611,5036,606254129,
4823889110,606382210,595993237,606387930,5720,,
4824389111,606882203,596493238,606889769,7566,,
4824777316,607270402,596881445,607277975,7573,607273356,
4824889112,607382195,596993240,607388736,6541,,
4825389114,607882189,597493242,607885155,2966,,
4825804142,608297210,597908270,608300183,2973,608301761,
4825889116,608382182,597993243,608385425,3243,,
4826389118,608882177,598493246,608886740,4563,,
4826824590,609317641,598928718,609322212,4571,609318898,
4826889119,609382168,598993247,609386312,4144,,
4827389120,609882161,599493247,609883430,1269,,
4827843859,610336893,599947988,610338170,1277,610337707,
4827889126,610382159,599993255,610383396,1237,,
4828389128,610882152,600493256,610882978,826,,
4828868940,611361956,600973069,611362791,835,611364235,
4828889134,611382150,600993264,611383043,893,,
4829389135,611882142,601493263,611884431,2289,,
4829888430,612381428,601992558,612383727,2299,612382264,
4829889136,612382134,601993264,612384429,2295,,
4830389137,612882127,602493265,612882973,846,,
4830920974,613413956,603025103,613414812,856,613421361,
4830920983,613413965,603025112,613414819,854,,
4831420984,613913957,603525112,613921373,7416,,
4831940632,614433596,604044761,614441023,7427,614434141,
4831940640,614433603,604044768,614441029,7426,,
4832440642,614933597,604544770,614934152,555,,
4832959901,615452848,605064030,615453413,565,615453718,
4832959910,615452857,605064038,615453419,562,,
4833459911,615952848,605564039,615953730,882,,
4833979282,616472212,606083410,616473102,890,616473085,
4833979289,616472219,606083417,616473107,888,,
4834479291,616972211,606583419,616973095,884,,
4835011519,617504432,607115649,617505327,895,617508444,
4835011534,617504446,607115664,617505339,893,,
4835511535,618004439,607615663,618008462,4023,,
4836030911,618523806,608135039,618527839,4033,618524620,
4836030953,618523848,608135081,618527879,4031,,
4836530955,619023840,608635082,619024666,826,,
4837051407,619544283,609155535,619545119,836,619545681,
4837051414,619544290,609155542,619545125,835,,
4837551416,620044284,609655544,620045693,1409,,
4838077571,620570431,610181699,620571848,1417,620574690,
4838077578,620570438,610181706,620571854,1416,,
4838577579,621070429,610681707,621074700,4271,,
4839099139,621591981,611203267,621596260,4279,621593653,
4839099146,621591988,611203274,621596266,4278,,
4839599148,622091982,611703276,622093665,1683,,
4840123646,622616470,612227774,622618163,1693,622619277,
4840123653,622616478,612227781,622618169,1691,,
4840623656,623116472,612727783,623119289,2817,,
4841145750,623638557,613249878,623641384,2827,623640745,
4841145757,623638565,613249885,623641390,2825,,
4841645759,624138557,613749887,624140757,2200,,
4842170571,624663361,614274700,624665570,2209,624666774,
4842170579,624663369,614274708,624665576,2207,,
4842670580,625163362,614774708,625166786,3424,,
4843170581,625663353,615274708,625666786,3433,,
4843194371,625687143,615298499,625690577,3434,625690080,
4843670583,626163348,615774711,626166317,2969,,
4844170586,626663341,616274713,626666297,2956,,
4844217817,626710573,616321946,626713530,2957,626711289,
4844670587,627163335,616774715,627164272,937,,
4845170589,627663327,617274717,627664062,735,,
4845242070,627734808,617346198,627735544,736,627738243,
4845670591,628163322,617774719,628166380,3058,,
4846170593,628663314,618274720,628666768,3454,,
4846262104,628754825,618366232,628758280,3455,628755605,
4846670594,629163307,618774722,629164585,1278,,
4847170595,629663300,619274723,629664099,799,,
4847291825,629784527,619395953,629785329,802,629788693,
4847670596,630163293,619774724,630166651,3358,,
4848170598,630663286,620274726,630667468,4182,,
4848316059,630808745,620420187,630812930,4185,630811557,
4848670601,631163280,620774728,631166499,3219,,
4849170603,631663273,621274731,631666103,2830,,
4849379840,631872508,621483969,631875343,2835,631895096,
4849670605,632163267,621774733,632177595,14328,,
4850170606,632663259,622274734,632685865,22606,,
4850409470,632902120,622513599,632924730,22610,632902306,
4850670607,633163252,622774734,633174155,10903,,
4851170609,633663245,623274736,633663446,201,,
4851430687,633923320,623534815,633923525,205,633925272,
4851670611,634163240,623774739,634164287,1047,,
4852170613,634663232,624274740,634665200,1968,,
4852450998,634943614,624555126,634945586,1972,634944879,
4852670615,635163226,624774743,635164892,1666,,
4853170616,635663219,625274744,635664499,1280,,
4853474943,635967540,625579071,635968825,1285,635970534,
4853670617,636163212,625774746,636165169,1957,,
4854170618,636663203,626274745,636666211,3008,,
4854494382,636986963,626598511,636989977,3014,636987919,
4854670620,637163197,626774748,637165488,2291,,
4855170622,637663190,627274749,637664161,971,,
4855515723,638008286,627619851,638009263,977,638010104,
4855670624,638163185,627774752,638164425,1240,,
4856170625,638663176,628274753,638665007,1831,,
4856535189,639027735,628639318,639029572,1837,639028701,
4856670627,639163171,628774755,639164773,1602,,
4857170629,639663163,629274757,639664142,979,,
4857554376,640046905,629658505,640047890,985,640047835,
4857670630,640163156,629774757,640164129,973,,
4858170632,640663150,630274760,640664093,943,,
4858578668,641071178,630682796,641072129,951,641074442,
4858670633,641163142,630774761,641164518,1376,,
4859170634,641663134,631274761,641666410,3276,,
4859598058,642090552,631702186,642093835,3283,642091416,
4859670635,642163127,631774763,642166059,2932,,
4860170637,642663120,632274765,642663996,876,,
4860621708,643114184,632725836,643115068,884,643117404,
4860670638,643163114,632774766,643164226,1112,,
4861170639,643663105,633274767,643666337,3232,,
4861645432,644137890,633749560,644141130,3240,644140855,
4861670643,644163102,633774772,644166329,3227,,
4862170645,644663094,634274772,644666070,2976,,
4862688134,645180576,634792262,645183560,2984,645193154,
4862688141,645180583,634792269,645183566,2983,,
4863188142,645680574,635292270,645693164,12590,,
4863711041,646203465,635815169,646216064,12599,646205281,
4863711048,646203472,635815176,646216070,12598,,
4864211049,646703465,636315177,646705290,1825,,
4864735674,647228080,636839802,647229916,1836,647231180,
4864735681,647228087,636839809,647229922,1835,,
4865235682,647728079,637339809,647731190,3111,,
4865759816,648252205,637863945,648255325,3120,648255411,
4865759823,648252212,637863952,648255331,3119,,
4866259825,648752205,638363953,648755421,3216,,
4866779136,649271508,638883265,649274733,3225,649272265,
4866779177,649271549,638883305,649274772,3223,,
4867279178,649771541,639383306,649772309,768,,
4867779179,650271533,639883307,650272309,776,,
4867802778,650295133,639906906,650295909,776,650298136,
4868279181,650771526,640383309,650774436,2910,,
4868779183,651271521,640883311,651274544,3023,,
4868822207,651314543,640926335,651317568,3025,651315283,
4869279184,651771513,641383312,651772458,945,,
4869779186,652271506,641883313,652272264,758,,
4869842384,652334703,641946512,652335462,759,652335806,
4870279188,652771499,642383316,652772568,1069,,
4870779190,653271494,642883318,653272614,1120,,
4870866160,653358463,642970289,653359586,1123,653361617,
4871279192,653771486,643383319,653774297,2811,,
4871779193,654271479,643883321,654274652,3173,,
4871887908,654380193,643992036,654383368,3175,654382112,
4872279195,654771472,644383323,654773673,2201,,
4872779198,655271467,644883325,655273404,1937,,
4872908669,655400937,645012797,655402876,1939,655402506,
4873279200,655771460,645383328,655773133,1673,,
4873779202,656271454,645883329,656273041,1587,,
4873932162,656424412,646036291,656426003,1591,656427372,
4874279203,656771446,646383331,656773995,2549,,
4874779205,657271440,646883333,657274417,2977,,
4874958763,657450996,647062893,657453978,2982,657455467,
4875279206,657771432,647383333,657775375,3943,,
4875779207,658271425,647883335,658275914,4489,,
4875982342,658474558,648086470,658479049,4491,658477442,
4876279208,658771417,648383335,658774961,3544,,
4876779209,659271411,648883337,659274312,2901,,
4877001542,659493740,649105671,659496646,2906,659494727,
4877279211,659771403,649383339,659773249,1846,,
4877779213,660271397,649883341,660272400,1003,,
4878020929,660513109,650125057,660514116,1007,660514026,
4878279215,660771390,650383342,660772356,966,,
4878779216,661271384,650883344,661272316,932,,
4879042536,661534700,651146666,661535640,940,661536605,
4879279217,661771376,651383345,661772776,1400,,
4879779218,662271368,651883345,662273291,1923,,
4880066125,662558271,652170253,662560199,1928,662561246,
4880279219,662771360,652383347,662773739,2379,,
4880779221,663271354,652883348,663274344,2990,,
4881087917,663580046,653192045,663583041,2995,663581053,
4881279222,663771347,653383350,663773586,2239,,
4881779223,664271339,653883351,664272361,1022,,
4882109284,664601394,654213412,664602422,1028,664603067,
4882279224,664771331,654383352,664772581,1250,,
4882779225,665271324,654883352,665273010,1686,,
4883133506,665625600,655237635,665627292,1692,665628230,
4883279226,665771316,655383354,665773285,1969,,
4883779228,666271310,655883356,666273954,2644,,
4884159547,666651623,656263675,666654273,2650,666655889,
4884279229,666771302,656383357,666774341,3039,,
4884779231,667271296,656883359,667275575,4279,,
4885196294,667688353,657300422,667692639,4286,667697934,
4885279233,667771289,657383361,667776454,5165,,
4885779234,668271282,657883362,668280876,9594,,
4886222134,668714175,658326263,668723776,9601,668718066,
4886279235,668771275,658383363,668780224,8949,,
4886779236,669271268,658883364,669275170,3902,,
4887242241,669734265,659346370,669738175,3910,669735535,
4887279237,669771260,659383365,669774973,3713,,
4887779239,670271254,659883367,670272535,1281,,
4888272362,670764368,660376490,670765658,1290,670769794,
4888279240,670771246,660383369,670772594,1348,,
4888779241,671271239,660883369,671276676,5437,,
4889299779,671791767,661403907,671797214,5447,671796672,
4889299786,671791775,661403914,671797220,5445,,
4889799787,672291768,661903915,672296683,4915,,
4890320226,672812198,662424354,672817122,4924,672813680,
4890320233,672812204,662424361,672817128,4924,,
4890820235,673312198,662924363,673313691,1493,,
4891378693,673870648,663482823,673872152,1504,673891011,
4891378708,673870663,663482838,673872165,1502,,
4891878709,674370653,663982837,674391029,20376,,
4892403715,674895651,664507844,674916036,20385,674898658,
4892403723,674895658,664507851,674916040,20382,,
4892903725,675395652,665007853,675398669,3017,,
4893423142,675915061,665527270,675918087,3026,675915888,
4893423149,675915068,665527277,675918093,3025,,
4893923150,676415060,666027278,676415898,838,,
4894444223,676936124,666548351,676936972,848,676937542,
4894444230,676936132,666548358,676936978,846,,
4894944231,677436123,667048359,677437552,1429,,
4895444232,677936116,667548359,677937553,1437,,
4895467900,677959783,667572028,677961221,1438,677962864,
4895944233,678436109,668048361,678439122,3013,,
4896444234,678936101,668548361,678939200,3099,,
4896503559,678995426,668607689,678998528,3102,679003602,
4896944236,679436094,669048364,679443679,7585,,
4897444237,679936088,669548365,679944284,8196,,
4897523390,680015239,669627518,680023437,8198,680016444,
4897944239,680436080,670048367,680438401,2321,,
4898444241,680936075,670548369,680937298,1223,,
4898545452,681037284,670649580,681038509,1225,681038489,
4898944242,681436066,671048369,681437284,1218,,
4899444244,681936061,671548372,681937284,1223,,
4899575964,682067778,671680092,682069004,1226,682068453,
4899944246,682436054,672048374,682436880,826,,
4900444247,682936046,672548375,682936737,691,,
4900599975,683091772,672704103,683092466,694,683094990,
4900949660,683441451,673053789,683443919,2468,,
4901449664,683941447,673553793,683944683,3236,,
4901624297,684116077,673728426,684119316,3239,684118930,
4901949667,684441441,674053796,684444437,2996,,
4902449668,684941433,674553795,684944303,2870,,
4902649940,685141702,674754069,685144576,2874,685145651,
4902949669,685441426,675053797,685444950,3524,,
4903449671,685941419,675553799,685945383,3964,,
4903670198,686161942,675774326,686165910,3968,686163313,
4903949672,686441411,676053799,686443933,2522,,
4904449673,686941404,676553801,686942790,1386,,
4904693859,687185586,676797988,687186977,1391,687188705,
4904949674,687441396,677053802,687443675,2279,,
4905449676,687941391,677553804,687944524,3133,,
4905717726,688209436,677821854,688212575,3139,688212275,
4905949677,688441382,678053805,688444387,3005,,
4906449678,688941375,678553806,688944229,2854,,
4906742157,689233849,678846285,689236708,2859,689236779,
4906949679,689441367,679053807,689444260,2893,,
4907449680,689941361,679553808,689944305,2944,,
4907766178,690257853,679870306,690260803,2950,690261026,
4907949681,690441353,680053809,690444388,3035,,
4908449683,690941346,680553811,690944532,3186,,
4908789527,691281184,680893655,691284377,3193,691284225,
4908949685,691441339,681053813,691444487,3148,,
4909449686,691941333,681553814,691944386,3053,,
4909822748,692314388,681926877,692317450,3062,692318353,
4909949688,692441325,682053815,692444618,3293,,
4910449689,692941318,682553816,692945295,3977,,
4910842020,693333642,682946148,693337626,3984,693334506,
4910949690,693441311,683053818,693444624,3313,,
4911449692,693941304,683553820,693942180,876,,
4911862010,694353615,683966138,694354499,884,694354807,
4911949693,694441297,684053821,694442236,939,,
4912449696,694941291,684553823,694942495,1204,,
4912886675,695378264,684990805,695379477,1213,695381582,
4912949697,695441284,685053825,695442760,1476,,
4913449699,695941277,685553827,695944608,3331,,
4913925768,696417338,686029896,696420678,3340,696409152,
4913949702,696441271,686053829,696444058,2787,,
4914449704,696941265,686553832,696933089,-8176,,
4914950297,697441850,687054425,697433683,-8167,697444606,
4914950304,697441857,687054432,697433690,-8167,,
4915450306,697941850,687554433,697944617,2767,,
4915973091,698464627,688077219,698467403,2776,698466218,
4915973098,698464634,688077226,698467409,2775,,
4916473099,698964626,688577227,698966229,1603,,
4916996922,699488439,689101050,699490052,1613,699491651,
4916996929,699488446,689101057,699490057,1611,,
4917496930,699988439,689601058,699991661,3222,,
4918018530,700510031,690122659,700513262,3231,700509842,
4918018539,700510040,690122668,700513269,3229,,
4918518540,701010031,690622668,701009854,-177,,
4919045065,701536548,691149193,701536380,-168,701540156,
4919045072,701536554,691149200,701536386,-168,,
4919545074,702036549,691649202,702040167,3618,,
4920075142,702566608,692179271,702570237,3629,702566920,
4920075149,702566615,692179278,702570243,3628,,
4920575150,703066606,692679278,703066929,323,,
4921099565,703591013,693203693,703591344,331,703594407,
4921099605,703591053,693203733,703591384,331,,
4921599606,704091045,693703734,704094451,3406,,
4922125076,704616506,694229204,704619921,3415,704620483,
4922125083,704616514,694229211,704619927,3413,,
4922625085,705116507,694729213,705120495,3988,,
4923144895,705636308,695249023,705640305,3997,705637214,
4923144902,705636316,695249030,705640310,3994,,
4923644904,706136308,695749032,706137226,918,,
4924165737,706657133,696269866,706658059,926,706657221,
4924165745,706657140,696269873,706658064,924,,
4924665747,707157134,696769875,707157232,98,,
4925188935,707680315,697293065,707680423,108,707683290,
4925188950,707680329,697293080,707680435,106,,
4925688952,708180322,697793080,708183309,2987,,
4926212589,708703951,698316717,708706947,2996,708707124,
4926212596,708703958,698316724,708706953,2995,,
4926712598,709203950,698816725,709207135,3185,,
4927237245,709728589,699341374,709731783,3194,709731591,
4927237253,709728596,699341381,709731789,3193,,
4927737254,710228590,699841382,710231601,3011,,
4928261274,710752601,700365403,710755622,3021,710755675,
4928261315,710752642,700365444,710755661,3019,,
4928761316,711252633,700865443,711255718,3085,,
4929285315,711776624,701389444,711779718,3094,711778946,
4929285323,711776632,701389451,711779725,3093,,
4929785324,712276624,701889452,712278956,2332,,
4930309246,712800538,702413374,712802879,2341,712802714,
4930309253,712800545,702413381,712802885,2340,,
4930809254,713300536,702913382,713302723,2187,,
4931336959,713828234,703441087,713830429,2195,713833217,
4931337000,713828274,703441128,713830467,2193,,
4931837001,714328266,703941129,714333260,4994,,
4932360722,714851978,704464850,714856981,5003,714855164,
4932360728,714851984,704464856,714856985,5001,,
4932860730,715351978,704964857,715355174,3196,,
4933384494,715875734,705488623,715878939,3205,715878919,
4933384503,715875743,705488632,715878947,3204,,
4933884504,716375735,705988632,716378932,3197,,
4934404077,716895299,706508206,716898505,3206,716896427,
4934404084,716895306,706508213,716898512,3206,,
4934904085,717395298,707008213,717396436,1138,,
4935429201,717920405,707533329,717921552,1147,717923434,
4935429208,717920412,707533336,717921558,1146,,
4935929209,718420405,708033337,718423445,3040,,
4936453655,718944843,708557784,718947891,3048,718947553,
4936453662,718944850,708557791,718947897,3047,,
4936953663,719444842,709057791,719447564,2722,,
4937480123,719971292,709584251,719974023,2731,719975340,
4937480129,719971299,709584258,719974028,2729,,
4937980130,720471292,710084258,720475349,4057,,
4938506449,720997601,710610577,721001668,4067,721002091,
4938506491,720997644,710610619,721001709,4065,,
4939006492,721497636,711110620,721502137,4501,,
4939527339,722018474,711631467,722022984,4510,722018799,
4939527347,722018481,711631474,722022989,4508,,
4940027348,722518474,712131476,722518809,335,,
4940550907,723042024,712655035,723042368,344,723045068,
4940550914,723042031,712655042,723042374,343,,
4941050915,723542023,713155043,723545078,3055,,
4941576142,724067242,713680270,724070306,3064,724069821,
4941576151,724067250,713680279,724070314,3064,,
4942076152,724567243,714180279,724569833,2590,,
4942599195,725090278,714703324,725092878,2600,725093040,
4942599202,725090285,714703331,725092884,2599,,
4943099203,725590277,715203331,725593049,2772,,
4943620513,726111579,715724641,726114360,2781,726113366,
4943620520,726111586,715724648,726114366,2780,,
4944120521,726611577,716224649,726613376,1799,,
4944655969,727147016,716760097,727148825,1809,727154403,
4944655976,727147024,716760104,727148831,1807,,
4945155978,727647017,717260106,727654414,7397,,
4945681863,728172893,717785991,728180300,7407,728177034,
4945681870,728172900,717785998,728180306,7406,,
4946181871,728672892,718285999,728677045,4153,,
4946702869,729193882,718806997,729198043,4161,729194330,
4946702877,729193889,718807005,729198049,4160,,
4947202879,729693883,719307007,729694341,458,,
4947726826,730217822,719830955,730218289,467,730220842,
4947726833,730217829,719830962,730218295,466,,
4948226834,730717820,720330962,730720851,3031,,
4948726835,731217813,720830963,731220852,3039,,
4948752870,731243847,720856998,731246888,3041,731248142,
4949226837,731717806,721330965,731722046,4240,,
4949726838,732217800,721830966,732222112,4312,,
4949778737,732269698,721882866,732274012,4314,732273823,
4950226840,732717793,722330968,732721949,4156,,
4950726841,733217786,722830969,733221929,4143,,
4950800952,733291895,722905080,733296041,4146,733294256,
4951226842,733717778,723330970,733720412,2634,,
4951726844,734217771,723830972,734220150,2379,,
4951828103,734319029,723932231,734321410,2381,734322049,
4952226845,734717763,724330972,734720663,2900,,
4952726847,735217757,724830975,735220795,3038,,
4952856154,735347062,724960282,735350103,3041,735352276,
4953226848,735717750,725330976,735722410,4660,,
4953726849,736217743,725830977,736222974,5231,,
4953880924,736371814,725985052,736377049,5235,736375310,
4954226851,736717735,726330979,736721774,4039,,
4954726853,737217729,726830980,737221241,3512,,
4954901942,737392815,727006070,737396330,3515,737394478,
4955226854,737717721,727330981,737720039,2318,,
4955726855,738217714,727830983,738219394,1680,,
4955940733,738431588,728044861,738433272,1684,738440581,
4956226856,738717707,728330984,738723578,5871,,
4956726858,739217701,728830986,739226709,9008,,
4956966484,739457322,729070612,739466335,9013,739461423,
4957226860,739717693,729330988,739724153,6460,,
4957726861,740217687,729830989,740221802,4115,,
4957985924,740476745,730090052,740480866,4121,740477640,
4958226863,740717679,730330991,740720251,2572,,
4958726865,741217673,730830993,741218583,910,,
4959008885,741499688,731113013,741500604,916,741500229,
4959226867,741717666,731330995,741718422,756,,
4959726868,742217659,731830996,742218214,555,,
4960033732,742524518,732137860,742525078,560,742523750,
4960226870,742717652,732330997,742717703,51,,
4960726871,743217646,732831000,743216892,-754,,
4961061660,743552428,733165788,743551680,-748,743555834,
4961226872,743717637,733331000,743718265,628,,
4961726874,744217631,733831002,744221050,3419,,
4962082483,744573235,734186611,744576660,3425,744574193,
4962226875,744717623,734331003,744720338,2715,,
4962726877,745217617,734831005,745218588,971,,
4963102070,745592803,735206198,745593782,979,745593870,
4963226878,745717610,735331006,745718611,1001,,
4963726879,746217603,735831007,746218682,1079,,
4964127193,746617909,736231321,746618996,1087,746621709,
4964226880,746717595,736331009,746719223,1628,,
4964726882,747217588,736831010,747221400,3812,,
4965228945,747719644,737333075,747723467,3823,747684623,
4965228961,747719660,737333091,747723478,3818,,
4965728962,748219651,737833090,748184642,-35009,,
4966261839,748752520,738365968,748717520,-35000,748759857,
4966261846,748752527,738365975,748717527,-35000,,
4966761848,749252520,738865976,749259867,7347,,
4967285759,749776421,739389887,749783778,7357,749779413,
4967285766,749776428,739389894,749783785,7357,,
4967785768,750276422,739889896,750279424,3002,,
4968310084,750800730,740414213,750803741,3011,750803913,
4968310091,750800737,740414220,750803747,3010,,
4968810092,751300728,740914220,751303922,3194,,
4969310093,751800722,741414221,751803923,3201,,
4969343700,751834328,741447828,751837531,3203,751842393,
4969810095,752300715,741914223,752308463,7748,,
4970310096,752800707,742414224,752808790,8083,,
4970365003,752855614,742469131,752863698,8084,752857343,
4970810098,753300700,742914226,753303138,2438,,
4971310101,753800695,743414228,753802443,1748,,
4971393537,753884130,743497665,753885880,1750,753887741,
4971810102,754300688,743914230,754303998,3310,,
4972310104,754800681,744414232,754804310,3629,,
4972415859,754906434,744519987,754910066,3632,754908832,
4972810106,755300674,744914233,755303341,2667,,
4973310107,755800668,745414235,755803083,2415,,
4973439193,755929752,745543322,755932169,2417,755932703,
4973810109,756300660,745914236,756303482,2822,,
4974310110,756800653,746414237,756803622,2969,,
4974460301,756950842,746564429,756953814,2972,756952687,
4974810111,757300646,746914239,757302837,2191,,
4975310113,757800639,747414241,757802500,1861,,
4975498663,757989187,747602792,757991051,1864,757999441,
4975810114,758300632,747914242,758307728,7096,,
4976310115,758800625,748414243,758810895,10270,,
4976519626,759010132,748623754,759020406,10274,759010307,
4976810117,759300617,748914245,759305030,4413,,
4977310118,759800610,749414246,759800801,191,,
4977545366,760035855,749649495,760036050,195,760039695,
4977810119,760300602,749914247,760302732,2130,,
4978310121,760800596,750414249,760804452,3856,,
4978570701,761061173,750674830,761065032,3859,761064874,
4978810122,761300589,750914250,761304377,3788,,
4979310124,761800582,751414252,761804299,3717,,
4979594853,762085307,751698981,762089028,3721,762087348,
4979810125,762300575,751914253,762303576,3001,,
4980310126,762800568,752414255,762802623,2055,,
4980614638,763105074,752718766,763107134,2060,763105790,
4980810128,763300560,752914256,763302099,1539,,
4981310129,763800554,753414257,763801283,729,,
4981636194,764126613,753740322,764127349,736,764127700,
4981810132,764300547,753914259,764301408,861,,
4982310133,764800540,754414260,764801641,1101,,
4982656361,765146762,754760489,765147870,1108,765147324,
4982810134,765300532,754914262,765301475,943,,
4983310135,765800525,755414263,765801100,575,,
4983676402,766166787,755780531,766167369,582,766168155,
4983810136,766300518,755914264,766301311,793,,
4984310137,766800510,756414264,766801891,1381,,
4984701110,767191476,756805238,767192864,1388,767194727,
4984810138,767300503,756914266,767302299,1796,,
4985310140,767800496,757414268,767803759,3263,,
4985732809,768223158,757836937,768226428,3270,768227805,
4985810141,768300488,757914268,768303972,3484,,
4986310142,768800481,758414269,768805140,4659,,
4986764512,769254844,758868642,769259513,4669,769259658,
4986810144,769300474,758914271,769305154,4680,,
4987310146,769800469,759414274,769805296,4827,,
4987788955,770279270,759893084,770284105,4835,770282102,
4987810147,770300461,759914275,770305210,4749,,
4988310148,770800453,760414276,770803296,2843,,
4988812689,771302986,760916817,771305838,2852,771306199,
4988812696,771302993,760916824,771305844,2851,,
4989312698,771802986,761416826,771806210,3224,,
4989834925,772325205,761939054,772328438,3233,772325303,
4989834932,772325212,761939061,772328443,3231,,
4990334933,772825205,762439061,772825313,108,,
4990866041,773356304,762970169,773356421,117,773363005,
4990866049,773356311,762970177,773356427,116,,
4991366050,773856303,763470178,773863015,6712,,
4991890010,774380255,763994138,774386976,6721,774383511,
4991890017,774380262,763994145,774386982,6720,,
4992390019,774880255,764494147,774883522,3267,,
4992909170,775399398,765013298,775402674,3276,775400385,
4992909211,775399438,765013339,775402712,3274,,
4993409212,775899431,765513340,775900429,998,,
4993929333,776419542,766033461,776420549,1007,776420468,
4993929340,776419549,766033467,776420555,1006,,
4994429341,776919542,766533468,776920478,936,,
4994953463,777443656,767057592,777444601,945,777446442,
4994953470,777443662,767057598,777444607,945,,
4995453472,777943656,767557600,777946452,2796,,
4995973576,778463752,768077704,778466557,2805,778465244,
4995973583,778463759,768077711,778466562,2803,,
4996473585,778963751,768577713,778965254,1503,,
4996992887,779483045,769097016,779484558,1513,779483943,
4996992895,779483052,769097023,779484563,1511,,
4997492898,779983047,769597025,779983955,908,,
4998013720,780503860,770117848,780504778,918,780505599,
4998013727,780503868,770117856,780504784,916,,
4998513728,781003860,770617856,781005610,1750,,
4999037040,781527164,771141169,781528922,1758,781529366,
4999037047,781527171,771141176,781528929,1758,,
4999537048,782027162,771641176,782029376,2214,,
5000061199,782551305,772165328,782553528,2223,782554645,
5000061206,782551312,772165334,782553533,2221,,
5000561207,783051304,772665335,783054654,3350,,
5001092498,783582586,773196626,783585946,3360,783586720,
5001092505,783582593,773196633,783585952,3359,,
5001592507,784082586,773696635,784086731,4145,,
5002114778,784604848,774218906,784609003,4155,784606242,
5002114785,784604855,774218913,784609008,4153,,
5002614786,785104848,774718914,785106252,1404,,
5003140790,785630844,775244919,785632257,1413,785632860,
5003140832,785630885,775244960,785632298,1413,,
5003640835,786130879,775744962,786132906,2027,,
5004167079,786657114,776271207,786659150,2036,786660965,
5004167086,786657121,776271214,786659157,2036,,
5004667087,787157114,776771215,787160976,3862,,
5005189119,787679137,777293247,787683008,3871,787678694,
5005189126,787679145,777293255,787683014,3869,,
5005689129,788179139,777793256,788178706,-433,,
5006211731,788701733,778315859,788701309,-424,788702405,
5006211738,788701740,778315866,788701314,-426,,
5006711739,789201732,778815868,789202415,683,,
5007211741,789701725,779315868,789702416,691,,
5007242396,789732380,779346524,789733072,692,789738754,
5007711742,790201718,779815870,790207754,6036,,
5008211744,790701712,780315872,790708104,6392,,
5008266593,790756559,780370721,790762954,6395,790759978,
5008711746,791201704,780815873,791205460,3756,,
5009211747,791701698,781315875,791705135,3437,,
5009291167,791781115,781395295,791784555,3440,791784189,
5009711749,792201690,781815876,792204831,3141,,
5010211751,792701684,782315879,792704775,3091,,
5010320542,792810474,782424670,792813567,3093,792813097,
5010711753,793201678,782815881,793204412,2734,,
5011211755,793701671,783315883,793704311,2640,,
5011352928,793842842,783457056,793845485,2643,793850225,
5011711757,794201664,783815885,794207715,6051,,
5012211759,794701658,784315887,794709058,7400,,
5012375684,794865581,784479813,794872983,7402,794868216,
5012711760,795201650,784815888,795205855,4205,,
5013211762,795701644,785315890,795704295,2651,,
5013400401,795890280,785504530,795892935,2655,795894075,
5013711764,796201638,785815892,796205009,3371,,
5014211765,796701630,786315893,796705440,3810,,
5014419733,796909594,786523861,796913408,3814,796910612,
5014711767,797201624,786815895,797203810,2186,,
5015211768,797701616,787315896,797702649,1033,,
5015439131,797928975,787543259,797930013,1038,797930031,
5015711769,798201608,787815897,798202661,1053,,
5016211770,798701602,788315898,798702673,1071,,
5016460629,798950456,788564758,798951532,1076,798950310,
5016711771,799201594,788815899,799202060,466,,
5017211773,799701587,789315901,799701456,-131,,
5017490563,799980373,789594691,799980247,-126,799980329,
5017711775,800201580,789815903,800201494,-86,,
5018211777,800701574,790315904,800701544,-30,,
5018514326,801004118,790618454,801004094,-24,801007198,
5018711779,801201567,790815907,801202773,1206,,
5019211780,801701560,791315908,801704654,3094,,
5019535206,802024981,791639334,802028080,3099,802025920,
5019711781,802201552,791815909,802203893,2341,,
5020211783,802701546,792315911,802702499,953,,
5020558251,803048009,792662379,803048968,959,803050770,
5020711785,803201539,792815912,803203054,1515,,
5021211787,803701533,793315914,803704308,2775,,
5021577772,804067512,793681900,804070294,2782,804068487,
5021711788,804201526,793815916,804203825,2299,,
5022211790,804701519,794315918,804702506,987,,
5022604302,805094024,794708430,805095019,995,805098126,
5022711792,805201512,794815919,805203176,1664,,
5023211793,805701505,795315921,805705619,4114,,
5023625255,806114960,795729383,806119082,4122,806116517,
5023711795,806201499,795815923,806205178,3679,,
5024211796,806701492,796315924,806703061,1569,,
5024651296,807140984,796755424,807142561,1577,807140530,
5024711797,807201483,796815925,807202814,1331,,
5025211798,807701476,797315926,807701034,-442,,
5025675374,808165045,797779503,808164611,-434,808168379,
5025711799,808201468,797815926,808201307,-161,,
5026211801,808701462,798315929,808704808,3346,,
5026698349,809188002,798802478,809191357,3355,809187227,
5026711803,809201455,798815931,809204697,3242,,
5027211805,809701449,799315932,809700684,-765,,
5027724017,810213653,799828146,810212899,-754,810216280,
5027724030,810213665,799828159,810212910,-755,,
5028224032,810713658,800328160,810716297,2639,,
5028745046,811234665,800849175,811237312,2647,811236571,
5028745053,811234672,800849182,811237318,2646,,
5029245054,811734663,801349181,811736580,1917,,
5029767434,812257034,801871562,812258961,1927,812257816,
5029767441,812257041,801871569,812258967,1926,,
5030267443,812757036,802371571,812757828,792,,
5030789627,813279211,802893755,813280012,801,813281624,
5030789634,813279218,802893763,813280018,800,,
5031289635,813779209,803393762,813781633,2424,,
5031812796,814302362,803916924,814304795,2433,814302633,
5031812803,814302369,803916932,814304800,2431,,
5032312804,814802362,804416932,814802643,281,,
5032832060,815321609,804936189,815321900,291,815322687,
5032832069,815321618,804936198,815321908,290,,
5033332071,815821612,805436199,815822701,1089,,
5033860154,816349686,805964283,816350784,1098,816353537,
5033860195,816349726,805964323,816350822,1096,,
5034360196,816849719,806464324,816853581,3862,,
5034885544,817375058,806989673,817378929,3871,817379136,
5034885551,817375065,806989680,817378935,3870,,
5035385554,817875059,807489681,817879148,4089,,
5035910602,818400099,808014730,818404197,4098,818399778,
5035910609,818400106,808014737,818404203,4097,,
5036410611,818900099,808514739,818899790,-309,,
5036937391,819426869,809041519,819426570,-299,819431726,
5036937398,819426877,809041526,819426577,-300,,
5037437400,819926870,809541528,819931737,4867,,
5037962254,820451715,810066382,820456592,4877,820454450,
5037962261,820451723,810066389,820456598,4875,,
5038462262,820951714,810566390,820954461,2747,,
5038986298,821475742,811090426,821478497,2755,821479279,
5038986305,821475748,811090433,821478503,2755,,
5039486307,821975742,811590435,821979290,3548,,
5040010236,822499662,812114364,822503220,3558,822502982,
5040010246,822499673,812114375,822503229,3556,,
5040510248,822999667,812614376,823002996,3329,,
5041036624,823526033,813140752,823529373,3340,823528568,
5041036631,823526040,813140759,823529379,3339,,
5041536632,824026032,813640759,824028578,2546,,
5042063393,824552785,814167522,824555340,2555,824554454,
5042063401,824552792,814167529,824555346,2554,,
5042563403,825052787,814667531,825054466,1679,,
5043082800,825572175,815186929,825573863,1688,825573188,
5043082808,825572182,815186936,825573869,1687,,
5043582809,826072174,815686937,826073198,1024,,
5044104594,826593951,816208722,826594984,1033,826594718,
5044104632,826593989,816208760,826595020,1031,,
5044604634,827093983,816708762,827094760,777,,
5045128317,827617657,817232445,827618443,786,827618708,
5045128324,827617664,817232452,827618449,785,,
5045628325,828117657,817732453,828118718,1061,,
5046202363,828691685,818306493,828692759,1074,828718968,
5046202378,828691700,818306508,828692772,1072,,
5046702379,829191692,818806507,829218987,27295,,
5047228114,829717418,819332243,829744722,27304,829721563,
5047228121,829717425,819332250,829744727,27302,,
5047728123,830217418,819832251,830221573,4155,,
5048251908,830741195,820356036,830745359,4164,830744363,
5048251915,830741202,820356043,830745365,4163,,
5048751917,831241195,820856045,831244374,3179,,
5049282763,831772033,821386893,831775223,3190,831777675,
5049282779,831772049,821386909,831775236,3187,,
5049782780,832272041,821886908,832277695,5654,,
5050312411,832801663,822416540,832807326,5663,832807685,
5050312418,832801670,822416547,832807332,5662,,
5050812419,833301662,822916547,833307695,6033,,
5051333100,833822335,823437228,833828376,6041,833823853,
5051333107,833822342,823437235,833828382,6040,,
5051833109,834322335,823937237,834323865,1530,,
5052356745,834845961,824460873,834847501,1540,834849123,
5052356752,834845968,824460880,834847506,1538,,
5052856753,835345961,824960881,835349133,3172,,
5053380067,835869266,825484195,835872448,3182,835872534,
5053380074,835869273,825484202,835872453,3180,,
5053880076,836369267,825984204,836372545,3278,,
5054405049,836894231,826509177,836897519,3288,836898277,
5054405091,836894273,826509219,836897560,3287,,
5054905093,837394266,827009220,837398322,4056,,
5055429106,837918271,827533236,837922338,4067,837921509,
5055429120,837918286,827533250,837922351,4065,,
5055929122,838418277,828033250,838421529,3252,,
5056453236,838942384,828557364,838945643,3259,838945936,
5056453243,838942391,828557371,838945649,3258,,
5056953244,839442382,829057372,839445946,3564,,
5057472724,839961853,829576852,839965427,3574,839962827,
5057472731,839961860,829576859,839965433,3573,,
5057972733,840461854,830076861,840462838,984,,
5058497679,840986792,830601807,840987785,993,840990496,
5058497686,840986799,830601814,840987790,991,,
5058997688,841486792,831101816,841490507,3715,,
5059517867,842006961,831621995,842010685,3724,842008329,
5059517874,842006968,831622002,842010691,3723,,
5060017876,842506962,832122004,842508340,1378,,
5060546488,843035566,832650617,843036954,1388,843040259,
5060546500,843035578,832650629,843036964,1386,,
5061046502,843535570,833150630,843540275,4705,,
5061567174,844056235,833671302,844060948,4713,844056620,
5061567181,844056242,833671310,844060953,4711,,
5062067182,844556234,834171310,844556630,396,,
5062567183,845056226,834671311,845056630,404,,
5062591203,845080246,834695332,845080651,405,845083695,
5063067185,845556219,835171313,845559532,3313,,
5063567186,846056213,835671314,846059679,3466,,
5063611606,846100631,835715734,846104099,3468,846101304,
5064067188,846556206,836171316,846557137,931,,
5064567189,847056198,836671317,847056889,691,,
5064633219,847122226,836737347,847122919,693,847122982,
5065067190,847556190,837171318,847556947,757,,
5065567192,848056184,837671320,848056957,773,,
5065656876,848145866,837761004,848146642,776,848148894,
5066067194,848556177,838171322,848558809,2632,,
5066567196,849056171,838671324,849059216,3045,,
5066683846,849172819,838787974,849175867,3048,849177161,
5067067197,849556164,839171325,849560211,4047,,
5067567198,850056156,839671326,850060515,4359,,
5067742874,850231830,839847004,850236194,4364,850213741,
5068067199,850556149,840171327,850545954,-10195,,
5068567200,851056141,840671328,851038069,-18072,,
5068802999,851291938,840907129,851273872,-18066,851313245,
5069067202,851556134,841171329,851558879,2745,,
5069567203,852056128,841671331,852077453,21325,,
5069827638,852316558,841931766,852337888,21330,852320315,
5070067204,852556120,842171332,852569034,12914,,
5070567206,853056113,842671334,853059885,3772,,
5070877341,853366243,842981469,853370021,3778,853382634,
5071067207,853556106,843171335,853564676,8570,,
5071567208,854056099,843671337,854072503,16404,,
5071923240,854412125,844027369,854428537,16412,854426221,
5072067210,854556091,844171338,854571837,15746,,
5072567212,855056086,844671340,855070196,14110,,
5072948689,855437556,845052817,855451674,14118,855441427,
5073067213,855556078,845171341,855567768,11690,,
5073567215,856056071,845671343,856059955,3884,,
5073970432,856459281,846074560,856463172,3891,856461463,
5074067216,856556063,846171343,856559624,3561,,
5074567217,857056056,846671344,857058250,2194,,
5074991393,857480224,847095521,857482426,2202,857482000,
5075067218,857556048,847171345,857558186,2138,,
5075567220,858056043,847671348,858057830,1787,,
5076011637,858500452,848115766,858502248,1796,858502057,
5076067221,858556034,848171348,858557808,1774,,
5076567223,859056028,848671351,859057645,1617,,
5077036076,859524873,849140204,859526498,1625,859528512,
5077067229,859556027,849171359,859557778,1751,,
5077567231,860056019,849671359,860059669,3650,,
5078059757,860548536,850163885,860552195,3659,860551754,
5078067232,860556012,850171360,860559664,3652,,
5078567233,861056004,850671361,861059232,3228,,
5079086389,861575151,851190517,861578389,3238,861579814,
5079086396,861575158,851190524,861578396,3238,,
5079586398,862075152,851690526,862079826,4674,,
5080086400,862575146,852190528,862579827,4681,,
5080108337,862597081,852212465,862601765,4684,862599489,
5080586401,863075138,852690529,863077656,2518,,
5081086403,863575131,853190531,863577557,2426,,
5081138138,863626866,853242266,863629293,2427,863633268,
5081586404,864075123,853690532,864081124,6001,,
5082086405,864575116,854190533,864581536,6420,,
5082162439,864651148,854266567,864657571,6423,864654649,
5082586406,865075108,854690534,865079062,3954,,
5083086407,865575102,855190535,865578620,3518,,
5083186203,865674895,855290331,865678415,3520,865678180,
5083586408,866075094,855690536,866078435,3341,,
5084086410,866575087,856190537,866578389,3302,,
5084210334,866699010,856314462,866702314,3304,866702456,
5084586412,867075081,856690540,867078499,3418,,
5085086414,867575074,857190541,867578537,3463,,
5085245767,867734425,857349895,867737891,3466,867743563,
5085586416,868075067,857690544,868082404,7337,,
5086086417,868575060,858190544,868584214,9154,,
5086270496,868759137,858374624,868768294,9157,868762285,
5086586419,869075054,858690547,869080421,5367,,
5087086420,869575047,859190548,869578211,3164,,
5087299232,869787854,859403360,869791024,3170,869793498,
5087586422,870075039,859690550,870079635,4596,,
5088086423,870575032,860190551,870580691,5659,,
5088320454,870809060,860424582,870814723,5663,870809211,
5088586424,871075024,860690552,871077761,2737,,
5089086426,871575018,861190554,871575185,167,,
5089347954,871836542,861452083,871836714,172,871840020,
5089586427,872075011,861690555,872076764,1753,,
5090086428,872575003,862190556,872578496,3493,,
5090372645,872861215,862476773,872864714,3499,872864217,
5090586429,873074995,862690556,873078285,3290,,
5091086430,873574989,863190558,873578004,3015,,
5091397414,873885967,863501543,873888989,3022,873889741,
5091586431,874074981,863690559,874078290,3309,,
5092086433,874574974,864190560,874578762,3788,,
5092421543,874910079,864525672,874913873,3794,874913464,
5092586434,875074966,864690561,875078628,3662,,
5093086435,875574959,865190562,875578357,3398,,
5093445326,875933844,865549454,875937249,3405,875937099,
5093586436,876074951,865690564,876078315,3364,,
5094086437,876574944,866190565,876578212,3268,,
5094495956,876984457,866600084,876987732,3275,876985739,
5094586439,877074937,866690566,877077853,2916,,
5095086440,877574931,867190569,877576226,1295,,
5095528577,878017060,867632705,878018363,1303,878024769,
5095586442,878074923,867690570,878076967,2044,,
5096086443,878574917,868190571,878582636,7719,,
5096555137,879043603,868659265,879051331,7728,879047830,
5096586446,879074912,868690576,879082422,7510,,
5097086448,879574904,869190576,879579142,4238,,
5097576664,880065111,869680792,880069358,4247,880067154,
5097586450,880074897,869690577,880079100,4203,,
5098086451,880574890,870190579,880576944,2054,,
5098600765,881089196,870704894,881091258,2062,881092699,
5098600804,881089234,870704932,881091296,2062,,
5099100805,881589227,871204933,881592740,3513,,
5099622825,882111239,871726954,882114761,3522,882113477,
5099622833,882111247,871726961,882114767,3520,,
5100122835,882611239,872226963,882613488,2249,,
5100649344,883137739,872753472,883139998,2259,883142227,
5100649351,883137747,872753479,883140004,2257,,
5101149353,883637740,873253481,883642238,4498,,
5101672298,884160677,873776426,884165184,4507,884163424,
5101672305,884160684,873776433,884165190,4506,,
5102172307,884660676,874276434,884663435,2759,,
5102694117,885182478,874798245,885185246,2768,885184584,
5102694124,885182485,874798252,885185251,2766,,
5103194126,885682478,875298253,885684595,2117,,
5103717203,886205546,875821331,886207673,2127,886208546,
5103717212,886205556,875821340,886207680,2124,,
5104217214,886705549,876321341,886708559,3010,,
5104741803,887230130,876845931,887233149,3019,887233547,
5104741810,887230137,876845938,887233154,3017,,
5105241812,887730129,877345940,887733558,3429,,
5105770858,888259166,877874986,888262604,3438,888265132,
5105770865,888259174,877874993,888262610,3436,,
5106270866,888759166,878374993,888765142,5976,,
5106790334,889278626,878894463,889284612,5986,889279723,
5106790343,889278635,878894472,889284619,5984,,
5107290344,889778626,879394472,889779734,1108,,
5107790345,890278619,879894473,890279735,1116,,
5107814288,890302562,879918417,890303679,1117,890305914,
5108290347,890778612,880394474,890781867,3255,,
5108790348,891278605,880894476,891281976,3371,,
5108837885,891326142,880942014,891329514,3372,891329335,
5109290349,891778598,881394477,891781818,3220,,
5109790350,892278590,881894477,892281801,3211,,
5109857428,892345667,881961556,892348880,3213,892346819,
5110290351,892778582,882394479,892780020,1438,,
5110790353,893278576,882894480,893279746,1170,,
5110879978,893368200,882984107,893369373,1173,893370837,
5111290355,893778569,883394483,893780952,2383,,
5111790357,894278563,883894484,894281217,2654,,
5111904454,894392658,884008582,894395314,2656,894396202,
5112290358,894778556,884394486,894781906,3350,,
5112790360,895278549,884894488,895282110,3561,,
5112933608,895421794,885037736,895425359,3565,895427921,
5113290361,895778542,885394489,895783942,5400,,
5113790363,896278536,885894491,896284678,6142,,
5113953023,896441192,886057151,896447339,6147,896442387,
5114290365,896778528,886394492,896781341,2813,,
5114790367,897278522,886894495,897279733,1211,,
5114987604,897475757,887091734,897476974,1217,897484120,
5115290368,897778515,887394496,897784064,5549,,
5115790369,898278508,887894497,898286888,8380,,
5116017449,898505583,888121577,898513968,8385,898511916,
5116290370,898778499,888394497,898785769,7270,,
5116790371,899278492,888894498,899284840,6348,,
5117039149,899527266,889143277,899533619,6353,899529604,
5117290372,899778485,889394500,899782825,4340,,
5117790373,900278478,889894502,900280831,2353,,
5118058441,900546541,890162569,900548899,2358,900547704,
5118290375,900778470,890394503,900780277,1807,,
5118790377,901278465,890894505,901279641,1176,,
5119084783,901572866,891188912,901574050,1184,901577207,
5119290378,901778457,891394506,901780941,2484,,
5119790380,902278451,891894508,902282808,4357,,
5120105348,902593413,892209476,902597776,4363,902595143,
5120290381,902778443,892394509,902781835,3392,,
5120790382,903278435,892894509,903280179,1744,,
5121138949,903626997,893243078,903628747,1750,903634783,
5121290384,903778428,893394511,903782009,3581,,
5121790385,904278421,893894512,904286220,7799,,
5122162686,904650716,894266814,904658522,7806,904654036,
5122290386,904778413,894394514,904785075,6662,,
5122790388,905278407,894894516,905281739,3332,,
5123193745,905681757,895297873,905685096,3339,905683594,
5123290390,905778400,895394517,905781449,3049,,
5123790392,906278394,895894520,906280243,1849,,
5124218466,906706462,896322594,906708318,1856,906706231,
5124290393,906778386,896394521,906779944,1558,,
5124790395,907278380,896894523,907278162,-218,,
5125269668,907757646,897373798,907757438,-208,907747451,
5125290400,907778377,897394529,907777754,-623,,
5125790402,908278371,897894530,908268188,-10183,,
5126298188,908786148,898402316,908775975,-10173,908791328,
5126298195,908786155,898402324,908775980,-10175,,
5126798196,909286147,898902324,909291337,5190,,
5127298197,909786139,899402324,909791338,5199,,
5127322262,909810204,899426390,909815403,5199,909813350,
5127798199,910286133,899902327,910289387,3254,,
5128298200,910786125,900402327,910789290,3165,,
5128347915,910835840,900452044,910839006,3166,910838469,
5128798201,911286119,900902330,911288810,2691,,
5129298202,911786111,901402331,911788758,2647,,
5129371371,911859279,901475500,911861928,2649,911862483,
5129798203,912286104,901902331,912289236,3132,,
5130298205,912786097,902402333,912789320,3223,,
5130392967,912880857,902497095,912884081,3224,912883058,
5130798206,913286089,902902334,913288492,2403,,
5131298207,913786081,903402335,913788300,2219,,
5131417137,913905010,903521266,913907232,2222,913908482,
5131798208,914286074,903902336,914289256,3182,,
5132298210,914786067,904402338,914789556,3489,,
5132452698,914940555,904556828,914944047,3492,914941876,
5132798211,915286061,904902339,915288060,1999,,
5133298212,915786053,905402340,915787393,1340,,
5133476403,915964241,905580532,915965585,1344,915967688,
5133798215,916286047,905902342,916288751,2704,,
5134298216,916786039,906402344,916789503,3464,,
5134505453,916993274,906609582,916996741,3467,916998599,
5134798217,917286032,906902345,917290593,4561,,
5135298219,917786025,907402347,917791366,5341,,
5135529675,918017478,907633804,918022823,5345,918020713,
5135798220,918286019,907902348,918290235,4216,,
5136298222,918786012,908402350,918789262,3250,,
5136551555,919039341,908655684,919042597,3256,919041703,
5136798224,919286006,908902352,919288825,2819,,
5137298226,919785998,909402354,919788375,2377,,
5137576127,920063895,909680255,920066277,2382,920067270,
5137798228,920285992,909902355,920288819,2827,,
5138298230,920785985,910402358,920789376,3391,,
5138603552,921091303,910707680,921094698,3395,921096449,
5138798231,921285978,910902358,921290058,4080,,
5139298232,921785970,911402360,921791131,5161,,
5139627909,922115643,911732037,922120809,5166,922118933,
5139798233,922285963,911902360,922290494,4531,,
5140298234,922785955,912402362,922789260,3305,,
5140651751,923139466,912755879,923142777,3311,923142809,
5140798236,923285950,912902364,923289272,3322,,
5141298237,923785942,913402365,923789298,3356,,
5141671410,924159108,913775538,924162471,3363,924160482,
5141798238,924285934,913902365,924288794,2860,,
5142298239,924785927,914402367,924787314,1387,,
5142696754,925184434,914800882,925185829,1395,925188186,
5142798241,925285920,914902369,925287793,1873,,
5143298242,925785913,915402370,925789676,3763,,
5143723654,926211318,915827782,926215089,3771,926215915,
5143798243,926285906,915902371,926289799,3893,,
5144298244,926785897,916402372,926790506,4609,,
5144748036,927235683,916852165,927240299,4616,927239353,
5144798245,927285891,916902373,927290411,4520,,
5145298246,927785882,917402374,927789564,3682,,
5145780965,928268594,917885094,928272284,3690,928276242,
5145798247,928285877,917902377,928289703,3826,,
5146298249,928785868,918402377,928793527,7659,,
5146802378,929289990,918906507,929297657,7667,929292112,
5146802385,929289997,918906514,929297663,7666,,
5147302387,929789990,919406515,929792123,2133,,
5147830152,930317746,919934281,930319889,2143,930323245,
5147830160,930317754,919934288,930319896,2142,,
5148330161,930817747,920434289,930823257,5510,,
5148852163,931339740,920956292,931345259,5519,931342152,
5148852170,931339747,920956299,931345264,5517,,
5149352171,931839738,921456298,931842161,2423,,
5149852172,932339731,921956300,932342162,2431,,
5149881661,932369220,921985791,932371654,2434,932372094,
5150352173,932839723,922456300,932842583,2860,,
5150852175,933339717,922956303,933342611,2894,,
5150906280,933393821,923010408,933396717,2896,933394320,
5151352177,933839710,923456305,933840478,768,,
5151852179,934339704,923956307,934340221,517,,
5151928946,934416470,924033074,934416989,519,934418292,
5152352181,934839698,924456309,934841330,1632,,
5152852182,935339690,924956310,935341530,1840,,
5152954076,935441583,925058205,935443425,1842,935442753,
5153352183,935839682,925456311,935840998,1316,,
5153852184,936339675,925956311,936340863,1188,,
5153974863,936462353,926078991,936463543,1190,936464040,
5154352185,936839667,926456313,936841241,1574,,
5154852187,937339661,926956315,937341365,1704,,
5154995797,937483268,927099925,937484976,1708,937485287,
5155352188,937839654,927456316,937841590,1936,,
5155852190,938339648,927956318,938341682,2034,,
5156077692,938565146,928181821,938567187,2041,938596876,
5156352192,938839640,928456319,938857986,18346,,
5156852193,939339633,928956320,939371380,31747,,
5157097929,939585365,929202057,939617116,31751,939586879,
5157352194,939839626,929456322,939856006,16380,,
5157852195,940339619,929956323,940341148,1529,,
5158131487,940618906,930235616,940620440,1534,940619910,
5158352197,940839612,930456325,940840916,1304,,
5158852198,941339604,930956325,941340623,1019,,
5159152335,941639736,931256463,941640761,1025,941640161,
5159352199,941839596,931456326,941840385,789,,
5159852200,942339589,931956328,942340028,439,,
5160186224,942673607,932290352,942674052,445,942681921,
5160352201,942839581,932456328,942842641,3060,,
5160852203,943339576,932956331,943347902,8326,,
5161210066,943697433,933314194,943705766,8333,943700722,
5161352205,943839568,933456333,943846470,6902,,
5161852206,944339561,933956334,944342864,3303,,
5162230331,944717680,934334459,944720990,3310,944719105,
5162352208,944839554,934456335,944842406,2852,,
5162852210,945339548,934956338,945340986,1438,,
5163250467,945737798,935354595,945739243,1445,945738717,
5163352211,945839540,935456339,945840880,1340,,
5163852212,946339534,935956340,946340465,931,,
5164271050,946758364,936375178,946759303,939,946760180,
5164352213,946839526,936456341,946840608,1082,,
5164852214,947339519,936956343,947341348,1829,,
5165303032,947790329,937407160,947792166,1837,947797864,
5165352215,947839510,937456343,947841908,2398,,
5165852216,948339504,937956344,948347051,7547,,
5166327062,948814342,938431191,948821898,7556,948817797,
5166352221,948839500,938456351,948846851,7351,,
5166852223,949339493,938956351,949342961,3468,,
5167356774,949844036,939460902,949847512,3476,949848981,
5167356783,949844045,939460911,949847519,3474,,
5167856784,950344038,939960912,950348993,4955,,
5168386479,950873724,940490608,950878691,4967,950877501,
5168386494,950873740,940490624,950878704,4964,,
5168886495,951373730,940990623,951377520,3790,,
5169408208,951895435,941512337,951899234,3799,951897816,
5169408249,951895476,941512377,951899273,3797,,
5169908250,952395468,942012378,952397859,2391,,
5170432549,952919758,942536676,952922158,2400,952923499,
5170432556,952919765,942536684,952922164,2399,,
5170932558,953419758,943036686,953423510,3752,,
5171458725,953945917,943562853,953949678,3761,953950492,
5171458732,953945924,943562860,953949684,3760,,
5171958734,954445917,944062861,954450502,4585,,
5172481114,954968288,944585242,954972883,4595,954970992,
5172481121,954968295,944585249,954972889,4594,,
5172981123,955468289,945085251,955471003,2714,,
5173507557,955994714,945611685,955997438,2724,955996691,
5173507564,955994721,945611692,955997443,2722,,
5174007565,956494714,946111693,956496702,1988,,
5174536476,957023615,946640604,957025612,1997,957026880,
5174536483,957023622,946640611,957025619,1997,,
5175036484,957523615,947140612,957526890,3275,,
5175581587,958068709,947685717,958071996,3287,958082322,
5175581601,958068724,947685731,958072010,3286,,
5176081602,958568716,948185730,958582341,13625,,
5176605709,959092814,948709837,959106448,13634,959095953,
5176605748,959092853,948709876,959106486,13633,,
5177105749,959592845,949209878,959595996,3151,,
5177714306,960201393,949818437,960204556,3163,960162207,
5177714322,960201409,949818452,960204567,3158,,
5178214323,960701400,950318451,960662226,-39174,,
5178762496,961249565,950866627,961210404,-39161,961260180,
5178762516,961249584,950866646,961210421,-39163,,
5179262517,961749576,951366645,961760204,10628,,
5179787332,962274383,951891460,962285020,10637,962278235,
5179787373,962274424,951891501,962285059,10635,,
5180287375,962774417,952391503,962778281,3864,,
5180823564,963310597,952927694,963314472,3875,963319684,
5180823579,963310612,952927708,963314485,3873,,
5181323581,963810605,953427709,963819704,9099,,
5181843549,964330566,953947679,964339675,9109,964331635,
5181843565,964330581,953947694,964339687,9106,,
5182343566,964830572,954447694,964831654,1082,,
5182869511,965356509,954973640,965357601,1092,965359635,
5182869522,965356520,954973650,965357611,1091,,
5183369524,965856513,955473651,965859650,3137,,
5183897945,966384926,956002074,966388072,3146,966390590,
5183897955,966384936,956002083,966388077,3141,,
5184397957,966884929,956502085,966890605,5676,,
5184917315,967404279,957021443,967409963,5684,967405488,
5184917322,967404286,957021451,967409968,5682,,
5185417324,967904278,957521452,967905498,1220,,
5185940933,968427879,958045062,968429108,1229,968431164,
5185940941,968427886,958045069,968429114,1228,,
5186440943,968927880,958545071,968931176,3296,,
5186976205,969463134,959080334,969466438,3304,969472345,
5186976297,969463226,959080425,969466530,3304,,
5187476299,969963218,959580427,969972440,9222,,
5187997514,970484424,960101642,970493655,9231,970486565,
5187997521,970484431,960101649,970493660,9229,,
5188497522,970984425,960601650,970986576,2151,,
5189021189,971508082,961125317,971510242,2160,971511527,
5189021196,971508089,961125324,971510249,2160,,
5189521198,972008082,961625326,972011539,3457,,
5190045632,972532508,962149761,972535973,3465,972533835,
5190045672,972532548,962149800,972536012,3464,,
5190545673,973032541,962649801,973033878,1337,,
5191065939,973552798,963170067,973554145,1347,973554214,
5191065946,973552805,963170074,973554151,1346,,
5191565947,974052797,963670075,974054224,1427,,
5192089649,974576491,964193777,974577927,1436,974579919,
5192089656,974576498,964193784,974577933,1435,,
5192589658,975076490,964693786,975079930,3440,,
5193116834,975603657,965220962,975607107,3450,975608831,
5193116841,975603664,965220969,975607113,3449,,
5193616842,976103658,965720970,976108842,5184,,
5194146784,976633590,966250912,976638783,5193,976634418,
5194146791,976633597,966250919,976638790,5193,,
5194646792,977133589,966750919,977134428,839,,
5195166953,977653741,967271081,977654590,849,977655444,
5195166960,977653748,967271088,977654596,848,,
5195666962,978153742,967771090,978155455,1713,,
5196190420,978677192,968294549,978678914,1722,978680487,
5196190429,978677201,968294558,978678921,1720,,
5196690430,979177192,968794558,979180498,3306,,
5197209797,979696552,969313926,979699866,3314,979697712,
5197209845,979696600,969313974,979699914,3314,,
5197709847,980196593,969813975,980197765,1172,,
5198233498,980720235,970337626,980721416,1181,980723712,
5198233505,980720242,970337633,980721421,1179,,
5198733507,981220235,970837635,981223722,3487,,
5199261322,981748042,971365451,981751539,3497,981750708,
5199261333,981748053,971365462,981751548,3495,,
5199761335,982248045,971865462,982250722,2677,,
5200285577,982772279,972389705,982774965,2686,982775919,
5200285584,982772286,972389712,982774971,2685,,
5200785586,983272279,972889714,983275930,3651,,
5201309550,983796235,973413679,983799895,3660,983799755,
5201309557,983796242,973413686,983799901,3659,,
5201809558,984296233,973913686,984299764,3531,,
5202329912,984816580,974434041,984820119,3539,984818408,
5202329919,984816587,974434048,984820125,3538,,
5202829921,985316579,974934049,985318418,1839,,
5203354263,985840912,975458391,985842760,1848,985844481,
5203354270,985840920,975458398,985842767,1847,,
5203854271,986340913,975958399,986344491,3578,,
5204373510,986860143,976477638,986863731,3588,986861331,
5204373517,986860149,976477645,986863737,3588,,
5204873519,987360142,976977646,987361342,1200,,
5205396753,987883368,977500882,987884577,1209,987886593,
5205396761,987883375,977500889,987884583,1208,,
5205896762,988383369,978000890,988386603,3234,,
5206421950,988908548,978526079,988911792,3244,988911812,
5206421957,988908555,978526085,988911798,3243,,
5206921959,989408549,979026087,989411823,3274,,
5207441071,989927652,979545199,989930936,3284,989928819,
5207441111,989927692,979545240,989930975,3283,,
5207941112,990427684,980045240,990428863,1179,,
5208462049,990948612,980566177,990949800,1188,990948983,
5208462056,990948619,980566185,990949805,1186,,
5208962057,991448611,981066185,991448992,381,,
5209483335,991969881,981587463,991970271,390,991971995,
5209483342,991969888,981587471,991970276,388,,
5209983343,992469881,982087471,992472005,2124,,
5210483344,992969872,982587472,992972005,2133,,
5210503578,992990106,982607706,992992240,2134,992990747,
5210983345,993469865,983087473,993470577,712,,
5211483346,993969857,983587474,993970517,660,,
5211527497,994014008,983631626,994014669,661,994013935,
5211983347,994469850,984087475,994469850,0,,
5212483349,994969843,984587476,994969788,-55,,
5212570504,995056999,984674634,995056946,-53,995069781,
5212983350,995469837,985087478,995480392,10555,,
5213483352,995969829,985587480,995982633,12804,,
5213590310,996076785,985694438,996089591,12806,996077690,
5213983353,996469822,986087481,996473279,3457,,
5214483354,996969814,986587482,996970736,922,,
5214614086,997100545,986718215,997101470,925,997104006,
5214983355,997469808,987087483,997472613,2805,,
5215483356,997969799,987587483,997973277,3478,,
5215633455,998119895,987737583,998123377,3482,998121087,
5215983357,998469793,988087486,998471678,1885,,
5216483359,998969785,988587487,998970993,1208,,
5216653073,999139496,988757201,999140708,1212,999140583,
5216983362,999469780,989087489,999470915,1135,,
5217483364,999969774,989587492,999970876,1102,,
5217680189,1000166596,989784318,1000167702,1106,1000170905,
5217983366,1000469767,990087493,1000472821,3054,,
5218483367,1000969759,990587495,1000974084,4325,,
5218704599,1001190988,990808727,1001195317,4329,1001193949,
5218983369,1001469753,991087497,1001473324,3571,,
5219483370,1001969745,991587498,1001972722,2977,,
5219728358,1002214730,991832486,1002217711,2981,1002218206,
5219983371,1002469738,992087498,1002472975,3237,,
5220483373,1002969731,992587501,1002973222,3491,,
5220756617,1003242971,992860746,1003246467,3496,1003248486,
5220983374,1003469724,993087502,1003474139,4415,,
5221483376,1003969717,993587504,1003975246,5529,,
5221780281,1004266617,993884409,1004272152,5535,1004269920,
5221983378,1004469712,994087506,1004474342,4630,,
5222483379,1004969704,994587507,1004973021,3317,,
5222846317,1005332636,994950447,1005335961,3325,1005336640,
5222983380,1005469696,995087507,1005473206,3510,,
5223483381,1005969689,995587509,1005973707,4018,,
5223868544,1006354844,995972672,1006358870,4026,1006354595,
5223983383,1006469682,996087511,1006472726,3044,,
5224483384,1006969675,996587512,1006969438,-237,,
5224896168,1007382451,997000296,1007382222,-229,1007387783,
5224983385,1007469667,997087512,1007470408,741,,
5225483387,1007969660,997587515,1007975004,5344,,
5225915328,1008401594,998019456,1008406946,5352,1008402801,
5225983389,1008469654,998087516,1008474441,4787,,
5226483390,1008969646,998587517,1008970865,1219,,
5226938955,1009425204,999043084,1009426431,1227,1009428628,
5226983392,1009469640,999087519,1009471060,1420,,
5227483394,1009969633,999587522,1009973068,3435,,
5227962791,1010449022,1000066919,1010452466,3444,1010452358,
5227983398,1010469629,1000087525,1010473067,3438,,
5228483399,1010969622,1000587527,1010972968,3346,,
5228982101,1011468316,1001086230,1011471672,3356,1011469592,
5228983400,1011469615,1001087528,1011472964,3349,,
5229483401,1011969606,1001587529,1011970894,1288,,
5230005772,1012491968,1002109900,1012493265,1297,1012495326,
5230005779,1012491975,1002109907,1012493271,1296,,
5230505781,1012991970,1002609909,1012995338,3368,,
5231029458,1013515638,1003133587,1013519016,3378,1013518929,
5231029467,1013515647,1003133596,1013519023,3376,,
5231529468,1014015639,1003633597,1014018942,3303,,
5232029469,1014515631,1004133596,1014518942,3311,,
5232050152,1014536314,1004154281,1014539626,3312,1014538278,
5232529470,1015015624,1004633599,1015017654,2030,,
5233029472,1015515617,1005133600,1015517599,1982,,
5233069522,1015555666,1005173650,1015557650,1984,1015556871,
5233529473,1016015609,1005633601,1016016886,1277,,
5234029474,1016515602,1006133602,1016516825,1223,,
5234088826,1016574954,1006192955,1016576179,1225,1016576263,
5234529475,1017015594,1006633603,1017016903,1309,,
5235029477,1017515588,1007133605,1017516915,1327,,
5235123040,1017609149,1007227180,1017610493,1344,1017617849,
5235529478,1018015580,1007633606,1018022909,7329,,
5236029480,1018515574,1008133608,1018524292,8718,,
5236146763,1018632855,1008250891,1018641575,8720,1018636304,
5236529482,1019015568,1008633610,1019020262,4694,,
5237029483,1019515561,1009133611,1019519027,3466,,
5237166065,1019652140,1009270194,1019655609,3469,1019653416,
5237529484,1020015552,1009633612,1020017434,1882,,
5238029485,1020515546,1010133613,1020516838,1292,,
5238188118,1020674176,1010292247,1020675471,1295,1020676862,
5238529486,1021015538,1010633614,1021017790,2252,,
5239029487,1021515530,1011133615,1021518233,2703,,
5239216180,1021702221,1011320308,1021704926,2705,1021707737,
5239529488,1022015522,1011633615,1022019995,4473,,
5240029489,1022515515,1012133617,1022521047,5532,,
5240235641,1022721663,1012339769,1022727200,5537,1022722892,
5240529490,1023015507,1012633618,1023018518,3011,,
5241029492,1023515501,1013133619,1023516745,1244,,
5241259986,1023745992,1013364114,1023747241,1249,1023749292,
5241529494,1024015495,1013633622,1024017856,2361,,
5242029496,1024515488,1014133624,1024518806,3318,,
5242283273,1024769261,1014387401,1024772583,3322,1024772756,
5242529497,1025015480,1014633625,1025018892,3412,,
5243029499,1025515474,1015133627,1025518983,3509,,
5243306938,1025792908,1015411066,1025796423,3515,1025796377,
5243529500,1026015467,1015633628,1026018966,3499,,
5244029502,1026515461,1016133630,1026518943,3482,,
5244326188,1026812141,1016430316,1026815629,3488,1026813351,
5244529515,1027015464,1016633643,1027018030,2566,,
5245029517,1027515459,1017133645,1027516683,1224,,
5245356785,1027842721,1017460914,1027843952,1231,1027848339,
5245529519,1028015451,1017633647,1028018200,2749,,
5246029521,1028515445,1018133649,1028521077,5632,,
5246380731,1028866650,1018484859,1028872288,5638,1028870235,
5246529522,1029015437,1018633650,1029020467,5030,,
5247029523,1029515430,1019133651,1029519028,3598,,
5247405003,1029890904,1019509131,1029894509,3605,1029894622,
5247529525,1030015423,1019633652,1030019058,3635,,
5248029527,1030515417,1020133655,1030519148,3731,,
5248428647,1030914531,1020532775,1030918269,3738,1030917854,
5248529530,1031015411,1020633657,1031019067,3656,,
5249029531,1031515404,1021133658,1031518740,3336,,
5249448847,1031934714,1021552976,1031938057,3343,1031935776,
5249529532,1032015396,1021633659,1032018371,2975,,
5250029533,1032515390,1022133661,1032516464,1074,,
5250472602,1032958451,1022576730,1032959533,1082,1032961968,
5250529534,1033015382,1022633662,1033016742,1360,,
5251029535,1033515374,1023133662,1033518903,3529,,
5251491938,1033977770,1023596066,1033981307,3537,1033978963,
5251529536,1034015367,1023633664,1034018727,3360,,
5252029537,1034515360,1024133665,1034516564,1204,,
5252511556,1034997371,1024615684,1034998584,1213,1034998650,
5252529538,1035015352,1024633666,1035016567,1215,,
5253029540,1035515345,1025133668,1035516637,1292,,
5253531278,1036017075,1025635407,1036018375,1300,1036018489,
5253531285,1036017082,1025635414,1036018381,1299,,
5254031286,1036517075,1026135414,1036518499,1424,,
5254550508,1037036288,1026654636,1037037721,1433,1037037524,
5254550515,1037036295,1026654643,1037037727,1432,,
5255050521,1037536291,1027154649,1037537539,1248,,
5255575153,1038060914,1027679281,1038062172,1258,1038059998,
5255575160,1038060921,1027679288,1038062178,1257,,
5256075162,1038560915,1028179290,1038560009,-906,,
5256596369,1039082114,1028700497,1039081217,-897,1039084218,
5256596376,1039082121,1028700504,1039081223,-898,,
5257096379,1039582115,1029200506,1039584230,2115,,
5257618186,1040103914,1029722314,1040106038,2124,1040105786,
5257618194,1040103921,1029722322,1040106044,2123,,
5258118195,1040603914,1030222323,1040605797,1883,,
5258642372,1041128081,1030746500,1041129974,1893,1041131177,
5258642379,1041128089,1030746507,1041129980,1891,,
5259142380,1041628082,1031246508,1041631188,3106,,
5259642381,1042128073,1031746508,1042131188,3115,,
5259667828,1042153521,1031771957,1042156637,3116,1042157819,
5260142382,1042628067,1032246510,1042632315,4248,,
5260642384,1043128059,1032746511,1043132376,4317,,
5260700061,1043185736,1032804191,1043190056,4320,1043192486,
5261142386,1043628054,1033246514,1043634533,6479,,
5261642387,1044128046,1033746515,1044134815,6769,,
5261726597,1044212255,1033830725,1044219026,6771,1044216992,
5262142388,1044628039,1034246516,1044633126,5087,,
5262642390,1045128031,1034746518,1045132786,4755,,
5262750753,1045236393,1034854881,1045241150,4757,1045240125,
5263142391,1045628024,1035246519,1045631986,3962,,
5263642393,1046128017,1035746520,1046131766,3749,,
5263774423,1046260046,1035878551,1046263797,3751,1046263457,
5264142394,1046628011,1036246522,1046631519,3508,,
5264642395,1047128002,1036746523,1047131432,3430,,
5264795062,1047280667,1036899190,1047284099,3432,1047282244,
5265142396,1047627995,1037246523,1047630145,2150,,
5265642397,1048127987,1037746524,1048129581,1594,,
5265831664,1048317251,1037935792,1048318848,1597,1048327181,
5266142398,1048627980,1038246526,1048634762,6782,,
5266642400,1049127973,1038746527,1049137919,9946,,
5266856199,1049341770,1038960327,1049351719,9949,1049345615,
5267142402,1049627968,1039246530,1049634428,6460,,
5267642403,1050127960,1039746531,1050131822,3862,,
5267879906,1050365459,1039984034,1050369325,3866,1050368938,
5268142405,1050627953,1040246532,1050631621,3668,,
5268642406,1051127946,1040746534,1051131440,3494,,
5268907232,1051392767,1041011360,1051396266,3499,1051397306,
5269142408,1051627939,1041246536,1051631932,3993,,
5269642409,1052127931,1041746537,1052132486,4555,,
5269930713,1052416231,1042034979,1052420928,4697,1052419829,
5270142411,1052627926,1042246539,1052632082,4156,,
5270642412,1053127918,1042746540,1053131530,3612,,
5270950279,1053435780,1043054407,1053439398,3618,1053436930,
5271142414,1053627912,1043246542,1053630583,2671,,
5271642415,1054127904,1043746543,1054129068,1164,,
5271971188,1054456672,1044075316,1054457842,1170,1054458802,
5272142416,1054627897,1044246544,1054629398,1501,,
5272642418,1055127889,1044746545,1055130034,2145,,
5273028445,1055513911,1045132575,1055516064,2153,1055533897,
5273142420,1055627883,1045246548,1055634100,6217,,
5273642421,1056127875,1045746549,1056147876,20001,,
5274052180,1056537628,1046156308,1056557636,20008,1056540985,
5274142422,1056627868,1046246550,1056644871,17003,,
5274642423,1057127860,1046746551,1057131230,3370,,
5275072855,1057558285,1047176983,1057561663,3378,1057558863,
5275142424,1057627854,1047246552,1057630842,2988,,
5275642426,1058127846,1047746554,1058128436,590,,
5276105546,1058590958,1048209674,1058591556,598,1058598936,
5276142430,1058627844,1048246560,1058628988,1144,,
5276642431,1059127834,1048746559,1059135823,7989,,
5277125335,1059610730,1049229463,1059618728,7998,1059612174,
5277142432,1059627828,1049246560,1059635599,7771,,
5277642434,1060127820,1049746561,1060129275,1455,,
5278149035,1060634414,1050253163,1060635877,1463,1060637824,
5278149074,1060634453,1050253203,1060635914,1461,,
5278649075,1061134445,1050753203,1061137866,3421,,
5279149076,1061634437,1051253203,1061637866,3429,,
5279174061,1061659421,1051278189,1061662851,3430,1061661861,
5279649078,1062134430,1051753206,1062136929,2499,,
5280149080,1062634425,1052253208,1062636882,2457,,
5280198100,1062683443,1052302228,1062685903,2460,1062687060,
5280649082,1063134418,1052753210,1063137931,3513,,
5281149083,1063634411,1053253211,1063638046,3635,,
5281222085,1063707411,1053326213,1063711048,3637,1063711053,
5281649085,1064134403,1053753213,1064138054,3651,,
5282149087,1064634397,1054253215,1064638057,3660,,
5282245861,1064731169,1054349989,1064734831,3662,1064734561,
5282649089,1065134391,1054753217,1065137844,3453,,
5283149090,1065634384,1055253218,1065637793,3409,,
5283271199,1065756490,1055375327,1065759902,3412,1065760954,
5283649091,1066134375,1055753218,1066138590,4215,,
5284149092,1066634368,1056253220,1066638850,4482,,
5284292504,1066777777,1056396632,1066782261,4484,1066779181,
5284649093,1067134361,1056753221,1067136655,2294,,
5285149094,1067634353,1057253222,1067635773,1420,,
5285318136,1067803392,1057422264,1067804815,1423,1067806014,
5285649095,1068134346,1057753223,1068136569,2223,,
5286149096,1068634338,1058253224,1068636976,2638,,
5286342138,1068827377,1058446267,1068830020,2643,1068831074,
5286649097,1069134330,1058753225,1069137626,3296,,
5287149099,1069634324,1059253227,1069638036,3712,,
5287365931,1069851153,1059470059,1069854869,3716,1069854738,
5287649100,1070134317,1059753228,1070137964,3647,,
5288149101,1070634309,1060253229,1070637910,3601,,
5288393191,1070878395,1060497319,1070882001,3606,1070882046,
5288649103,1071134302,1060753231,1071137936,3634,,
5289149104,1071634295,1061253232,1071637961,3666,,
5289417195,1071902382,1061521324,1071906053,3671,1071905616,
5289649105,1072134287,1061753232,1072137760,3473,,
5290149106,1072634280,1062253234,1072637528,3248,,
5290440662,1072925832,1062544790,1072929085,3253,1072929274,
5290649107,1073134272,1062753235,1073137609,3337,,
5291149109,1073634266,1063253236,1073637723,3457,,
5291470351,1073955503,1063574480,1073958967,3464,1073961906,
5291649110,1074134258,1063753237,1074138776,4518,,
5292149112,1074634252,1064253240,1074640668,6416,,
5292494636,1074979771,1064598764,1074986193,6422,1074983570,
5292649113,1075134245,1064753241,1075139860,5615,,
5293149114,1075634237,1065253242,1075638049,3812,,
5293520110,1076005227,1065624238,1076009046,3819,1076009683,
5293649115,1076134229,1065753243,1076138214,3985,,
5294149117,1076634223,1066253245,1076638691,4468,,
5294544813,1077029913,1066648941,1077034388,4475,1077034077,
5294649118,1077134216,1066753246,1077138628,4412,,
5295149120,1077634209,1067253248,1077638386,4177,,
5295568123,1078053206,1067672251,1078057389,4183,1078056660,
5295649122,1078134202,1067753250,1078138269,4067,,
5296149125,1078634197,1068253252,1078637664,3467,,
5296592111,1079077176,1068696240,1079080652,3476,1079080885,
5296649126,1079134189,1068753254,1079137691,3502,,
5297149127,1079634182,1069253254,1079637902,3720,,
5297620612,1080105660,1069724740,1080109388,3728,1080109365,
5297649128,1080134175,1069753257,1080137902,3727,,
5298149130,1080634168,1070253258,1080637885,3717,,
5298653972,1081139002,1070758101,1081142729,3727,1081137935,
5298653979,1081139009,1070758108,1081142735,3726,,
5299153981,1081639003,1071258109,1081637946,-1057,,
5299674952,1082159965,1071779081,1082158917,-1048,1082162119,
5299674959,1082159972,1071779088,1082158924,-1048,,
5300174960,1082659964,1072279088,1082662130,2166,,
5300699946,1083184940,1072804074,1083187116,2176,1083188954,
5300699953,1083184948,1072804082,1083187123,2175,,
5301199954,1083684941,1073304082,1083688964,4023,,
5301699955,1084184932,1073804083,1084188965,4033,,
5301724260,1084209237,1073828388,1084213271,4034,1084213093,
5302199957,1084684926,1074304085,1084688800,3874,,
5302699958,1085184919,1074804086,1085188794,3875,,
5302747989,1085232950,1074852118,1085236825,3875,1085236423,
5303199960,1085684912,1075304088,1085688434,3522,,
5303699961,1086184905,1075804089,1086188398,3493,,
5303771821,1086256764,1075875949,1086260258,3494,1086260206,
5304199963,1086684898,1076304091,1086688357,3459,,
5304699964,1087184891,1076804092,1087188351,3460,,
5304812145,1087297071,1076916276,1087300536,3465,1087308411,
5305199965,1087684884,1077304093,1087694464,9580,,
5305699966,1088184875,1077804094,1088196234,11359,,
5305838704,1088323612,1077942832,1088334973,11361,1088328390,
5306199967,1088684868,1078304095,1088691480,6612,,
5306699969,1089184861,1078804097,1089189657,4796,,
5306858542,1089343433,1078962670,1089348230,4797,1089344933,
5307199970,1089684855,1079304098,1089687406,2551,,
5307699972,1090184847,1079804100,1090186364,1517,,
5307879490,1090364363,1079983619,1090365883,1520,1090366390,
5308199973,1090684840,1080304101,1090686692,1852,,
5308699974,1091184832,1080804101,1091186875,2043,,
5308905433,1091390288,1081009561,1091392335,2047,1091393042,
5309199975,1091684826,1081304104,1091687294,2468,,
5309699977,1092184819,1081804105,1092187589,2770,,
5309935227,1092420065,1082039357,1092422841,2776,1092423804,
5310199978,1092684811,1082304106,1092688102,3291,,
5310699979,1093184803,1082804107,1093188559,3756,,
5310959080,1093443901,1083063209,1093447662,3761,1093447255,
5311199981,1093684797,1083304109,1093688366,3569,,
5311699983,1094184790,1083804110,1094188159,3369,,
5311983037,1094467841,1084087165,1094471214,3373,1094469757,
5312199985,1094684784,1084304113,1094687529,2745,,
5312699986,1095184777,1084804115,1095186709,1932,,
5313012691,1095497477,1085116819,1095499414,1937,1095502547,
5313199987,1095684769,1085304114,1095687883,3114,,
5313699989,1096184762,1085804117,1096189847,5085,,
5314043484,1096528253,1086147615,1096533347,5094,1096535106,
5314199990,1096684755,1086304117,1096690399,5644,,
5314699991,1097184748,1086804119,1097191617,6869,,
5315070926,1097555677,1087175054,1097562552,6875,1097559063,
5315199993,1097684742,1087304121,1097690717,5975,,
5315699994,1098184733,1087804122,1098188132,3399,,
5316099027,1098583760,1088203155,1098587165,3405,1098589606,
5316199995,1098684726,1088304123,1098688625,3899,,
5316699997,1099184719,1088804124,1099190578,5859,,
5317122746,1099607462,1089226875,1099613328,5866,1099610963,
5317199999,1099684714,1089304127,1099690213,5499,,
5317700000,1100184706,1089804128,1100188219,3513,,
5318146347,1100631046,1090250475,1100634566,3520,1100634550,
5318200001,1100684698,1090304129,1100688217,3519,,
5318700003,1101184691,1090804131,1101188208,3517,,
5319170271,1101654951,1091274399,1101658477,3526,1101658363,
5319200011,1101684693,1091304141,1101688212,3519,,
5319700013,1102184684,1091804141,1102188108,3424,,
5320191292,1102675956,1092295420,1102679387,3431,1102677947,
5320200014,1102684678,1092304142,1102688082,3404,,
5320700015,1103184670,1092804143,1103186672,2002,,
5321212434,1103697080,1093316562,1103699091,2011,1103699388,
5321212441,1103697087,1093316569,1103699097,2010,,
5321712442,1104197080,1093816571,1104199399,2319,,
5322232598,1104717227,1094336727,1104719555,2328,1104718062,
5322232605,1104717234,1094336734,1104719560,2326,,
5322732606,1105217226,1094836733,1105218071,845,,
5323256865,1105741477,1095360993,1105742331,854,1105744655,
5323256872,1105741484,1095361000,1105742337,853,,
5323756874,1106241476,1095861001,1106244666,3190,,
5324293365,1106777958,1096397493,1106781158,3200,1106776519,
5324293372,1106777965,1096397500,1106781164,3199,,
5324793374,1107277959,1096897502,1107276530,-1429,,
5325335757,1107820334,1097439886,1107818914,-1420,1107833183,
5325335765,1107820341,1097439893,1107818920,-1421,,
5325835767,1108320334,1097939895,1108333195,12861,,
5326359372,1108843931,1098463501,1108856801,12870,1108847403,
5326359380,1108843938,1098463508,1108856806,12868,,
5326859382,1109343932,1098963510,1109347414,3482,,
5327394437,1109878978,1099498565,1109882470,3492,1109886146,
5327394444,1109878985,1099498572,1109882476,3491,,
5327894445,1110378977,1099998572,1110386156,7179,,
5328394446,1110878970,1100498574,1110886158,7188,,
5328413694,1110898218,1100517822,1110905406,7188,1110899531,
5328894447,1111378962,1100998575,1111380512,1550,,
5329394448,1111878955,1101498575,1111880287,1332,,
5329438021,1111922528,1101542149,1111923861,1333,1111926508,
5329894449,1112378948,1101998577,1112382707,3759,,
5330394451,1112878942,1102498579,1112882941,3999,,
5330462096,1112946585,1102566224,1112950586,4001,1112950325,
5330894452,1113378934,1102998580,1113382719,3785,,
5331394453,1113878926,1103498581,1113882684,3758,,
5331485657,1113970128,1103589785,1113973888,3760,1113973667,
5331894454,1114378918,1103998581,1114382506,3588,,
5332394456,1114878913,1104498584,1114882469,3556,,
5332505142,1114989597,1104609270,1114993155,3558,1114991010,
5332894457,1115378905,1104998585,1115380801,1896,,
5333394458,1115878897,1105498586,1115880328,1431,,
5333530289,1116014725,1105634417,1116016159,1434,1116019035,
5333894460,1116378890,1105998588,1116382426,3536,,
5334394462,1116878884,1106498590,1116883210,4326,,
5334551737,1117036156,1106655865,1117040485,4329,1117038392,
5334894463,1117378876,1106998590,1117381777,2901,,
5335394464,1117878869,1107498591,1117881121,2252,,
5335577691,1118062092,1107681819,1118064349,2257,1118066776,
5335894465,1118378862,1107998593,1118382661,3799,,
5336394466,1118878854,1108498594,1118883553,4699,,
5336601308,1119085693,1108705436,1119090396,4703,1119089157,
5336894467,1119378846,1108998595,1119382828,3982,,
5337394468,1119878840,1109498596,1119882319,3479,,
5337620633,1120105001,1109724762,1120108486,3485,1120106339,
5337894470,1120378833,1109998598,1120381147,2314,,
5338394472,1120878826,1110498600,1120880179,1353,,
5338644070,1121128420,1110748198,1121129778,1358,1121131951,
5338894473,1121378819,1110998601,1121381269,2450,,
5339394475,1121878812,1111498603,1121882357,3545,,
5339663676,1122148008,1111767804,1122151559,3551,1122149283,
5339894477,1122378805,1111998604,1122381309,2504,,
5340394478,1122878798,1112498606,1122880087,1289,,
5340711645,1123195961,1112815775,1123197258,1297,1123211420,
5340894479,1123378790,1112998606,1123385267,6477,,
5341394480,1123878783,1113498608,1123894257,15474,,
5341735728,1124220026,1113839856,1124235506,15480,1124223343,
5341894482,1124378776,1113998610,1124390398,11622,,
5342394483,1124878770,1114498612,1124882101,3331,,
5342760017,1125244297,1114864145,1125247635,3338,1125247806,
5342894485,1125378762,1114998613,1125382148,3386,,
5343394486,1125878755,1115498614,1125882276,3521,,
5343779268,1126263531,1115883396,1126267059,3528,1126264962,
5343894487,1126378748,1115998615,1126381795,3047,,
5344394488,1126878740,1116498616,1126880184,1444,,
5344800614,1127284860,1116904742,1127286311,1451,1127285234,
5344894489,1127378732,1116998617,1127379982,1250,,
5345394490,1127878725,1117498618,1127879111,386,,
5346023581,1128507807,1118127711,1128508205,398,1128548802,
5346023596,1128507821,1118127726,1128508220,399,,
5346523598,1129007813,1118627725,1129048822,41009,,
5347076444,1129560651,1119180574,1129601671,41020,1129577888,
5347076459,1129560667,1119180589,1129601684,41017,,
5347576460,1130060658,1119680588,1130077907,17249,,
5348100217,1130584407,1120204345,1130601665,17258,1130588096,
5348100258,1130584447,1120204386,1130601703,17256,,
5348600260,1131084441,1120704388,1131088142,3701,,
5349119757,1131603928,1121223885,1131607638,3710,1131605499,
5349119764,1131603935,1121223892,1131607644,3709,,
5349619765,1132103929,1121723893,1132105509,1580,,
5350152553,1132636707,1122256681,1132638298,1591,1132643804,
5350152560,1132636714,1122256688,1132638304,1590,,
5350652561,1133136706,1122756689,1133143814,7108,,
5351180435,1133664571,1123284563,1133671689,7118,1133670081,
5351180467,1133664603,1123284595,1133671720,7117,,
5351680469,1134164597,1123784597,1134170117,5520,,
5352214746,1134698866,1124318875,1134704396,5530,1134707503,
5352214758,1134698877,1124318887,1134704406,5529,,
5352714760,1135198871,1124818888,1135207520,8649,,
5353238350,1135722452,1125342478,1135731110,8658,1135725757,
5353238357,1135722459,1125342485,1135731116,8657,,
5353738359,1136222452,1125842487,1136225768,3316,,
5354261764,1136745848,1126365892,1136749173,3325,1136749319,
5354261771,1136745856,1126365899,1136749180,3324,,
5354761773,1137245848,1126865901,1137249330,3482,,
5355286193,1137770259,1127390321,1137773750,3491,1137773762,
5355286200,1137770266,1127390328,1137773756,3490,,
5355786202,1138270260,1127890330,1138273773,3513,,
5356309725,1138793775,1128413853,1138797297,3522,1138797392,
5356309734,1138793784,1128413863,1138797304,3520,,
5356809735,1139293775,1128913863,1139297404,3629,,
5357333547,1139817579,1129437675,1139821217,3638,1139821081,
5357333554,1139817586,1129437682,1139821223,3637,,
5357833556,1140317579,1129937684,1140321092,3513,,
5358352806,1140836821,1130456934,1140840343,3522,1140838241,
5358352814,1140836828,1130456942,1140840349,3521,,
5358852816,1141336822,1130956944,1141338252,1430,,
5359377744,1141861741,1131481872,1141863181,1440,1141864787,
5359377751,1141861748,1131481879,1141863187,1439,,
5359877752,1142361740,1131981880,1142364797,3057,,
5360401946,1142885926,1132506075,1142888992,3066,1142889715,
5360401954,1142885934,1132506082,1142889000,3066,,
5360901955,1143385927,1133006083,1143389727,3800,,
5361425540,1143909503,1133529668,1143913312,3809,1143913093,
5361425547,1143909510,1133529675,1143913317,3807,,
5361925549,1144409502,1134029677,1144413103,3601,,
5362467635,1144951581,1134571766,1144955194,3613,1144961886,
5362467654,1144951600,1134571785,1144955210,3610,,
5362967656,1145451592,1135071784,1145461910,10318,,
5363491547,1145975475,1135595675,1145985802,10327,1145979045,
5363491555,1145975482,1135595683,1145985807,10325,,
5363991556,1146475474,1136095684,1146479055,3581,,
5364514772,1146998682,1136618900,1147002272,3590,1147000862,
5364514779,1146998689,1136618907,1147002277,3588,,
5365014780,1147498681,1137118908,1147500871,2190,,
5365514781,1147998673,1137618909,1148000872,2199,,
5365539337,1148023230,1137643465,1148025429,2199,1148026430,
5366014783,1148498667,1138118911,1148501828,3161,,
5366514784,1148998659,1138618912,1149001879,3220,,
5366564398,1149048274,1138668526,1149051494,3220,1149046747,
5367014785,1149498653,1139118913,1149497608,-1045,,
5367514787,1149998645,1139618915,1149997138,-1507,,
5367587265,1150071122,1139691393,1150069617,-1505,1150072689,
5368014788,1150498639,1140118916,1150499770,1131,,
5368514790,1150998631,1140618917,1151000216,1585,,
5368606474,1151090315,1140710602,1151091901,1586,1151091739,
5369014791,1151498624,1141118919,1151500086,1462,,
5369514792,1151998617,1141618920,1152000059,1442,,
5369627320,1152111143,1141731448,1152112586,1443,1152113431,
5370014794,1152498610,1142118922,1152500716,2106,,
5370514795,1152998602,1142618922,1153000908,2306,,
5370647274,1153131080,1142751403,1153133388,2308,1153132816,
5371014796,1153498595,1143118924,1153500492,1897,,
5371514797,1153998588,1143618925,1154000342,1754,,
5371672397,1154156186,1143776526,1154157943,1757,1154159551,
5372014798,1154498580,1144118926,1154501444,2864,,
5372514799,1154998572,1144618927,1155001954,3382,,
5372706407,1155190177,1144810535,1155193563,3386,1155195418,
5373014801,1155498566,1145118928,1155503101,4535,,
5373514802,1155998558,1145618929,1156003815,5257,,
5373730984,1156214738,1145835112,1156219998,5260,1156217964,
5374014804,1156498553,1146118932,1156502663,4110,,
5374514806,1156998545,1146618934,1157001788,3243,,
5374759322,1157243058,1146863450,1157246304,3246,1157248725,
5375014808,1157498540,1147118936,1157503027,4487,,
5375514809,1157998531,1147618936,1158004213,5682,,
5375779165,1158262883,1147883293,1158268570,5687,1158264119,
5376014811,1158498525,1148118939,1158502118,3593,,
5376514812,1158998518,1148618940,1158999769,1251,,
5376802099,1159285801,1148906227,1159287056,1255,1159289053,
5377014813,1159498511,1149118941,1159500618,2107,,
5377514814,1159998503,1149618942,1160001770,3267,,
5377827234,1160310918,1149931362,1160314190,3272,1160315196,
5378014815,1160498495,1150118943,1160502149,3654,,
5378514817,1160998488,1150618945,1161002781,4293,,
5378851550,1161335217,1150955678,1161339515,4298,1161338042,
5379014819,1161498482,1151118947,1161502303,3821,,
5379514820,1161998474,1151618948,1162001313,2839,,
5379875840,1162359488,1151979968,1162362333,2845,1162360884,
5380014821,1162498467,1152118949,1162500911,2444,,
5380514822,1162998459,1152618949,1162999868,1409,,
5380899730,1163383361,1153003858,1163384777,1416,1163386205,
5381014823,1163498453,1153118951,1163500199,1746,,
5381514825,1163998445,1153618953,1164001302,2857,,
5381924009,1164407624,1154028137,1164410487,2863,1164408891,
5382014826,1164498438,1154118954,1164501012,2574,,
5382514827,1164998430,1154618954,1164999710,1280,,
5382948122,1165431719,1155052250,1165433006,1287,1165435571,
5383014828,1165498423,1155118955,1165500053,1630,,
5383514829,1165998415,1155618957,1166002280,3865,,
5383976358,1166459937,1156080486,1166463810,3873,1166465756,
5384014830,1166498409,1156118960,1166502433,4024,,
5384514831,1166998400,1156618959,1167004231,5831,,
5384995885,1167479446,1157100013,1167485286,5840,1167481097,
5385014832,1167498393,1157118960,1167504072,5679,,
5385514834,1167998386,1157618962,1168000049,1663,,
5386019458,1168503002,1158123586,1168504673,1671,1168506414,
5386019464,1168503009,1158123593,1168504678,1669,,
5386519466,1169003001,1158623594,1169006424,3423,,
5387042994,1169526520,1159147122,1169529953,3433,1169530093,
5387043001,1169526528,1159147129,1169529959,3431,,
5387543003,1170026521,1159647131,1170030105,3584,,
5388067934,1170551443,1160172062,1170555035,3592,1170555820,
5388067941,1170551450,1160172069,1170555042,3592,,
5388567942,1171051443,1160672070,1171055831,4388,,
5389091657,1171575149,1161195785,1171579545,4396,1171578489,
5389091663,1171575156,1161195792,1171579551,4395,,
5389591665,1172075148,1161695793,1172078499,3351,,
5390116631,1172600105,1162220759,1172603465,3360,1172604208,
5390116638,1172600112,1162220766,1172603471,3359,,
5390616640,1173100106,1162720768,1173104219,4113,,
5391145870,1173629328,1163249998,1173633450,4122,1173634970,
5391145877,1173629334,1163250005,1173633456,4122,,
5391645878,1174129327,1163750006,1174134980,5653,,
5392173058,1174656498,1164277186,1174662161,5663,1174659476,
5392173065,1174656505,1164277193,1174662167,5662,,
5392673066,1175156498,1164777194,1175159486,2988,,
5393192839,1175676261,1165296967,1175679260,2999,1175677828,
5393192846,1175676269,1165296975,1175679266,2997,,
5393692849,1176176262,1165796976,1176177840,1578,,
5394217361,1176700766,1166321489,1176702353,1587,1176704601,
5394217368,1176700774,1166321496,1176702359,1585,,
5394717369,1177200765,1166821496,1177204611,3846,,
5395238539,1177721926,1167342667,1177725782,3856,1177722438,
5395238546,1177721934,1167342674,1177725788,3854,,
5395738547,1178221927,1167842675,1178222449,522,,
5396238548,1178721919,1168342676,1178722450,531,,
5396271740,1178755111,1168375869,1178755643,532,1178763588,
5396738549,1179221912,1168842677,1179229873,7961,,
5397238551,1179721904,1169342679,1179730401,8497,,
5397302235,1179785588,1169406363,1179794086,8498,1179792641,
5397738553,1180221898,1169842681,1180229144,7246,,
5398238554,1180721891,1170342682,1180728962,7071,,
5398330017,1180813353,1170434146,1180820426,7073,1180819099,
5398738556,1181221885,1170842684,1181227881,5996,,
5399238557,1181721876,1171342685,1181727640,5764,,
5399352988,1181836306,1171457116,1181842072,5766,1181839697,
5399738558,1182221869,1171842686,1182225811,3942,,
5400238560,1182721862,1172342687,1182725270,3408,,
5400374139,1182857440,1172478268,1182860851,3411,1182859565,
5400738561,1183221855,1172842688,1183224335,2480,,
5401238562,1183721847,1173342689,1183723989,2142,,
5401393385,1183876669,1173497513,1183878813,2144,1183878121,
5401738564,1184221841,1173842692,1184223515,1674,,
5402238566,1184721834,1174342694,1184723304,1470,,
5402412853,1184896119,1174516981,1184897592,1473,1184897538,
5402738567,1185221828,1174842695,1185223272,1444,,
5403238568,1185721819,1175342696,1185723254,1435,,
5403433535,1185916783,1175537663,1185918222,1439,1185918826,
5403738569,1186221812,1175842697,1186223625,1813,,
5404238571,1186721805,1176342698,1186723864,2059,,
5404457078,1186940309,1176561207,1186942372,2063,1186943967,
5404738572,1187221799,1176842700,1187224765,2966,,
5405238573,1187721790,1177342701,1187725464,3674,,
5405480549,1187963763,1177584678,1187967441,3678,1187967490,
5405738575,1188221785,1177842703,1188225493,3708,,
5406238576,1188721776,1178342704,1188725518,3742,,
5406499669,1188982866,1178603797,1188986612,3746,1188984333,
5406738577,1189221770,1178842705,1189224432,2662,,
5407238579,1189721762,1179342707,1189723246,1484,,
5407523403,1190006581,1179627531,1190008071,1490,1190010069,
5407738581,1190221757,1179842709,1190224108,2351,,
5408238583,1190721750,1180342711,1190725252,3502,,
5408547496,1191030657,1180651624,1191034165,3508,1191033417,
5408738585,1191221743,1180842713,1191224968,3225,,
5409238586,1191721736,1181342715,1191724510,2774,,
5409572335,1192055479,1181676463,1192058259,2780,1192059686,
5409738588,1192221730,1181842716,1192224986,3256,,
5410238589,1192721722,1182342717,1192725942,4220,,
5410592162,1193075288,1182696290,1193079515,4227,1193076742,
5410738591,1193221715,1182842718,1193225131,3416,,
5411238593,1193721708,1183342721,1193723175,1467,,
5411624356,1194107466,1183728484,1194108939,1473,1194115396,
5411738595,1194221702,1183842723,1194224652,2950,,
5412238597,1194721695,1184342725,1194729639,7944,,
5412649247,1195132338,1184753375,1195140289,7951,1195136430,
5412738598,1195221688,1184842726,1195228951,7263,,
5413238600,1195721681,1185342728,1195725785,4104,,
5413673656,1196156730,1185777784,1196160841,4111,1196160478,
5413738601,1196221674,1185842729,1196225738,4064,,
5414238603,1196721668,1186342731,1196725427,3759,,
5414697344,1197180401,1186801473,1197184169,3768,1197183851,
5414738605,1197221662,1186842734,1197225404,3742,,
5415238607,1197721654,1187342735,1197725115,3461,,
5415716674,1198199714,1187820803,1198203183,3469,1198201124,
5415738609,1198221648,1187842736,1198225026,3378,,
5416238611,1198721641,1188342738,1198723062,1421,,
5416741027,1199224050,1188845155,1199225479,1429,1199225241,
5416741035,1199224057,1188845163,1199225486,1429,,
5417241036,1199724050,1189345165,1199725253,1203,,
5417762213,1200245218,1189866341,1200246430,1212,1200247579,
5417762220,1200245225,1189866348,1200246436,1211,,
5418262221,1200745218,1190366349,1200747589,2371,,
5418787906,1201270894,1190892034,1201273275,2381,1201275338,
5418787913,1201270901,1190892041,1201273280,2379,,
5419287914,1201770892,1191392041,1201775347,4455,,
5419811956,1202294926,1191916084,1202299390,4464,1202296856,
5419811963,1202294933,1191916092,1202299395,4462,,
5420311965,1202794926,1192416093,1202796866,1940,,
5420835338,1203318290,1192939467,1203320240,1950,1203320132,
5420835347,1203318300,1192939476,1203320248,1948,,
5421335349,1203818293,1193439477,1203820145,1852,,
5421859593,1204342528,1193963721,1204344389,1861,1204345811,
5421859600,1204342536,1193963728,1204344396,1860,,
5422359601,1204842527,1194463729,1204845821,3294,,
5422903989,1205386907,1195008118,1205390212,3305,1205400407,
5422904005,1205386923,1195008134,1205390225,3302,,
5423404007,1205886915,1195508135,1205900428,13513,,
5423926658,1206409558,1196030786,1206423080,13522,1206412647,
5423926665,1206409565,1196030793,1206423086,13521,,
5424426667,1206909558,1196530795,1206912658,3100,,
5424949056,1207431938,1197053184,1207435047,3109,1207431796,
5424949063,1207431945,1197053191,1207435052,3107,,
5425449065,1207931939,1197553193,1207931807,-132,,
5425968306,1208451172,1198072434,1208451049,-123,1208452570,
5425968313,1208451179,1198072441,1208451055,-124,,
5426468314,1208951170,1198572441,1208952580,1410,,
5426991439,1209474287,1199095568,1209475706,1419,1209473847,
5426991446,1209474294,1199095575,1209475711,1417,,
5427491447,1209974287,1199595575,1209973857,-430,,
5428010836,1210493666,1200114964,1210493246,-420,1210495026,
5428010876,1210493706,1200115004,1210493285,-421,,
5428510877,1210993699,1200615005,1210995069,1370,,
5429036434,1211519248,1201140562,1211520627,1379,1211523800,
5429036441,1211519255,1201140570,1211520632,1377,,
5429536442,1212019246,1201640569,1212023809,4563,,
5430036443,1212519240,1202140571,1212523811,4571,,
5430055915,1212538711,1202160043,1212543283,4572,1212540164,
5430536444,1213019231,1202640572,1213020816,1585,,
5431036445,1213519224,1203140573,1213520697,1473,,
5431102771,1213585549,1203206901,1213587025,1476,1213600664,
5431536447,1214019217,1203640575,1214032532,13315,,
5432036448,1214519211,1204140576,1214534344,15133,,
5432126403,1214609164,1204230531,1214624299,15135,1214612835,
5432536449,1215019203,1204640577,1215024946,5743,,
5433036450,1215519195,1205140578,1215522884,3689,,
5433149411,1215632154,1205253539,1215635846,3692,1215635494,
5433536451,1216019187,1205640578,1216022614,3427,,
5434036452,1216519181,1206140580,1216522538,3357,,
5434174083,1216656808,1206278211,1216660169,3361,1216660881,
5434536454,1217019173,1206640582,1217023057,3884,,
5435036456,1217519167,1207140584,1217523256,4089,,
5435198132,1217680840,1207302260,1217684933,4093,1217684256,
5435536458,1218019160,1207640586,1218022803,3643,,
5436036459,1218519153,1208140586,1218522585,3432,,
5436218790,1218701482,1208322920,1218704918,3436,1218703688,
5436536460,1219019145,1208640588,1219021806,2661,,
5437036462,1219519139,1209140590,1219521361,2222,,
5437240160,1219722834,1209344289,1219725061,2227,1219724218,
5437536463,1220019132,1209640592,1220020865,1733,,
5438036465,1220519126,1210140593,1220520525,1399,,
5438262857,1220745513,1210366985,1220746918,1405,1220748663,
5438536467,1221019119,1210640595,1221021484,2365,,
5439036468,1221519111,1211140595,1221522276,3165,,
5439285552,1221768191,1211389681,1221771362,3171,1221769711,
5439536470,1222019104,1211640598,1222021451,2347,,
5440036471,1222519097,1212140599,1222520632,1535,,
5440314327,1222796949,1212418455,1222798489,1540,1222803185,
5440536472,1223019089,1212640600,1223022721,3632,,
5441036473,1223519082,1213140601,1223525334,6252,,
5441338945,1223821549,1213443073,1223827806,6257,1223825522,
5441536474,1224019074,1213640602,1224024432,5358,,
5442036476,1224519069,1214140604,1224523055,3986,,
5442363768,1224846355,1214467896,1224850348,3993,1224849766,
5442536478,1225019061,1214640605,1225022855,3794,,
5443036479,1225519055,1215140607,1225522478,3423,,
5443383383,1225865952,1215487511,1225869383,3431,1225867468,
5443536480,1226019047,1215640608,1226021893,2846,,
5444036482,1226519040,1216140610,1226520569,1529,,
5444406668,1226889219,1216510796,1226890755,1536,1226892621,
5444536483,1227019033,1216640611,1227021056,2023,,
5445036484,1227519026,1217140612,1227522440,3414,,
5445436073,1227918607,1217540201,1227922028,3421,1227924025,
5445536485,1228019017,1217640613,1228022840,3823,,
5446036487,1228519011,1218140615,1228524442,5431,,
5446467745,1228950262,1218571874,1228955700,5438,1228956165,
5446536488,1229019003,1218640615,1229024506,5503,,
5447036489,1229518996,1219140616,1229524911,5915,,
5447491903,1229974403,1219596031,1229980326,5923,1229978191,
5447536490,1230018988,1219640618,1230024721,5733,,
5448036491,1230518981,1220140618,1230522781,3800,,
5448516628,1230999109,1220620756,1231002919,3810,1231003337,
5448536493,1231018975,1220640623,1231022802,3827,,
5449036495,1231518969,1221140623,1231523206,4237,,
5449539956,1232022420,1221644084,1232026667,4247,1232026125,
5449540105,1232022570,1221644233,1232026816,4246,,
5450040106,1232522562,1222144234,1232526277,3715,,
5450566135,1233048583,1222670263,1233052307,3724,1233053339,
5450566144,1233048592,1222670273,1233052314,3722,,
5451066146,1233548584,1223170274,1233553352,4768,,
5451590020,1234072450,1223694148,1234077227,4777,1234076297,
5451590028,1234072457,1223694156,1234077232,4775,,
5452090029,1234572450,1224194156,1234576307,3857,,
5452609184,1235091596,1224713312,1235095462,3866,1235093096,
5452609191,1235091604,1224713319,1235095469,3865,,
5453109192,1235591596,1225213320,1235593107,1511,,
5453632493,1236114887,1225736621,1236116407,1520,1236118413,
5453632500,1236114894,1225736628,1236116414,1520,,
5454132501,1236614887,1226236629,1236618423,3536,,
5454656103,1237138481,1226760231,1237142026,3545,1237142111,
5454656110,1237138488,1226760238,1237142032,3544,,
5455156111,1237638480,1227260239,1237642121,3641,,
5455678302,1238160662,1227782430,1238164313,3651,1238162257,
5455678311,1238160671,1227782439,1238164321,3650,,
5456178312,1238660663,1228282440,1238662270,1607,,
5456701814,1239184157,1228805943,1239185773,1616,1239187706,
5456701855,1239184198,1228805983,1239185813,1615,,
5457201856,1239684191,1229305984,1239687750,3559,,
5457722635,1240204960,1229826763,1240208528,3568,1240206421,
5457722642,1240204967,1229826770,1240208535,3568,,
5458222643,1240704959,1230326771,1240706431,1472,,
5458744284,1241226592,1230848412,1241228072,1480,1241229268,
5458744291,1241226599,1230848419,1241228080,1481,,
5459244292,1241726591,1231348420,1241729279,2688,,
5459778306,1242260596,1231882434,1242263292,2696,1242261338,
5459778346,1242260636,1231882474,1242263331,2695,,
5460278347,1242760628,1232382474,1242761381,753,,
5460807954,1243290228,1232912084,1243290992,764,1243295173,
5460807969,1243290242,1232912099,1243291004,762,,
5461307970,1243790235,1233412098,1243795191,4956,,
5461833495,1244315750,1233937623,1244320717,4967,1244320390,
5461833502,1244315758,1233937631,1244320723,4965,,
5462333504,1244815751,1234437632,1244820401,4650,,
5462852712,1245334951,1234956841,1245339610,4659,1245336421,
5462852752,1245334990,1234956880,1245339648,4658,,
5463352753,1245834983,1235456881,1245836463,1480,,
5463872371,1246354592,1235976500,1246356082,1490,1246356284,
5463872379,1246354599,1235976507,1246356088,1489,,
5464372381,1246854594,1236476509,1246856295,1701,,
5464893613,1247375817,1236997741,1247377528,1711,1247378214,
5464893620,1247375824,1236997748,1247377534,1710,,
5465393622,1247875817,1237497750,1247878226,2409,,
5465918995,1248401181,1238023123,1248403598,2417,1248405515,
5465919002,1248401188,1238023130,1248403603,2415,,
5466419003,1248901181,1238523131,1248905526,4345,,
5466938332,1249420501,1239042460,1249424855,4354,1249422084,
5466938339,1249420508,1239042467,1249424861,4353,,
5467438340,1249920501,1239542468,1249922095,1594,,
5467938341,1250420493,1240042469,1250422096,1603,,
5467961705,1250443857,1240065834,1250445461,1604,1250447633,
5468438343,1250920486,1240542471,1250924171,3685,,
5468938345,1251420479,1241042472,1251424275,3796,,
5468986195,1251468329,1241090323,1251472126,3797,1251472412,
5469438346,1251920472,1241542474,1251924537,4065,,
5469938347,1252420465,1242042475,1252424566,4101,,
5470013268,1252495385,1242117397,1252499489,4104,1252500578,
5470438348,1252920458,1242542476,1252925497,5039,,
5470938350,1253420451,1243042478,1253425663,5212,,
5471034615,1253516715,1243138743,1253521929,5214,1253519107,
5471438351,1253920444,1243542480,1253923389,2945,,
5471938353,1254420436,1244042481,1254422847,2411,,
5472060425,1254542507,1244164553,1254544920,2413,1254547190,
5472438354,1254920430,1244542482,1254924566,4136,,
5472938356,1255420422,1245042483,1255425123,4701,,
5473085136,1255567201,1245189265,1255571905,4704,1255571281,
5473438357,1255920415,1245542485,1255924685,4270,,
5473938358,1256420407,1246042486,1256424504,4097,,
5474109027,1256591073,1246213155,1256595173,4100,1256594835,
5474438360,1256920401,1246542488,1256924285,3884,,
5474938361,1257420393,1247042488,1257424171,3778,,
5475133803,1257615833,1247237931,1257619614,3781,1257619881,
5475438363,1257920388,1247542491,1257924337,3949,,
5475938365,1258420380,1248042492,1258424444,4064,,
5476158063,1258640075,1248262191,1258644143,4068,1258644085,
5476438366,1258920373,1248542494,1258924414,4041,,
5476938367,1259420366,1249042495,1259424393,4027,,
5477188299,1259670293,1249292427,1259674325,4032,1259677517,
5477438369,1259920359,1249542497,1259925992,5633,,
5477938371,1260420353,1250042499,1260427591,7238,,
5478212957,1260694935,1250317086,1260702178,7243,1260699233,
5478438373,1260920346,1250542500,1260926266,5920,,
5478938374,1261420338,1251042502,1261424651,4313,,
5479233549,1261715509,1251337677,1261719827,4318,1261717839,
5479438375,1261920331,1251542503,1261923837,3506,,
5479938377,1262420324,1252042504,1262422669,2345,,
5480253009,1262734952,1252357137,1262737302,2350,1262736762,
5480438378,1262920318,1252542506,1262922471,2153,,
5480938380,1263420310,1253042508,1263422135,1825,,
5481274508,1263756434,1253378636,1263758264,1830,1263758573,
5481438382,1263920304,1253542510,1263922238,1934,,
5481938383,1264420296,1254042511,1264422449,2153,,
5482295280,1264777187,1254399408,1264779347,2160,1264779157,
5482438384,1264920290,1254542512,1264922397,2107,,
5482938386,1265420282,1255042513,1265422265,1983,,
5483318951,1265800842,1255423079,1265802831,1989,1265804554,
5483438387,1265920275,1255542514,1265922678,2403,,
5483938389,1266420268,1256042517,1266423994,3726,,
5484343807,1266825679,1256447935,1266829413,3734,1266829999,
5484438390,1266920261,1256542518,1266924105,3844,,
5484938391,1267420253,1257042519,1267424585,4332,,
5485368275,1267850131,1257472403,1267854470,4339,1267853919,
5485438392,1267920246,1257542520,1267924508,4262,,
5485938393,1268420239,1258042521,1268424040,3801,,
5486387674,1268869512,1258491802,1268873321,3809,1268870900,
5486438394,1268920232,1258542522,1268923794,3562,,
5486938395,1269420223,1259042522,1269421623,1400,,
5487409574,1269891395,1259513703,1269892803,1408,1269894213,
5487438396,1269920216,1259542524,1269921705,1489,,
5487938397,1270420209,1260042525,1270423039,2830,,
5488433846,1270915650,1260537975,1270918488,2838,1270919242,
5488438399,1270920202,1260542527,1270923044,2842,,
5488938401,1271420195,1261042529,1271423798,3603,,
5489452975,1271934761,1261557103,1271938372,3611,1271936370,
5489452982,1271934768,1261557110,1271938378,3610,,
5489952984,1272434761,1262057112,1272436381,1620,,
5490488784,1272970553,1262592914,1272972184,1631,1272978981,
5490488799,1272970569,1262592929,1272972199,1630,,
5490988801,1273470560,1263092929,1273479002,8442,,
5491513247,1273994999,1263617375,1274003448,8449,1273998013,
5491513288,1273995040,1263617416,1274003487,8447,,
5492013312,1274495054,1264117440,1274498079,3025,,
5492537231,1275018965,1264641360,1275021999,3034,1275022837,
5492537240,1275018974,1264641369,1275022007,3033,,
5493037242,1275518967,1265141370,1275522849,3882,,
5493562083,1276043800,1265666211,1276047691,3891,1276046828,
5493562090,1276043807,1265666218,1276047697,3890,,
5494062091,1276543798,1266166219,1276546838,3040,,
5494587281,1277068979,1266691409,1277072029,3050,1277073445,
5494587288,1277068986,1266691416,1277072035,3049,,
5495087289,1277568980,1267191417,1277573456,4476,,
5495610156,1278091838,1267714285,1278096323,4485,1278095305,
5495610163,1278091845,1267714292,1278096330,4485,,
5496110165,1278591838,1268214293,1278595316,3478,,
5496631709,1279113373,1268735837,1279116861,3488,1279116002,
5496631717,1279113380,1268735845,1279116866,3486,,
5497131718,1279613373,1269235846,1279616012,2639,,
5497650935,1280132582,1269755063,1280135230,2648,1280134193,
5497650945,1280132592,1269755073,1280135238,2646,,
5498150947,1280632585,1270255074,1280634207,1622,,
5498675769,1281157399,1270779898,1281159030,1631,1281161640,
5498675776,1281157406,1270779905,1281159036,1630,,
5499175777,1281657398,1271279905,1281661650,4252,,
5499695224,1282176835,1271799352,1282181097,4262,1282178319,
5499695231,1282176843,1271799360,1282181103,4260,,
5500195233,1282676837,1272299361,1282678331,1494,,
5500731261,1283212855,1272835389,1283214358,1503,1283222733,
5500731268,1283212862,1272835396,1283214365,1503,,
5501231269,1283712854,1273335396,1283722743,9889,,
5501750694,1284232271,1273854823,1284242169,9898,1284233903,
5501750702,1284232278,1273854830,1284242176,9898,,
5502250704,1284732272,1274354832,1284733914,1642,,
5502778568,1285260128,1274882696,1285261779,1651,1285265804,
5502778575,1285260134,1274882703,1285261785,1651,,
5503278577,1285760127,1275382705,1285765816,5689,,
5503802013,1286283556,1275906142,1286289252,5696,1286287227,
5503802021,1286283563,1275906149,1286289258,5695,,
5504302022,1286783556,1276406150,1286787238,3682,,
5504823577,1287305101,1276927705,1287308793,3692,1287307787,
5504823584,1287305109,1276927712,1287308799,3690,,
5505323586,1287805103,1277427714,1287807798,2695,,
5505854258,1288335767,1277958388,1288338474,2707,1288342805,
5505854273,1288335781,1277958403,1288338485,2704,,
5506354274,1288835772,1278458402,1288842824,7052,,
5506877847,1289359337,1278981976,1289366397,7060,1289363022,
5506877854,1289359344,1278981983,1289366403,7059,,
5507377855,1289859336,1279481983,1289863031,3695,,
5507898527,1290379999,1280002655,1290383704,3705,1290382212,
5507898534,1290380006,1280002662,1290383710,3704,,
5508398535,1290879999,1280502663,1290882223,2224,,
5508919498,1291400954,1281023627,1291403186,2232,1291403352,
5508919507,1291400963,1281023636,1291403194,2231,,
5509419509,1291900955,1281523637,1291903365,2410,,
5509939410,1292420848,1282043539,1292423267,2419,1292422133,
5509939417,1292420855,1282043546,1292423273,2418,,
5510439418,1292920847,1282543546,1292922143,1296,,
5510967728,1293449149,1283071857,1293450454,1305,1293455055,
5510967767,1293449188,1283071896,1293450492,1304,,
5511467769,1293949180,1283571897,1293955098,5918,,
5511986836,1294468239,1284090965,1294474166,5927,1294469796,
5511986845,1294468248,1284090974,1294474175,5927,,
5512486846,1294968240,1284590973,1294969808,1568,,
5513006889,1295488275,1285111017,1295489852,1577,1295489379,
5513006897,1295488282,1285111025,1295489858,1576,,
5513506899,1295988276,1285611027,1295989390,1114,,
5514032389,1296513757,1286136517,1296514880,1123,1296518380,
5514032428,1296513796,1286136556,1296514919,1123,,
5514532429,1297013789,1286636557,1297018422,4633,,
5515063960,1297545312,1287168090,1297549956,4644,1297552940,
5515063975,1297545326,1287168105,1297549969,4643,,
5515563977,1298045319,1287668105,1298052959,7640,,
5516100360,1298581693,1288204488,1298589343,7650,1298591815,
5516100369,1298581703,1288204498,1298589350,7647,,
5516600371,1299081695,1288704499,1299091828,10133,,
5517124261,1299605577,1289228390,1299615719,10142,1299608717,
5517124268,1299605584,1289228397,1299615725,10141,,
5517624271,1300105578,1289728398,1300108729,3151,,
5518143518,1300624817,1290247647,1300627978,3161,1300626334,
5518143526,1300624825,1290247654,1300627984,3159,,
5518643528,1301124817,1290747656,1301126345,1528,,
5519168917,1301650199,1291273047,1301651737,1538,1301654620,
5519168931,1301650212,1291273060,1301651748,1536,,
5519668932,1302150205,1291773060,1302154638,4433,,
5520189522,1302670785,1292293650,1302675228,4443,1302672908,
5520189529,1302670792,1292293657,1302675234,4442,,
5520689531,1303170786,1292793659,1303172919,2133,,
5521215079,1303696326,1293319207,1303698468,2142,1303701241,
5521215086,1303696332,1293319214,1303698473,2141,,
5521715088,1304196325,1293819216,1304201252,4927,,
5522238299,1304719528,1294342428,1304724464,4936,1304722933,
5522238307,1304719535,1294342435,1304724470,4935,,
5522738309,1305219530,1294842437,1305222945,3415,,
5523259571,1305740783,1295363700,1305744208,3425,1305742433,
5523259580,1305740792,1295363711,1305744217,3425,,
5523759581,1306240783,1295863709,1306242445,1662,,
5524283031,1306764225,1296387160,1306765898,1673,1306768070,
5524283041,1306764235,1296387170,1306765906,1671,,
5524783043,1307264228,1296887171,1307268084,3856,,
5525306580,1307787756,1297410708,1307791622,3866,1307791572,
5525306587,1307787763,1297410715,1307791628,3865,,
5525806588,1308287756,1297910715,1308291582,3826,,
5526336486,1308817646,1298440615,1308821481,3835,1308824384,
5526336493,1308817653,1298440622,1308821487,3834,,
5526836494,1309317644,1298940622,1309324393,6749,,
5527360024,1309841166,1299464152,1309847924,6758,1309844895,
5527360031,1309841173,1299464159,1309847929,6756,,
5527860032,1310341165,1299964159,1310344904,3739,,
5528360033,1310841157,1300464160,1310844905,3748,,
5528383688,1310864812,1300487816,1310868561,3749,1310868474,
5528860034,1311341150,1300964161,1311344826,3676,,
5529360035,1311841142,1301464162,1311844823,3681,,
5529411989,1311893096,1301516117,1311896778,3682,1311896012,
5529860037,1312341137,1301964165,1312344143,3006,,
5530360038,1312841128,1302464166,1312844063,2935,,
5530431490,1312912580,1302535618,1312915516,2936,1312913952,
5530860039,1313341122,1302964167,1313342727,1605,,
5531360041,1313841115,1303464169,1313842505,1390,,
5531457989,1313939060,1303562117,1313940454,1394,1313943586,
5531860043,1314341109,1303964171,1314345027,3918,,
5532360045,1314841101,1304464172,1314845644,4543,,
5532477527,1314958582,1304581656,1314963127,4545,1314960223,
5532860046,1315341094,1304964173,1315343425,2331,,
5533360048,1315841087,1305464176,1315842745,1658,,
5533506072,1315987109,1305610200,1315988770,1661,1315993338,
5533860050,1316341081,1305964178,1316345982,4901,,
5534360052,1316841074,1306464179,1316847320,6246,,
5534525691,1317006710,1306629819,1317012960,6250,1317008180,
5534860053,1317341067,1306964180,1317344126,3059,,
5535360055,1317841060,1307464183,1317842546,1486,,
5535553427,1318034430,1307657555,1318035919,1489,1318040168,
5535860056,1318341053,1307964184,1318345154,4101,,
5536360057,1318841046,1308464185,1318846800,5754,,
5536580058,1319061043,1308684186,1319066802,5759,1319065436,
5536860059,1319341039,1308964187,1319346039,5000,,
5537360060,1319841031,1309464188,1319845440,4409,,
5537637597,1320118565,1309741727,1320122981,4416,1320127431,
5537860061,1320341024,1309964189,1320347422,6398,,
5538360063,1320841017,1310464190,1320849899,8882,,
5538661075,1321142024,1310765203,1321150912,8888,1321145818,
5538860065,1321341012,1310964193,1321347875,6863,,
5539360067,1321841004,1311464195,1321844812,3808,,
5539691359,1322172290,1311795487,1322176105,3815,1322179342,
5539860069,1322340998,1311964196,1322345907,4909,,
5540360071,1322840991,1312464199,1322848056,7065,,
5540724531,1323205446,1312828660,1323212519,7073,1323209040,
5540860072,1323340985,1312964200,1323347113,6128,,
5541360074,1323840977,1313464202,1323844586,3609,,
5541748256,1324229154,1313852384,1324232769,3615,1324232812,
5541860076,1324340971,1313964203,1324344598,3627,,
5542360077,1324840964,1314464205,1324844636,3672,,
5542776063,1325256942,1314880191,1325260622,3680,1325262581,
5542860079,1325340957,1314964207,1325344965,4008,,
5543360081,1325840950,1315464208,1325846601,5651,,
5543801051,1326281914,1315905180,1326287573,5659,1326286369,
5543860083,1326340944,1315964211,1326346460,5516,,
5544360084,1326840936,1316464212,1326845403,4467,,
5544825276,1327306122,1316929406,1327310599,4477,1327309858,
5544860085,1327340929,1316964213,1327345350,4421,,
5545360087,1327840922,1317464215,1327844671,3749,,
5545851022,1328331850,1317955150,1328335607,3757,1328336602,
5545860092,1328340920,1317964221,1328344697,3777,,
5546360093,1328840912,1318464221,1328845676,4764,,
5546973986,1329454795,1319078116,1329459571,4776,1329405201,
5546974002,1329454811,1319078132,1329459582,4771,,
5547474003,1329954803,1319578131,1329905221,-49582,,
5547994095,1330474886,1320098223,1330425313,-49573,1330476645,
5547994103,1330474893,1320098231,1330425319,-49574,,
5548494104,1330974887,1320598232,1330976655,1768,,
5549018316,1331499089,1321122444,1331500868,1779,1331502565,
5549018323,1331499096,1321122451,1331500874,1778,,
5549518324,1331999088,1321622452,1332002575,3487,,
5550037620,1332518376,1322141748,1332521872,3496,1332519919,
5550037627,1332518383,1322141755,1332521878,3495,,
5550537629,1333018376,1322641757,1333019930,1554,,
5551066397,1333547136,1323170526,1333548699,1563,1333552146,
5551066404,1333547143,1323170533,1333548705,1562,,
5551566405,1334047135,1323670533,1334052155,5020,,
5552066406,1334547128,1324170534,1334552157,5029,,
5552091783,1334572505,1324195911,1334577534,5029,1334577027,
5552566408,1335047122,1324670536,1335051680,4558,,
5553066410,1335547115,1325170538,1335551656,4541,,
5553221059,1335701762,1325325189,1335706309,4547,1335650299,
5553566412,1336047108,1325670540,1336012974,-34134,,
5554066414,1336547102,1326170542,1336495656,-51446,,
5554250429,1336731113,1326354557,1336679672,-51441,1336737677,
5554566415,1337047094,1326670543,1337032316,-14778,,
5555066416,1337547086,1327170544,1337553666,6580,,
5555270380,1337751047,1327374508,1337757630,6583,1337752468,
5555566419,1338047081,1327670546,1338050613,3532,,
5556066420,1338547073,1328170548,1338548510,1437,,
5556289862,1338770512,1328393990,1338771953,1441,1338772147,
5556566421,1339047066,1328670548,1339048619,1553,,
5557066422,1339547059,1329170550,1339548709,1650,,
5557310811,1339791444,1329414939,1339793098,1654,1339792617,
5557566424,1340047052,1329670552,1340048466,1414,,
5558066425,1340547044,1330170553,1340548234,1190,,
5558336558,1340817174,1330440687,1340818367,1193,1340820939,
5558566426,1341047038,1330670554,1341049419,2381,,
5559066427,1341547029,1331170555,1341550810,3781,,
5559361359,1341841957,1331465487,1341845743,3786,1341841645,
5559566428,1342047022,1331670556,1342049130,2108,,
5560066430,1342547015,1332170558,1342546718,-297,,
5560385238,1342865819,1332489366,1342865527,-292,1342869740,
5560566431,1343047009,1332670559,1343048246,1237,,
5561066432,1343547000,1333170560,1343550936,3936,,
5561409182,1343889745,1333513310,1343893687,3942,1343893596,
5561566434,1344046994,1333670562,1344050909,3915,,
5562066436,1344546987,1334170563,1344550851,3864,,
5562433315,1344913860,1334537443,1344917731,3871,1344917209,
5562566437,1345046980,1334670565,1345050713,3733,,
5563066439,1345546973,1335170567,1345550335,3362,,
5563466234,1345946763,1335570364,1345950133,3370,1345953387,
5563566441,1346046968,1335670569,1346050988,4020,,
5564066443,1346546961,1336170571,1346553599,6638,,
5564505266,1346985777,1336609394,1346992422,6645,1346994937,
5564566444,1347046953,1336670572,1347053907,6954,,
5565066445,1347546945,1337170572,1347556118,9173,,
5565525589,1348006082,1337629717,1348015263,9181,1348008339,
5565566446,1348046938,1337670573,1348055552,8614,,
5566066447,1348546931,1338170575,1348549200,2269,,
5566555957,1349036434,1338660088,1349038714,2280,1349042256,
5566566449,1349046926,1338670579,1349049275,2349,,
5567066451,1349546917,1339170579,1349552753,5836,,
5567577676,1350058134,1339681805,1350063980,5846,1350060939,
5567577685,1350058143,1339681814,1350063987,5844,,
5568077687,1350558136,1340181814,1350560952,2816,,
5568601088,1351081529,1340705216,1351084354,2825,1351083300,
5568601095,1351081535,1340705223,1351084360,2825,,
5569101096,1351581528,1341205224,1351583310,1782,,
5569627714,1352108138,1341731842,1352109929,1791,1352112942,
5569627721,1352108145,1341731849,1352109935,1790,,
5570127722,1352608136,1342231850,1352612952,4816,,
5570657214,1353137619,1342761342,1353142444,4825,1353139872,
5570657221,1353137626,1342761349,1353142450,4824,,
5571157223,1353637620,1343261351,1353639883,2263,,
5571677251,1354157640,1343781380,1354159912,2272,1354159442,
5571677295,1354157684,1343781423,1354159955,2271,,
5572177297,1354657676,1344281425,1354659489,1813,,
5572697329,1355177699,1344801457,1355179521,1822,1355179025,
5572697335,1355177706,1344801464,1355179527,1821,,
5573197337,1355677699,1345301465,1355679035,1336,,
5573720451,1356200804,1345824579,1356202150,1346,1356202952,
5573720457,1356200811,1345824586,1356202156,1345,,
5574220459,1356700803,1346324586,1356702962,2159,,
5574744786,1357225123,1346848914,1357227290,2167,1357228509,
5574744829,1357225165,1346848957,1357227333,2168,,
5575244830,1357725158,1347348959,1357728556,3398,,
5575769373,1358249692,1347873501,1358253099,3407,1358253252,
5575769382,1358249701,1347873510,1358253106,3405,,
5576269384,1358749694,1348373511,1358753265,3571,,
5576793060,1359273361,1348897188,1359276942,3581,1359273950,
5576793067,1359273368,1348897195,1359276948,3580,,
5577293069,1359773361,1349397197,1359773961,600,,
5577817594,1360297877,1349921722,1360298487,610,1360301160,
5577817601,1360297885,1349921729,1360298493,608,,
5578317603,1360797879,1350421731,1360801172,3293,,
5578817952,1361298218,1350922079,1361301520,3302,,
5578839109,1361319376,1350943237,1361322678,3302,1361322057,
5579317954,1361798212,1351422082,1361800929,2717,,
5579817955,1362298204,1351922082,1362300904,2700,,
5579865610,1362345860,1351969738,1362348560,2700,1362348311,
5580317956,1362798198,1352422084,1362800682,2484,,
5580817957,1363298190,1352922085,1363300660,2470,,
5580889150,1363369382,1352993278,1363371853,2471,1363369861,
5581317958,1363798182,1353422086,1363798954,772,,
5581817960,1364298175,1353922088,1364298673,498,,
5581913154,1364393368,1354017282,1364393867,499,1364397235,
5582317962,1364798170,1354422090,1364801403,3233,,
5582817964,1365298162,1354922091,1365302047,3885,,
5582935598,1365415794,1355039726,1365419682,3888,1365418963,
5583317965,1365798156,1355422094,1365801501,3345,,
5583817967,1366298148,1355922095,1366301334,3186,,
5583955494,1366435673,1356059622,1366438862,3189,1366437744,
5584317969,1366798142,1356422096,1366800528,2386,,
5584817971,1367298135,1356922098,1367300223,2088,,
5584985436,1367465597,1357089564,1367467689,2092,1367472117,
5585317972,1367798128,1357422099,1367803170,5042,,
5585817974,1368298121,1357922102,1368304657,6536,,
5586006203,1368486348,1358110331,1368492887,6539,1368488510,
5586317976,1368798116,1358422104,1368801931,3815,,
5586817978,1369298108,1358922106,1369300286,2178,,
5587029898,1369510026,1359134027,1369512207,2181,1369513886,
5587317979,1369798101,1359422106,1369801255,3154,,
5587817980,1370298093,1359922108,1370301970,3877,,
5588057383,1370537492,1360161511,1370541372,3880,1370540611,
5588317981,1370798087,1360422109,1370801575,3488,,
5588817982,1371298078,1360922110,1371301212,3134,,
5589077799,1371557892,1361181928,1371561031,3139,1371560199,
5589317983,1371798071,1361422111,1371800815,2744,,
5589817984,1372298063,1361922111,1372300386,2323,,
5590097984,1372578060,1362202112,1372580387,2327,1372580089,
5590317986,1372798057,1362422113,1372800257,2200,,
5590817987,1373298049,1362922115,1373300094,2045,,
5591123565,1373603623,1363227693,1373605672,2049,1373608296,
5591317989,1373798044,1363422117,1373801115,3071,,
5591817990,1374298036,1363922118,1374302722,4686,,
5592168394,1374648434,1364272523,1374653129,4695,1374662710,
5592317991,1374798029,1364422119,1374805589,7560,,
5592817994,1375298022,1364922121,1375312313,14291,,
5593192040,1375672062,1365296168,1375686359,14297,1375675752,
5593317995,1375798015,1365422123,1375809640,11625,,
5593817996,1376298008,1365922124,1376301711,3703,,
5594222829,1376702833,1366326957,1376706544,3711,1376710235,
5594317997,1376798001,1366422125,1376802415,4414,,
5594817998,1377297992,1366922126,1377305406,7414,,
5595256069,1377736057,1367360199,1377743480,7423,1377742581,
5595317999,1377797985,1367422127,1377805294,7309,,
5595818000,1378297978,1367922128,1378304516,6538,,
5596288261,1378768231,1368392390,1378774778,6547,1378776309,
5596318002,1378797971,1368422130,1378804608,6637,,
5596818004,1379297964,1368922132,1379306053,8089,,
5597307408,1379787361,1369411537,1379795459,8098,1379789062,
5597318005,1379797957,1369422133,1379805917,7960,,
5597818007,1380297950,1369922135,1380299664,1714,,
5598331358,1380811294,1370435486,1380813015,1721,1380814926,
5598331365,1380811301,1370435493,1380813021,1720,,
5598831368,1381311294,1370935495,1381314938,3644,,
5599362261,1381842179,1371466390,1381845832,3653,1381849528,
5599362268,1381842186,1371466397,1381845839,3653,,
5599862269,1382342179,1371966397,1382349538,7359,,
5600383090,1382862991,1372487218,1382870359,7368,1382864997,
5600383126,1382863027,1372487254,1382870395,7368,,
5600883127,1383363018,1372987254,1383365036,2018,,
5601383128,1383863011,1373487256,1383865037,2026,,
5601406859,1383886741,1373510987,1383888768,2027,1383890552,
5601883130,1384363005,1373987258,1384366741,3736,,
5602383131,1384862997,1374487259,1384866826,3829,,
5602432156,1384912022,1374536285,1384915852,3830,1384914980,
5602883133,1385362991,1374987261,1385366044,3053,,
5603383135,1385862984,1375487263,1385865962,2978,,
5603460286,1385940134,1375564414,1385943113,2979,1385939478,
5603883137,1386362977,1375987265,1386362891,-86,,
5604383139,1386862972,1376487267,1386862333,-639,,
5604490120,1386969950,1376594248,1386969315,-635,1386976622,
5604883140,1387362964,1376987268,1387368081,5117,,
5605383142,1387862957,1377487270,1387869647,6690,,
5605509659,1387989472,1377613787,1387996163,6691,1387991289,
5605883143,1388362950,1377987271,1388366008,3058,,
5606383144,1388862943,1378487273,1388864777,1834,,
5606533434,1389013230,1378637562,1389015067,1837,1389017208,
5606883145,1389362934,1378987273,1389366276,3342,,
5607383146,1389862927,1379487273,1389866922,3995,,
5607557203,1390036981,1379661331,1390040980,3999,1390040715,
5607883147,1390362920,1379987275,1390366752,3832,,
5608383149,1390862913,1380487276,1390866663,3750,,
5608598443,1391078204,1380702573,1391081960,3756,1391073532,
5608883150,1391362905,1380987277,1391361867,-1038,,
5609383151,1391862899,1381487279,1391858244,-4655,,
5609622638,1392102382,1381726766,1392097731,-4651,1392106166,
5609883152,1392362890,1381987280,1392362639,-251,,
5610383153,1392862884,1382487281,1392866683,3799,,
5610642687,1393122412,1382746815,1393126217,3805,1393124415,
5610883155,1393362877,1382987283,1393365820,2943,,
5611383157,1393862871,1383487285,1393864887,2016,,
5611667285,1394146994,1383771414,1394149016,2022,1394150920,
5611883158,1394362863,1383987286,1394365711,2848,,
5612383159,1394862856,1384487287,1394866796,3940,,
5612691143,1395170834,1384795271,1395174780,3946,1395174699,
5612883160,1395362848,1384987288,1395366765,3917,,
5613383162,1395862842,1385487290,1395866721,3879,,
5613712735,1396192409,1385816864,1396196295,3886,1396195218,
5613883164,1396362834,1385987291,1396366355,3521,,
5614383165,1396862827,1386487292,1396865649,2822,,
5614737044,1397216700,1386841172,1397219529,2829,1397220616,
5614883166,1397362819,1386987293,1397365968,3149,,
5615383167,1397862813,1387487295,1397866742,3929,,
5615757835,1398237474,1387861964,1398241411,3937,1398238247,
5615883169,1398362805,1387987297,1398365949,3144,,
5616383170,1398862799,1388487298,1398863584,785,,
5616781757,1399261379,1388885886,1399262171,792,1399265053,
5616883171,1399362790,1388987299,1399364169,1379,,
5617383173,1399862785,1389487301,1399866471,3686,,
5617801122,1400280727,1389905251,1400284421,3694,1400282408,
5617883175,1400362777,1389987302,1400366142,3365,,
5618383176,1400862770,1390487304,1400864463,1693,,
5618825106,1401304693,1390929234,1401306394,1701,1401308590,
5618883178,1401362764,1390987306,1401364720,1956,,
5619383179,1401862757,1391487307,1401866666,3909,,
5619852610,1402332180,1391956739,1402336098,3918,1402337032,
5619883180,1402362748,1391987307,1402366722,3974,,
5620383181,1402862742,1392487309,1402867606,4864,,
5620872079,1403351631,1392976207,1403356504,4873,1403353693,
5620883182,1403362733,1392987310,1403367541,4808,,
5621383184,1403862728,1393487312,1403864800,2072,,
5621895797,1404375331,1393999925,1404377413,2082,1404379188,
5621895803,1404375338,1393999932,1404377419,2081,,
5622395805,1404875331,1394499932,1404879198,3867,,
5622915608,1405395126,1395019737,1405399002,3876,1405397077,
5622915615,1405395133,1395019744,1405399007,3874,,
5623415617,1405895125,1395519745,1405897087,1962,,
5623939407,1406418906,1396043535,1406420878,1972,1406422803,
5623939414,1406418913,1396043542,1406420884,1971,,
5624439415,1406918906,1396543543,1406922813,3907,,
5624966389,1407445872,1397070518,1407449788,3916,1407448054,
5624966396,1407445879,1397070524,1407449793,3914,,
5625466397,1407945871,1397570526,1407948064,2193,,
5625990301,1408469765,1398094429,1408471968,2203,1408473736,
5625990308,1408469772,1398094436,1408471974,2202,,
5626490310,1408969766,1398594438,1408973747,3981,,
5627014361,1409493808,1399118489,1409497798,3990,1409497576,
5627014368,1409493815,1399118496,1409497804,3989,,
5627514369,1409993807,1399618497,1409997586,3779,,
5628033595,1410513026,1400137724,1410516814,3788,1410514699,
5628033605,1410513036,1400137734,1410516823,3787,,
5628533607,1411013028,1400637735,1411014713,1685,,
5629056858,1411536270,1401160987,1411537965,1695,1411540104,
5629056906,1411536319,1401161035,1411538013,1694,,
5629556908,1412036312,1401661036,1412040156,3844,,
5630077333,1412556729,1402181462,1412560583,3854,1412559040,
5630077342,1412556738,1402181471,1412560591,3853,,
5630577344,1413056730,1402681472,1413059053,2323,,
5631097480,1413576859,1403201609,1413579190,2331,1413578044,
5631097487,1413576866,1403201616,1413579195,2329,,
5631597489,1414076858,1403701617,1414078054,1196,,
5632122225,1414601585,1404226353,1414602791,1206,1414605497,
5632122264,1414601625,1404226393,1414602829,1204,,
5632622266,1415101618,1404726394,1415105540,3922,,
5633146823,1415626166,1405250951,1415630098,3932,1415629599,
5633146830,1415626173,1405250958,1415630104,3931,,
5633646832,1416126166,1405750960,1416129610,3444,,
5634172245,1416651571,1406276374,1416655025,3454,1416656474,
5634172254,1416651580,1406276383,1416655031,3451,,
5634672255,1417151573,1406776384,1417156487,4914,,
5635195508,1417674817,1407299636,1417679740,4923,1417678660,
5635195544,1417674853,1407299672,1417679775,4922,,
5635695546,1418174845,1407799674,1418178699,3854,,
5636219801,1418699091,1408323929,1418702955,3864,1418703201,
5636219808,1418699099,1408323936,1418702961,3862,,
5636719809,1419199091,1408823937,1419203211,4120,,
5637243711,1419722985,1409347839,1419727114,4129,1419726933,
5637243718,1419722992,1409347846,1419727120,4128,,
5637743720,1420222986,1409847848,1420226944,3958,,
5638266495,1420745751,1410370623,1420749719,3968,1420748987,
5638266502,1420745758,1410370630,1420749725,3967,,
5638766504,1421245751,1410870632,1421248998,3247,,
5639286755,1421765993,1411390883,1421769249,3256,1421767172,
5639286762,1421766001,1411390890,1421769256,3255,,
5639786764,1422265994,1411890892,1422267184,1190,,
5640307939,1422787160,1412412067,1422788358,1198,1422789719,
5640307946,1422787167,1412412074,1422788365,1198,,
5640807948,1423287161,1412912076,1423289730,2569,,
5641331518,1423810722,1413435646,1423813300,2578,1423814277,
5641331525,1423810729,1413435653,1423813306,2577,,
5641831527,1424310722,1413935655,1424314288,3566,,
5642351427,1424830614,1414455555,1424834189,3575,1424832596,
5642351435,1424830621,1414455563,1424834195,3574,,
5642851436,1425330614,1414955563,1425332607,1993,,
5643379435,1425858605,1415483563,1425860607,2002,1425862877,
5643379442,1425858612,1415483570,1425860613,2001,,
5643879444,1426358605,1415983572,1426362889,4284,,
5644402442,1426881594,1416506570,1426885887,4293,1426885120,
5644402449,1426881601,1416506577,1426885893,4292,,
5644902450,1427381593,1417006578,1427385129,3536,,
5645402451,1427881586,1417506579,1427885131,3545,,
5645423594,1427902729,1417527722,1427906274,3545,1427905294,
5645902453,1428381579,1418006581,1428384195,2616,,
5646402455,1428881572,1418506583,1428884157,2585,,
5646451570,1428930688,1418555698,1428933272,2584,1428937037,
5646902456,1429381566,1419006585,1429387555,5989,,
5647402457,1429881557,1419506584,1429887925,6368,,
5647478191,1429957291,1419582320,1429963660,6369,1429962444,
5647902459,1430381551,1420006587,1430386898,5347,,
5648402460,1430881544,1420506588,1430886715,5171,,
5648500743,1430979826,1420604871,1430984998,5172,1430983109,
5648902461,1431381536,1421006588,1431385199,3663,,
5649402462,1431881528,1421506590,1431884830,3302,,
5649524525,1432003589,1421628653,1432006894,3305,1432007349,
5649902463,1432381521,1422006590,1432385177,3656,,
5650402465,1432881514,1422506593,1432885291,3777,,
5650545428,1433024476,1422649557,1433028255,3779,1433026957,
5650902467,1433381509,1423006595,1433384367,2858,,
5651402468,1433881501,1423506596,1433883998,2497,,
5651564740,1434043771,1423668868,1434046271,2500,1434045602,
5651902470,1434381494,1424006598,1434383549,2055,,
5652402471,1434881487,1424506599,1434883335,1848,,
5652589897,1435068911,1424694027,1435070764,1853,1435072506,
5652902473,1435381481,1425006601,1435384428,2947,,
5653402475,1435881473,1425506603,1435885086,3613,,
5653609302,1436088297,1425713430,1436091913,3616,1436089865,
5653902476,1436381467,1426006604,1436383886,2419,,
5654402478,1436881459,1426506606,1436883043,1584,,
5654633453,1437112430,1426737581,1437114019,1589,1437115976,
5654902479,1437381452,1427006606,1437384098,2646,,
5655402480,1437881445,1427506608,1437885006,3561,,
5655657113,1438136073,1427761241,1438139638,3565,1438139993,
5655902481,1438381438,1428006609,1438385182,3744,,
5656402483,1438881431,1428506611,1438885366,3935,,
5656681484,1439160427,1428785612,1439164366,3939,1439164633,
5656902484,1439381424,1429006613,1439385486,4062,,
5657402485,1439881416,1429506614,1439885637,4221,,
5657700853,1440179779,1429804982,1440184005,4226,1440181519,
5657902487,1440381410,1430006615,1440384635,3225,,
5658402488,1440881401,1430506616,1440883156,1755,,
5658724476,1441203384,1430828604,1441205145,1761,1441207204,
5658902489,1441381395,1431006618,1441383891,2496,,
5659402490,1441881386,1431506618,1441885220,3834,,
5659744183,1442223074,1431848311,1442226914,3840,1442224953,
5659902491,1442381379,1432006619,1442384600,3221,,
5660402494,1442881373,1432506621,1442883266,1893,,
5660769313,1443248186,1432873441,1443250085,1899,1443250980,
5660902496,1443381367,1433006624,1443383506,2139,,
5661402497,1443881359,1433506625,1443884166,2807,,
5661789926,1444268783,1433894055,1444271596,2813,1444271174,
5661902499,1444381353,1434006627,1444384072,2719,,
5662402501,1444881346,1434506628,1444883750,2404,,
5662814110,1445292949,1434918238,1445295360,2411,1445296970,
5662902502,1445381339,1435006630,1445384034,2695,,
5663402504,1445881332,1435506632,1445885365,4033,,
5663843526,1446322347,1435947654,1446326388,4041,1446329103,
5663902505,1446381325,1436006633,1446385687,4362,,
5664402506,1446881318,1436506634,1446888086,6768,,
5664862770,1447341575,1436966899,1447348350,6775,1447343207,
5664902507,1447381310,1437006634,1447387676,6366,,
5665402508,1447881302,1437506636,1447882946,1644,,
5665886709,1448365495,1437990837,1448367148,1653,1448369594,
5665902509,1448381295,1438006637,1448383024,1729,,
5666402510,1448881288,1438506639,1448885398,4110,,
5666907087,1449385856,1439011215,1449389975,4119,1449386839,
5666907095,1449385865,1439011224,1449389981,4116,,
5667407096,1449885857,1439511224,1449886851,994,,
5667930463,1450409215,1440034591,1450410218,1003,1450410164,
5667930471,1450409222,1440034599,1450410224,1002,,
5668430472,1450909215,1440534600,1450910175,960,,
5668954564,1451433299,1441058693,1451434269,970,1451436918,
5668954574,1451433310,1441058703,1451434278,968,,
5669454575,1451933301,1441558702,1451936931,3630,,
5669974561,1452453278,1442078689,1452456917,3639,1452455246,
5669974568,1452453285,1442078696,1452456922,3637,,
5670474570,1452953279,1442578698,1452955257,1978,,
5671007730,1453486429,1443111858,1453488418,1989,1453495068,
5671007737,1453486436,1443111865,1453488424,1988,,
5671507739,1453986431,1443611867,1453995080,8649,,
5672026849,1454505532,1444130978,1454514190,8658,1454507250,
5672026856,1454505539,1444130984,1454514196,8657,,
5672526857,1455005530,1444630985,1455007260,1730,,
5673026858,1455505523,1445130986,1455507261,1738,,
5673055159,1455533823,1445159287,1455535562,1739,1455539801,
5673526860,1456005516,1445630988,1456011264,5748,,
5674026862,1456505511,1446130990,1456511507,5996,,
5674074339,1456552986,1446178467,1456558984,5998,1456554638,
5674526864,1457005503,1446630992,1457007577,2074,,
5675026865,1457505497,1447130993,1457507167,1670,,
5675094589,1457573219,1447198717,1457574891,1672,1457575251,
5675526866,1458005488,1447630994,1458007480,1992,,
5676026868,1458505482,1448130996,1458507532,2050,,
5676129193,1458607806,1448233323,1458609860,2054,1458616682,
5676526869,1459005474,1448630997,1459012963,7489,,
5677026870,1459505468,1449130998,1459514362,8894,,
5677153043,1459631638,1449257171,1459640535,8897,1459635517,
5677526871,1460005459,1449630999,1460010612,5153,,
5678026872,1460505453,1450131000,1460509348,3895,,
5678179069,1460657646,1450283197,1460661545,3899,1460661158,
5678526873,1461005445,1450631001,1461009081,3636,,
5679026874,1461505438,1451131002,1461508966,3528,,
5679202892,1461681452,1451307020,1461684983,3531,1461685261,
5679526875,1462005429,1451631003,1462009147,3718,,
5680026876,1462505422,1452131004,1462509247,3825,,
5680222641,1462701184,1452326769,1462705013,3829,1462702839,
5680526877,1463005414,1452631005,1463007925,2511,,
5681026879,1463505408,1453131007,1463507078,1670,,
5681247169,1463725694,1453351297,1463727368,1674,1463729577,
5681526880,1464005400,1453631008,1464008316,2916,,
5682026881,1464505394,1454131009,1464509292,3898,,
5682266553,1464745062,1454370681,1464748964,3902,1464746594,
5682526882,1465005385,1454631010,1465008059,2674,,
5683026883,1465505378,1455131010,1465506926,1548,,
5683290620,1465769110,1455394748,1465770664,1554,1465772732,
5683526884,1466005371,1455631012,1466007906,2535,,
5684026886,1466505364,1456131014,1466509000,3636,,
5684319532,1466798006,1456423661,1466801647,3641,1466804185,
5684526887,1467005357,1456631015,1467010054,4697,,
5685026888,1467505350,1457131016,1467511543,6193,,
5685338745,1467817201,1457442874,1467823400,6199,1467818884,
5685526889,1468005342,1457631017,1468009845,4503,,
5686026890,1468505334,1458131018,1468507031,1697,,
5686366471,1468844909,1458470599,1468846612,1703,1468850755,
5686526891,1469005326,1458631018,1469008361,3035,,
5687026892,1469505319,1459131019,1469511178,5859,,
5687392805,1469871226,1459496933,1469877091,5865,1469875001,
5687526894,1470005313,1459631022,1470010619,5306,,
5688026895,1470505305,1460131023,1470509093,3788,,
5688424269,1470902673,1460528399,1470906471,3798,1470903432,
5688526896,1471005298,1460631024,1471008471,3173,,
5689026897,1471505290,1461131025,1471506064,774,,
5689448165,1471926552,1461552294,1471927332,780,1471930362,
5689526898,1472005282,1461631025,1472006541,1259,,
5690026899,1472505275,1462131027,1472509098,3823,,
5690477705,1472956074,1462581833,1472959904,3830,1472962200,
5690526901,1473005268,1462631029,1473009325,4057,,
5691026903,1473505262,1463131031,1473511401,6139,,
5691506816,1473985168,1463610945,1473991314,6146,1473990869,
5691526904,1474005254,1463631032,1474011382,6128,,
5692026905,1474505248,1464131033,1474510960,5712,,
5692527384,1475005718,1464631513,1475011439,5721,1475008034,
5692527429,1475005763,1464631557,1475011483,5720,,
5693027431,1475505757,1465131559,1475508084,2327,,
5693549128,1476027445,1465653351,1476029876,2431,1476030066,
5693549232,1476027549,1465653360,1476029884,2335,,
5694049233,1476527540,1466153361,1476530173,2633,,
5694569617,1477047917,1466673745,1477050558,2641,1477049967,
5694569624,1477047924,1466673752,1477050564,2640,,
5695069626,1477547916,1467173754,1477549978,2062,,
5695593098,1478071380,1467697227,1478073452,2072,1478075283,
5695593108,1478071390,1467697237,1478073459,2069,,
5696093110,1478571384,1468197238,1478575296,3912,,
5696614588,1479092853,1468718716,1479096775,3922,1479095688,
5696614597,1479092861,1468718725,1479096782,3921,,
5697114599,1479592854,1469218726,1479595701,2847,,
5697633875,1480112122,1469738004,1480114978,2856,1480113915,
5697633884,1480112130,1469738012,1480114985,2855,,
5698133885,1480612123,1470238013,1480613927,1804,,
5698654411,1481132641,1470758540,1481134455,1814,1481135060,
5698654420,1481132650,1470758549,1481134462,1812,,
5699154421,1481632642,1471258549,1481635072,2430,,
5699677924,1482156137,1471782053,1482158576,2439,1482155706,
5699677935,1482156147,1471782063,1482158585,2438,,
5700177936,1482656140,1472282064,1482655721,-419,,
5700702945,1483181140,1472807073,1483180730,-410,1483185740,
5700702952,1483181147,1472807080,1483180736,-411,,
5701202953,1483681140,1473307081,1483685750,4610,,
5701723443,1484201621,1473827572,1484206241,4620,1484203749,
5701723451,1484201628,1473827579,1484206248,4620,,
5702223452,1484701620,1474327580,1484703759,2139,,
5702743276,1485221437,1474847405,1485223585,2148,1485223446,
5702743285,1485221446,1474847414,1485223592,2146,,
5703243287,1485721438,1475347415,1485723459,2021,,
5703766505,1486244647,1475870633,1486246678,2031,1486248563,
5703766512,1486244654,1475870640,1486246684,2030,,
5704266513,1486744648,1476370642,1486748574,3926,,
5704804756,1487282882,1476908886,1487286819,3937,1487294008,
5704804771,1487282898,1476908901,1487286832,3934,,
5705304772,1487782888,1477408900,1487794026,11138,,
5705824202,1488302310,1477928330,1488313457,11147,1488303911,
5705824210,1488302317,1477928338,1488313463,11146,,
5706324211,1488802311,1478428339,1488803922,1611,,
5706854529,1489332620,1478958658,1489334240,1620,1489340059,
5706854536,1489332627,1478958665,1489334246,1619,,
5707354537,1489832618,1479458665,1489840068,7450,,
5707873880,1490351953,1479978008,1490359412,7459,1490353636,
5707873887,1490351960,1479978015,1490359418,7458,,
5708373889,1490851953,1480478017,1490853647,1694,,
5708894761,1491372817,1480998889,1491374520,1703,1491375219,
5708894768,1491372824,1480998897,1491374526,1702,,
5709394769,1491872817,1481498897,1491875230,2413,,
5709918726,1492396765,1482022855,1492399188,2423,1492400912,
5709918733,1492396772,1482022862,1492399193,2421,,
5710418734,1492896763,1482522861,1492900921,4158,,
5710918735,1493396756,1483022863,1493400923,4167,,
5710938764,1493416785,1483042893,1493420952,4167,1493418025,
5711418737,1493896749,1483522865,1493898116,1367,,
5711918739,1494396743,1484022867,1494398001,1258,,
5711967032,1494445036,1484071160,1494446295,1259,1494451286,
5712418740,1494896735,1484522868,1494902513,5778,,
5712918741,1495396728,1485022869,1495402997,6269,,
5713170188,1495648172,1485274318,1495654448,6276,1495642143,
5713418743,1495896721,1485522871,1495896884,163,,
5713918745,1496396715,1486022872,1496390702,-6013,,
5714211503,1496689469,1486315631,1496683461,-6008,1496702165,
5714418746,1496896708,1486522874,1496898457,1749,,
5714918747,1497396700,1487022875,1497409411,12711,,
5715235581,1497713528,1487339709,1497726246,12718,1497717814,
5715418748,1497896692,1487522875,1497906322,9630,,
5715918749,1498396686,1488022877,1498400985,4299,,
5716260029,1498737960,1488364157,1498742265,4305,1498742244,
5716418750,1498896677,1488522877,1498900978,4301,,
5716918751,1499396671,1489022879,1499400969,4298,,
5717285870,1499763783,1489389998,1499768088,4305,1499767998,
5717418753,1499896664,1489522881,1499900946,4282,,
5717918755,1500396657,1490022883,1500400884,4227,,
5718308568,1500786464,1490412696,1500790698,4234,1500789910,
5718418756,1500896649,1490522884,1500900710,4061,,
5718918757,1501396643,1491022885,1501400100,3457,,
5719336268,1501814146,1491440396,1501817612,3466,1501816190,
5719418759,1501896635,1491522886,1501899867,3232,,
5719918761,1502396629,1492022889,1502398685,2056,,
5720359729,1502837590,1492463857,1502839654,2064,1502838061,
5720418763,1502896623,1492522891,1502898498,1875,,
5720918764,1503396616,1493022892,1503397097,481,,
5721382248,1503860092,1493486376,1503860582,490,1503863414,
5721418766,1503896608,1493522893,1503897305,697,,
5721918768,1504396602,1494022896,1504399936,3334,,
5722403522,1504881347,1494507650,1504884691,3344,1504884019,
5722418771,1504896598,1494522901,1504899921,3323,,
5722918773,1505396591,1495022901,1505399272,2681,,
5723427423,1505905232,1495531551,1505907923,2691,1505909324,
5723427430,1505905239,1495531558,1505907929,2690,,
5723927431,1506405230,1496031559,1506409334,4104,,
5724456155,1506933945,1496560283,1506938058,4113,1506940119,
5724456198,1506933989,1496560326,1506938101,4112,,
5724956199,1507433982,1497060327,1507440165,6183,,
5725477448,1507955221,1497581576,1507961414,6193,1507956810,
5725477455,1507955229,1497581583,1507961421,6192,,
5725977456,1508455222,1498081584,1508456820,1598,,
5726500907,1508978663,1498605035,1508980272,1609,1508982570,
5726500914,1508978670,1498605042,1508980278,1608,,
5727000915,1509478662,1499105042,1509482580,3918,,
5727524038,1510001776,1499628166,1510005704,3928,1510005329,
5727524045,1510001784,1499628173,1510005710,3926,,
5728024046,1510501776,1500128174,1510505339,3563,,
5728548694,1511026415,1500652822,1511029987,3572,1511030711,
5728548701,1511026422,1500652829,1511029993,3571,,
5729048702,1511526414,1501152830,1511530721,4307,,
5729572676,1512050380,1501676804,1512054696,4316,1512054544,
5729572683,1512050387,1501676811,1512054702,4315,,
5730072685,1512550380,1502176812,1512554555,4175,,
5730597114,1513074800,1502701242,1513078985,4185,1513079032,
5730597121,1513074807,1502701249,1513078991,4184,,
5731097123,1513574801,1503201251,1513579043,4242,,
5731620489,1514098159,1503724618,1514102410,4251,1514101985,
5731620496,1514098166,1503724625,1514102415,4249,,
5732120497,1514598158,1504224625,1514601995,3837,,
5732643691,1515121343,1504747819,1515125189,3846,1515124894,
5732643698,1515121350,1504747826,1515125195,3845,,
5733143700,1515621343,1505247827,1515624905,3562,,
5733668809,1516146443,1505772937,1516150015,3572,1516151110,
5733668816,1516146450,1505772944,1516150021,3571,,
5734168818,1516646443,1506272946,1516651121,4678,,
5734688595,1517166213,1506792723,1517170899,4686,1517168198,
5734688602,1517166220,1506792730,1517170904,4684,,
5735188603,1517666212,1507292731,1517668207,1995,,
5735688604,1518166204,1507792732,1518168208,2004,,
5735707890,1518185490,1507812018,1518187495,2005,1518187250,
5736188605,1518666197,1508292733,1518667977,1780,,
5736688607,1519166190,1508792735,1519167969,1779,,
5736731932,1519209515,1508836060,1519211295,1780,1519213219,
5737188609,1519666183,1509292737,1519669732,3549,,
5737688610,1520166176,1509792737,1520169899,3723,,
5737756056,1520233621,1509860184,1520237346,3725,1520237437,
5738188611,1520666168,1510292739,1520669981,3813,,
5738688612,1521166162,1510792740,1521169995,3833,,
5738779368,1521256916,1510883496,1521260751,3835,1521260772,
5739188614,1521666154,1511292742,1521670016,3862,,
5739688615,1522166147,1511792743,1522170021,3874,,
5739805535,1522283066,1511909664,1522286942,3876,1522288092,
5740188617,1522666140,1512292745,1522670905,4765,,
5740688618,1523166134,1512792746,1523171176,5042,,
5740829924,1523307437,1512934053,1523312484,5047,1523311493,
5741188624,1523666131,1513292754,1523670476,4345,,
5741688626,1524166124,1513792753,1524170196,4072,,
5741853404,1524330900,1513957532,1524334975,4075,1524334636,
5742188628,1524666117,1514292756,1524669974,3857,,
5742688629,1525166111,1514792757,1525169864,3753,,
5742874338,1525351815,1514978466,1525355573,3758,1525353398,
5743188631,1525666104,1515292759,1525668499,2395,,
5743688632,1526166097,1515792760,1526167694,1597,,
5743898410,1526375871,1516002539,1526377474,1603,1526380007,
5744188633,1526666088,1516292761,1526669166,3078,,
5744688635,1527166082,1516792763,1527170233,4151,,
5744923467,1527400910,1517027594,1527405065,4155,1527404288,
5745188637,1527666075,1517292764,1527669824,3749,,
5745688639,1528166069,1517792767,1528169462,3393,,
5745947080,1528424506,1518051208,1528427904,3398,1528428408,
5746188640,1528666061,1518292768,1528669707,3646,,
5746688642,1529166055,1518792769,1529169972,3917,,
5746970903,1529448312,1519075032,1529452234,3922,1529452380,
5747188643,1529666048,1519292772,1529670037,3989,,
5747688645,1530166041,1519792773,1530170123,4082,,
5747995726,1530473117,1520099855,1530477205,4088,1530476676,
5748188646,1530666034,1520292774,1530669921,3887,,
5748688647,1531166026,1520792775,1531169598,3572,,
5749019525,1531496898,1521123653,1531500476,3578,1531500820,
5749188649,1531666019,1521292777,1531669716,3697,,
5749688650,1532166013,1521792778,1532169947,3934,,
5750045374,1532522729,1522149502,1532526672,3943,1532527463,
5750188651,1532666005,1522292779,1532670176,4171,,
5750688653,1533165999,1522792781,1533170745,4746,,
5751094484,1533571823,1523198614,1533576578,4755,1533585509,
5751188654,1533665990,1523292782,1533672426,6436,,
5751688655,1534165984,1523792783,1534179684,13700,,
5752113746,1534591066,1524217874,1534604775,13709,1534592768,
5752188657,1534665976,1524292785,1534677886,11910,,
5752688658,1535165969,1524792785,1535167682,1713,,
5753136414,1535613718,1525240543,1535615440,1722,1535615371,
5753188659,1535665962,1525292787,1535667676,1714,,
5753688661,1536165955,1525792788,1536167619,1664,,
5754160174,1536637461,1526264303,1536639133,1672,1536641410,
5754188665,1536665951,1526292794,1536667754,1803,,
5754688667,1537165945,1526792795,1537169904,3959,,
5755199816,1537677085,1527303946,1537681056,3971,1537669576,
5755199831,1537677100,1527303960,1537681068,3968,,
5755699832,1538177091,1527803960,1538169594,-7497,,
5756223893,1538701144,1528328021,1538693656,-7488,1538705137,
5756223901,1538701151,1528328029,1538693663,-7488,,
5756723903,1539201145,1528828031,1539205148,4003,,
5757243153,1539720387,1529347281,1539724399,4012,1539722142,
5757243160,1539720394,1529347288,1539724405,4011,,
5757743162,1540220388,1529847290,1540222153,1765,,
5758267068,1540744284,1530371196,1540746058,1774,1540748044,
5758267075,1540744291,1530371203,1540746065,1774,,
5758767077,1541244284,1530871205,1541248055,3771,,
5759289401,1541766599,1531393529,1541770380,3781,1541768682,
5759289408,1541766606,1531393536,1541770386,3780,,
5759789409,1542266600,1531893537,1542268693,2093,,
5760308845,1542786027,1532412974,1542788129,2102,1542787708,
5760308853,1542786035,1532412981,1542788135,2100,,
5760808854,1543286027,1532912982,1543287719,1692,,
5761328429,1543805593,1533432557,1543807293,1700,1543807368,
5761328436,1543805600,1533432564,1543807299,1699,,
5761828437,1544305592,1533932564,1544307378,1786,,
5762353478,1544830625,1534457606,1544832420,1795,1544835035,
5762353485,1544830632,1534457613,1544832426,1794,,
5762853487,1545330625,1534957615,1545335046,4421,,
5763372863,1545849993,1535476992,1545854424,4431,1545851654,
5763372871,1545850000,1535476999,1545854429,4429,,
5763872872,1546349992,1535977000,1546351664,1672,,
5764393711,1546870823,1536497839,1546872503,1680,1546872445,
5764393718,1546870830,1536497846,1546872509,1679,,
5764893719,1547370823,1536997847,1547372455,1632,,
5765412957,1547890052,1537517085,1547891694,1642,1547891660,
5765412965,1547890059,1537517093,1547891700,1641,,
5765912966,1548390053,1538017094,1548391671,1618,,
5766436738,1548913816,1538540866,1548915443,1627,1548917276,
5766436746,1548913823,1538540874,1548915449,1626,,
5766936747,1549413815,1539040874,1549417286,3471,,
5767461994,1549939054,1539566123,1549942534,3480,1549943808,
5767462001,1549939061,1539566130,1549942540,3479,,
5767962003,1550439054,1540066131,1550443818,4764,,
5768488415,1550965458,1540592544,1550970232,4774,1550967830,
5768488425,1550965467,1540592553,1550970238,4771,,
5768988427,1551465461,1541092556,1551467845,2384,,
5769513004,1551990030,1541617132,1551992422,2392,1551994405,
5769513011,1551990037,1541617139,1551992429,2392,,
5770013012,1552490028,1542117140,1552494415,4387,,
5770534666,1553011674,1542638794,1553016070,4396,1553014111,
5770534673,1553011681,1542638802,1553016075,4394,,
5771034674,1553511674,1543138802,1553514121,2447,,
5771534675,1554011665,1543638802,1554014121,2456,,
5771555833,1554032824,1543659961,1554035280,2456,1554035504,
5772034677,1554511659,1544138805,1554514339,2680,,
5772534679,1555011652,1544638806,1555014351,2699,,
5772579951,1555056923,1544684079,1555059624,2701,1555061071,
5773034681,1555511646,1545138809,1555515672,4026,,
5773534682,1556011639,1545638810,1556015805,4166,,
5773608189,1556085144,1545712317,1556089312,4168,1556090088,
5774034684,1556511633,1546138812,1556516471,4838,,
5774534686,1557011625,1546638813,1557016587,4962,,
5774628833,1557105772,1546732962,1557110735,4963,1557108116,
5775034688,1557511620,1547138816,1557514465,2845,,
5775534690,1558011613,1547638818,1558013975,2362,,
5775652079,1558129000,1547756208,1558131364,2364,1558132640,
5776034692,1558511606,1548138820,1558514953,3347,,
5776534693,1559011598,1548638821,1559015256,3658,,
5776675893,1559152797,1548780021,1559156456,3659,1559156852,
5777034694,1559511591,1549138821,1559515542,3951,,
5777534695,1560011583,1549638822,1560015656,4073,,
5777710489,1560187374,1549814617,1560191451,4077,1560196572,
5778034697,1560511577,1550138825,1560518980,7403,,
5778534698,1561011570,1550638826,1561020784,9214,,
5778732433,1561209302,1550836561,1561218519,9217,1561209777,
5779034699,1561511562,1551138827,1561515501,3939,,
5779534700,1562011554,1551638828,1562012047,493,,
5779752307,1562229157,1551856435,1562229653,496,1562230625,
5780034702,1562511548,1552138830,1562512598,1050,,
5780534703,1563011541,1552638831,1563013024,1483,,
5780772276,1563249110,1552876405,1563250598,1488,1563251211,
5781034705,1563511534,1553138833,1563513348,1814,,
5781534707,1564011528,1553638835,1564013644,2116,,
5781795944,1564272760,1553900072,1564274880,2120,1564276758,
5782034709,1564511521,1554138837,1564514542,3021,,
5782534711,1565011514,1554638838,1565015527,4013,,
5782820921,1565297720,1554925049,1565301738,4018,1565302111,
5783034713,1565511508,1555138840,1565515690,4182,,
5783534714,1566011500,1555638841,1566015906,4406,,
5783843099,1566319880,1555947227,1566324292,4412,1566322952,
5784034715,1566511493,1556138843,1566515394,3901,,
5784534716,1567011485,1556638843,1567014571,3086,,
5784868274,1567345038,1556972402,1567348130,3092,1567349723,
5785034717,1567511479,1557138846,1567515103,3624,,
5785534719,1568011471,1557638847,1568016170,4699,,
5785891226,1568367973,1557995355,1568372678,4705,1568371583,
5786034721,1568511466,1558138849,1568515858,4392,,
5786534723,1569011458,1558638850,1569015082,3624,,
5786966352,1569443081,1559070482,1569446714,3633,1569472319,
5787034724,1569511451,1559138852,1569518584,7133,,
5787534725,1570011443,1559638853,1570040695,29252,,
5787989951,1570466661,1560094079,1570495921,29260,1570470551,
5788034726,1570511437,1560138854,1570538424,26987,,
5788534728,1571011429,1560638856,1571015330,3901,,
5789009568,1571486262,1561113697,1571490172,3910,1571488024,
5789034730,1571511423,1561138858,1571515224,3801,,
5789534731,1572011416,1561638859,1572013188,1772,,
5790029996,1572506673,1562134124,1572508454,1781,1572509055,
5790034733,1572511409,1562138861,1572513194,1785,,
5790534734,1573011401,1562638862,1573013794,2393,,
5791052034,1573528693,1563156163,1573531096,2403,1573531872,
5791052044,1573528703,1563156173,1573531104,2401,,
5791552046,1574028697,1563656174,1574031886,3189,,
5792078488,1574555130,1564182617,1574558329,3199,1574560524,
5792078497,1574555138,1564182625,1574558336,3198,,
5792578498,1575055130,1564682626,1575060536,5406,,
5793120855,1575597478,1565224983,1575602894,5416,1575605108,
5793120862,1575597486,1565224991,1575602900,5414,,
5793620864,1576097479,1565724992,1576105119,7640,,
5794141265,1576617871,1566245393,1576625520,7649,1576619456,
5794141272,1576617878,1566245400,1576625526,7648,,
5794641274,1577117872,1566745402,1577119467,1595,,
5795161058,1577637646,1567265186,1577639251,1605,1577639736,
5795161064,1577637653,1567265193,1577639256,1603,,
5795661066,1578137646,1567765194,1578139746,2100,,
5796184634,1578661205,1568288762,1578663315,2110,1578665165,
5796184641,1578661212,1568288769,1578663321,2109,,
5796684642,1579161205,1568788769,1579165175,3970,,
5797208981,1579685536,1569313109,1579689515,3979,1579689652,
5797208988,1579685543,1569313116,1579689521,3978,,
5797708990,1580185535,1569813117,1580189663,4128,,
5798236194,1580712730,1570340322,1580716868,4138,1580715177,
5798236201,1580712737,1570340329,1580716874,4137,,
5798736203,1581212732,1570840331,1581215188,2456,,
5799261556,1581738075,1571365684,1581740542,2467,1581741953,
5799261563,1581738082,1571365691,1581740548,2466,,
5799761565,1582238075,1571865693,1582241965,3890,,
5800281534,1582758036,1572385662,1582761934,3898,1582759873,
5800281541,1582758043,1572385669,1582761940,3897,,
5800781543,1583258037,1572885671,1583259885,1848,,
5801300786,1583777271,1573404915,1583779128,1857,1583779076,
5801300829,1583777314,1573404957,1583779169,1855,,
5801800831,1584277307,1573904959,1584279123,1816,,
5802320117,1584796585,1574424246,1584798410,1825,1584798380,
5802320124,1584796592,1574424253,1584798416,1824,,
5802820125,1585296583,1574924252,1585298389,1806,,
5803340245,1585816694,1575444373,1585818510,1816,1585819003,
5803340254,1585816704,1575444382,1585818517,1813,,
5803840255,1586316696,1575944383,1586319015,2319,,
5804367950,1586844384,1576472080,1586846714,2330,1586846291,
5804368033,1586844467,1576472163,1586846793,2326,,
5804868035,1587344458,1576972163,1587346378,1920,,
5805393453,1587869869,1577497581,1587871797,1928,1587874676,
5805393460,1587869876,1577497589,1587871803,1927,,
5805893462,1588369869,1577997590,1588374688,4819,,
5806412632,1588889029,1578516760,1588893858,4829,1588890858,
5806412641,1588889038,1578516769,1588893865,4827,,
5806912643,1589389032,1579016771,1589390872,1840,,
5807436404,1589912784,1579540532,1589914633,1849,1589916601,
5807436444,1589912825,1579540573,1589914672,1847,,
5807936446,1590412817,1580040574,1590416645,3828,,
5808455899,1590932262,1580560028,1590936099,3837,1590934182,
5808455906,1590932269,1580560035,1590936104,3835,,
5808955907,1591432261,1581060035,1591434191,1930,,
5809455908,1591932253,1581560036,1591934192,1939,,
5809475138,1591951483,1581579266,1591953423,1940,1591953218,
5809955909,1592432246,1582060036,1592433999,1753,,
5810455910,1592932238,1582560037,1592933992,1754,,
5810495525,1592971854,1582599654,1592973608,1754,1592974117,
5810955911,1593432231,1583060038,1593434473,2242,,
5811455912,1593932223,1583560039,1593934515,2292,,
5811520212,1593996522,1583624340,1593998815,2293,1594000845,
5811955913,1594432216,1584060041,1594436286,4070,,
5812455915,1594932209,1584560043,1594936550,4341,,
5812547241,1595023535,1584651370,1595027877,4342,1595025942,
5812955916,1595432203,1585060044,1595434972,2769,,
5813455917,1595932194,1585560045,1595934619,2425,,
5813574666,1596050941,1585678794,1596053369,2428,1596055232,
5813955918,1596432188,1586060047,1596436043,3855,,
5814455919,1596932179,1586560046,1596936487,4308,,
5814598682,1597074941,1586702811,1597079251,4310,1597079083,
5814955920,1597432172,1587060047,1597436370,4198,,
5815455921,1597932164,1587560049,1597936324,4160,,
5815622369,1598098611,1587726498,1598102773,4162,1598102373,
5815955922,1598432157,1588060050,1598436059,3902,,
5816455923,1598932150,1588560051,1598935929,3779,,
5816648239,1599124463,1588752367,1599128246,3783,1599127351,
5816955924,1599432142,1589060052,1599435380,3238,,
5817455926,1599932135,1589560054,1599935039,2904,,
5817667601,1600143808,1589771730,1600146716,2908,1600145569,
5817955927,1600432129,1590060055,1600434381,2252,,
5818455929,1600932121,1590560057,1600933898,1777,,
5818687726,1601163915,1590791854,1601165696,1781,1601166030,
5818955930,1601432115,1591060058,1601434081,1966,,
5819455931,1601932107,1591560059,1601934238,2131,,
5819707947,1602184118,1591812075,1602186253,2135,1602186343,
5819955932,1602432100,1592060060,1602434284,2184,,
5820455933,1602932091,1592560060,1602934331,2240,,
5820731553,1603207707,1592835681,1603209952,2245,1603211665,
5820955934,1603432085,1593060063,1603435102,3017,,
5821455935,1603932077,1593560063,1603936050,3973,,
5821776760,1604252898,1593880890,1604256878,3980,1604264892,
5821955936,1604432069,1594060064,1604438922,6853,,
5822455938,1604932063,1594560066,1604944073,12010,,
5822804299,1605280418,1594908427,1605292433,12015,1605286227,
5822955939,1605432055,1595060066,1605442191,10136,,
5823455941,1605932048,1595560069,1605937871,5823,,
5823823826,1606299928,1595927955,1606305758,5830,1606301555,
5823955943,1606432042,1596060071,1606436762,4720,,
5824455944,1606932034,1596560072,1606933675,1641,,
5824843124,1607319208,1596947252,1607320856,1648,1607321014,
5824955946,1607432028,1597060074,1607433712,1684,,
5825455947,1607932021,1597560075,1607933840,1819,,
5825862390,1608338458,1597966518,1608340283,1825,1608340228,
5825955948,1608432014,1598060076,1608433831,1817,,
5826455950,1608932006,1598560078,1608933790,1784,,
5826886442,1609362492,1598990570,1609364283,1791,1609366541,
5826955951,1609432000,1599060080,1609434106,2106,,
5827455954,1609931993,1599560081,1609936054,4061,,
5827910060,1610386092,1600014188,1610390160,4068,1610390106,
5827955955,1610431986,1600060083,1610436049,4063,,
5828455956,1610931978,1600560084,1610936004,4026,,
5828929241,1611405256,1601033370,1611409290,4034,1611407194,
5828955958,1611431973,1601060086,1611435894,3921,,
