Current Real Time,Local Server Time,Hardware Clock Time,Software Clock Time,Error,Remote Est Time,
77677387139,25146670,982763,982765,-24163905,,
77677406713,25166244,1002338,1002340,-24163904,25166119,
77677887140,25646669,1482762,24700778,-945891,,
77678387141,26146670,1982763,26146550,-120,,
77678429326,26188856,2024948,26188736,-120,26188831,
77678887142,26646671,2482764,26646641,-30,,
77679387144,27146673,2982765,27146651,-22,,
77679452597,27212127,3048220,27212105,-22,27214151,
77679887146,27646675,3482768,27648433,1758,,
77680387147,28146676,3982769,28148703,2027,,
77680471707,28231237,4067330,28233265,2028,28231108,
77680887148,28646678,4482770,28646916,238,,
77681387149,29146678,4982771,29146552,-126,,
77681491269,29250799,5086892,29250674,-125,29250814,
77681887150,29646679,5482772,29646667,-12,,
77682387151,30146681,5982773,30146699,18,,
77682510760,30270290,6106382,30270308,18,30270280,
77682887152,30646681,6482773,30646680,-1,,
77683387154,31146683,6982776,31146676,-7,,
77683534109,31293639,7129732,31293633,-6,31295545,
77683887155,31646685,7482777,31648031,1346,,
77684387157,32146686,7982779,32148595,1909,,
77684558483,32318012,8154105,32319922,1910,32320362,
77684887159,32646688,8482780,32648888,2200,,
77685387160,33146690,8982782,33149042,2352,,
77685578901,33338431,9174524,33340784,2353,33338857,
77685887162,33646691,9482784,33647857,1166,,
77686387164,34146694,9982786,34147122,428,,
77686602383,34361912,10198005,34362342,430,34363746,
77686887165,34646694,10482786,34647923,1229,,
77687387166,35146695,10982788,35148531,1836,,
77687625841,35385371,11221464,35387208,1837,35387086,
77687887167,35646696,11482789,35648469,1773,,
77688387169,36146698,11982791,36148416,1718,,
77688649966,36409495,12245588,36411213,1718,36411365,
77688887170,36646699,12482791,36648489,1790,,
77689387172,37146701,12982794,37148573,1872,,
77689673840,37433370,13269463,37435243,1873,37434751,
77689887173,37646703,13482795,37648366,1663,,
77690387174,38146704,13982796,38148088,1384,,
77690695179,38454709,14290802,38456094,1385,38455509,
77690887175,38646704,14482796,38647864,1160,,
77691387176,39146706,14982798,39147509,803,,
77691718594,39478124,15314217,39478927,803,39479804,
77691887178,39646707,15482800,39647806,1099,,
77692387179,40146708,15982801,40148391,1683,,
77692742139,40501669,16337761,40503352,1683,40503461,
77692887180,40646710,16482802,40648424,1714,,
77693387182,41146711,16982804,41148505,1794,,
77693765341,41524871,17360963,41526665,1794,41526474,
77693887183,41646712,17482805,41648459,1747,,
77694387185,42146714,17982807,42148320,1606,,
77694785341,42544871,18380964,42546477,1606,42545113,
77694887186,42646716,18482808,42648044,1328,,
77695387188,43146717,18982810,43146961,244,,
77695808765,43568295,19404388,43568540,245,43569837,
77695887189,43646718,19482810,43647165,447,,
77696387190,44146720,19982812,44148265,1545,,
77696831974,44591504,20427597,44593050,1546,44593186,
77696887191,44646720,20482813,44648279,1559,,
77697387192,45146722,20982814,45148407,1685,,
77697855465,45614995,21451088,45616680,1685,45616657,
77697887194,45646723,21482816,45648405,1682,,
77698387196,46146726,21982818,46148389,1663,,
77698878889,46638419,22474512,46640083,1664,46640064,
77698887197,46646727,22482819,46648389,1662,,
77699387199,47146728,22982821,47148376,1648,,
77699898330,47657859,23493952,47659508,1649,47657592,
77699898337,47657866,23493959,47659514,1648,,
77700398338,48157867,23993959,48157602,-265,,
77700921684,48681213,24517306,48680949,-264,48682855,
77700921691,48681220,24517313,48680955,-265,,
77701421692,49181221,25017313,49182865,1644,,
77701921693,49681222,25517314,49682866,1644,,
77701940635,49700165,25536258,49701810,1645,49699636,
77702421694,50181223,26017316,50180778,-445,,
77702921695,50681224,26517317,50680697,-527,,
77702964142,50723672,26559764,50723145,-527,50725298,
77703421696,51181226,27017318,51182672,1446,,
77703921698,51681227,27517319,51682857,1630,,
77703987913,51747443,27583536,51749074,1631,51749043,
77704421699,52181228,28017321,52182834,1606,,
77704921700,52681230,28517322,52682833,1603,,
77705011510,52771039,28607132,52772643,1604,52772643,
77705421701,53181230,29017322,53182835,1605,,
77705921703,53681232,29517324,53682838,1606,,
77706034511,53794041,29630134,53795648,1607,53795577,
77706421704,54181233,30017325,54182786,1553,,
77706921705,54681234,30517327,54682772,1538,,
77707058174,54817704,30653796,54819242,1538,54819144,
77707421707,55181236,31017329,55182705,1469,,
77707921709,55681238,31517331,55682681,1443,,
77708078014,55837544,31673637,55838988,1444,55837294,
77708421711,56181240,32017333,56181521,281,,
77708921712,56681241,32517333,56680994,-247,,
77709101877,56861406,32697500,56861160,-246,56863108,
77709421714,57181243,33017336,57182244,1001,,
77709921715,57681245,33517337,57682948,1703,,
77710125862,57885392,33721485,57887096,1704,57887069,
77710421717,58181246,34017339,58182935,1689,,
77710921719,58681248,34517340,58682928,1680,,
77711147734,58907264,34743357,58908945,1681,58907723,
77711421720,59181249,35017342,59182261,1012,,
77711921721,59681251,35517343,59681713,462,,
77712166971,59926501,35762594,59926964,463,59925726,
77712421722,60181251,36017343,60181084,-167,,
77712921723,60681252,36517345,60680480,-772,,
77713186075,60945605,36781697,60944833,-772,60944948,
77713421725,61181254,37017347,61180536,-718,,
77713921726,61681255,37517348,61680601,-654,,
77714205734,61965264,37801356,61964610,-654,61964188,
77714421727,62181257,38017349,62180422,-835,,
77714921728,62681257,38517350,62680184,-1073,,
77715226971,62986501,38822594,62985429,-1072,62986772,
77715421730,63181259,39017352,63180710,-549,,
77715921732,63681261,39517354,63681535,274,,
77716247060,64006590,39842683,64006865,275,64005641,
77716421733,64181262,40017355,64181108,-154,,
77716921734,64681264,40517356,64680316,-948,,
77717270324,65029853,40865946,65028907,-946,65031235,
77717421736,65181265,41017357,65181023,-242,,
77717921738,65681267,41517360,65682652,1385,,
77718294014,66053544,41889636,66054929,1385,66055021,
77718421740,66181269,42017361,66182676,1407,,
77718921741,66681270,42517363,66682749,1479,,
77719313791,67073321,42909414,67074800,1479,67072861,
77719421743,67181272,43017364,67182331,1059,,
77719921744,67681273,43517365,67680815,-458,,
77720337629,68097159,43933252,68096702,-457,68098613,
77720421745,68181274,44017367,68181137,-137,,
77720921746,68681275,44517368,68682731,1456,,
77721356943,69116473,44952566,69117930,1457,69115649,
77721421748,69181277,45017370,69182436,1159,,
77721921750,69681279,45517372,69680458,-821,,
77722380172,70139702,45975795,70138882,-820,70140857,
77722421751,70181280,46017373,70180623,-657,,
77722921752,70681281,46517374,70682439,1158,,
77723403705,71163235,46999328,71164393,1158,71164335,
77723421754,71181283,47017375,71182437,1154,,
77723921755,71681284,47517376,71682386,1102,,
77724426264,72185793,48021887,72186896,1103,72186470,
77724426273,72185802,48021895,72186903,1101,,
77724926274,72685803,48521895,72686482,679,,
77725445485,73205015,49041108,73205694,679,73203996,
77725445493,73205022,49041115,73205700,678,,
77725945494,73705024,49541116,73704006,-1018,,
77726464525,74224055,50060148,74223039,-1016,74223090,
77726464534,74224064,50060157,74223046,-1018,,
77726964535,74724064,50560157,74723102,-962,,
77727464536,75224065,51060157,75223103,-962,,
77727488141,75247670,51083763,75246709,-961,75248820,
77727964537,75724066,51560158,75725119,1053,,
77728464538,76224067,52060160,76225219,1152,,
77728509280,76268810,52104903,76269963,1153,76268786,
77728964540,76724069,52560162,76724153,84,,
77729464542,77224071,53060164,77224050,-21,,
77729532657,77292187,53128279,77292166,-21,77293290,
77729964544,77724073,53560165,77725025,952,,
77730464545,78224074,54060167,78225180,1106,,
77730551967,78311497,54147589,78312603,1106,78310502,
77730964546,78724076,54560168,78723450,-626,,
77731464547,79224077,55060169,79223084,-993,,
77731575517,79335047,55171139,79334055,-992,79336139,
77731964548,79724078,55560170,79724708,630,,
77732464549,80224078,56060170,80225173,1095,,
77732599253,80358782,56194875,80359878,1096,80359962,
77732964551,80724080,56560173,80725239,1159,,
77733464552,81224081,57060174,81225263,1182,,
77733618421,81377951,57214044,81379134,1183,81376859,
77733964553,81724082,57560174,81723690,-392,,
77734464554,82224084,58060176,82222994,-1090,,
77734637945,82397474,58233567,82396386,-1088,82396591,
77734964556,82724085,58560177,82723131,-954,,
77735464558,83224087,59060180,83223206,-881,,
77735661462,83420992,59257085,83420112,-880,83421811,
77735964559,83724089,59560181,83724239,150,,
77736464560,84224089,60060182,84224911,822,,
77736681838,84441368,60277461,84442190,822,84440658,
77736964562,84724091,60560184,84724048,-43,,
77737464563,85224092,61060185,85223385,-707,,
77737704938,85464467,61300560,85463761,-706,85465173,
77737964565,85724094,61560187,85724121,27,,
77738464566,86224096,62060188,86224804,708,,
77738737766,86497296,62333389,86498005,709,86502973,
77738964567,86724096,62560188,86727058,2962,,
77739464569,87224098,63060191,87229778,5680,,
77739756931,87516461,63352553,87522141,5680,87515223,
77739964570,87724099,63560192,87726907,2808,,
77740464571,88224100,64060193,88222865,-1235,,
77740776682,88536211,64372304,88534977,-1234,88535344,
77740964573,88724102,64560195,88723006,-1096,,
77741464574,89224103,65060196,89223238,-865,,
77741801770,89561301,65397394,89560438,-863,89562945,
77741964575,89724104,65560197,89724056,-48,,
77742464577,90224106,66060199,90225754,1648,,
77742824857,90584386,66420479,90586035,1649,90585122,
77742964579,90724108,66560201,90725501,1393,,
77743464580,91224109,67060201,91224847,738,,
77743857715,91617245,67453338,91617984,739,91622845,
77743964582,91724111,67560204,91725887,1776,,
77744464583,92224112,68060205,92229715,5603,,
77744877517,92637047,68473139,92642650,5603,92636173,
77744964584,92724113,68560206,92728587,4474,,
77745464586,93224115,69060208,93223244,-871,,
77745897671,93657200,69493293,93656330,-870,93656451,
77745964588,93724117,69560210,93723261,-856,,
77746464590,94224119,70060212,94223372,-747,,
77746921457,94680986,70517079,94680240,-746,94681624,
77746964592,94724122,70560214,94723493,-629,,
77747464594,95224123,71060215,95224763,640,,
77747944944,95704473,71540566,95705113,640,95705255,
77747964595,95724125,71560217,95724769,644,,
77748464596,96224125,72060217,96224909,784,,
77748979087,96738617,72574710,96739402,785,96744794,
77748979224,96738754,72574847,96739540,786,,
77749479225,97238754,73074846,97244934,6180,,
77749998322,97757852,73593945,97764033,6181,97756516,
77749998331,97757861,73593954,97764039,6178,,
77750498332,98257861,74093953,98256527,-1334,,
77751021503,98781032,74617125,98779698,-1334,98781773,
77751021510,98781039,74617132,98779704,-1335,,
77751521512,99281041,75117133,99281784,743,,
77752042038,99801567,75637660,99802311,744,99800764,
77752042045,99801574,75637667,99802317,743,,
77752542046,100301575,76137667,100300773,-802,,
77753065111,100824641,76660733,100823840,-801,100825143,
77753065120,100824650,76660742,100823848,-802,,
77753565121,101324650,77160743,101325155,505,,
77754099380,101858909,77695002,101859415,506,101865061,
77754099389,101858918,77695011,101859423,505,,
77754599390,102358920,78195012,102365074,6154,,
77755118553,102878083,78714177,102884238,6155,102876635,
77755118563,102878093,78714186,102884245,6152,,
77755618565,103378094,79214187,103376648,-1446,,
77756118760,103878290,79714382,103876844,-1446,,
77756137770,103897300,79733393,103895854,-1446,103895822,
77756618762,104378291,80214384,104376817,-1474,,
77757118763,104878293,80714385,104876817,-1476,,
77757156848,104916378,80752470,104914903,-1475,104914881,
77757618765,105378294,81214387,105376802,-1492,,
77758118767,105878296,81714389,105876802,-1494,,
77758180531,105940061,81776154,105938568,-1493,105940804,
77758618769,106378298,82214391,106378766,468,,
77759118771,106878300,82714393,106879045,745,,
77759220874,106980403,82816496,106981149,746,106989444,
77759618772,107378301,83214394,107385650,7349,,
77760118773,107878303,83714395,107887345,9042,,
77760244453,108003983,83840076,108013026,9043,108004717,
77760618775,108378304,84214396,108381127,2823,,
77761118776,108878306,84714398,108879042,736,,
77761263731,109023261,84859354,109023998,737,109021649,
77761618777,109378306,85214399,109377377,-929,,
77762118778,109878308,85714400,109876699,-1609,,
77762282925,110042455,85878548,110040847,-1608,110040818,
77762618779,110378308,86214401,110376682,-1626,,
77763118781,110878310,86714403,110876676,-1634,,
77763389668,111149200,86985294,111147569,-1631,111104477,
77763618782,111378312,87214404,111356933,-21379,,
77764118783,111878313,87714405,111833596,-44717,,
77764414064,112173594,88009687,112128878,-44716,112174522,
77764618784,112378314,88214406,112352287,-26027,,
77765118785,112878314,88714407,112879244,930,,
77765434075,113193604,89029698,113194535,931,113192351,
77765618787,113378316,89214409,113378439,123,,
77766118789,113878318,89714411,113877067,-1251,,
77766454827,114214357,90050450,114213107,-1250,114213335,
77766618790,114378320,90214412,114377143,-1177,,
77767118791,114878320,90714413,114877301,-1019,,
77767478547,115238077,91074170,115237059,-1018,115238899,
77767618793,115378322,91214415,115377819,-503,,
77768118794,115878324,91714416,115879149,825,,
77768503644,116263174,92099267,116264000,826,116262755,
77768618796,116378325,92214418,116378863,538,,
77769118798,116878328,92714420,116877911,-417,,
77769528470,117287999,93124092,117287584,-415,117288851,
77769618799,117378328,93214421,117378139,-189,,
77770118800,117878329,93714422,117879183,854,,
77770552446,118311975,94148068,118312830,855,118312629,
77770618802,118378331,94214423,118379158,827,,
77771118803,118878332,94714424,118878988,656,,
77771575705,119335235,95171327,119335891,656,119335605,
77771618804,119378334,95214426,119378963,629,,
77772118806,119878335,95714428,119878707,372,,
77772599505,120359035,96195128,120359408,373,120359579,
77772618807,120378336,96214429,120378712,376,,
77773118821,120878350,96714443,120878896,546,,
77773621653,121381183,97217276,121381730,547,121380609,
77773621662,121381192,97217285,121381736,544,,
77774121663,121881192,97717285,121880621,-571,,
77774641086,122400616,98236709,122400046,-570,122399128,
77774641095,122400625,98236718,122400054,-571,,
77775141097,122900626,98736718,122899141,-1485,,
77775660281,123419810,99255903,123418326,-1484,123417991,
77775660290,123419819,99255913,123418333,-1486,,
77776160291,123919820,99755912,123918003,-1817,,
77776680158,124439688,100275781,124437871,-1817,124437528,
77776680165,124439695,100275788,124437876,-1819,,
77777180166,124939695,100775787,124937537,-2158,,
77777680167,125439696,101275789,125437538,-2158,,
77777703942,125463472,101299565,125461314,-2158,125463523,
77778180168,125939697,101775790,125939646,-51,,
77778680170,126439699,102275792,126439753,54,,
77778723133,126482663,102318756,126482718,55,126480710,
77779180171,126939700,102775793,126937923,-1777,,
77779680172,127439702,103275794,127437753,-1949,,
77779757126,127516656,103352749,127514708,-1948,127520373,
77780180173,127939702,103775795,127942549,2847,,
77780680174,128439704,104275796,128443423,3719,,
77780780925,128540455,104376547,128544174,3719,128540883,
77781180176,128939705,104775797,128940799,1094,,
77781680177,129439706,105275799,129440139,433,,
77781804789,129564319,105400411,129564751,432,129564687,
77782180178,129939707,105775800,129940092,385,,
77782680179,130439708,106275800,130440078,370,,
77782824095,130583625,106419719,130583996,371,130581557,
77783180180,130939709,106775801,130938343,-1366,,
77783680181,131439710,107275802,131437644,-2066,,
77783848036,131607565,107443658,131605499,-2066,131607813,
77784180182,131939711,107775804,131939183,-528,,
77784680183,132439713,108275805,132439962,249,,
77784867809,132627339,108463432,132627589,250,132625549,
77785180184,132939714,108775806,132938690,-1024,,
77785680185,133439714,109275807,133437927,-1787,,
77785888784,133648314,109484407,133646527,-1787,133647103,
77786180187,133939716,109775808,133938265,-1451,,
77786680188,134439717,110275809,134438509,-1208,,
77786908425,134667955,110504048,134666748,-1207,134666120,
77787180190,134939719,110775812,134938170,-1549,,
77787680192,135439721,111275814,135437888,-1833,,
77787959811,135719341,111555433,135717508,-1833,135733603,
77788180194,135939723,111775815,135944985,5262,,
77788680196,136439725,112275818,136453990,14265,,
77788983006,136742536,112578629,136756801,14265,136742633,
77789180198,136939727,112775820,136948405,8678,,
77789680200,137439729,113275822,137439828,99,,
77790002126,137761655,113597748,137761755,100,137759630,
77790180201,137939731,113775823,137939073,-658,,
77790680203,138439732,114275825,138437709,-2023,,
77791025483,138785013,114621106,138782990,-2023,138785150,
77791180205,138939734,114775826,138938379,-1355,,
77791680206,139439735,115275828,139439875,140,,
77792044876,139804406,115640499,139804547,141,139802228,
77792180208,139939737,115775829,139939248,-489,,
77792680210,140439739,116275832,140437563,-2176,,
77793068894,140828423,116664516,140826248,-2175,140828821,
77793180211,140939741,116775833,140938136,-1605,,
77793680212,141439741,117275834,141440141,400,,
77794092161,141851691,117687784,141852092,401,141850908,
77794180214,141939744,117775836,141939934,190,,
77794680216,142439745,118275838,142438964,-781,,
77795115949,142875479,118711572,142874699,-780,142875756,
77795180217,142939747,118775839,142939100,-647,,
77795680219,143439748,119275840,143440028,280,,
77796139578,143899107,119735200,143899388,281,143899113,
77796180220,143939750,119775842,143940006,256,,
77796680222,144439752,120275844,144439759,7,,
77797162974,144922503,120758596,144922512,9,144922481,
77797180224,144939753,120775845,144939758,5,,
77797680225,145439754,121275847,145439734,-20,,
77798187182,145946711,121782804,145946692,-19,145946494,
77798187191,145946720,121782813,145946699,-21,,
77798687192,146446722,122282814,146446507,-215,,
77799210880,146970410,122806503,146970195,-215,146970208,
77799210887,146970417,122806510,146970200,-217,,
77799710889,147470418,123306511,147470218,-200,,
77800229958,147989488,123825580,147989288,-200,147987257,
77800229967,147989497,123825589,147989295,-202,,
77800729968,148489498,124325590,148487269,-2229,,
77801251879,149011409,124847502,149009181,-2228,149010711,
77801251887,149011417,124847509,149009188,-2229,,
77801751889,149511418,125347510,149510722,-696,,
77802275799,150035329,125871421,150034633,-696,150035415,
77802275806,150035336,125871428,150034640,-696,,
77802775808,150535337,126371430,150535426,89,,
77803295676,151055206,126891299,151055296,90,151053221,
77803295686,151055215,126891308,151055304,89,,
77803795688,151555217,127391309,151553235,-1982,,
77804314793,152074323,127910416,152072342,-1981,152072038,
77804314802,152074332,127910425,152072350,-1982,,
77804814803,152574332,128410425,152572050,-2282,,
77805334355,153093885,128929978,153091604,-2281,153091415,
77805334364,153093894,128929987,153091611,-2283,,
77805834365,153593894,129429986,153591427,-2467,,
77806353861,154113391,129949483,154110924,-2467,154110889,
77806353870,154113400,129949493,154110931,-2469,,
77806853871,154613400,130449493,154610901,-2499,,
77807373685,155133215,130969308,155130717,-2498,155131300,
77807373694,155133224,130969317,155130724,-2500,,
77807873695,155633225,131469317,155631312,-1913,,
77808397254,156156784,131992877,156154872,-1912,156156673,
77808397264,156156793,131992886,156154879,-1914,,
77808897266,156656795,132492888,156656687,-108,,
77809417207,157176737,133012830,157176630,-107,157174743,
77809417341,157176870,133012963,157176761,-109,,
77809917342,157676871,133512963,157674880,-1991,,
77810417343,158176872,134012965,158174881,-1991,,
77810436430,158195960,134032053,158193969,-1991,158193589,
77810917344,158676873,134512965,158674519,-2354,,
77811417346,159176875,135012967,159174507,-2368,,
77811456035,159215564,135051657,159213196,-2368,159213412,
77811917347,159676876,135512968,159674709,-2167,,
77812417348,160176877,136012969,160174727,-2150,,
77812475837,160235367,136071459,160233217,-2150,160233298,
77812917349,160676878,136512970,160674802,-2076,,
77813417350,161176879,137012972,161174813,-2066,,
77813495045,161254575,137090668,161252510,-2065,161252211,
77813917351,161676880,137512973,161674564,-2316,,
77814417353,162176882,138012974,162174521,-2361,,
77814518576,162278106,138114199,162275746,-2360,162277787,
77814917354,162676883,138512976,162676153,-730,,
77815417355,163176884,139012976,163176568,-316,,
77815537669,163297198,139133291,163296883,-315,163294687,
77815917356,163676885,139512978,163674903,-1982,,
77816417357,164176887,140012979,164174378,-2509,,
77816556783,164316312,140152405,164313804,-2508,164313828,
77816917358,164676888,140512980,164674397,-2491,,
77817417359,165176888,141012981,165174406,-2482,,
77817575774,165335304,141171397,165332823,-2481,165332775,
77817917361,165676890,141512982,165674377,-2513,,
77818417362,166176891,142012983,166174364,-2527,,
77818599131,166358661,142194754,166356135,-2526,166358201,
77818917364,166676893,142512986,166675684,-1209,,
77819417366,167176895,143012988,167176438,-457,,
77819622936,167382465,143218558,167382009,-456,167382269,
77819917367,167676896,143512989,167676593,-303,,
77820417368,168176898,144012990,168176703,-195,,
77820643440,168402970,144239063,168402777,-193,168401126,
77820917370,168676899,144512991,168675801,-1098,,
77821417372,169176901,145012994,169175060,-1841,,
77821662634,169422164,145258256,169420323,-1841,169419563,
77821917373,169676902,145512995,169674674,-2228,,
77822417375,170176905,146012997,170174306,-2599,,
77822688094,170447623,146283716,170445026,-2597,170446273,
77822917376,170676905,146512997,170674880,-2025,,
77823417377,171176907,147012999,171175559,-1348,,
77823711824,171471356,147307450,171470011,-1345,171470806,
77823917379,171676908,147513000,171675889,-1019,,
77824417380,172176909,148013002,172176365,-544,,
77824735579,172495109,148331202,172494566,-543,172494828,
77824917382,172676911,148513004,172676462,-449,,
77825417383,173176912,149013005,173176634,-278,,
77825758952,173518482,149354574,173518204,-278,173518034,
77825917385,173676914,149513007,173676582,-332,,
77826417387,174176916,150013008,174176470,-446,,
77826778055,174537584,150373677,174537139,-445,174534931,
77826917388,174676917,150513010,174675856,-1061,,
77827417389,175176919,151013011,175174268,-2651,,
77827801654,175561184,151397277,175558534,-2650,175560751,
77827917391,175676920,151513012,175674783,-2137,,
77828417393,176176922,152013015,176176492,-430,,
77828825578,176585107,152421200,176584678,-429,176584456,
77828917395,176676924,152513016,176676451,-473,,
77829417396,177176926,153013018,177176277,-649,,
77829849203,177608733,153444826,177608084,-649,177608170,
77829917398,177676927,153513019,177676289,-638,,
77830417399,178176928,154013021,178176368,-560,,
77830873131,178632661,154468754,178632102,-559,178632262,
77830917400,178676930,154513022,178676382,-548,,
77831417401,179176931,155013023,179176534,-397,,
77831895443,179654973,155491066,179654576,-397,179653579,
77831917407,179676938,155513031,179676497,-441,,
77832417408,180176937,156013029,180175544,-1393,,
77832914706,180674235,156510328,180672844,-1391,180671398,
77832917409,180676938,156513030,180675536,-1402,,
77833417410,181176940,157013032,181174105,-2835,,
77833938226,181697756,157533848,181694921,-2835,181697022,
77833938233,181697763,157533855,181694928,-2835,,
77834438234,182197764,158033856,182197033,-731,,
77834961818,182721347,158557440,182720617,-730,182720816,
77834961826,182721356,158557449,182720624,-732,,
77835461828,183221357,159057449,183220828,-529,,
77835985203,183744733,159580826,183744204,-529,183744024,
77835985211,183744740,159580833,183744210,-530,,
77836485213,184244742,160080835,184244035,-707,,
77837008955,184768485,160604578,184767779,-706,184767727,
77837008964,184768494,160604587,184767787,-707,,
77837508966,185268495,161104587,185267740,-755,,
77838032095,185791625,161627718,185790871,-754,185790946,
77838032104,185791634,161627727,185790880,-754,,
77838532106,186291635,162127728,186290959,-676,,
77839055264,186814794,162650886,186814118,-676,186814061,
77839055299,186814829,162650921,186814153,-676,,
77839555300,187314830,163150922,187314100,-730,,
77840074738,187834268,163670360,187833538,-730,187831524,
77840074747,187834277,163670369,187833544,-733,,
77840574749,188334278,164170370,188331537,-2741,,
77841097858,188857388,164693481,188854648,-2740,188856658,
77841097868,188857397,164693490,188854656,-2741,,
77841597870,189357399,165193492,189356672,-727,,
77842121480,189881009,165717102,189880283,-726,189880143,
77842121489,189881019,165717112,189880290,-729,,
77842621490,190381020,166217112,190380156,-864,,
77843141290,190900820,166736913,190899956,-864,190898056,
77843141299,190900828,166736921,190899964,-864,,
77843641300,191400829,167236922,191398068,-2761,,
77844164734,191924263,167760356,191921503,-2760,191923558,
77844164743,191924272,167760365,191921510,-2762,,
77844664744,192424274,168260366,192423571,-703,,
77845184409,192943939,168780032,192943237,-702,192941163,
77845184499,192944029,168780121,192943325,-704,,
77845684500,193444030,169280122,193441257,-2773,,
77846208066,193967596,169803688,193964823,-2773,193966717,
77846208075,193967605,169803698,193964831,-2774,,
77846708077,194467606,170303699,194466730,-876,,
77847256042,195015571,170851664,195014696,-875,194998822,
77847256051,195015581,170851674,195014704,-877,,
77847756052,195515581,171351674,195498834,-16747,,
77848256053,196015582,171851674,195998835,-16747,,
77848280876,196040405,171876498,196023658,-16747,196039002,
77848756054,196515583,172351675,196513419,-2164,,
77849256055,197015584,172851677,197014183,-1401,,
77849300606,197060136,172896229,197058736,-1400,197057449,
77849756056,197515585,173351678,197513015,-2570,,
77850256058,198015587,173851680,198012903,-2684,,
77850324425,198083955,173920048,198081271,-2684,198083061,
77850756059,198515589,174351681,198514453,-1136,,
77851256061,199015590,174851683,199014699,-891,,
77851349095,199108625,174944717,199107734,-891,199108310,
77851756062,199515591,175351684,199515171,-420,,
77852256064,200015593,175851686,200015281,-312,,
77852373556,200133085,175969178,200132774,-311,200131962,
77852756065,200515595,176351687,200514663,-932,,
77853256066,201015596,176851688,201014474,-1122,,
77853397730,201157260,176993353,201156139,-1121,201156061,
77853756067,201515596,177351688,201514421,-1175,,
77854256068,202015597,177851690,202014401,-1196,,
77854421136,202180666,178016759,202179471,-1195,202179649,
77854756069,202515598,178351691,202514523,-1075,,
77855256071,203015601,178851693,203014586,-1015,,
77855444602,203204132,179040225,203203119,-1013,203203207,
77855756072,203515601,179351694,203514643,-958,,
77856256074,204015603,179851696,204014681,-922,,
77856468576,204228106,180064199,204227185,-921,204227293,
77856756075,204515604,180351697,204514745,-859,,
77857256076,205015605,180851698,205014795,-810,,
77857487972,205247502,181083595,205246693,-809,205244349,
77857756077,205515606,181351699,205513541,-2065,,
77858256079,206015608,181851700,206012457,-3151,,
77858507233,206266763,182102856,206263614,-3149,206263587,
77858756080,206515610,182351702,206512448,-3162,,
77859256081,207015610,182851703,207012436,-3174,,
77859530707,207290236,183126329,207287063,-3173,207289147,
77859756082,207515611,183351703,207513377,-2234,,
77860256083,208015613,183851705,208014527,-1086,,
77860550385,208309914,184146007,208308829,-1085,208306853,
77860756084,208515613,184351706,208513715,-1898,,
77861256085,209015615,184851707,209012556,-3059,,
77861574259,209333789,185169881,209330730,-3059,209332537,
77861756086,209515616,185351708,209513214,-2402,,
77862256087,210015617,185851709,210014367,-1250,,
77862593800,210353329,186189422,210352081,-1248,210349877,
77862756088,210515618,186351710,210513653,-1965,,
77863256090,211015619,186851712,211012170,-3449,,
77863617552,211377081,187213174,211373633,-3448,211375826,
77863756092,211515621,187351714,211512779,-2842,,
77864256093,212015622,187851715,212014369,-1253,,
77864641269,212400799,188236892,212399546,-1253,212399811,
77864756094,212515624,188351716,212514432,-1192,,
77865256096,213015625,188851718,213014640,-985,,
77865660686,213420216,189256309,213419232,-984,213416895,
77865756097,213515626,189351719,213514194,-1432,,
77866256099,214015628,189851721,214012310,-3318,,
77866679754,214439284,190275377,214435967,-3317,214435953,
77866756100,214515629,190351721,214512309,-3320,,
77867256102,215015631,190851723,215012303,-3328,,
77867698834,215458364,191294457,215455037,-3327,215455052,
77867756103,215515632,191351725,215512304,-3328,,
77868256104,216015633,191851725,216012323,-3310,,
77868722353,216481882,192317976,216478573,-3309,216480746,
77868756105,216515634,192351726,216512469,-3165,,
77869256106,217015636,192851728,217014502,-1134,,
77869741579,217501109,193337202,217499975,-1134,217497768,
77869756108,217515637,193351730,217514437,-1200,,
77870256109,218015638,193851731,218012299,-3339,,
77870760742,218520271,194356364,218516932,-3339,218516886,
77870760749,218520278,194356371,218516938,-3340,,
77871260750,219020279,194856372,219016896,-3383,,
77871784417,219543947,195380040,219540565,-3382,219542834,
77871784554,219544084,195380177,219540700,-3384,,
77872284556,220044085,195880178,220042975,-1110,,
77872808044,220567574,196403667,220566465,-1109,220566289,
77872808053,220567583,196403676,220566472,-1111,,
77873308054,221067583,196903675,221066301,-1282,,
77873831189,221590719,197426812,221589437,-1282,221589422,
77873831198,221590728,197426821,221589445,-1283,,
77874331199,222090728,197926821,222089434,-1294,,
77874831200,222590729,198426821,222589435,-1294,,
77874851022,222610552,198446645,222609259,-1293,222607251,
77875331201,223090730,198926823,223087511,-3219,,
77875831203,223590732,199426824,223587434,-3298,,
77875875194,223634724,199470817,223631426,-3298,223633737,
77876331204,224090733,199926825,224089545,-1188,,
77876831205,224590734,200426827,224589750,-984,,
77876896121,224655651,200491744,224654668,-983,224653127,
77877331206,225090735,200926827,225088414,-2321,,
77877831207,225590736,201426829,225588215,-2521,,
77877919607,225679137,201515231,225676617,-2520,225677792,
77878331208,226090737,201926830,226089185,-1552,,
77878831209,226590738,202426830,226589395,-1343,,
77878939834,226699364,202535456,226698021,-1343,226696482,
77879331210,227090739,202926831,227088194,-2545,,
77879831211,227590740,203426833,227587861,-2879,,
77879958983,227718513,203554606,227715635,-2878,227714979,
77880331212,228090741,203926834,228087376,-3365,,
77880831214,228590743,204426836,228587212,-3531,,
77880982459,228741989,204578082,228738459,-3530,228740592,
77881331215,229090744,204926837,229088703,-2041,,
77881831216,229590745,205426838,229589351,-1394,,
77882001488,229761017,205597110,229759624,-1393,229757470,
77882331217,230090746,205926839,230087932,-2814,,
77882831219,230590748,206426841,230587203,-3545,,
77883021633,230781163,206617255,230777618,-3545,230778285,
77883331220,231090749,206926841,231087619,-3130,,
77883831221,231590751,207426843,231587876,-2875,,
77884044907,231804437,207640529,231801562,-2875,231803004,
77884331223,232090752,207926844,232088705,-2047,,
77884831225,232590754,208426846,232589324,-1430,,
77885064126,232823656,208659748,232822226,-1430,232820002,
77885331226,233090756,208926848,233088138,-2618,,
77885831227,233590756,209426849,233587105,-3651,,
77886084406,233843936,209680029,233840286,-3650,233840832,
77886331229,234090758,209926850,234087378,-3380,,
77886831230,234590759,210426851,234587658,-3101,,
77887108117,234867646,210703739,234864546,-3100,234866193,
77887331232,235090761,210926854,235088395,-2366,,
77887831234,235590763,211426856,235589312,-1451,,
77888132221,235891751,211727844,235890301,-1450,235890607,
77888331235,236090764,211926857,236089436,-1328,,
77888831236,236590765,212426858,236589624,-1141,,
77889165964,236925493,212761586,236924353,-1140,236929145,
77889331237,237090766,212926858,237091208,442,,
77889831238,237590767,213426859,237594421,3654,,
77890185113,237944643,213780736,237948298,3655,237940980,
77890331239,238090768,213926861,238092283,1515,,
77890831240,238590769,214426862,238587109,-3660,,
77891205780,238965310,214801402,238961650,-3660,238962445,
77891331241,239090771,214926863,239087310,-3461,,
77891831242,239590772,215426864,239587910,-2862,,
77892225118,239984648,215820741,239981787,-2861,239980818,
77892331243,240090772,215926864,240087704,-3068,,
77892831244,240590774,216426866,240586947,-3827,,
77893244392,241003922,216840015,241000096,-3826,241000158,
77893331245,241090774,216926866,241086957,-3817,,
77893831246,241590776,217426868,241587015,-3761,,
77894265455,242024985,217861078,242021224,-3761,242022117,
77894331247,242090776,217926869,242087131,-3645,,
77894831248,242590777,218426869,242587911,-2866,,
77895527574,243287104,219123198,243284240,-2864,243367825,
77895527589,243287120,219123213,243284258,-2862,,
77896027591,243787121,219623213,243867845,80724,,
77896551045,244310575,220146668,244391301,80726,244308908,
77896551055,244310584,220146677,244391307,80723,,
77897051057,244810586,220646679,244808922,-1664,,
77897570726,245330255,221166349,245328592,-1663,245326706,
77897570735,245330265,221166358,245328600,-1665,,
77898070737,245830266,221666359,245826719,-3547,,
77898590026,246349556,222185649,246346009,-3547,246345581,
77898590035,246349565,222185658,246346016,-3549,,
77899090036,246849565,222685658,246845593,-3972,,
77899590037,247349566,223185659,247345594,-3972,,
77899609249,247368779,223204872,247364807,-3972,247364880,
77900090038,247849568,223685660,247845669,-3899,,
77900590039,248349569,224185661,248345673,-3896,,
77900628241,248387770,224223863,248383874,-3896,248383968,
77901090040,248849569,224685661,248845761,-3808,,
77901590041,249349570,225185662,249345770,-3800,,
77901650817,249410346,225246439,249406547,-3799,249408188,
77902090042,249849572,225685664,249847216,-2356,,
77902590043,250349573,226185665,250347417,-2156,,
77902671976,250431506,226267599,250429352,-2154,250428529,
77903090045,250849574,226685666,250846733,-2841,,
77903590046,251349575,227185667,251346601,-2974,,
77903695262,251454792,227290885,251451819,-2973,251453063,
77904090048,251849577,227685669,251847588,-1989,,
77904590049,252349578,228185671,252347852,-1726,,
77904718497,252478027,228314119,252476301,-1726,252476212,
77905090051,252849580,228685673,252847789,-1791,,
77905590053,253349582,229185674,253347770,-1812,,
77905741976,253501506,229337599,253499694,-1812,253499763,
77906090054,253849583,229685676,253847821,-1762,,
77906590055,254349584,230185676,254347844,-1740,,
77906765501,254525031,230361124,254523292,-1739,254523184,
77907090056,254849586,230685678,254847778,-1808,,
77907590057,255349586,231185678,255347742,-1844,,
77907789041,255548571,231384663,255546727,-1844,255546689,
77908090058,255849588,231685680,255847721,-1867,,
77908590060,256349589,232185681,256347710,-1879,,
77908812581,256572110,232408203,256570232,-1878,256570262,
77909090062,256849591,232685683,256847730,-1861,,
77909590064,257349593,233185686,257347747,-1846,,
77909831702,257591232,233427324,257589386,-1846,257587244,
77910090066,257849595,233685687,257846642,-2953,,
77910590068,258349597,234185690,258345612,-3985,,
77910855476,258615006,234451098,258611021,-3985,258613208,
77911090070,258849599,234685691,258846641,-2958,,
77911590071,259349600,235185693,259347805,-1795,,
77911879336,259638866,235474959,259637071,-1795,259637082,
77912090072,259849602,235685694,259847813,-1789,,
77912590073,260349602,236185695,260347821,-1781,,
77912903100,260662630,236498722,260660850,-1780,260660774,
77913090074,260849604,236685696,260847795,-1809,,
77913590076,261349605,237185698,261347752,-1853,,
77913927013,261686542,237522635,261684690,-1852,261684832,
77914090077,261849606,237685699,261847799,-1807,,
77914590078,262349607,238185699,262347899,-1708,,
77914950661,262710191,238546283,262708483,-1708,262708229,
77915090080,262849609,238685701,262847829,-1780,,
77915590082,263349611,239185704,263347651,-1960,,
77915974439,263733969,239570062,263732010,-1959,263732128,
77916090084,263849613,239685705,263847680,-1933,,
77916590086,264349616,240185708,264347778,-1838,,
77916998419,264757949,240594041,264756111,-1838,264756004,
77917090087,264849616,240685709,264847757,-1859,,
77917590089,265349618,241185711,265347676,-1942,,
77918018879,265778409,241614502,265776467,-1942,265774776,
77918090091,265849620,241685712,265847436,-2184,,
77918590092,266349621,242185713,266345990,-3631,,
77919042298,266801828,242637921,266798199,-3629,266799698,
77919090093,266849623,242685715,266846136,-3487,,
77919590094,267349623,243185716,267347496,-2127,,
77920061395,267820925,243657018,267818798,-2127,267816771,
77920090095,267849625,243685717,267847380,-2245,,
77920590097,268349626,244185719,268345475,-4151,,
77921085140,268844670,244680763,268840520,-4150,268842856,
77921090098,268849627,244685720,268845497,-4130,,
77921590099,269349628,245185720,269347817,-1811,,
77922108653,269868183,245704276,269866373,-1810,269866129,
77922108661,269868190,245704283,269866378,-1812,,
77922608663,270368192,246204285,270366140,-2052,,
77923131900,270891430,246727523,270889378,-2052,270889455,
77923131909,270891439,246727532,270889386,-2053,,
77923631910,271391440,247227532,271389468,-1972,,
77924131911,271891440,247727532,271889468,-1972,,
77924151051,271910581,247746673,271908609,-1972,271906251,
77924631912,272391442,248227534,272387205,-4237,,
77925131913,272891442,248727535,272887115,-4327,,
77925175924,272935455,248771549,272931131,-4324,272932649,
77925631914,273391444,249227536,273388508,-2936,,
77926131915,273891445,249727537,273888644,-2801,,
77926199821,273959353,249795447,273956555,-2798,273957220,
77926631917,274391446,250227538,274389227,-2219,,
77927131918,274891447,250727539,274889320,-2127,,
77927223282,274982812,250818905,274980685,-2127,274980609,
77927631919,275391448,251227540,275389261,-2187,,
77928131920,275891449,251727541,275889249,-2200,,
77928246867,276006397,251842490,276004197,-2200,276004319,
77928631922,276391451,252227543,276389346,-2105,,
77929131923,276891453,252727545,276889377,-2076,,
77929272358,277031888,252867981,277029812,-2076,277030686,
77929631924,277391453,253227545,277390007,-1446,,
77930131925,277891454,253727547,277890254,-1200,,
77930295622,278055152,253891245,278053953,-1199,278052904,
77930631927,278391456,254227549,278389552,-1904,,
77931131929,278891459,254727551,278889213,-2246,,
77931319472,279079002,254915095,279076758,-2244,279076919,
77931631930,279391460,255227552,279389316,-2144,,
77932131932,279891461,255727553,279889381,-2080,,
77932343012,280102542,255938634,280100462,-2080,280100461,
77932631933,280391462,256227555,280389381,-2081,,
77933131934,280891463,256727556,280889384,-2079,,
77933363529,281123059,256959152,281120981,-2078,281119397,
77933631936,281391465,257227558,281388537,-2928,,
77934131938,281891467,257727560,281887808,-3659,,
77934387557,282147086,257983179,282143428,-3658,282145045,
77934631939,282391468,258227561,282388600,-2868,,
77935131941,282891470,258727562,282889431,-2039,,
77935407499,283167029,259003121,283164990,-2039,283162898,
77935631942,283391471,259227563,283388493,-2978,,
77936131944,283891473,259727566,283887344,-4129,,
77936431042,284190572,260026665,284186444,-4128,284188277,
77936631946,284391475,260227568,284388084,-3391,,
77937131948,284891477,260727569,284889185,-2292,,
77937454739,285214269,261050361,285211977,-2292,285211892,
77937631949,285391478,261227571,285389156,-2322,,
77938131950,285891480,261727572,285889106,-2374,,
77938479045,286238575,262074667,286236201,-2374,286236669,
77938631951,286391481,262227573,286389251,-2230,,
77939131952,286891482,262727574,286889578,-1904,,
77939502588,287262118,263098210,287260215,-1903,287259744,
77939631954,287391483,263227575,287389458,-2025,,
77940131955,287891484,263727576,287889113,-2371,,
77940526260,288285790,264121883,288283419,-2371,288283303,
77940631957,288391486,264227579,288389089,-2397,,
77941131959,288891488,264727580,288889004,-2484,,
77941549980,289309510,265145603,289307027,-2483,289307372,
77941631961,289391490,265227582,289389062,-2428,,
77942131962,289891491,265727584,289889356,-2135,,
77942574094,290333624,266169716,290331489,-2135,290331278,
77942631963,290391492,266227585,290389333,-2159,,
77943131965,290891494,266727587,290889150,-2344,,
77943593266,291352795,267188889,291350452,-2343,291348271,
77943631966,291391495,267227588,291388981,-2514,,
77944131968,291891497,267727590,291886975,-4522,,
77944613725,292373255,268209348,292368734,-4521,292369243,
77944631969,292391498,268227591,292386994,-4504,,
77945131971,292891500,268727593,292887491,-4009,,
77945633650,293393180,269229273,293389172,-4008,293388877,
77945633660,293393190,269229282,293389179,-4011,,
77946133661,293893190,269729283,293888890,-4300,,
77946652854,294412384,270248477,294408085,-4299,294407750,
77946652993,294412523,270248616,294408223,-4300,,
77947152995,294912524,270748617,294907893,-4631,,
77947672069,295431599,271267692,295426969,-4630,295427052,
77947672078,295431608,271267701,295426976,-4632,,
77948172079,295931608,271767701,295927063,-4545,,
77948691839,296451368,272287461,296446824,-4544,296446626,
77948691847,296451377,272287469,296446831,-4546,,
77949191849,296951378,272787471,296946638,-4740,,
77949711257,297470787,273306879,297466047,-4740,297466116,
77949711264,297470794,273306886,297466053,-4741,,
77950211265,297970795,273806887,297966126,-4669,,
77950734495,298494024,274330117,298489357,-4667,298491497,
77950734504,298494034,274330126,298489365,-4669,,
77951234506,298994035,274830128,298991511,-2524,,
77951754552,299514082,275350175,299511559,-2523,299509859,
77951754563,299514092,275350185,299511567,-2525,,
77952254564,300014093,275850186,300009873,-4220,,
77952778480,300538010,276374103,300533790,-4220,300535221,
77952778489,300538019,276374112,300533798,-4221,,
77953278490,301038019,276874111,301035233,-2786,,
77953797641,301557171,277393263,301554385,-2786,301552471,
77953797648,301557178,277393270,301554390,-2788,,
77954297649,302057178,277893271,302052480,-4698,,
77954817052,302576582,278412675,302571885,-4697,302571721,
77954817061,302576591,278412683,302571892,-4699,,
77955317062,303076591,278912684,303071733,-4858,,
77955836372,303595902,279431995,303591045,-4857,303591095,
77955836381,303595911,279432003,303591051,-4860,,
77956336383,304095912,279932004,304091108,-4804,,
77956855590,304615120,280451213,304610316,-4804,304610362,
77956855598,304615127,280451220,304610321,-4806,,
77957355600,305115129,280951221,305110373,-4756,,
77957875125,305634654,281470747,305629899,-4755,305630167,
77957875137,305634667,281470760,305629910,-4757,,
77958375139,306134668,281970761,306130183,-4485,,
77958894743,306654272,282490365,306649787,-4485,306649259,
77958894750,306654279,282490372,306649793,-4486,,
77959394751,307154280,282990372,307149269,-5011,,
77959915991,307675521,283511614,307670511,-5010,307671765,
77959916034,307675564,283511656,307670551,-5013,,
77960416036,308175565,284011658,308171811,-3754,,
77960939715,308699245,284535338,308695492,-3753,308696590,
77960939725,308699255,284535347,308695499,-3756,,
77961439727,309199256,285035349,309196603,-2653,,
77961963541,309723070,285559164,309720418,-2652,309720546,
77961963550,309723080,285559173,309720426,-2654,,
77962463551,310223081,286059173,310220558,-2523,,
77962982855,310742385,286578478,310739864,-2521,310737504,
77962982864,310742394,286578487,310739869,-2525,,
77963482865,311242394,287078487,311237516,-4878,,
77963982866,311742395,287578487,311737517,-4878,,
77964006484,311766013,287602106,311761135,-4878,311763327,
77964482867,312242397,288078489,312239610,-2787,,
77964982868,312742398,288578490,312739714,-2684,,
77965030358,312789888,288625980,312787204,-2684,312787312,
77965482870,313242399,289078491,313239816,-2583,,
77965982871,313742400,289578493,313739827,-2573,,
77966054398,313813928,289650021,313811355,-2573,313811191,
77966482872,314242402,290078494,314239690,-2712,,
77966982874,314742403,290578496,314739668,-2735,,
77967077933,314837463,290673556,314834729,-2734,314834646,
77967482876,315242405,291078498,315239606,-2799,,
77967982878,315742407,291578500,315739593,-2814,,
77968101871,315861401,291697493,315858587,-2814,315858590,
77968482880,316242409,292078502,316239599,-2810,,
77968982882,316742411,292578503,316739603,-2808,,
77969126378,316885908,292722000,316883100,-2808,316883122,
77969482883,317242413,293078505,317239622,-2791,,
77969982884,317742414,293578506,317739631,-2783,,
77970149559,317909088,293745182,317906306,-2782,317906250,
77970482885,318242415,294078507,318239595,-2820,,
77970982887,318742416,294578509,318739580,-2836,,
77971173440,318932970,294769063,318930135,-2835,318930293,
77971482889,319242418,295078510,319239681,-2737,,
77971982891,319742420,295578512,319739744,-2676,,
77972197375,319956904,295792997,319954230,-2674,319954274,
77972482892,320242422,296078514,320239774,-2648,,
77972982894,320742423,296578516,320739795,-2628,,
77973221080,320980609,296816702,320977982,-2627,320977885,
77973482895,321242425,297078517,321239748,-2677,,
77973982896,321742425,297578517,321739704,-2721,,
77974244832,322004362,297840455,322001641,-2721,322001706,
77974482898,322242427,298078520,322239737,-2690,,
77974982900,322742429,298578522,322739775,-2654,,
77975263991,323023521,298859614,323020868,-2653,323018439,
77975482902,323242431,299078524,323238713,-3718,,
77975982903,323742432,299578524,323737352,-5080,,
77976287629,324047159,299883252,324042080,-5079,324044241,
77976482905,324242434,300078527,324238198,-4236,,
77976982906,324742435,300578528,324739520,-2915,,
77977311728,325071258,300907351,325068344,-2914,325068290,
77977482907,325242437,301078529,325239502,-2935,,
77977982908,325742438,301578530,325739472,-2966,,
77978336079,326095609,301931701,326092643,-2966,326092694,
77978482910,326242440,302078532,326239488,-2952,,
77978982912,326742441,302578534,326739529,-2912,,
77979359994,327119524,302955617,327116613,-2911,327116701,
77979482913,327242442,303078535,327239552,-2890,,
77979982914,327742444,303578536,327739624,-2820,,
77980379302,328138832,303974924,328136012,-2820,328133664,
77980482915,328242444,304078537,328239136,-3308,,
77980982917,328742446,304578539,328737280,-5166,,
77981403166,329162695,304998788,329157530,-5165,329159771,
77981482919,329242448,305078541,329237638,-4810,,
77981982921,329742450,305578543,329739528,-2922,,
77982426468,330185998,306022091,330183077,-2921,330182814,
77982482922,330242452,306078545,330239498,-2954,,
77982982923,330742453,306578545,330739271,-3182,,
77983450388,331209918,307046010,331206736,-3182,331206964,
77983482925,331242454,307078547,331239286,-3168,,
77983982927,331742456,307578549,331739505,-2951,,
77984474308,332233838,308069931,332230888,-2950,332231083,
77984482929,332242458,308078551,332239509,-2949,,
77984982930,332742459,308578551,332739707,-2752,,
77985493396,333252926,309089019,333250175,-2751,333247701,
77985493405,333252935,309089028,333250182,-2753,,
77985993406,333752935,309589027,333747712,-5223,,
77986512504,334272034,310108127,334266812,-5222,334266767,
77986512513,334272043,310108136,334266820,-5223,,
77987012514,334772043,310608136,334766779,-5264,,
77987536309,335295839,311131932,335290576,-5263,335292821,
77987536318,335295848,311131941,335290582,-5266,,
77988036319,335795848,311631940,335792832,-3016,,
77988536320,336295849,312131941,336292833,-3016,,
77988559728,336319258,312155351,336316243,-3015,336316093,
77989036321,336795850,312631943,336792695,-3155,,
77989536322,337295851,313131944,337292689,-3162,,
77989583779,337343309,313179402,337340148,-3161,337340332,
77990036323,337795852,313631944,337792859,-2993,,
77990536324,338295854,314131946,338292878,-2976,,
77990607753,338367282,314203376,338364308,-2974,338364200,
77991036326,338795855,314631948,338792790,-3065,,
77991536327,339295856,315131948,339292776,-3080,,
77991631343,339390873,315226966,339387794,-3079,339387838,
77992036328,339795857,315631949,339792816,-3041,,
77992536329,340295859,316131951,340292827,-3032,,
77992654907,340414436,316250529,340411405,-3031,340411306,
77993036330,340795860,316631952,340792755,-3105,,
77993536331,341295861,317131953,341292732,-3129,,
77993678658,341438188,317274281,341435061,-3127,341434823,
77994036333,341795862,317631954,341792566,-3296,,
77994536334,342295863,318131955,342292500,-3363,,
77994697786,342457316,318293409,342453954,-3362,342451897,
77995036336,342795865,318631958,342791111,-4754,,
77995536337,343295866,319131959,343290450,-5416,,
77995721321,343480851,319316944,343475436,-5415,343477542,
77996036339,343795869,319631961,343791781,-4088,,
77996536340,344295870,320131962,344292563,-3307,,
77996744918,344504448,320340541,344501143,-3305,344501157,
77997036341,344795871,320631963,344792572,-3299,,
77997536343,345295872,321131964,345292583,-3289,,
77997768373,345527903,321363996,345524615,-3288,345524597,
77998036345,345795874,321631967,345792576,-3298,,
77998536346,346295875,322131968,346292571,-3304,,
77998791828,346551357,322387450,346548054,-3303,346548030,
77999036347,346795876,322631969,346792562,-3314,,
77999536348,347295877,323131969,347292553,-3324,,
77999815835,347575365,323411457,347572041,-3324,347571897,
78000036350,347795879,323631971,347792492,-3387,,
78000536352,348295881,324131973,348292416,-3465,,
78000839888,348599417,324435510,348595952,-3465,348596388,
78001036353,348795882,324631974,348792589,-3293,,
78001536354,349295883,325131975,349292856,-3027,,
78001863659,349623189,325459282,349620163,-3026,349619980,
78002036355,349795884,325631977,349792795,-3089,,
78002536356,350295885,326131978,350292679,-3206,,
78002887444,350646974,326483067,350643769,-3205,350643807,
78003036357,350795887,326631979,350792691,-3196,,
78003536358,351295888,327131980,351292723,-3165,,
78003912920,351672451,327508545,351669290,-3161,351669845,
78004036359,351795889,327631981,351792860,-3029,,
78004536361,352295890,328131982,352293289,-2601,,
78004932435,352691965,328528058,352689365,-2600,352686614,
78005036363,352795892,328631985,352792719,-3173,,
78005536364,353295893,329131986,353290545,-5348,,
78005955893,353715422,329551515,353710075,-5347,353711773,
78006036365,353795894,329631986,353790819,-5075,,
78006536366,354295895,330131987,354292248,-3647,,
78006979447,354738977,330575070,354735331,-3646,354735493,
78007036367,354795896,330631988,354792266,-3630,,
78007536368,355295897,331131989,355292415,-3482,,
78008002839,355762369,331598462,355758888,-3481,355759037,
78008036371,355795901,331631993,355792427,-3474,,
78008536372,356295901,332131994,356292572,-3329,,
78009023334,356782864,332618956,356779535,-3329,356777852,
78009036378,356795908,332632002,356792536,-3372,,
78009536380,357295909,333132001,357290900,-5009,,
78010043430,357802960,333639053,357797952,-5008,357797485,
78010043440,357802969,333639062,357797960,-5009,,
78010543441,358302970,334139063,358297498,-5472,,
78011067645,358827175,334663268,358821704,-5471,358823867,
78011067655,358827184,334663277,358821711,-5473,,
78011567656,359327185,335163278,359323879,-3306,,
78012087747,359847277,335683370,359843972,-3305,359842205,
78012087879,359847409,335683502,359844101,-3308,,
78012587880,360347410,336183502,360342341,-5069,,
78013087881,360847410,336683503,360842341,-5069,,
78013107121,360866650,336702743,360861582,-5068,360860869,
78013587882,361347411,337183503,361341659,-5752,,
78014087883,361847412,337683504,361841633,-5779,,
78014126240,361885769,337721862,361879991,-5778,361880117,
78014587884,362347413,338183505,362341753,-5660,,
78015087885,362847414,338683507,362841764,-5650,,
78015149997,362909527,338745620,362903878,-5649,362906171,
78015587886,363347415,339183508,363343776,-3639,,
78016087888,363847417,339683509,363844063,-3354,,
78016169120,363928650,339764743,363925296,-3354,363922974,
78016587889,364347418,340183510,364342121,-5297,,
78017087890,364847419,340683511,364841746,-5673,,
78017188354,364947884,340783977,364942212,-5672,364942124,
78017587892,365347421,341183514,365341681,-5740,,
78018087894,365847424,341683516,365841666,-5758,,
78018207519,365967049,341803141,365961292,-5757,365961354,
78018587896,366347425,342183517,366341717,-5708,,
78019087897,366847426,342683518,366841734,-5692,,
78019231142,366990672,342826765,366984981,-5691,366987096,
78019587898,367347427,343183519,367343247,-4180,,
78020087899,367847428,343683521,367843855,-3573,,
78020250335,368009865,343845958,368006292,-3573,368004111,
78020587900,368347429,344183522,368342385,-5044,,
78021087901,368847431,344683523,368841679,-5752,,
78021273889,369033419,344869512,369027668,-5751,369029692,
78021587903,369347432,345183524,369342954,-4478,,
78022087904,369847433,345683525,369843709,-3724,,
78022293081,370052611,345888703,370048887,-3724,370046732,
78022587905,370347434,346183526,370342440,-4994,,
78023087906,370847435,346683528,370841559,-5876,,
78023316805,371076335,346912428,371070460,-5875,371072655,
78023587907,371347436,347183529,371342752,-4684,,
78024087908,371847437,347683529,371843759,-3678,,
78024340445,372099975,347936068,372096299,-3676,372096173,
78024587910,372347439,348183531,372343701,-3738,,
78025087911,372847440,348683532,372843640,-3800,,
78025363792,373123322,348959415,373119523,-3799,373119643,
78025587912,373347442,349183534,373343696,-3746,,
78026087914,373847443,349683536,373843766,-3677,,
78026561021,374320552,350156646,374316878,-3674,374233628,
78026587915,374347445,350183539,374339288,-8157,,
78027087916,374847445,350683538,374760526,-86919,,
78027586559,375346089,351182182,375259170,-86919,375343128,
78027587922,375347452,351183546,375260764,-86688,,
78028087923,375847453,351683545,375844493,-2960,,
78028606750,376366279,352202372,376363321,-2958,376360799,
78028606759,376366288,352202381,376363329,-2959,,
78029106761,376866290,352702383,376860813,-5477,,
78029630302,377389832,353225925,377384356,-5476,377386008,
78029630312,377389842,353225934,377384364,-5478,,
78030130314,377889843,353725936,377886022,-3821,,
78030650681,378410211,354246303,378406390,-3821,378404785,
78030650690,378410220,354246312,378406398,-3822,,
78031150691,378910220,354746313,378904797,-5423,,
78031670459,379429989,355266082,379424567,-5422,379424360,
78031670597,379430127,355266219,379424702,-5425,,
78032170599,379930128,355766220,379924501,-5627,,
78032694673,380454202,356290295,380448577,-5625,380450635,
78032694682,380454211,356290304,380448584,-5627,,
78033194683,380954212,356790304,380950647,-3565,,
78033714135,381473665,357309758,381470101,-3564,381467512,
78033714142,381473672,357309765,381470105,-3567,,
78034214144,381973673,357809766,381967522,-6151,,
78034738302,382497831,358333925,382491681,-6150,382494182,
78034738344,382497874,358333966,382491722,-6152,,
78035238345,382997875,358833967,382994228,-3647,,
78035758920,383518450,359354543,383514804,-3646,383513047,
78035758929,383518459,359354551,383514811,-3648,,
78036258931,384018460,359854553,384013060,-5400,,
78036782483,384542013,360378106,384536614,-5399,384538069,
78036782492,384542022,360378114,384536621,-5401,,
78037282493,385042022,360878115,385038081,-3941,,
78037802229,385561759,361397852,385557818,-3941,385555506,
78037802238,385561768,361397861,385557825,-3943,,
78038302239,386061768,361897860,386055518,-6250,,
78038826049,386585579,362421672,386579329,-6250,386581957,
78038826056,386585586,362421678,386579335,-6251,,
78039326058,387085588,362921680,387081968,-3620,,
78039845893,387605423,363441516,387601804,-3619,387599678,
78039845900,387605430,363441522,387601809,-3621,,
78040345901,388105430,363941523,388099687,-5743,,
78040875795,388635325,364471418,388629583,-5742,388634342,
78040875806,388635336,364471429,388629592,-5744,,
78041375807,389135337,364971429,389134356,-981,,
78041894926,389654456,365490549,389653477,-979,389648306,
78041894936,389654465,365490558,389653485,-980,,
78042394937,390154466,365990559,390148319,-6147,,
78042915989,390675519,366511612,390669373,-6146,390670374,
78042915999,390675529,366511621,390669380,-6149,,
78043416000,391175530,367011622,391170386,-5144,,
78043935333,391694863,367530956,391689721,-5142,391688733,
78043935342,391694872,367530965,391689728,-5144,,
78044435344,392194873,368030965,392188746,-6127,,
78044959102,392718632,368554725,392712506,-6126,392714624,
78044959112,392718642,368554734,392712514,-6128,,
78045459114,393218643,369054736,393214638,-4005,,
78045996609,393756139,369592232,393752135,-4004,393759059,
78045996618,393756148,369592241,393752142,-4006,,
78046496620,394256149,370092242,394259072,2923,,
78047019739,394779269,370615362,394782192,2923,394775113,
78047019746,394779276,370615369,394782197,2921,,
78047519747,395279277,371115369,395275123,-4154,,
78048038880,395798409,371634502,395794256,-4153,395792104,
78048039016,395798546,371634639,395794390,-4156,,
78048539018,396298547,372134640,396292244,-6303,,
78049093057,396852587,372688681,396846286,-6301,396863019,
78049093072,396852602,372688695,396846299,-6303,,
78049593074,397352603,373188696,397363038,10435,,
78050117555,397877085,373713178,397887520,10435,397872521,
78050117563,397877092,373713185,397887526,10434,,
78050617564,398377093,374213186,398372531,-4562,,
78051142050,398901580,374737673,398897019,-4561,398897960,
78051142060,398901590,374737682,398897026,-4564,,
78051642062,399401591,375237684,399397974,-3617,,
78052165682,399925212,375761305,399921595,-3617,399921031,
78052165691,399925221,375761314,399921602,-3619,,
78052665692,400425222,376261314,400421043,-4179,,
78053165693,400925222,376761314,400921043,-4179,,
78053186366,400945896,376781988,400941717,-4179,400938765,
78053665694,401425223,377261315,401418217,-7006,,
78054165696,401925225,377761318,401918097,-7128,,
78054212254,401971783,377807876,401964655,-7128,401966597,
78054665697,402425226,378261319,402419861,-5365,,
78055165699,402925228,378761321,402920044,-5184,,
78055236050,402995579,378831672,402990396,-5183,402991281,
78055665700,403425230,379261322,403420808,-4422,,
78056165702,403925231,379761324,403920935,-4296,,
78056259502,404019032,379855125,404014737,-4295,404014901,
78056665703,404425233,380261325,404421072,-4161,,
78057165705,404925234,380761326,404921105,-4129,,
78057283159,405042688,380878781,405038560,-4128,405038349,
78057665707,405425236,381261329,405420948,-4288,,
78058165708,405925237,381761330,405920901,-4336,,
78058305151,406064680,381900773,406060345,-4335,406059049,
78058665710,406425239,382261332,406419948,-5291,,
78059165711,406925241,382761333,406919612,-5629,,
78059324149,407083679,382919772,407078051,-5628,407077288,
78059665712,407425241,383261334,407419092,-6149,,
78060165713,407925242,383761335,407918853,-6389,,
78060344321,408103850,383939943,408097462,-6388,408097777,
78060665714,408425243,384261336,408419057,-6186,,
78061165715,408925245,384761337,408919173,-6072,,
78061364085,409123615,384959708,409117545,-6070,409117513,
78061665716,409425246,385261338,409419157,-6089,,
78062165717,409925246,385761339,409919147,-6099,,
78062385459,410144989,385981081,410138890,-6099,410139287,
78062665718,410425247,386261340,410419372,-5875,,
78063165719,410925249,386761341,410919550,-5699,,
78063404722,411164251,387000345,411158554,-5697,411157715,
78063665720,411425249,387261342,411419114,-6135,,
78064165721,411925251,387761343,411918717,-6534,,
78064428118,412187648,388023741,412181114,-6534,412183387,
78064665722,412425251,388261343,412419798,-5453,,
78065165723,412925252,388761345,412920994,-4258,,
78065451320,413210850,389046942,413206592,-4258,413206437,
78065665725,413425254,389261347,413420930,-4324,,
78066165727,413925256,389761349,413920846,-4410,,
78066480686,414240216,390076309,414235807,-4409,414238861,
78066665729,414425258,390261350,414421978,-3280,,
78067165731,414925260,390761353,414923908,-1352,,
78067504160,415263690,391099783,415262339,-1351,415259189,
78067665733,415425262,391261355,415422893,-2369,,
78068165734,415925263,391761356,415920765,-4498,,
78068528058,416287588,392123681,416283090,-4498,416283021,
78068665736,416425265,392261358,416420747,-4518,,
78069165737,416925267,392761359,416920702,-4565,,
78069552983,417312513,393148606,417307948,-4565,417307728,
78069665739,417425268,393261361,417420652,-4616,,
78070165741,417925270,393761362,417920487,-4783,,
78070572171,418331701,394167793,418326918,-4783,418325171,
78070665742,418425271,394261363,418420161,-5110,,
78071165743,418925272,394761365,418918745,-6527,,
78071601709,419361239,395197332,419354713,-6526,419359952,
78071665744,419425273,395261366,419419416,-5857,,
78072165745,419925274,395761367,419923990,-1284,,
78072626094,420385623,396221716,420384339,-1284,420380952,
78072665746,420425275,396261368,420423722,-1553,,
78073165747,420925277,396761369,420920607,-4670,,
78073646513,421406043,397242136,421401375,-4668,421399998,
78073665748,421425277,397261370,421420553,-4724,,
78074165750,421925279,397761371,421919237,-6042,,
78074670529,422430059,398266152,422424018,-6041,422425257,
78074670539,422430068,398266161,422424025,-6043,,
78075170541,422930070,398766163,422925270,-4800,,
78075689881,423449410,399285503,423444611,-4799,423442657,
78075689888,423449417,399285510,423444617,-4800,,
78076189890,423949419,399785511,423942668,-6751,,
78076708880,424468410,400304503,424461660,-6750,424461716,
78076708889,424468419,400304512,424461668,-6751,,
78077208891,424968420,400804513,424961729,-6691,,
78077732358,425491888,401327981,425485198,-6690,425487363,
78077732368,425491897,401327990,425485206,-6691,,
78078232369,425991899,401827991,425987377,-4522,,
78078755841,426515371,402351464,426510850,-4521,426510806,
78078755851,426515381,402351474,426510857,-4524,,
78079255853,427015383,402851475,427010819,-4564,,
78079779267,427538797,403374890,427534235,-4562,427534121,
78079779276,427538806,403374899,427534242,-4564,,
78080279278,428038807,403874900,428034134,-4673,,
78080798673,428558202,404394295,428553530,-4672,428551284,
78080798709,428558239,404394331,428553565,-4674,,
78081298710,429058240,404894332,429051323,-6917,,
78081818031,429577560,405413653,429570645,-6915,429571048,
78081818037,429577566,405413659,429570649,-6917,,
78082318038,430077567,405913660,430071057,-6510,,
78082841829,430601359,406437451,430594849,-6510,430596538,
78082841837,430601367,406437459,430594855,-6512,,
78083341838,431101367,406937460,431096548,-4819,,
78083864836,431624366,407460459,431619547,-4819,431619681,
78083864881,431624410,407460503,431619591,-4819,,
78084364882,432124412,407960504,432119730,-4682,,
78084864883,432624412,408460504,432619730,-4682,,
78084885053,432644582,408480675,432639901,-4681,432638452,
78085364884,433124413,408960506,433118343,-6070,,
78085864886,433624415,409460508,433618288,-6127,,
78085908106,433667636,409503728,433661508,-6128,433662904,
78086364887,434124416,409960508,434119565,-4851,,
78086864888,434624417,410460510,434619688,-4729,,
78086931312,434690842,410526934,434686112,-4730,434686097,
78087364889,435124418,410960511,435119677,-4741,,
78087864891,435624420,411460513,435619677,-4743,,
78087954658,435714188,411550281,435709445,-4743,435709646,
78088364892,436124421,411960514,436119844,-4577,,
78088864894,436624423,412460516,436619883,-4540,,
78088978469,436737998,412574091,436733459,-4539,436733199,
78089364896,437124425,412960518,437119687,-4738,,
78089864897,437624426,413460519,437619630,-4796,,
78089997333,437756862,413592955,437752066,-4796,437750083,
78090364899,438124428,413960521,438118175,-6253,,
78090864901,438624431,414460523,438617653,-6778,,
78091020917,438780447,414616540,438773671,-6776,438775560,
78091364903,439124432,414960525,439118956,-5476,,
78091864904,439624434,415460526,439619550,-4884,,
78092040747,439800277,415636370,439795394,-4883,439793630,
78092364905,440124434,415960526,440118409,-6025,,
78092864907,440624436,416460529,440617792,-6644,,
78093064120,440823650,416659743,440817007,-6643,440818834,
78093364908,441124438,416960530,441118894,-5544,,
78093864910,441624439,417460532,441619626,-4813,,
78094087360,441846889,417682982,441842077,-4812,441842041,
78094364912,442124441,417960534,442119610,-4831,,
78094864913,442624442,418460534,442619596,-4846,,
78095106548,442866078,418702170,442861232,-4846,442859051,
78095364914,443124443,418960536,443118471,-5972,,
78095864915,443624445,419460537,443617421,-7024,,
78096125718,443885248,419721341,443878225,-7023,443878217,
78096364916,444124445,419960538,444117417,-7028,,
78096864917,444624447,420460539,444617417,-7030,,
78097148915,444908445,420744537,444901416,-7029,444903541,
78097364918,445124448,420960540,445118337,-6111,,
78097864919,445624448,421460541,445619547,-4901,,
78098168509,445928039,421764132,445923138,-4901,445921117,
78098364921,446124450,421960543,446118755,-5695,,
78098864922,446624451,422460544,446617531,-6920,,
78099192001,446951530,422787623,446944611,-6919,446946636,
78099364923,447124452,422960545,447118233,-6219,,
78099864924,447624454,423460546,447619562,-4892,,
78100211252,447970782,423806875,447965892,-4890,447963754,
78100364925,448124454,423960547,448118905,-5549,,
78100864926,448624456,424460548,448617429,-7027,,
78101230982,448990512,424826604,448983486,-7026,448983552,
78101364927,449124456,424960549,449117388,-7068,,
78101864929,449624458,425460550,449617501,-6957,,
78102254588,450014118,425850210,450007161,-6957,450009244,
78102364931,450124460,425960553,450117962,-6498,,
78102864933,450624463,426460555,450619591,-4872,,
78103278827,451038356,426874449,451033486,-4870,451033875,
78103364934,451124463,426960556,451119659,-4804,,
78103864935,451624464,427460557,451619985,-4479,,
78104301784,452061314,427897407,452056835,-4479,452055951,
78104364937,452124466,427960559,452119874,-4592,,
78104864938,452624467,428460559,452619106,-5361,,
78105325741,453085271,428921363,453079910,-5361,453080510,
78105364941,453124472,428960566,453119159,-5313,,
78105864942,453624471,429460564,453619713,-4758,,
78106349957,454109487,429945580,454104729,-4758,454104926,
78106364943,454124473,429960565,454119719,-4754,,
78106864944,454624473,430460566,454619914,-4559,,
78107373628,455133157,430969250,455128599,-4558,455128215,
78107373637,455133167,430969260,455128606,-4561,,
78107873638,455633167,431469259,455628227,-4940,,
78108397340,456156870,431992963,456151930,-4940,456151957,
78108397349,456156879,431992972,456151937,-4942,,
78108897350,456656880,432492972,456651970,-4910,,
78109397351,457156880,432992973,457151970,-4910,,
78109421400,457180930,433017023,457176021,-4909,457176017,
78109897352,457656881,433492973,457651970,-4911,,
78110397354,458156883,433992976,458151973,-4910,,
78110441922,458201452,434037545,458196543,-4909,458194875,
78110897356,458656885,434492978,458650459,-6426,,
78111397357,459156887,434992979,459150312,-6575,,
78111465240,459224770,435060862,459218196,-6574,459219626,
78111897359,459656888,435492981,459651552,-5336,,
78112397360,460156889,435992982,460151748,-5141,,
78112484430,460243960,436080053,460238820,-5140,460236739,
78112897361,460656890,436492983,460650033,-6857,,
78113397362,461156891,436992984,461149673,-7218,,
78113508046,461267576,437103669,461260359,-7217,461262414,
78113897364,461656893,437492986,461651277,-5616,,
78114397366,462156895,437992988,462151735,-5160,,
78114531418,462290948,438127041,462285789,-5159,462285860,
78114897368,462656897,438492990,462651791,-5106,,
78115397370,463156899,438992992,463151814,-5085,,
78115555827,463315357,439151449,463310273,-5084,463310704,
78115897371,463656900,439492992,463652112,-4788,,
78116397372,464156901,439992994,464152251,-4650,,
78116579376,464338906,440174999,464334257,-4649,464333654,
78116897374,464656903,440492996,464651871,-5032,,
78117397376,465156906,440992998,465151656,-5250,,
78117603175,465362704,441198797,465357455,-5249,465357592,
78117897377,465656906,441492999,465651738,-5168,,
78118397378,466156908,441993000,466151797,-5111,,
78118622973,466382503,442218595,466377393,-5110,466375467,
78118897380,466656909,442493001,466650743,-6166,,
78119397382,467156911,442993004,467149878,-7033,,
78119646736,467406266,443242359,467399234,-7032,467401141,
78119897383,467656912,443493005,467650836,-6076,,
78120397385,468156914,443993007,468151792,-5122,,
78120670169,468429699,444265792,468424577,-5122,468424352,
78120897387,468656916,444493009,468651692,-5224,,
78121397388,469156917,444993010,469151572,-5345,,
78121693665,469453195,445289288,469447850,-5345,469447940,
78121897389,469656918,445493010,469651611,-5307,,
78122397390,470156919,445993011,470151667,-5252,,
78122712952,470472482,446308575,470467231,-5251,470464968,
78122897392,470656921,446493014,470650836,-6085,,
78123397393,471156922,446993014,471149411,-7511,,
78123732171,471491701,447327794,471484191,-7510,471484158,
78123897394,471656923,447493015,471649401,-7522,,
78124397395,472156924,447993016,472149384,-7540,,
78124866343,472625874,448461969,472618338,-7536,472565316,
78124897396,472656927,448493020,472646093,-10834,,
78125397397,473156926,448993018,473096373,-60553,,
78125890103,473649633,449485726,473589081,-60552,473644366,
78125897399,473656928,449493021,473597180,-59748,,
78126397400,474156929,449993022,474151664,-5265,,
78126914676,474674205,450510298,474668940,-5265,474668521,
78126914683,474674212,450510305,474668946,-5266,,
78127414684,475174213,451010305,475168531,-5682,,
78127933966,475693496,451529589,475687815,-5681,475686070,
78127933976,475693506,451529599,475687822,-5684,,
78128433978,476193508,452029600,476186083,-7425,,
78128954535,476714065,452550158,476706642,-7423,476707268,
78128954545,476714075,452550167,476706649,-7426,,
78129454546,477214075,453050168,477207281,-6794,,
78129977880,477737410,453573503,477730617,-6793,477731983,
78129977890,477737419,453573512,477730625,-6794,,
78130477891,478237421,454073513,478231996,-5425,,
78130996959,478756489,454592582,478751065,-5424,478748941,
78130996968,478756498,454592591,478751074,-5424,,
78131496969,479256498,455092590,479248953,-7545,,
78132017423,479776952,455613045,479769408,-7544,479769919,
78132017432,479776962,455613054,479769338,-7624,,
78132517433,480276963,456113055,480269931,-7032,,
78133053276,480812806,456648899,480805775,-7031,480813620,
78133053285,480812815,456648908,480805782,-7033,,
78133553287,481312816,457148909,481313633,817,,
78134076725,481836255,457672347,481837072,817,481830723,
78134076732,481836262,457672354,481837077,815,,
78134576733,482336262,458172355,482330732,-5530,,
78135100500,482860030,458696123,482854501,-5529,482854739,
78135100509,482860039,458696132,482854508,-5531,,
78135600510,483360039,459196131,483354750,-5289,,
78136100511,483860040,459696133,483854751,-5289,,
78136120351,483879881,459715973,483874592,-5289,483871840,
78136600512,484360041,460196134,484352112,-7929,,
78137100514,484860043,460696136,484852005,-8038,,
78137144048,484903577,460739671,484895541,-8036,484898193,
78137600515,485360044,461196137,485354431,-5613,,
78138100516,485860045,461696137,485854663,-5382,,
78138164900,485924430,461760522,485919048,-5382,485917495,
78138600517,486360046,462196139,486353313,-6733,,
78139100519,486860048,462696141,486853116,-6932,,
78139188948,486948478,462784570,486941546,-6932,486942632,
78139600521,487360050,463196142,487354015,-6035,,
78140100522,487860052,463696144,487854208,-5844,,
78140208198,487967728,463803821,487961886,-5842,487959912,
78140600523,488360053,464196145,488352663,-7390,,
78141100525,488860054,464696147,488852241,-7813,,
78141227354,488986883,464822977,488979072,-7811,488979154,
78141600527,489360056,465196149,489352307,-7749,,
78142100528,489860058,465696150,489852331,-7727,,
78142251494,490011023,465847116,490003297,-7726,490005632,
78142600529,490360058,466196151,490353963,-6095,,
78143100530,490860059,466696152,490854670,-5389,,
78143270737,491030267,466866359,491024878,-5389,491022453,
78143600531,491360060,467196152,491353072,-6988,,
78144100532,491860062,467696154,491852250,-7812,,
78144290303,492049832,467885925,492042020,-7812,492042325,
78144600533,492360062,468196154,492352440,-7622,,
78145100534,492860063,468696156,492852558,-7505,,
78145314115,493073645,468909737,493066140,-7505,493068023,
78145600535,493360064,469196157,493353639,-6425,,
78146100536,493860065,469696158,493854446,-5619,,
78146333312,494092841,469928934,494087223,-5618,494084940,
78146600538,494360067,470196160,494353229,-6838,,
78147100539,494860069,470696161,494852170,-7899,,
78147702087,495461617,471297712,495453722,-7895,495368474,
78147702108,495461639,471297733,495453734,-7905,,
78148202109,495961638,471797730,495868500,-93138,,
78148725637,496485167,472321260,496392030,-93137,496479399,
78148725646,496485176,472321269,496392039,-93137,,
78149225647,496985177,472821269,496979411,-5766,,
78149725648,497485177,473321269,497479411,-5766,,
78149749792,497509322,473345415,497503556,-5766,497503667,
78150225649,497985179,473821271,497979520,-5659,,
78150725650,498485180,474321272,498479526,-5654,,
78150773555,498533085,474369178,498527432,-5653,498526889,
78151225652,498985181,474821274,498979039,-6142,,
78151725654,499485183,475321276,499478989,-6194,,
78151797495,499557025,475393118,499550832,-6193,499551511,
78152225656,499985185,475821278,499979575,-5610,,
78152725657,500485186,476321278,500479675,-5511,,
78152821535,500581064,476417157,500575554,-5510,500575258,
78153225658,500985187,476821280,500979439,-5748,,
78153725660,501485189,477321282,501479385,-5804,,
78153845565,501605095,477441187,501599292,-5803,501599515,
78154225661,501985190,477821282,501979558,-5632,,
78154725663,502485192,478321285,502479615,-5577,,
78154869566,502629096,478465189,502623520,-5576,502623005,
78155225664,502985193,478821285,502979251,-5942,,
78155725665,503485194,479321287,503479106,-6088,,
78155893611,503653141,479489234,503647054,-6087,503647045,
78156225666,503985196,479821288,503979104,-6092,,
78156725667,504485196,480321288,504479103,-6093,,
78156917789,504677319,480513411,504671226,-6093,504671855,
78157225668,504985197,480821290,504979492,-5705,,
78157725669,505485198,481321290,505479737,-5461,,
78157938422,505697952,481534044,505692491,-5461,505690560,
78158225670,505985199,481821291,505978629,-6570,,
78158725672,506485201,482321294,506477812,-7389,,
78158961904,506721433,482557526,506714045,-7388,506715509,
78159225674,506985203,482821296,506978587,-6616,,
78159725675,507485204,483321297,507479282,-5922,,
78159985814,507745344,483581436,507739422,-5922,507739649,
78160225677,507985206,483821298,507979393,-5813,,
78160725678,508485207,484321299,508479515,-5692,,
78161009252,508768782,484604875,508763091,-5691,508762863,
78161225679,508985208,484821300,508979418,-5790,,
78161725681,509485210,485321303,509479293,-5917,,
78162140517,509900047,485736141,509894132,-5915,509877536,
78162225682,509985212,485821305,509976467,-8745,,
78162725684,510485213,486321306,510462706,-22507,,
78163164296,510923826,486759920,510901321,-22505,510917722,
78163225685,510985214,486821307,510964719,-20495,,
78163725686,511485216,487321308,511479115,-6101,,
78164188384,511947913,487784006,511941813,-6100,511942131,
78164225688,511985217,487821309,511979140,-6077,,
78164725689,512485219,488321311,512479438,-5781,,
78165212137,512971667,488807760,512965888,-5779,512965529,
78165225691,512985220,488821313,512979430,-5790,,
78165725692,513485222,489321314,513479087,-6135,,
78166236419,513995948,489832041,513989814,-6134,513989531,
78166236428,513995958,489832051,513989821,-6137,,
78166736429,514495958,490332051,514489543,-6415,,
78167260154,515019683,490855776,515013269,-6414,515013532,
78167260161,515019690,490855783,515013275,-6415,,
78167760162,515519691,491355783,515513542,-6149,,
78168284146,516043676,491879769,516037527,-6149,516037480,
78168284153,516043683,491879776,516037532,-6151,,
78168784154,516543683,492379775,516537489,-6194,,
78169308249,517067779,492903872,517061585,-6194,517061489,
78169308256,517067786,492903879,517061590,-6196,,
78169808258,517567787,493403879,517561499,-6288,,
78170329465,518088995,493925088,518082708,-6287,518081652,
78170329474,518089004,493925097,518082716,-6288,,
78170829476,518589005,494425098,518581665,-7340,,
78171353197,519112727,494948820,519105387,-7340,519106835,
78171353206,519112736,494948829,519105394,-7342,,
78171853208,519612737,495448830,519606848,-5889,,
78172376609,520136139,495972232,520130250,-5889,520130082,
78172376744,520136274,495972367,520130384,-5890,,
78172876745,520636275,496472367,520630221,-6054,,
78173376746,521136275,496972368,521130221,-6054,,
78173396836,521156366,496992459,521150313,-6053,521148631,
78173876747,521636276,497472368,521628612,-7664,,
78174376748,522136278,497972370,522128545,-7733,,
78174416029,522175559,498011652,522167828,-7731,522167244,
78174876750,522636279,498472371,522628011,-8268,,
78175376751,523136280,498972372,523127967,-8313,,
78175438130,523197659,499033752,523189347,-8312,523188518,
78175876752,523636282,499472374,523627245,-9037,,
78176376753,524136282,499972374,524127142,-9140,,
78176461934,524221463,500057556,524212324,-9139,524215390,
78176876755,524636284,500472377,524629690,-6594,,
78177376756,525136285,500972377,525130214,-6071,,
78177481780,525241310,501077403,525235240,-6070,525233277,
78177876758,525636287,501472380,525628668,-7619,,
78178376759,526136288,501972381,526128258,-8030,,
78178502194,526261723,502097816,526253694,-8029,526253960,
78178876761,526636290,502472383,526628461,-7829,,
78179376762,527136291,502972383,527128530,-7761,,
78179525773,527285302,503121395,527277542,-7760,527279109,
78179876764,527636293,503472385,527629633,-6660,,
78180376765,528136294,503972387,528130103,-6191,,
78180549194,528308724,504144817,528302534,-6190,528302512,
78180876766,528636295,504472387,528630090,-6205,,
78181376767,529136296,504972389,529130086,-6210,,
78181596746,529356276,505192369,529350067,-6209,529334403,
78181876768,529636297,505472390,529621317,-14980,,
78182376770,530136299,505972392,530114429,-21870,,
78182620418,530379947,506216041,530358078,-21869,530373751,
78182876772,530636302,506472394,530622467,-13835,,
78183376774,531136303,506972396,531130109,-6194,,
78183639533,531399063,507235156,531392870,-6193,531390621,
78183876775,531636304,507472397,531629044,-7260,,
78184376776,532136305,507972397,532127866,-8439,,
78184664036,532423565,508259658,532415126,-8439,532417657,
78184876777,532636306,508472398,532628944,-7362,,
78185376778,533136307,508972400,533130401,-5906,,
78185688147,533447678,509283772,533441774,-5904,533441434,
78185876779,533636308,509472401,533630275,-6033,,
78186376781,534136310,509972402,534130072,-6238,,
78186708215,534467745,510303838,534461507,-6238,534459680,
78186876783,534636312,510472405,534629458,-6854,,
78187376785,535136314,510972407,535128251,-8063,,
78187732063,535491592,511327686,535483530,-8062,535485475,
78187876786,535636315,511472407,535628814,-7501,,
78188376788,536136317,511972410,536130202,-6115,,
78188758761,536518291,512354383,536512176,-6115,536513514,
78188876789,536636319,512472411,536630520,-5799,,
78189376790,537136319,512972411,537131545,-4774,,
78189778703,537538233,513374326,537533460,-4773,537530082,
78189876792,537636321,513472413,537630883,-5438,,
78190376793,538136323,513972415,538128174,-8149,,
78190802080,538561610,514397702,538553462,-8148,538555266,
78190876795,538636325,514472417,538628444,-7881,,
78191376796,539136325,514972418,539129983,-6342,,
78191823257,539582786,515418879,539576445,-6341,539573814,
78191876797,539636326,515472419,539629701,-6625,,
78192376799,540136328,515972420,540127358,-8970,,
78192844952,540604482,516440576,540595514,-8968,540596925,
78192876800,540636329,516472422,540627448,-8881,,
78193376801,541136331,516972423,541128778,-7553,,
78193865366,541624896,517460989,541617344,-7552,541616970,
78193876804,541636335,517472428,541628774,-7561,,
78194376805,542136334,517972427,542128411,-7923,,
78194888960,542648489,518484583,542640568,-7921,542641986,
78194889097,542648627,518484719,542640702,-7925,,
78195389098,543148628,518984720,543142126,-6502,,
78195889099,543648628,519484721,543642127,-6501,,
78195912578,543672107,519508200,543665607,-6500,543665477,
78196389101,544148630,519984722,544142008,-6622,,
78196889103,544648632,520484724,544642003,-6629,,
78196935893,544695423,520531516,544688796,-6627,544688881,
78197389105,545148634,520984727,545142086,-6548,,
78197889107,545648636,521484728,545642097,-6539,,
78197959416,545718946,521555039,545712408,-6538,545712439,
78198389108,546148638,521984730,546142129,-6509,,
78198889110,546648639,522484731,546642135,-6504,,
78198979976,546739506,522575598,546733002,-6504,546731464,
78199389111,547148640,522984732,547140879,-7761,,
78199889112,547648641,523484734,547640601,-8040,,
78200003521,547763051,523599143,547755011,-8040,547756516,
78200389113,548148642,523984735,548141765,-6877,,
78200889114,548648643,524484736,548642111,-6532,,
78201027232,548786762,524622854,548780230,-6532,548780417,
78201389115,549148645,524984737,549142250,-6395,,
78201889116,549648646,525484738,549642304,-6342,,
78202046827,549806357,525642450,549800016,-6341,549797825,
78202389117,550148646,525984739,550140806,-7840,,
78202889119,550648648,526484741,550640118,-8530,,
78203069983,550829513,526665606,550820984,-8529,550822868,
78203389121,551148650,526984743,551141324,-7326,,
78203889122,551648652,527484744,551642009,-6643,,
78204097477,551857006,527693099,551850365,-6641,551852546,
78204389124,552148653,527984745,552143285,-5368,,
78204889126,552648655,528484747,552644198,-4457,,
78205120859,552880389,528716481,552875932,-4457,552873737,
78205389127,553148657,528984749,553143023,-5634,,
78205889128,553648657,529484749,553642008,-6649,,
78206144329,553903859,529739952,553897211,-6648,553897378,
78206389129,554148658,529984750,554142092,-6566,,
78206889130,554648659,530484752,554642181,-6478,,
78207164694,554924224,530760318,554917748,-6476,554915998,
78207389131,555148660,530984752,555141398,-7262,,
78207889132,555648661,531484753,555640439,-8222,,
78208188110,555947641,531783734,555939421,-8220,555941110,
78208389133,556148663,531984755,556141119,-7544,,
78208889134,556648664,532484756,556642136,-6528,,
78209207241,556966771,532802864,556960244,-6527,556957877,
78209389135,557148664,532984757,557141276,-7388,,
78209889137,557648666,533484759,557639775,-8891,,
78210226335,557985865,533821958,557976975,-8890,557976989,
78210389138,558148667,533984759,558139780,-8887,,
78210889139,558648668,534484760,558639795,-8873,,
78211249743,559009273,534845366,559000401,-8872,559002486,
78211389140,559148670,534984762,559140378,-8292,,
78211889142,559648671,535484764,559641887,-6784,,
78212269088,560028618,535864711,560021834,-6784,560019691,
78212389143,560148673,535984765,560141374,-7299,,
78212889145,560648674,536484767,560639749,-8925,,
78213288824,561048354,536884447,561039430,-8924,561039139,
78213389147,561148676,536984769,561139693,-8983,,
78213889148,561648677,537484770,561639465,-9212,,
78214307955,562067486,537903578,562058274,-9212,562058502,
78214389150,562148679,537984771,562139503,-9176,,
78214889151,562648680,538484772,562639699,-8981,,
78215327445,563086974,538923067,563077994,-8980,563077905,
78215389153,563148682,538984775,563139689,-8993,,
78215889155,563648684,539484776,563639617,-9067,,
78216346788,564106319,539942412,564097253,-9066,564097233,
78216389157,564148686,539984778,564139615,-9071,,
78216889159,564648688,540484781,564639606,-9082,,
78217365666,565125196,540961289,565116115,-9081,565116257,
78217389160,565148689,540984782,565139613,-9076,,
78217889162,565648691,541484783,565639755,-8936,,
78218389163,566148692,541984786,566139758,-8934,566141847,
78218389172,566148702,541984795,566139765,-8937,,
78218889173,566648702,542484795,566641859,-6843,,
78219408294,567167824,543003916,567160981,-6843,567158811,
78219408303,567167832,543003925,567160988,-6844,,
78219908305,567667835,543503927,567658824,-9011,,
78220427458,568186988,544023081,568177979,-9009,568177918,
78220427468,568186997,544023090,568177987,-9010,,
78220927469,568686998,544523090,568677931,-9067,,
78221449423,569208953,545045046,569199888,-9065,569201042,
78221449437,569208968,545045061,569199900,-9068,,
78221949438,569708967,545545060,569701060,-7907,,
78222473119,570232648,546068741,570224742,-7906,570225816,
78222473128,570232657,546068750,570224748,-7909,,
78222973129,570732658,546568750,570725828,-6830,,
78223496866,571256395,547092488,571249566,-6829,571249602,
78223496873,571256403,547092495,571249572,-6831,,
78223996874,571756403,547592495,571749612,-6791,,
78224520537,572280067,548116160,572273277,-6790,572273300,
78224520547,572280077,548116169,572273285,-6792,,
78225020548,572780077,548616170,572773313,-6764,,
78225544165,573303695,549139787,573296931,-6764,573296978,
78225544174,573303704,549139797,573296939,-6765,,
78226044176,573803705,549639797,573796991,-6714,,
78226567681,574327211,550163304,574320497,-6714,574320153,
78226567690,574327220,550163313,574320506,-6714,,
78227067691,574827221,550663313,574820166,-7055,,
78227591570,575351100,551187193,575344045,-7055,575344128,
78227591702,575351232,551187324,575344175,-7057,,
78228091704,575851233,551687326,575844264,-6969,,
78228616328,576375857,552211950,576368889,-6968,576368261,
78228616337,576375867,552211959,576368896,-6971,,
78229116339,576875868,552711961,576868274,-7594,,
78229640385,577399915,553236008,577392321,-7594,577393331,
78229640392,577399922,553236015,577392326,-7596,,
78230140393,577899922,553736015,577893340,-6582,,
78230664498,578424028,554260120,578417446,-6582,578417158,
78230664643,578424172,554260265,578417589,-6583,,
78231164644,578924173,554760266,578917306,-6867,,
78231688244,579447773,555283866,579440906,-6867,579440922,
78231688250,579447780,555283873,579440912,-6868,,
78232188251,579947780,555783873,579940931,-6849,,
78232688252,580447781,556283873,580440932,-6849,,
78232711732,580471262,556307354,580464413,-6849,580464077,
78233188254,580947783,556783876,580940617,-7166,,
78233688255,581447784,557283877,581440602,-7182,,
78233731065,581490595,557326689,581483416,-7179,581481225,
78234188257,581947786,557783878,581938606,-9180,,
78234688258,582447788,558283880,582438420,-9368,,
78234751102,582510632,558346725,582501266,-9366,582501242,
78235188260,582947789,558783882,582938403,-9386,,
78235688261,583447790,559283883,583438402,-9388,,
78235774599,583534128,559370221,583524741,-9387,583527045,
78236188262,583947791,559783884,583940311,-7480,,
78236688263,584447793,560283885,584440711,-7082,,
78236795110,584554639,560390732,584547559,-7080,584546008,
78237188264,584947794,560783886,584939494,-8300,,
78237688266,585447795,561283887,585439166,-8629,,
78237818602,585578131,561414224,585569503,-8628,585570931,
78238188267,585947797,561783889,585940226,-7571,,
78238688268,586447798,562283890,586440600,-7198,,
78238842672,586602202,562438295,586595004,-7198,586595363,
78239188269,586947798,562783890,586940850,-6948,,
78239688270,587447799,563283892,587440963,-6836,,
78239866143,587625672,563461765,587618837,-6835,587618442,
78240188272,587947801,563783893,587940712,-7089,,
78240688273,588447802,564283894,588440574,-7228,,
78240889982,588649511,564485604,588642284,-7227,588642395,
78241188275,588947804,564783897,588940643,-7161,,
78241688276,589447805,565283898,589440691,-7114,,
78241913731,589673261,565509354,589666147,-7114,589666193,
78242188278,589947808,565783900,589940719,-7089,,
78242688279,590447808,566283900,590440743,-7065,,
78242937726,590697256,566533349,590690192,-7064,590690191,
78243188281,590947810,566783903,590940746,-7064,,
78243688282,591447811,567283903,591440749,-7062,,
78243961155,591720685,567556778,591713623,-7062,591713276,
78244188283,591947813,567783905,591940594,-7219,,
78244688284,592447814,568283906,592440408,-7406,,
78244983401,592742931,568579024,592735526,-7405,592733417,
78245188285,592947814,568783907,592939544,-8270,,
78245688286,593447815,569283908,593438303,-9512,,
78246003258,593762788,569598881,593753276,-9512,593753637,
78246188288,593947817,569783909,593938438,-9379,,
78246688289,594447818,570283910,594438668,-9150,,
78247027057,594786586,570622679,594777438,-9148,594779237,
78247188291,594947820,570783912,594939252,-8568,,
78247688292,595447821,571283914,595440474,-7347,,
78248050645,595810174,571646267,595802828,-7346,595802851,
78248188294,595947823,571783916,595940482,-7341,,
78248688296,596447825,572283917,596440504,-7321,,
78249072221,596831751,572667844,596824430,-7321,596823504,
78249188297,596947826,572783918,596940290,-7536,,
78249688299,597447828,573283921,597439583,-8245,,
78250092369,597851900,573687994,597843658,-8242,597841876,
78250188300,597947829,573783921,597939240,-8589,,
78250688301,598447831,574283923,598437812,-10019,,
78251116354,598875884,574711977,598865866,-10018,598868673,
78251188302,598947831,574783923,598938214,-9617,,
78251688303,599447832,575283925,599440624,-7208,,
78252139873,599899403,575735495,599892195,-7208,599892038,
78252188305,599947834,575783927,599940610,-7224,,
78252688307,600447836,576283928,600440473,-7363,,
78253163660,600923190,576759283,600915828,-7362,600915845,
78253188308,600947837,576783930,600940474,-7363,,
78253688310,601447839,577283932,601440496,-7343,,
78254187489,601947019,577783112,601939676,-7343,601939817,
78254188313,601947842,577783935,601940498,-7344,,
78254688314,602447844,578283936,602440645,-7199,,
78255211392,602970922,578807015,602963723,-7199,602963370,
78255211399,602970929,578807022,602963729,-7200,,
78255711400,603470930,579307022,603463380,-7550,,
78256230745,603990275,579826367,603982725,-7550,603980566,
78256230754,603990284,579826376,603982732,-7552,,
78256730755,604490284,580326377,604480578,-9706,,
78257249928,605009457,580845550,604999752,-9705,604999803,
78257249937,605009467,580845560,604999760,-9707,,
78257749939,605509468,581345560,605499816,-9652,,
78258273157,606032687,581868780,606023035,-9652,606025156,
78258273165,606032694,581868787,606023041,-9653,,
78258773166,606532695,582368788,606525166,-7529,,
78259296773,607056302,582892396,607048774,-7528,607048746,
78259296782,607056312,582892405,607048781,-7531,,
78259796783,607556312,583392405,607548758,-7554,,
78260319945,608079475,583915567,608071921,-7554,608071929,
78260319952,608079481,583915574,608071927,-7554,,
78260819953,608579482,584415574,608571938,-7544,,
78261367402,609126931,584963024,609119388,-7543,609106846,
78261367412,609126942,584963034,609119397,-7545,,
78261867413,609626942,585463035,609606859,-20083,,
78262386850,610146379,585982472,610126297,-20082,610136732,
78262386859,610146388,585982481,610126305,-20083,,
78262886860,610646389,586482482,610636744,-9645,,
78263410288,611169818,587005911,611160173,-9645,611162286,
78263410333,611169862,587005955,611160216,-9646,,
78263910334,611669863,587505955,611662333,-7530,,
78264434403,612193933,588030026,612186404,-7529,612186577,
78264434412,612193942,588030035,612186411,-7531,,
78264934413,612693942,588530035,612686589,-7353,,
78265458044,613217573,589053667,613210222,-7351,613210107,
78265458053,613217583,589053676,613210228,-7355,,
78265958054,613717583,589553676,613710119,-7464,,
78266481591,614241121,590077214,614233658,-7463,614233659,
78266481601,614241131,590077224,614233666,-7465,,
78266981602,614741131,590577224,614733671,-7460,,
78267505497,615265027,591101120,615257568,-7459,615257605,
78267505507,615265037,591101129,615257576,-7461,,
78268005508,615765038,591601130,615757618,-7420,,
78268529179,616288708,592124802,616281290,-7418,616281193,
78268529188,616288718,592124811,616281298,-7420,,
78269029189,616788718,592624811,616781205,-7513,,
78269552957,617312487,593148580,617304975,-7512,617304664,
78269552967,617312496,593148589,617304982,-7514,,
78270052968,617812497,593648589,617804675,-7822,,
78270576836,618336366,594172458,618328545,-7821,618328730,
78270576843,618336373,594172465,618328551,-7822,,
78271076844,618836374,594672466,618828739,-7635,,
78271601008,619360538,595196630,619352904,-7634,619352820,
78271601015,619360545,595196638,619352909,-7636,,
78272101016,619860546,595696638,619852830,-7716,,
78272601017,620360546,596196638,620352830,-7716,,
78272625058,620384587,596220681,620376872,-7715,620376816,
78273101023,620860552,596696645,620852786,-7766,,
78273601024,621360554,597196646,621352785,-7769,,
78273644115,621403644,597239737,621395875,-7769,621393780,
78274101026,621860555,597696647,621850872,-9683,,
78274601027,622360556,598196648,622350694,-9862,,
78274673072,622432602,598268695,622422740,-9862,622425569,
78275101028,622860558,598696650,622853119,-7439,,
78275601029,623360559,599196651,623353528,-7031,,
78275696796,623456326,599292419,623449296,-7030,623448535,
78276101030,623860559,599696651,623852915,-7644,,
78276601032,624360561,600196654,624352772,-7789,,
78276720320,624479850,600315943,624472061,-7789,624472085,
78277101034,624860564,600696656,624852793,-7771,,
78277601036,625360565,601196658,625352802,-7763,,
78277743799,625503329,601339422,625495567,-7762,625495507,
78278101037,625860566,601696658,625852762,-7804,,
78278601038,626360568,602196660,626352749,-7819,,
78278767320,626526850,602362943,626519032,-7818,626519035,
78279101039,626860568,602696660,626852753,-7815,,
78279601040,627360569,603196661,627352757,-7812,,
78279786364,627545893,603381987,627538083,-7810,627535926,
78280101042,627860571,603696664,627851403,-9168,,
78280601043,628360572,604196664,628350607,-9965,,
78280809858,628569387,604405480,628559423,-9964,628561549,
78281101044,628860574,604696666,628851848,-8726,,
78281601046,629360575,605196668,629352739,-7836,,
78281833309,629592839,605428932,629585003,-7836,629585005,
78282101047,629860577,605696669,629852742,-7835,,
78282601048,630360577,606196670,630352746,-7831,,
78282852370,630611899,606447992,630604069,-7830,630601810,
78283101051,630860580,606696672,630851626,-8954,,
78283601052,631360582,607196674,631350495,-10087,,
78283875934,631635464,607471557,631625378,-10086,631627436,
78284101053,631860583,607696675,631851423,-9160,,
78284601054,632360584,608196676,632352559,-8025,,
78284896875,632656405,608492498,632648380,-8025,632647153,
78285101055,632860584,608696676,632852058,-8526,,
78285601056,633360585,609196678,633351335,-9250,,
78285920522,633680052,609516145,633670803,-9249,633672040,
78286101058,633860587,609696679,633851785,-8802,,
78286601059,634360588,610196681,634352579,-8009,,
78286944047,634703577,610539670,634695568,-8009,634695516,
78287101060,634860590,610696682,634852565,-8025,,
78287601061,635360590,611196682,635352531,-8059,,
78287964722,635724252,611560345,635716194,-8058,635714702,
78288101062,635860591,611696683,635852124,-8467,,
78288601063,636360593,612196685,636351046,-9547,,
78288988184,636747714,612583806,636738167,-9547,636739725,
78289101064,636860593,612696686,636851397,-9196,,
78289601065,637360595,613196687,637352608,-7987,,
78290011647,637771177,613607270,637763192,-7985,637763162,
78290101067,637860596,613696689,637852604,-7992,,
78290601068,638360597,614196690,638352585,-8012,,
78291037104,638796634,614632727,638788623,-8011,638789594,
78291101069,638860598,614696690,638852709,-7889,,
78291601071,639360600,615196693,639353562,-7038,,
78292060673,639820202,615656295,639813165,-7037,639812137,
78292101072,639860601,615696694,639853480,-7121,,
78292601074,640360603,616196696,640352541,-8062,,
78293083997,640843526,616679619,640835465,-8061,640835490,
78293101075,640860604,616696697,640852542,-8062,,
78293601077,641360606,617196699,641352572,-8034,,
78294103344,641862874,617698967,641854841,-8033,641852788,
78294103354,641862884,617698976,641854849,-8035,,
78294603355,642362885,618198977,642352801,-10084,,
78295127004,642886534,618722627,642876452,-10082,642878373,
78295127013,642886543,618722635,642876459,-10084,,
78295627014,643386543,619222636,643378385,-8158,,
78296150877,643910407,619746499,643902249,-8158,643902493,
78296151009,643910539,619746632,643902379,-8160,,
78296651010,644410539,620246631,644402628,-7911,,
78297151011,644910540,620746633,644902629,-7911,,
78297170138,644929667,620765760,644921757,-7910,644919339,
78297651013,645410542,621246635,645400309,-10233,,
78298151014,645910544,621746636,645900218,-10326,,
78298205044,645964574,621800667,645954249,-10325,645962244,
78298651015,646410544,622246637,646407352,-3192,,
78299151017,646910546,622746639,646908219,-2327,,
78299229044,646988575,622824667,646986249,-2326,646980598,
78299651018,647410547,623246640,647403454,-7093,,
78300151019,647910548,623746641,647902575,-7973,,
78300252475,648012005,623848098,648004033,-7972,648003837,
78300651021,648410550,624246643,648402424,-8126,,
78301151023,648910552,624746645,648902387,-8165,,
78301277282,649036812,624872904,649028648,-8164,649029268,
78301651024,649410554,625246646,649402855,-7699,,
78302151025,649910554,625746646,649903013,-7541,,
78302296487,650056017,625892110,650048477,-7540,650045662,
78302651027,650410556,626246649,650401022,-9534,,
78303151029,650910558,626746650,650900206,-10352,,
78303315724,651075254,626911346,651064902,-10352,651064910,
78303651030,651410559,627246652,651400213,-10346,,
78304151031,651910561,627746653,651900218,-10343,,
78304335463,652094993,627931086,652084651,-10342,652084276,
78304651032,652410562,628246654,652399983,-10579,,
78305151034,652910563,628746656,652899849,-10714,,
78305359294,653118823,628954916,653108110,-10713,653110714,
78305651035,653410564,629246656,653401370,-9194,,
78306151036,653910565,629746658,653902458,-8107,,
78306383863,654143393,629979486,654135286,-8107,654134789,
78306651037,654410566,630246659,654402195,-8371,,
78307151038,654910567,630746660,654901966,-8601,,
78307403813,655163342,630999435,655154742,-8600,655152479,
78307651039,655410568,631246661,655400848,-9720,,
78308151040,655910569,631746662,655899708,-10861,,
78308424110,656183640,632019733,656172780,-10860,656173716,
78308651042,656410571,632246663,656400136,-10435,,
78309151043,656910572,632746664,656900651,-9921,,
78309447839,657207368,633043461,657197448,-9920,657199258,
78309651044,657410573,633246665,657401387,-9186,,
78310151045,657910574,633746667,657902466,-8108,,
78310466957,658226487,634062581,658218380,-8107,658216025,
78310651047,658410576,634246669,658401601,-8975,,
78311151049,658910578,634746671,658900118,-10460,,
78311490493,659250022,635086115,659239563,-10459,659241662,
78311651051,659410580,635246672,659400794,-9786,,
78312151052,659910581,635746673,659902223,-8358,,
78312513983,660273513,636109606,660265155,-8358,660265151,
78312651053,660410582,636246675,660402223,-8359,,
78313151055,660910584,636746677,660902225,-8359,,
78313535572,661295102,637131195,661286744,-8358,661285817,
78313651056,661410585,637246678,661402012,-8573,,
78314151058,661910587,637746679,661901305,-9282,,
78314558947,662318477,638154570,662309195,-9282,662310053,
78314651060,662410589,638246681,662401464,-9125,,
78315151061,662910590,638746682,662902169,-8421,,
78315582434,663341964,639178057,663333544,-8420,663333491,
78315651063,663410592,639246684,663402163,-8429,,
78316151064,663910594,639746686,663902124,-8470,,
78316601780,664361310,640197403,664352840,-8470,664350747,
78316651066,664410595,640246688,664401918,-8677,,
78317151068,664910597,640746689,664900036,-10561,,
78317624950,665384480,641220573,665373919,-10561,665376014,
78317651069,665410598,641246691,665400146,-10452,,
78318151071,665910600,641746692,665902135,-8465,,
78318648382,666407911,642244004,666399448,-8463,666399462,
78318651073,666410604,642246697,666402140,-8464,,
78319151074,666910604,642746696,666902156,-8448,,
78319671780,667431310,643267403,667422863,-8447,667422822,
78319671789,667431319,643267412,667422871,-8448,,
78320171790,667931320,643767412,667922834,-8486,,
78320699928,668459457,644295550,668450972,-8485,668453252,
78320699937,668459466,644295559,668450979,-8487,,
78321199938,668959467,644795559,668953265,-6202,,
78321719024,669478554,645314647,669472353,-6201,669467864,
78321719159,669478688,645314781,669472485,-6203,,
78322219160,669978689,645814781,669968002,-10687,,
78322738162,670497692,646333785,670487005,-10687,670486960,
78322738171,670497701,646333794,670487013,-10688,,
78323238172,670997701,646833794,670986972,-10729,,
78323761567,671521097,647357190,671510369,-10728,671512523,
78323761576,671521106,647357199,671510376,-10730,,
78324261578,672021107,647857200,672012536,-8571,,
78324780619,672540149,648376242,672531579,-8570,672529399,
78324780628,672540158,648376251,672531586,-8572,,
78325280630,673040159,648876252,673029412,-10747,,
78325804272,673563801,649399894,673553055,-10746,673555110,
78325804281,673563811,649399904,673553063,-10748,,
78326304283,674063812,649899905,674055123,-8689,,
78326823422,674582952,650419044,674574263,-8689,674572186,
78326823432,674582961,650419054,674574271,-8690,,
78327323434,675082963,650919056,675072200,-10763,,
78327844062,675603592,651439685,675592830,-10762,675593421,
78327844072,675603601,651439694,675592838,-10763,,
78328344073,676103602,651939694,676093434,-10168,,
78328867770,676627300,652463393,676617133,-10167,676618615,
78328867779,676627309,652463402,676617140,-10169,,
78329367780,677127310,652963402,677118627,-8683,,
78329867781,677627310,653463403,677618627,-8683,,
78329891840,677651370,653487463,677642688,-8682,677642487,
78330367782,678127311,653963404,678118440,-8871,,
78330867784,678627313,654463405,678618433,-8880,,
78330915475,678675006,654511098,678666126,-8880,678666338,
78331367785,679127314,654963407,679118628,-8686,,
78331867787,679627316,655463409,679618651,-8665,,
78331937210,679696740,655532833,679688076,-8664,679687190,
78332367788,680127318,655963410,680117893,-9425,,
78332867789,680627318,656463411,680617771,-9547,,
78332961029,680720559,656556652,680711013,-9546,680711950,
78333367790,681127319,656963411,681118536,-8783,,
78333867792,681627321,657463414,681618714,-8607,,
78333984749,681744278,657580371,681735671,-8607,681735691,
78334367793,682127323,657963415,682118731,-8592,,
78334867794,682627324,658463416,682618738,-8586,,
78335008346,682767876,658603969,682759291,-8585,682759101,
78335367795,683127324,658963417,683118605,-8719,,
78335867796,683627325,659463418,683618553,-8772,,
78336032494,683792024,659628117,683783253,-8771,683783577,
78336367797,684127326,659963419,684118774,-8552,,
78336867798,684627327,660463420,684618883,-8444,,
78337056095,684815625,660651717,684807181,-8444,684806897,
78337367800,685127329,660963422,685118709,-8620,,
78337867802,685627331,661463424,685618606,-8725,,
78338080512,685840041,661676134,685831317,-8724,685831590,
78338367804,686127333,661963426,686118767,-8566,,
78338867805,686627334,662463427,686618886,-8448,,
78339101664,686861194,662697286,686852746,-8448,686851066,
78339367806,687127336,662963428,687117995,-9341,,
78339867808,687627337,663463430,687617212,-10125,,
78340121762,687881292,663717385,687871167,-10125,687870870,
78340367810,688127339,663963431,688117069,-10270,,
78340867812,688627341,664463434,688616922,-10419,,
78341145478,688905008,664741101,688894589,-10419,688896296,
78341367813,689127342,664963435,689117682,-9660,,
78341867815,689627344,665463437,689618635,-8709,,
78342169065,689928596,665764690,689919890,-8706,689919768,
78342367816,690127345,665963438,690118589,-8756,,
78342867818,690627347,666463439,690618524,-8823,,
78343192514,690952044,666788137,690943222,-8822,690943137,
78343367819,691127348,666963440,691118496,-8852,,
78343867821,691627350,667463442,691618446,-8904,,
78344211715,691971245,667807338,691962342,-8903,691960213,
78344367822,692127351,667963443,692117783,-9568,,
78344867824,692627353,668463446,692616324,-11029,,
78345235248,692994778,668830870,692983749,-11029,692985797,
78345367825,693127354,668963447,693116867,-10487,,
78345867826,693627355,669463448,693618377,-8978,,
78346259553,694019083,669855176,694010106,-8977,694010659,
78346367828,694127358,669963450,694118498,-8860,,
78346867830,694627359,670463451,694618937,-8422,,
78347278664,695038194,670874287,695029773,-8421,695027122,
78347367831,695127361,670963453,695118465,-8896,,
78347867832,695627361,671463454,695616291,-11070,,
78348297798,696057328,671893421,696046259,-11069,696046129,
78348367833,696127363,671963455,696116273,-11090,,
78348867834,696627363,672463456,696616166,-11197,,
78349321347,697080877,672916971,697069681,-11196,697071862,
78349367835,697127365,672963457,697116368,-10997,,
78349867837,697627366,673463459,697618353,-9013,,
78350345027,698104557,673940650,698095545,-9012,698095723,
78350367838,698127367,673963460,698118361,-9006,,
78350867839,698627368,674463461,698618536,-8832,,
78351364976,699124505,674960598,699115674,-8831,699113531,
78351367840,699127370,674963462,699118524,-8846,,
78351867842,699627371,675463464,699616399,-10972,,
78352388606,700148135,675984229,700137164,-10971,700139089,
78352388615,700148145,675984238,700137171,-10974,,
78352888616,700648146,676484238,700639102,-9044,,
78353407853,701167383,677003476,701158340,-9043,701156205,
78353407862,701167392,677003485,701158348,-9044,,
78353907864,701667393,677503485,701656218,-11175,,
78354427147,702186677,678022770,702175502,-11175,702175410,
78354427189,702186719,678022811,702175543,-11176,,
78354927191,702686721,678522813,702675456,-11265,,
78355446283,703205812,679041905,703194548,-11264,703194649,
78355446290,703205819,679041912,703194555,-11264,,
78355946291,703705821,679541913,703694660,-11161,,
78356471360,704230890,680066982,704219729,-11161,704222538,
78356471369,704230899,680066991,704219737,-11162,,
78356971371,704730900,680566992,704722551,-8349,,
78357624707,705384238,681220332,705375892,-8346,705350159,
78357624889,705384420,681220514,705376060,-8360,,
78358124891,705884420,681720512,705850346,-34074,,
78358644729,706404258,682240351,706370185,-34073,706393392,
78358644738,706404267,682240360,706370194,-34073,,
78359144740,706904269,682740362,706893406,-10863,,
78359672690,707432220,683268313,707421358,-10862,707424447,
78359672700,707432229,683268322,707421366,-10863,,
78360172701,707932230,683768322,707924460,-7770,,
78360696438,708455967,684292060,708448198,-7769,708446533,
78360696447,708455976,684292069,708448205,-7771,,
78361196448,708955977,684792070,708946545,-9432,,
78361715628,709475158,685311250,709465726,-9432,709463802,
78361715637,709475167,685311259,709465733,-9434,,
78362215638,709975167,685811259,709963814,-11353,,
78362735008,710494538,686330631,710483186,-11352,710483105,
78362735017,710494547,686330639,710483193,-11354,,
78363235019,710994548,686830640,710983118,-11430,,
78363754195,711513725,687349818,711502296,-11429,711502338,
78363754204,711513734,687349827,711502304,-11430,,
78364254205,712013734,687849827,712002350,-11384,,
78364773422,712532952,688369045,712521568,-11384,712521510,
78364773429,712532959,688369052,712521574,-11385,,
78365273430,713032960,688869052,713021520,-11440,,
78365796899,713556429,689392521,713544989,-11440,713547227,
78365796908,713556438,689392530,713544997,-11441,,
78366296909,714056439,689892531,714047240,-9199,,
78366821551,714581081,690417174,714571884,-9197,714572445,
78366821560,714581090,690417183,714571892,-9198,,
78367321562,715081091,690917184,715072458,-8633,,
78367844437,715603967,691440060,715595335,-8632,715594358,
78367844447,715603977,691440069,715595342,-8635,,
78368344449,716103978,691940071,716094371,-9607,,
78368864785,716624315,692460408,716614708,-9607,716613587,
78368864792,716624322,692460415,716614713,-9609,,
78369364794,717124323,692960416,717113597,-10726,,
78369884393,717643923,693480015,717633197,-10726,717632755,
78369884402,717643932,693480025,717633205,-10727,,
78370384403,718143932,693980025,718132767,-11165,,
78370907702,718667232,694503325,718656067,-11165,718657975,
78370907709,718667239,694503332,718656072,-11167,,
78371407711,719167240,695003332,719157985,-9255,,
78371927723,719687253,695523345,719677998,-9255,719676130,
78371927732,719687262,695523354,719678006,-9256,,
78372427733,720187263,696023355,720176143,-11120,,
78372946776,720706306,696542399,720695186,-11120,720694907,
78372946785,720706315,696542408,720695194,-11121,,
78373446786,721206315,697042408,721194919,-11396,,
78373966816,721726345,697562438,721714950,-11395,721715102,
78373966950,721726480,697562573,721715082,-11398,,
78374466951,722226480,698062573,722215239,-11241,,
78374987920,722747450,698583542,722736209,-11241,722736739,
78374987929,722747459,698583552,722736216,-11243,,
78375487931,723247460,699083553,723236752,-10708,,
78376008211,723767741,699603834,723757034,-10707,723756824,
78376008221,723767750,699603843,723757041,-10709,,
78376508222,724267751,700103843,724256837,-10914,,
78377027382,724786912,700623005,724775999,-10913,724775340,
78377027431,724786961,700623054,724776047,-10914,,
78377527432,725286962,701123054,725275393,-11569,,
78378050748,725810278,701646371,725798710,-11568,725800733,
78378050757,725810287,701646380,725798718,-11569,,
78378550759,726310288,702146380,726300746,-9542,,
78379074526,726834056,702670148,726824514,-9542,726824465,
78379074533,726834063,702670155,726824520,-9543,,
78379574535,727334064,703170156,727324476,-9588,,
78380098028,727857557,703693651,727847971,-9586,727848053,
78380098037,727857567,703693659,727847978,-9589,,
78380598038,728357568,704193660,728348065,-9503,,
78381098039,728857568,704693661,728848066,-9502,,
78381121968,728881497,704717591,728871996,-9501,728872007,
78381598040,729357569,705193662,729348080,-9489,,
78382098041,729857571,705693663,729848082,-9489,,
78382145135,729904665,705740758,729895178,-9487,729895121,
78382598043,730357572,706193664,730348036,-9536,,
78383098044,730857574,706693666,730848032,-9542,,
78383164324,730923854,706759946,730914313,-9541,730912154,
78383598046,731357575,707193668,731346163,-11412,,
78384098047,731857576,707693669,731845879,-11697,,
78384187787,731947317,707783410,731935621,-11696,731937702,
78384598048,732357577,708193669,732347590,-9987,,
78385098050,732857579,708693672,732847966,-9613,,
78385211237,732970767,708806859,732961155,-9612,732961035,
78385598051,733357581,709193673,733347878,-9703,,
78386098052,733857581,709693674,733847852,-9729,,
78386234906,733994436,709830529,733984708,-9728,733984735,
78386598054,734357583,710193675,734347876,-9707,,
78387098056,734857585,710693678,734847887,-9698,,
78387258326,735017856,710853948,735008158,-9698,735008207,
78387598057,735357586,711193679,735347922,-9664,,
78388098058,735857587,711693680,735847940,-9647,,
78388277542,736037071,711873164,736027425,-9646,736025260,
78388598059,736357588,712193680,736346555,-11033,,
78389098060,736857590,712693682,736845780,-11810,,
78389301003,737060533,712896626,737048725,-11808,737050949,
78389598062,737357591,713193684,737347106,-10485,,
78390098063,737857593,713693685,737848012,-9581,,
78390324527,738084057,713920149,738074476,-9581,738074370,
78390598066,738357595,714193688,738347958,-9637,,
78391098068,738857597,714693690,738847913,-9684,,
78391343686,739103216,714939309,739093533,-9683,739091424,
78391598069,739357598,715193690,739346842,-10756,,
78392098070,739857599,715693691,739845810,-11789,,
78392364003,740123533,715959626,740111745,-11788,740111078,
78392598072,740357601,716193694,740345501,-12100,,
78393098074,740857603,716693695,740845150,-12453,,
78393383287,741142817,716978910,741130365,-12452,741130906,
78393598076,741357605,717193698,741345386,-12219,,
78394098077,741857606,717693699,741845698,-11908,,
78394403838,742163368,717999460,742151460,-11908,742152351,
78394598079,742357608,718193701,742346047,-11561,,
78395098083,742857613,718693705,742846599,-11014,,
78395427802,743187332,719023424,743176318,-11014,743177771,
78395598085,743357614,719193706,743347095,-10519,,
78396098086,743857615,719693708,743848057,-9558,,
78396451853,744211383,720047476,744201825,-9558,744201944,
78396598088,744357617,720193710,744348094,-9523,,
78397098089,744857619,720693711,744848182,-9437,,
78397475788,745235317,721071411,745225882,-9435,745225794,
78397598091,745357621,721193713,745348162,-9459,,
78398098093,745857622,721693715,745848101,-9521,,
78398499497,746259027,722095119,746249506,-9521,746249028,
78398598095,746357624,722193716,746348008,-9616,,
78399098097,746857626,722693719,746847630,-9996,,
78399523015,747282545,723118638,747272550,-9995,747272660,
78399598098,747357628,723193720,747347647,-9981,,
78400098100,747857629,723693721,747847747,-9882,,
78400696290,748455821,724291915,748445941,-9880,748371631,
78400696310,748455841,724291935,748445953,-9888,,
78401196312,748955841,724791934,748871656,-84185,,
78401715389,749474919,725311012,749390735,-84184,749462927,
78401715399,749474929,725311021,749390745,-84184,,
78402215401,749974930,725811023,749962941,-11989,,
78402734538,750494068,726330161,750482080,-11988,750482034,
78402734547,750494077,726330170,750482088,-11989,,
78403234549,750994078,726830171,750982047,-12031,,
78403753666,751513196,727349289,751501165,-12031,751501204,
78403753675,751513205,727349298,751501172,-12033,,
78404253676,752013206,727849298,752001217,-11989,,
78404772765,752532294,728368387,752520306,-11988,752520310,
78404772774,752532303,728368396,752520314,-11989,,
78405272776,753032305,728868397,753020324,-11981,,
78405791867,753551396,729387489,753539416,-11980,753539307,
78405791876,753551405,729387498,753539423,-11982,,
78406291877,754051406,729887499,754039319,-12087,,
78406815354,754574883,730410976,754562797,-12086,754564939,
78406815363,754574893,730410985,754562804,-12089,,
78407315364,755074893,730910986,755064951,-9942,,
78407839223,755598753,731434846,755588811,-9942,755588956,
78407839232,755598762,731434855,755588819,-9943,,
78408339233,756098762,731934855,756088968,-9794,,
78408839234,756598763,732434855,756588969,-9794,,
78408862698,756622228,732458320,756612434,-9794,756612288,
78409339235,757098764,732934857,757088833,-9931,,
78409839237,757598766,733434858,757588829,-9937,,
78409886186,757645715,733481808,757635779,-9936,757635776,
78410339239,758098768,733934861,758088831,-9937,,
78410839240,758598769,734434862,758588832,-9937,,
78410909569,758669099,734505192,758659162,-9937,758659103,
78411339242,759098771,734934864,759088785,-9986,,
78411839243,759598772,735434865,759588778,-9994,,
78411928824,759688354,735524447,759678360,-9994,759676184,
78412339245,760098774,735934867,760086996,-11778,,
78412839246,760598776,736434868,760586609,-12167,,
78412952412,760711942,736548035,760699776,-12166,760701912,
78413339248,761098777,736934870,761088264,-10513,,
78413839249,761598779,737434871,761588751,-10028,,
78413976070,761735599,737571692,761725572,-10027,761725535,
78414339250,762098780,737934872,762088726,-10054,,
78414839252,762598782,738434874,762588719,-10063,,
78414995357,762754887,738590980,762744826,-10061,762742579,
78415339254,763098783,738934876,763087177,-11606,,
78415839255,763598784,739434877,763586479,-12305,,
78416018731,763778261,739614354,763765955,-12306,763768163,
78416339256,764098785,739934878,764087896,-10889,,
78416839258,764598787,740434880,764588692,-10095,,
78417037953,764797482,740633576,764787388,-10094,764785221,
78417339260,765098790,740934882,765087390,-11400,,
78417839262,765598791,741434884,765586532,-12259,,
78418061445,765820975,741657068,765808717,-12258,765810665,
78418339264,766098794,741934886,766087618,-11176,,
78418839266,766598795,742434887,766588487,-10308,,
78419083780,766843310,742679403,766833003,-10307,766832547,
78419339268,767098797,742934890,767088257,-10540,,
78419839269,767598798,743434891,767588037,-10761,,
78420107869,767867399,743703492,767856638,-10761,767857631,
78420339271,768098800,743934893,768088499,-10301,,
78420839272,768598802,744434894,768589037,-9765,,
78421127507,768887037,744723129,768877272,-9765,768875071,
78421339273,769098803,744934895,769088104,-10699,,
78421839275,769598805,745434897,769586840,-11965,,
78422151698,769911228,745747321,769899265,-11963,769900893,
78422339277,770098807,745934899,770087454,-11353,,
78422839279,770598809,746434901,770588476,-10333,,
78423175128,770934658,746770751,770924327,-10331,770924529,
78423339280,771098809,746934902,771088543,-10266,,
78423839281,771598811,747434903,771588684,-10127,,
78424198401,771957930,747794023,771947805,-10125,771947711,
78424339282,772098812,747934905,772088660,-10152,,
78424839284,772598813,748434906,772588596,-10217,,
78425222398,772981927,748818020,772971711,-10216,772971780,
78425339286,773098815,748934908,773088614,-10201,,
78425839288,773598817,749434910,773588672,-10145,,
78426245304,774004833,749840926,773994689,-10144,773994296,
78426339289,774098818,749934911,774088599,-10219,,
78426839290,774598820,750434912,774588285,-10535,,
78427268917,775028446,750864539,775017911,-10535,775018134,
78427339292,775098821,750934914,775088317,-10504,,
78427839294,775598823,751434916,775588513,-10310,,
78428288247,776047777,751883870,776037468,-10309,776035316,
78428339295,776098824,751934916,776088292,-10532,,
78428839296,776598826,752434918,776586367,-12459,,
78429312795,777072324,752908417,777059865,-12459,777062327,
78429339298,777098827,752934919,777086497,-12330,,
78429839299,777598828,753434921,777588833,-9995,,
78430334932,778094462,753930554,778084468,-9994,778083523,
78430339301,778098830,753934923,778088825,-10005,,
78430839302,778598831,754434924,778587895,-10936,,
78431355574,779115104,754951197,779104169,-10935,779103388,
78431355584,779115114,754951207,779104177,-10937,,
78431855585,779615114,755451207,779603400,-11714,,
78432355586,780115115,755951208,780103401,-11714,,
78432379068,780138598,755974690,780126884,-11714,780128320,
78432855588,780615118,756451210,780604774,-10344,,
78433355590,781115119,756951211,781104844,-10275,,
78433403105,781162635,756998728,781152361,-10274,781152268,
78433855591,781615120,757451213,781604765,-10355,,
78434355592,782115121,757951214,782104757,-10364,,
78434422592,782182122,758018215,782171759,-10363,782169835,
78434855593,782615122,758451215,782603095,-12027,,
78435355594,783115123,758951216,783102839,-12284,,
78435446606,783206136,759042228,783193852,-12284,783195899,
78435855595,783615125,759451217,783604517,-10608,,
78436355596,784115126,759951218,784104891,-10235,,
78436466719,784226249,760062342,784216015,-10234,784214274,
78436855598,784615127,760451220,784603542,-11585,,
78437355600,785115129,760951222,785103157,-11972,,
78437490184,785249714,761085806,785237741,-11973,785239052,
78437855602,785615132,761451224,785604118,-11014,,
78438355604,786115133,761951226,786104475,-10658,,
78438514276,786273805,762109898,786263147,-10658,786263738,
78438855605,786615134,762451227,786604880,-10254,,
78439355607,787115136,762951229,787105071,-10065,,
78439533442,787292972,763129065,787282908,-10064,787280358,
78439855608,787615137,763451229,787603431,-11706,,
78440355609,788115138,763951230,788102527,-12611,,
78440552597,788312126,764148220,788299516,-12610,788299569,
78440855610,788615140,764451232,788602562,-12578,,
78441355611,789115140,764951233,789102586,-12554,,
78441572501,789332031,765168124,789319477,-12554,789319569,
78441855613,789615142,765451235,789602641,-12501,,
78442355614,790115144,765951237,790102685,-12459,,
78442595937,790355466,766191559,790343008,-12458,790345019,
78442855616,790615145,766451238,790603732,-11413,,
78443355617,791115147,766951239,791104703,-10444,,
78443619388,791378918,767215010,791368474,-10444,791368467,
78443855619,791615148,767451240,791604701,-10447,,
78444355620,792115149,767951242,792104701,-10448,,
78444643001,792402530,768238623,792392083,-10447,792392147,
78444855622,792615151,768451244,792604730,-10421,,
78445355623,793115152,768951245,793104772,-10380,,
78445666934,793426464,769262557,793416084,-10380,793416190,
78445855625,793615155,769451247,793604813,-10342,,
78446355626,794115155,769951248,794104884,-10271,,
78446687881,794447411,770283504,794437140,-10271,794435201,
78446855627,794615156,770451249,794604235,-10921,,
78447355628,795115158,770951250,795102951,-12207,,
78447707025,795466555,771302647,795454348,-12207,795453910,
78447855630,795615159,771451252,795602821,-12338,,
78448355631,796115160,771951253,796102518,-12642,,
78448726337,796485867,772321959,796473225,-12642,796473113,
78448855633,796615162,772451254,796602491,-12671,,
78449355635,797115164,772951257,797102412,-12752,,
78449745470,797505000,773341092,797492248,-12752,797492250,
78449855637,797615166,773451258,797602413,-12753,,
78450355639,798115168,773951261,798102421,-12747,,
78450764623,798524153,774360246,798511407,-12746,798511361,
78450855640,798615169,774451261,798602414,-12755,,
78451355641,799115170,774951262,799102381,-12789,,
78451783920,799543449,775379543,799530662,-12787,799530558,
78451855643,799615172,775451265,799602367,-12805,,
78452355644,800115173,775951266,800102284,-12889,,
78452807809,800567339,776403432,800554451,-12888,800556742,
78452855645,800615174,776451267,800602502,-12672,,
78453355646,801115176,776951268,801104581,-10595,,
78453826833,801586362,777422456,801575768,-10594,801573579,
78453855647,801615177,777451270,801604454,-10723,,
78454355648,802115177,777951269,802102396,-12781,,
78454846132,802605662,778441755,802592882,-12780,802592828,
78454855649,802615179,778451271,802602395,-12784,,
78455355651,803115180,778951273,803102348,-12832,,
78455865182,803624711,779460805,803611880,-12831,803611856,
78455865191,803624721,779460814,803611887,-12834,,
78456365192,804124721,779960814,804111869,-12852,,
78456888214,804647744,780483836,804634891,-12853,804636987,
78456888223,804647753,780483845,804634899,-12854,,
78457388224,805147753,780983846,805136999,-10754,,
78457909122,805668651,781504744,805657897,-10754,805656296,
78457909129,805668658,781504751,805657904,-10754,,
78458409130,806168659,782004752,806156306,-12353,,
78458932601,806692131,782528224,806679779,-12352,806681348,
78458932610,806692140,782528233,806679785,-12355,,
78459432611,807192140,783028233,807181359,-10781,,
78459932612,807692141,783528233,807681360,-10781,,
78459951882,807711411,783547504,807700631,-10780,807698355,
78460432614,808192143,784028236,808179177,-12966,,
78460932617,808692146,784528238,808679092,-13054,,
78460971796,808731326,784567419,808718273,-13053,808718658,
78461432618,809192147,785028239,809179450,-12697,,
78461932619,809692148,785528241,809679482,-12666,,
78461995114,809754644,785590737,809741979,-12665,809743754,
78462432621,810192150,786028243,810181041,-11109,,
78462932623,810692152,786528245,810681265,-10887,,
78463014928,810774458,786610550,810763571,-10887,810761692,
78463432625,811192154,787028246,811179699,-12455,,
78463932627,811692156,787528249,811679393,-12763,,
78464037790,811797319,787633412,811784557,-12762,811786272,
78464432628,812192158,788028250,812180750,-11408,,
78464932630,812692159,788528251,812681114,-11045,,
78465061247,812820776,788656869,812809732,-11044,812809901,
78465432631,813192160,789028253,813181242,-10918,,
78465932633,813692162,789528255,813681289,-10873,,
78466084699,813844229,789680322,813833357,-10872,813833345,
78466432634,814192164,790028256,814181285,-10879,,
78466932635,814692164,790528256,814681283,-10881,,
78467109825,814869355,790705447,814858474,-10881,814857679,
78467432636,815192165,791028257,815180772,-11393,,
78467932637,815692166,791528259,815680493,-11673,,
78468133542,815893072,791729165,815881400,-11672,815882185,
78468432638,816192167,792028260,816180966,-11201,,
78468932639,816692169,792528261,816681284,-10885,,
78469156981,816916511,792752604,816905628,-10883,816905574,
78469432641,817192170,793028263,817181258,-10912,,
78469932642,817692171,793528263,817681237,-10934,,
78470176946,817936476,793772569,817925543,-10933,817923686,
78470432644,818192173,794028266,818180291,-11882,,
78470932645,818692175,794528267,818679388,-12787,,
78471196410,818955941,794792035,818943157,-12784,818942766,
78471432647,819192176,795028269,819179206,-12970,,
78471932649,819692178,795528270,819679008,-13170,,
78472220196,819979726,795815819,819966557,-13169,819968453,
78472432650,820192180,796028272,820179816,-12364,,
78472932651,820692180,796528273,820680910,-11270,,
78473243654,821003183,796839276,820991914,-11269,820992062,
78473432652,821192182,797028274,821180968,-11214,,
78473932654,821692183,797528276,821681064,-11119,,
78474262851,822022381,797858474,822011263,-11118,822009263,
78474432656,822192185,798028278,822180386,-11799,,
78474932658,822692188,798528280,822679072,-13116,,
78475286427,823045956,798882050,823032842,-13114,823035005,
78475432659,823192188,799028281,823179705,-12483,,
78475932660,823692189,799528281,823681240,-10949,,
78476312240,824071770,799907863,824060822,-10948,824059817,
78476432662,824192191,800028284,824181000,-11191,,
78476932664,824692193,800528286,824680243,-11950,,
78477335821,825095351,800931444,825083402,-11949,825084232,
78477432666,825192196,801028289,825180405,-11791,,
78477932667,825692197,801528289,825681088,-11109,,
78478359312,826118842,801954935,826107726,-11116,826107792,
78478432668,826192197,802028290,826181089,-11108,,
78478932669,826692198,802528291,826681151,-11047,,
78479382836,827142365,802978458,827131318,-11047,827131238,
78479432672,827192202,803028294,827181147,-11055,,
78479932673,827692202,803528295,827681077,-11125,,
78480402375,828161905,803997998,828150780,-11125,828148644,
78480432675,828192204,804028297,828180947,-11257,,
78480932676,828692205,804528297,828678947,-13258,,
78481421503,829181033,805017126,829167776,-13257,829167785,
78481432677,829192206,805028299,829178946,-13260,,
78481932678,829692207,805528300,829678962,-13245,,
78482446199,830205729,806041822,830192484,-13245,830193860,
78482446208,830205738,806041831,830192491,-13247,,
78482946209,830705738,806541830,830693872,-11866,,
78483470130,831229660,807065752,831217794,-11866,831218591,
78483470137,831229667,807065759,831217800,-11867,,
78483970139,831729668,807565760,831718602,-11066,,
78484496847,832256378,808092472,832245314,-11064,832246655,
78484496865,832256396,808092490,832245331,-11065,,
78484996866,832756396,808592488,832746677,-9719,,
78485520210,833279740,809115832,833270022,-9718,833268432,
78485520217,833279746,809115839,833270028,-9718,,
78486020219,833779748,809615840,833768443,-11305,,
78486543875,834303405,810139498,834292100,-11305,834292182,
78486543882,834303412,810139505,834292105,-11307,,
78487043883,834803412,810639504,834792191,-11221,,
78487543884,835303413,811139505,835292192,-11221,,
78487567222,835326752,811162845,835315532,-11220,835315506,
78488043885,835803414,811639507,835792172,-11242,,
78488543886,836303415,812139508,836292171,-11244,,
78488591342,836350872,812186965,836339628,-11244,836339342,
78489043887,836803416,812639508,836791914,-11502,,
78489543889,837303418,813139511,837291890,-11528,,
78489611909,837371439,813207532,837359912,-11527,837358539,
78490043891,837803421,813639513,837790709,-12712,,
78490543892,838303422,814139514,838290524,-12898,,
78490635801,838395331,814231423,838382434,-12897,838384309,
78491043894,838803423,814639515,838792058,-11365,,
78491543895,839303425,815139517,839292405,-11020,,
78491654911,839414441,815250534,839403422,-11019,839401032,
78492043903,839803432,815639525,839790554,-12878,,
78492543905,840303435,816139527,840290028,-13407,,
78492674194,840433724,816269817,840420317,-13407,840420164,
78493043907,840803437,816639529,840789917,-13520,,
78493543908,841303438,817139530,841289880,-13558,,
78493697828,841457357,817293450,841443801,-13556,841446119,
78494043909,841803438,817639531,841791487,-11951,,
78494543910,842303440,818139532,842292203,-11237,,
78494717160,842476690,818312783,842465454,-11236,842463075,
78495043911,842803441,818639533,842790651,-12790,,
78495543913,843303443,819139535,843289830,-13613,,
78495736399,843495929,819332022,843482317,-13612,843482361,
78496043915,843803444,819639536,843789859,-13585,,
78496543916,844303445,820139538,844289879,-13566,,
78496760131,844519660,820355753,844506095,-13565,844508435,
78497043917,844803446,820639538,844791209,-12237,,
78497543918,845303448,821139540,845292225,-11223,,
78497779249,845538779,821374871,845527556,-11223,845525173,
78498043919,845803449,821639541,845790965,-12484,,
78498543920,846303450,822139542,846289846,-13604,,
78498802858,846562388,822398480,846548784,-13604,846550984,
78499043921,846803451,822639543,846790907,-12544,,
78499543922,847303451,823139544,847292050,-11401,,
78499822200,847581730,823417823,847570329,-11401,847568109,
78500043923,847803453,823639545,847791068,-12385,,
78500543924,848303454,824139546,848289835,-13619,,
78500841857,848601386,824437479,848587769,-13617,848587680,
78501043926,848803455,824639547,848789801,-13654,,
78501543927,849303456,825139548,849289752,-13704,,
78501860961,849620491,825456584,849606788,-13703,849606851,
78502043928,849803458,825639550,849789778,-13680,,
78502543929,850303458,826139551,850289821,-13637,,
78502880146,850639675,826475768,850626039,-13636,850625978,
78503043931,850803460,826639552,850789803,-13657,,
78503543932,851303461,827139554,851289766,-13695,,
78503899406,851658935,827495028,851645241,-13694,851645311,
78504043933,851803463,827639555,851789788,-13675,,
78504543934,852303464,828139556,852289842,-13622,,
78504918944,852678474,828514567,852664853,-13621,852665004,
78505043936,852803465,828639558,852789880,-13585,,
78505543937,853303466,829139559,853289998,-13468,,
78505938447,853697977,829534069,853684509,-13468,853684122,
78506043939,853803468,829639561,853789917,-13551,,
78506543940,854303470,830139562,854289617,-13853,,
78506961834,854721363,830557456,854707511,-13852,854709801,
78507043941,854803470,830639563,854789994,-13476,,
78507543943,855303472,831139564,855291912,-11560,,
78507985370,855744899,831580992,855733340,-11559,855733309,
78508043945,855803474,831639566,855791909,-11565,,
78508543946,856303475,832139568,856291888,-11587,,
78509004523,856764053,832600145,856752465,-11588,856750293,
78509043947,856803476,832639569,856791716,-11760,,
78509543948,857303477,833139570,857289719,-13758,,
78510024765,857784294,833620387,857770536,-13758,857770904,
78510043950,857803480,833639572,857789735,-13745,,
78510543952,858303482,834139574,858290093,-13389,,
78511043848,858803377,834639470,858789990,-13387,858789634,
78511043998,858803528,834639620,858790138,-13390,,
78511543999,859303528,835139621,859289788,-13740,,
78512064948,859824478,835660571,859810738,-13740,859811682,
78512064958,859824487,835660580,859810746,-13741,,
78512564959,860324488,836160581,860311695,-12793,,
78513088664,860848194,836684287,860835402,-12792,860836560,
78513088673,860848203,836684296,860835410,-12793,,
78513588675,861348204,837184297,861336573,-11631,,
78514112283,861871813,837707906,861860183,-11630,861860210,
78514112293,861871822,837707915,861860191,-11631,,
78514612294,862371824,838207916,862360224,-11600,,
78515135866,862895396,838731489,862883796,-11600,862883772,
78515136007,862895537,838731629,862883935,-11602,,
78515636008,863395537,839231630,863383916,-11621,,
78516159602,863919132,839755225,863907512,-11620,863907527,
78516159611,863919141,839755233,863907518,-11623,,
78516659613,864419142,840255234,864407540,-11602,,
78517183325,864942855,840778948,864931254,-11601,864931288,
78517183334,864942864,840778957,864931261,-11603,,
78517683336,865442865,841278958,865431301,-11564,,
78518207328,865966858,841802951,865955294,-11564,865955428,
78518207371,865966901,841802994,865955335,-11566,,
78518707373,866466903,842302995,866455475,-11428,,
78519233855,866993385,842829478,866981958,-11427,866980092,
78519233864,866993394,842829487,866981965,-11429,,
78519733866,867493395,843329488,867480105,-13290,,
78520256362,868015892,843851985,868002603,-13289,868003646,
78520256371,868015901,843851994,868002611,-13290,,
78520756373,868515903,844351995,868503660,-12243,,
78521279695,869039225,844875318,869026982,-12243,869027392,
78521279834,869039363,844875456,869027119,-12244,,
78521779836,869539365,845375457,869527535,-11830,,
78522299072,870058602,845894695,870046773,-11829,870044554,
78522299082,870058611,845894704,870046780,-11831,,
78522799084,870558614,846394706,870544568,-14046,,
78523318184,871077713,846913806,871063668,-14045,871063668,
78523318193,871077723,846913815,871063675,-14048,,
78523818195,871577724,847413817,871563681,-14043,,
78524337674,872097203,847933296,872083160,-14043,872083002,
78524337681,872097210,847933303,872083166,-14044,,
78524837683,872597212,848433304,872583013,-14199,,
78525356909,873116439,848952531,873102240,-14199,873102433,
78525356916,873116446,848952538,873102246,-14200,,
78525856917,873616446,849452539,873602443,-14003,,
78526380285,874139814,849975907,874125812,-14002,874128000,
78526380292,874139821,849975914,874125818,-14003,,
78526880293,874639823,850475915,874628011,-11812,,
78527404059,875163588,850999682,875151777,-11811,875151512,
78527404068,875163597,850999690,875151784,-11813,,
78527904069,875663598,851499690,875651524,-12074,,
78528425112,876184642,852020735,876172568,-12074,876171560,
78528425119,876184649,852020742,876172574,-12075,,
78528925120,876684649,852520742,876671569,-13080,,
78529449137,877208667,853044759,877195587,-13080,877197004,
78529449146,877208676,853044768,877195595,-13081,,
78529949147,877708677,853544769,877697016,-11661,,
78530478346,878237876,854073969,878226217,-11659,878219237,
78530478356,878237885,854073978,878226225,-11660,,
78530978357,878737886,854573979,878719250,-18636,,
78531499285,879258815,855094908,879240180,-18635,879245673,
78531499294,879258824,855094917,879240186,-18638,,
78531999295,879758824,855594917,879745685,-13139,,
78532522924,880282454,856118547,880269316,-13138,880270428,
78532522934,880282463,856118556,880269322,-13141,,
78533022936,880782465,856618558,880770442,-12023,,
78533546451,881305981,857142074,881293959,-12022,881294068,
78533546460,881305990,857142083,881293967,-12023,,
78534046461,881805990,857642083,881794080,-11910,,
78534569894,882329424,858165517,882317515,-11909,882317452,
78534569903,882329433,858165526,882317522,-11911,,
78535069905,882829434,858665527,882817465,-11969,,
78535593245,883352775,859188868,883340807,-11968,883340654,
78535593255,883352785,859188877,883340815,-11970,,
78536093257,883852786,859688879,883840667,-12119,,
78536616568,884376098,860212190,884363979,-12119,884364082,
78536616577,884376107,860212200,884363986,-12121,,
78537116578,884876107,860712200,884864094,-12013,,
78537640080,885399610,861235703,885387598,-12012,885387527,
78537640124,885399653,861235746,885387639,-12014,,
78538140126,885899655,861735748,885887574,-12081,,
78538659200,886418729,862254822,886406649,-12080,886404451,
78538659209,886418738,862254831,886406657,-12081,,
78539159210,886918739,862754832,886904464,-14275,,
78539679373,887438903,863274995,887424628,-14275,887424916,
78539679380,887438909,863275002,887424634,-14275,,
78540179381,887938910,863775003,887924926,-13984,,
78540702590,888462120,864298213,888448136,-13984,888449977,
78540702728,888462258,864298351,888448275,-13983,,
78541202729,888962258,864798351,888950119,-12139,,
78541721879,889481409,865317502,889469270,-12139,889467121,
78541721888,889481418,865317511,889469277,-12141,,
78542221889,889981418,865817511,889967133,-14285,,
78542741130,890500660,866336753,890486376,-14284,890486322,
78542741140,890500670,866336762,890486384,-14286,,
78543241142,891000671,866836764,890986337,-14334,,
78543764554,891524084,867360177,891509750,-14334,891511918,
78543764563,891524093,867360186,891509758,-14335,,
78544264565,892024094,867860187,892011931,-12163,,
78544788005,892547535,868383628,892535373,-12162,892535341,
78544788014,892547544,868383637,892535381,-12163,,
78545288015,893047544,868883637,893035353,-12191,,
78545788016,893547545,869383637,893535354,-12191,,
78545807972,893567502,869403595,893555311,-12191,893553348,
78546288017,894047547,869883639,894033473,-14074,,
78546788018,894547548,870383640,894533395,-14153,,
78546831558,894591087,870427180,894576936,-14151,894578992,
78547288020,895047549,870883642,895035277,-12272,,
78547788022,895547551,871383644,895535458,-12093,,
78547854809,895614338,871450432,895602246,-12092,895602009,
78548288023,896047553,871883645,896035257,-12296,,
78548788025,896547554,872383647,896535227,-12327,,
78548878474,896638004,872474097,896625678,-12326,896625664,
78549288026,897047555,872883648,897035220,-12335,,
78549788028,897547558,873383650,897535221,-12337,,
78549902191,897661720,873497813,897649384,-12336,897649619,
78550288029,898047559,873883651,898035405,-12154,,
78550788031,898547560,874383653,898535461,-12099,,
78550925526,898685056,874521149,898672957,-12099,898672722,
78551288033,899047563,874883655,899035294,-12269,,
78551788034,899547563,875383656,899535231,-12332,,
78551944652,899704182,875540274,899691850,-12332,899689733,
78552288035,900047564,875883657,900033780,-13784,,
78552788036,900547566,876383658,900533120,-14446,,
78552976150,900735680,876571772,900721234,-14446,900727277,
78553288038,901047567,876883660,901036892,-10675,,
78553788040,901547569,877383662,901539169,-8400,,
78553995159,901754689,877590782,901746290,-8399,901740201,
78554288041,902047570,877883662,902035605,-11965,,
78554788042,902547572,878383664,902533086,-14486,,
78555014337,902773867,878609960,902759381,-14486,902759355,
78555288044,903047573,878883666,903033074,-14499,,
78555788045,903547575,879383667,903533065,-14510,,
78556037875,903797405,879633498,903782896,-14509,903785083,
78556288047,904047576,879883668,904034162,-13414,,
78556788049,904547578,880383670,904535259,-12319,,
78557057196,904816726,880652818,904804407,-12319,904802375,
78557288050,905047579,880883671,905034323,-13256,,
78557788051,905547580,881383672,905533232,-14348,,
78558096753,905856283,881692376,905841936,-14347,905851984,
78558288052,906047582,881883674,906037079,-10503,,
78558788054,906547583,882383676,906543287,-4296,,
78559115742,906875272,882711365,906870976,-4296,906860727,
78559288056,907047586,882883678,907039757,-7829,,
78559788058,907547587,883383679,907533044,-14543,,
78560134976,907894506,883730599,907879964,-14542,907879908,
78560288060,908047589,883883682,908033030,-14559,,
78560788062,908547591,884383684,908532997,-14594,,
78561159194,908918723,884754816,908904129,-14594,908906191,
78561288064,909047593,884883685,909033529,-14064,,
78561788065,909547594,885383686,909535064,-12530,,
78562182574,909942105,885778197,909929575,-12530,909929620,
78562288066,910047595,885883687,910035073,-12522,,
78562788067,910547596,886383688,910535114,-12482,,
78563201836,910961366,886797459,910948885,-12481,910946662,
78563288068,911047598,886883690,911034733,-12865,,
78563788070,911547600,887383692,911532899,-14701,,
78564221328,911980857,887816950,911966157,-14700,911966069,
78564288072,912047602,887883694,912032888,-14714,,
78564788073,912547603,888383695,912532816,-14787,,
78565244532,913004062,888840154,912989276,-14786,912991491,
78565288074,913047604,888883696,913033010,-14594,,
78565788075,913547604,889383697,913535036,-12568,,
78566263493,914023022,889859115,914010455,-12567,914008364,
78566288077,914047606,889883698,914034934,-12672,,
78566788078,914547608,890383701,914532952,-14656,,
78567282748,915042278,890878371,915027623,-14655,915027499,
78567288080,915047610,890883702,915032952,-14658,,
78567788081,915547610,891383703,915532834,-14776,,
78568306183,916065713,891901806,916050938,-14775,916053142,
78568306192,916065722,891901815,916050945,-14777,,
78568806193,916565723,892401815,916553153,-12570,,
78569325419,917084949,892921042,917072380,-12569,917070055,
78569325428,917084958,892921050,917072387,-12571,,
78569825429,917584959,893421051,917570068,-14891,,
78570325430,918084959,893921052,918070068,-14891,,
78570346585,918106115,893942208,918091225,-14890,918092362,
78570825431,918584960,894421052,918571162,-13798,,
78571325433,919084962,894921055,919071212,-13750,,
78571365726,919125256,894961348,919111506,-13750,919110530,
78571825434,919584963,895421056,919570318,-14645,,
78572325444,920084973,895921066,920070250,-14723,,
78572385063,920144592,895980685,920129870,-14722,920129668,
78572825445,920584975,896421067,920570076,-14899,,
78573325446,921084975,896921068,921070053,-14922,,
78573404258,921163788,896999881,921148867,-14921,921148911,
78573825447,921584976,897421068,921570094,-14882,,
78574325448,922084977,897921069,922070103,-14874,,
78574423583,922183113,898019206,922168240,-14873,922168245,
78574825449,922584979,898421071,922570111,-14868,,
78575325450,923084979,898921071,923070113,-14866,,
78575447519,923207048,899043141,923192182,-14866,923194418,
78575825451,923584980,899421073,923571806,-13174,,
78576325452,924084981,899921074,924072353,-12628,,
78576470912,924230442,900066535,924217815,-12627,924217759,
78576825453,924584983,900421075,924572317,-12666,,
78577325454,925084983,900921076,925072303,-12680,,
78577489991,925249521,901085614,925236842,-12679,925234641,
78577825456,925584985,901421078,925570832,-14153,,
78578325457,926084987,901921079,926070110,-14877,,
78578513513,926273043,902109136,926258167,-14876,926260198,
78578825459,926584988,902421080,926571381,-13607,,
78579325460,927084989,902921081,927072147,-12842,,
78579537228,927296758,903132851,927283917,-12841,927284162,
78579825461,927584990,903421083,927572292,-12698,,
78580325463,928084993,903921085,928072399,-12594,,
78580557257,928316787,904152880,928304195,-12592,928301472,
78580825464,928584994,904421086,928570941,-14053,,
78581325466,929084995,904921088,929069683,-15312,,
78581580415,929339945,905176038,929324633,-15312,929327142,
78581825468,929584997,905421090,929570916,-14081,,
78582325469,930084998,905921090,930072197,-12801,,
78582603886,930363416,906199509,930350616,-12800,930350574,
78582825471,930585000,906421093,930572182,-12818,,
78583325473,931085002,906921095,931072163,-12839,,
78583627432,931386962,907223055,931374124,-12838,931374168,
78583825475,931585004,907421096,931572183,-12821,,
78584325476,932085005,907921098,932072214,-12791,,
78584650654,932410184,908246277,932397393,-12791,932397317,
78584825477,932585006,908421098,932572188,-12818,,
78585325478,933085007,908921100,933072144,-12863,,
78585674462,933433992,909270085,933421129,-12863,933421169,
78585825480,933585009,909421102,933572158,-12851,,
78586325482,934085011,909921104,934072191,-12820,,
78586696626,934456157,910292250,934443338,-12819,934442128,
78586825483,934585012,910421105,934571879,-13133,,
78587325485,935085015,910921107,935070990,-14025,,
78587720611,935480141,911316234,935466116,-14025,935467052,
78587825486,935585015,911421108,935571185,-13830,,
78588325488,936085017,911921110,936071930,-13087,,
78588744601,936504131,912340224,936491044,-13087,936491511,
78588825489,936585018,912421111,936572006,-13012,,
78589325490,937085019,912921112,937072403,-12616,,
78589768540,937528069,913364162,937515453,-12616,937515185,
78589825491,937585020,913421113,937572372,-12648,,
78590325492,938085021,913921113,938072139,-12882,,
78590790437,938549967,914386060,938537086,-12881,938536012,
78590825493,938585022,914421115,938572064,-12958,,
78591325494,939085024,914921116,939071072,-13952,,
78591809668,939569198,915405291,939555247,-13951,939554070,
78591825495,939585026,915421119,939571038,-13988,,
78592325496,940085025,915921118,940069900,-15125,,
78592833249,940592779,916428872,940577655,-15124,940579834,
78592833258,940592788,916428881,940577663,-15125,,
78593333260,941092789,916928882,941079848,-12941,,
78593854104,941613633,917449726,941600692,-12941,941599429,
78593854111,941613640,917449733,941600698,-12942,,
78594354113,942113642,917949735,942099440,-14202,,
78594873236,942632765,918468858,942618564,-14201,942617602,
78594873243,942632772,918468865,942618570,-14202,,
78595373245,943132774,918968867,943117614,-15160,,
78595896805,943656335,919492427,943641174,-15161,943643397,
78595896814,943656344,919492436,943641181,-15163,,
78596396817,944156346,919992438,944143411,-12935,,
78596920518,944680048,920516141,944667114,-12934,944667214,
78596920528,944680057,920516150,944667121,-12936,,
78597420530,945180059,921016152,945167228,-12831,,
78597943583,945703113,921539205,945690282,-12831,945689959,
78597943592,945703122,921539214,945690290,-12832,,
78598443594,946203123,922039215,946189972,-13151,,
78598967128,946726657,922562750,946713507,-13150,946713575,
78598967137,946726666,922562759,946713514,-13152,,
78599467138,947226667,923062760,947213587,-13080,,
78599990544,947750073,923586166,947736994,-13079,947737083,
78599990553,947750083,923586175,947737002,-13081,,
78600490555,948250084,924086177,948237097,-12987,,
78601014395,948773925,924610018,948760937,-12988,948760969,
78601014402,948773932,924610025,948760943,-12989,,
78601514403,949273933,925110025,949260979,-12954,,
78602037790,949797320,925633413,949784367,-12953,949784189,
78602037799,949797329,925633422,949784374,-12955,,
78602537801,950297330,926133423,950284201,-13129,,
78603058823,950818352,926654445,950805224,-13128,950803918,
78603058830,950818360,926654452,950805230,-13130,,
78603558831,951318361,927154453,951303928,-14433,,
78604082356,951841886,927677979,951827456,-14430,951828746,
78604082369,951841899,927677992,951827465,-14434,,
78604582371,952341901,928177993,952328763,-13138,,
78605106363,952865893,928701986,952852757,-13136,952852913,
78605106375,952865905,928701998,952852767,-13138,,
78605606376,953365906,929201998,953352930,-12976,,
78606129782,953889312,929725405,953876336,-12976,953876099,
78606129791,953889320,929725413,953876343,-12977,,
78606629792,954389322,930225414,954376112,-13210,,
78607148906,954908436,930744529,954895227,-13209,954893049,
78607148916,954908445,930744538,954895235,-13210,,
78607648918,955408447,931244540,955393063,-15384,,
78608171761,955931290,931767383,955915907,-15383,955917759,
78608171897,955931427,931767520,955916043,-15384,,
78608671898,956431427,932267520,956417898,-13529,,
78609190977,956950507,932786600,956936979,-13528,956935090,
78609190986,956950516,932786609,956936987,-13529,,
78609690988,957450517,933286610,957435103,-15414,,
78610214389,957973918,933810012,957958505,-15413,957960648,
78610214398,957973928,933810021,957958513,-15415,,
78610714399,958473928,934310020,958460660,-13268,,
78611233442,958992972,934829064,958979704,-13268,958977503,
78611233578,958993107,934829200,958979837,-13270,,
78611733579,959493108,935329201,959477643,-15465,,
78612252737,960012266,935848359,959996801,-15465,959996788,
78612252746,960012275,935848369,959996809,-15466,,
78612752747,960512277,936348369,960496800,-15477,,
78613271862,961031391,936867484,961015917,-15474,961015952,
78613271871,961031401,936867494,961015924,-15477,,
78613771872,961531401,937367494,961515964,-15437,,
78614291246,962050776,937886870,962035340,-15436,962035195,
78614291256,962050786,937886879,962035347,-15439,,
78614791257,962550786,938386879,962535207,-15579,,
78615291258,963050787,938886880,963035209,-15578,,
78615471922,963231453,939067547,963215877,-15576,963158854,
78615791259,963550788,939386881,963498793,-51995,,
78616291260,964050789,939886882,963978195,-72594,,
78616496181,964255711,940091804,964183118,-72593,964241950,
78616791262,964550791,940386884,964512919,-37872,,
78617291264,965050793,940886886,965037035,-13758,,
78617516725,965276255,941112348,965262498,-13757,965261502,
78617791266,965550795,941386887,965536491,-14304,,
78618291267,966050796,941886889,966036045,-14751,,
78618540463,966299993,942136085,966285242,-14751,966286712,
78618791268,966550798,942386890,966536786,-14012,,
78619291269,967050798,942886891,967037520,-13278,,
78619563559,967323088,943159182,967309812,-13276,967309476,
78619791271,967550800,943386893,967537371,-13429,,
78620291272,968050802,943886894,968037192,-13610,,
78620586945,968346475,944182568,968332866,-13609,968333060,
78620791273,968550802,944386894,968537272,-13530,,
78621291275,969050804,944886897,969037392,-13412,,
78621610454,969369984,945206077,969356573,-13411,969356560,
78621791277,969550806,945386899,969537389,-13417,,
78622291279,970050808,945886900,970037386,-13422,,
78622634265,970393794,946229887,970380373,-13421,970380383,
78622791281,970550810,946386903,970537391,-13419,,
78623291282,971050811,946886904,971037402,-13409,,
78623658145,971417675,947253768,971404267,-13408,971404427,
78623791283,971550813,947386905,971537446,-13367,,
78624291284,972050814,947886906,972037568,-13246,,
78624684581,972444111,948280204,972430866,-13245,972432018,
78624791286,972550816,948386908,972537815,-13001,,
78625291288,973050817,948886910,973038727,-12090,,
78625707994,973467524,949303617,973455434,-12090,973454041,
78625791289,973550819,949386911,973538495,-12324,,
78626291291,974050820,949886913,974037339,-13481,,
78626728461,974487990,950324083,974474510,-13480,974472999,
78626791292,974550821,950386914,974537150,-13671,,
78627291294,975050823,950886916,975035834,-14989,,
78627751703,975511233,951347326,975496245,-14988,975497668,
78627791295,975550824,951386917,975535946,-14878,,
78628291296,976050825,951886918,976037263,-13562,,
78628775342,976534872,952370966,976521311,-13561,976521481,
78628791297,976550827,952386919,976537267,-13560,,
78629291298,977050827,952886920,977037438,-13389,,
78629794460,977553990,953390083,977540602,-13388,977538253,
78629794470,977554000,953390093,977540609,-13391,,
78630294472,978054001,953890094,978038266,-15735,,
78630819217,978578747,954414840,978563012,-15735,978560228,
78630819226,978578756,954414849,978563019,-15737,,
78631319227,979078757,954914849,979060241,-18516,,
78631838342,979597872,955433965,979579356,-18516,979582128,
78631838351,979597881,955433974,979579364,-18517,,
78632338352,980097881,955933974,980082140,-15741,,
78632857464,980616994,956453087,980601253,-15741,980601255,
78632857473,980617002,956453095,980601261,-15741,,
78633357474,981117003,956953096,981101267,-15736,,
78633878776,981638306,957474399,981622571,-15735,981623462,
78633878913,981638443,957474535,981622706,-15737,,
78634378915,982138444,957974537,982123603,-14841,,
78634898355,982657885,958493978,982643045,-14840,982641883,
78634898364,982657894,958493987,982643052,-14842,,
78635398365,983157894,958993987,983141895,-15999,,
78635917548,983677078,959513171,983661080,-15998,983661314,
78635917557,983677087,959513180,983661088,-15999,,
78636417559,984177088,960013180,984161327,-15761,,
78636936662,984696192,960532285,984680432,-15760,984680324,
78636936712,984696242,960532334,984680480,-15762,,
78637436713,985196242,961032335,985180377,-15865,,
78637956092,985715622,961551714,985699757,-15865,985699707,
78637956101,985715631,961551723,985699764,-15867,,
78638456103,986215632,962051725,986199721,-15911,,
78638979446,986738976,962575068,986723064,-15912,986725184,
78638979455,986738984,962575077,986723071,-15913,,
78639479456,987238986,963075078,987225196,-13790,,
78639998585,987758115,963594208,987744326,-13789,987742200,
78639998592,987758122,963594214,987744331,-13791,,
78640498593,988258122,964094215,988242209,-15913,,
78641017606,988777136,964613228,988761223,-15913,988761293,
78641017615,988777145,964613237,988761231,-15914,,
78641517617,989277146,965113238,989261306,-15840,,
78642038447,989797977,965634069,989782137,-15840,989782826,
78642038454,989797984,965634076,989782143,-15841,,
78642538455,990297985,966134077,990282837,-15148,,
78643038456,990797985,966634078,990782837,-15148,,
78643065294,990824825,966660919,990809680,-15145,990812435,
78643538457,991297987,967134079,991285454,-12533,,
78644038458,991797988,967634080,991785603,-12385,,
78644089093,991848622,967684716,991836238,-12384,991834798,
78644538459,992297988,968134081,992284311,-13677,,
78645038460,992797989,968634082,992784167,-13822,,
78645115457,992874986,968711079,992861164,-13822,992855353,
78645538461,993297990,969134083,993279253,-18737,,
78646038463,993797992,969634085,993778361,-19631,,
78646138933,993898462,969734555,993878832,-19630,993884648,
78646538465,994297994,970134087,994283013,-14981,,
78647038466,994797995,970634088,994784183,-13812,,
78647162444,994921974,970758067,994908163,-13811,994908221,
78647538468,995297997,971134089,995284231,-13766,,
78648038470,995797999,971634092,995784249,-13750,,
78648186652,995946181,971782274,995932432,-13749,995932628,
78648538471,996298000,972134093,996284390,-13610,,
78649038472,996798001,972634094,996784450,-13551,,
78649210421,996969951,972806044,996956400,-13551,996956137,
78649538473,997298002,973134095,997284280,-13722,,
78650038474,997798003,973634095,997784191,-13812,,
78650234205,997993735,973829828,997979923,-13812,997979689,
78650538475,998298005,974134097,998284052,-13953,,
78651038477,998798006,974634099,998783963,-14043,,
78651257829,999017359,974853452,999003317,-14042,999003426,
78651538478,999298008,975134100,999284027,-13981,,
78652038479,999798008,975634100,999784078,-13930,,
78652281630,1000041160,975877252,1000027230,-13930,1000027126,
78652538481,1000298010,976134103,1000284027,-13983,,
78653038483,1000798012,976634104,1000783981,-14031,,
78653305461,1001064991,976901083,1001050960,-14031,1001051093,
78653538484,1001298013,977134106,1001284045,-13968,,
78654038485,1001798014,977634106,1001784119,-13895,,
78654329008,1002088538,977924631,1002074643,-13895,1002074546,
78654538487,1002298016,978134109,1002284081,-13935,,
78655038488,1002798017,978634109,1002784028,-13989,,
78655348206,1003107736,978943829,1003093747,-13989,1003091571,
78655538490,1003298019,979134112,1003283202,-14817,,
78656038492,1003798021,979634113,1003781859,-16162,,
78656372036,1004131566,979967659,1004115405,-16161,1004117650,
78656538493,1004298022,980134114,1004282608,-15414,,
78657038495,1004798024,980634117,1004784112,-13912,,
78657391124,1005150654,980986746,1005136741,-13913,1005134465,
78657538496,1005298025,981134118,1005283441,-14584,,
78658038498,1005798027,981634120,1005781841,-16186,,
78658410215,1006169745,982005838,1006153560,-16185,1006153604,
78658538499,1006298028,982134121,1006281853,-16175,,
78659038500,1006798029,982634122,1006781891,-16138,,
78659433625,1007193155,983029248,1007177018,-16137,1007178932,
78659538502,1007298031,983134123,1007282295,-15736,,
78660038504,1007798033,983634125,1007783813,-14220,,
78660456821,1008216351,984052444,1008202132,-14219,1008202300,
78660538505,1008298034,984134126,1008283841,-14193,,
78661038506,1008798035,984634128,1008783986,-14049,,
78661482650,1009242180,985078273,1009228132,-14048,1009229092,
78661538507,1009298037,985134129,1009284095,-13942,,
78662038508,1009798038,985634130,1009784953,-13085,,
78662501715,1010261245,986097338,1010248160,-13085,1010245006,
78662538510,1010298039,986134132,1010284720,-13319,,
78663038512,1010798041,986634134,1010781805,-16236,,
78663520664,1011280194,987116286,1011263958,-16236,1011263899,
78663538514,1011298043,987134135,1011281804,-16239,,
78664038515,1011798044,987634137,1011781752,-16292,,
78664543780,1012303310,988139403,1012287019,-16291,1012285544,
78664543790,1012303319,988139412,1012287027,-16292,,
78665043791,1012803320,988639412,1012785557,-17763,,
78665564011,1013323540,989159633,1013305778,-17762,1013307712,
78665564020,1013323550,989159643,1013305786,-17764,,
78666064021,1013823551,989659643,1013807724,-15827,,
78666587525,1014347055,990183148,1014331230,-15825,1014332899,
78666587535,1014347065,990183157,1014331238,-15827,,
78667087536,1014847065,990683158,1014832912,-14153,,
78667610920,1015370449,991206542,1015356297,-14152,1015356329,
78667610929,1015370458,991206551,1015356305,-14153,,
78668110931,1015870460,991706553,1015856343,-14117,,
78668630037,1016389567,992225659,1016375450,-14117,1016373249,
78668630045,1016389575,992225668,1016375458,-14117,,
78669130050,1016889579,992725672,1016873266,-16313,,
78669653449,1017412979,993249072,1017396666,-16313,1017398807,
78669653458,1017412988,993249081,1017396673,-16315,,
78670153460,1017912990,993749083,1017898820,-14170,,
78670676968,1018436498,994272591,1018422329,-14169,1018422265,
78670676977,1018436507,994272599,1018422335,-14172,,
78671176979,1018936508,994772601,1018922278,-14230,,
78671696890,1019456420,995292513,1019442190,-14230,1019440204,
78671696899,1019456429,995292522,1019442198,-14231,,
78672196901,1019956430,995792523,1019940217,-16213,,
78672716150,1020475679,996311772,1020459467,-16212,1020459201,
78672716159,1020475688,996311781,1020459474,-16214,,
78673216160,1020975690,996811782,1020959214,-16476,,
78673741270,1021500800,997336892,1021484324,-16476,1021486659,
78673741279,1021500809,997336902,1021484331,-16478,,
78674241281,1022000811,997836903,1021986672,-14139,,
78674765052,1022524581,998360675,1022510444,-14137,1022510298,
78674765061,1022524591,998360684,1022510452,-14139,,
78675265063,1023024592,998860684,1023010311,-14281,,
78675788539,1023548069,999384162,1023533789,-14280,1023533731,
78675788548,1023548078,999384171,1023533797,-14281,,
78676288549,1024048079,999884171,1024033743,-14336,,
78676788550,1024548079,1000384172,1024533744,-14335,,
78676812421,1024571951,1000408045,1024557619,-14332,1024557653,
78677288551,1025048081,1000884173,1025033784,-14297,,
78677788553,1025548082,1001384175,1025533788,-14294,,
78677835673,1025595202,1001431295,1025580909,-14293,1025580810,
78678288555,1026048084,1001884177,1026033703,-14381,,
78678788556,1026548085,1002384177,1026533695,-14390,,
78678858838,1026618367,1002454460,1026603977,-14390,1026604013,
78679288557,1027048086,1002884178,1027033729,-14357,,
78679788558,1027548088,1003384180,1027533736,-14352,,
78679882332,1027641861,1003477954,1027627509,-14352,1027627472,
78680288559,1028048088,1003884180,1028033707,-14381,,
78680788560,1028548090,1004384182,1028533703,-14387,,
78680906379,1028665908,1004502001,1028651521,-14387,1028651298,
78681288562,1029048091,1004884183,1029033535,-14556,,
78681788563,1029548093,1005384185,1029533485,-14608,,
78681925924,1029685454,1005521547,1029670847,-14607,1029668685,
78682288564,1030048093,1005884186,1030031919,-16174,,
78682788565,1030548095,1006384187,1030531329,-16766,,
78682949385,1030708915,1006545008,1030692150,-16765,1030694537,
78683288566,1031048096,1006884188,1031032951,-15145,,
78683788567,1031548097,1007384189,1031533721,-14376,,
78683972876,1031732406,1007568498,1031718030,-14376,1031717987,
78684288568,1032048097,1007884189,1032033695,-14402,,
78684788570,1032548099,1008384191,1032533683,-14416,,
78684996458,1032755988,1008592081,1032741572,-14416,1032741562,
78685288571,1033048100,1008884192,1033033679,-14421,,
78685788572,1033548101,1009384193,1033533678,-14423,,
78686020269,1033779799,1009615892,1033765376,-14423,1033765450,
78686288573,1034048102,1009884195,1034033720,-14382,,
78686788575,1034548104,1010384197,1034533758,-14346,,
78687044048,1034803578,1010639671,1034789232,-14346,1034789118,
78687288577,1035048106,1010884199,1035033705,-14401,,
78687788579,1035548108,1011384201,1035533651,-14457,,
78688067655,1035827185,1011663278,1035812728,-14457,1035812613,
78688288581,1036048110,1011884203,1036033602,-14508,,
78688788582,1036548112,1012384204,1036533542,-14570,,
78689091105,1036850634,1012686727,1036836066,-14568,1036836083,
78689288583,1037048112,1012884205,1037033550,-14562,,
78689788586,1037548116,1013384209,1037533567,-14549,,
78690109950,1037869479,1013705572,1037854931,-14548,1037852854,
78690288588,1038048118,1013884210,1038032827,-15291,,
78690788590,1038548120,1014384212,1038531498,-16622,,
78691133412,1038892942,1014729035,1038876321,-16621,1038878294,
78691288591,1039048121,1014884213,1039032112,-16009,,
78691788592,1039548122,1015384214,1039533477,-14645,,
78692157086,1039916616,1015752709,1039901971,-14645,1039902110,
78692288594,1040048123,1015884215,1040033514,-14609,,
78692788595,1040548124,1016384217,1040533621,-14503,,
78693177938,1040937468,1016773561,1040922966,-14502,1040921486,
78693288596,1041048126,1016884218,1041033295,-14831,,
78693788597,1041548126,1017384218,1041532146,-15980,,
78694201377,1041960907,1017797000,1041944928,-15979,1041946290,
78694288598,1042048127,1017884220,1042032384,-15743,,
78694788600,1042548129,1018384222,1042533515,-14614,,
78695220535,1042980065,1018816158,1042965452,-14613,1042963255,
78695288601,1043048130,1018884223,1043033217,-14913,,
78695788602,1043548132,1019384224,1043531325,-16807,,
78696244218,1044003748,1019839841,1043986942,-16806,1043989136,
78696288603,1044048132,1019884225,1044031519,-16613,,
78696788604,1044548133,1020384225,1044533524,-14609,,
78697267799,1045027329,1020863422,1045012720,-14609,1045012615,
78697288605,1045048134,1020884227,1045033519,-14615,,
78697788606,1045548135,1021384228,1045533424,-14711,,
78698286936,1046046466,1021882559,1046031756,-14710,1046029573,
78698288607,1046048136,1021884229,1046033416,-14720,,
78698788609,1046548138,1022384230,1046531248,-16890,,
78699306367,1047065896,1022901989,1047049007,-16889,1047049302,
78699306374,1047065904,1022901996,1047049013,-16891,,
78699806375,1047565905,1023401997,1047549313,-16592,,
78700329360,1048088890,1023924984,1048072300,-16590,1048074116,
78700329375,1048088906,1023924999,1048072312,-16594,,
78700829376,1048588905,1024424997,1048574135,-14770,,
78701349054,1049108584,1024944677,1049093815,-14769,1049091998,
78701349064,1049108593,1024944686,1049093822,-14771,,
78701849065,1049608594,1025444687,1049592011,-16583,,
78702372516,1050132046,1025968138,1050115464,-16582,1050117349,
78702372525,1050132055,1025968147,1050115471,-16584,,
78702872526,1050632055,1026468148,1050617361,-14694,,
78703406493,1051166022,1027002115,1051151328,-14694,1051155121,
78703406500,1051166029,1027002122,1051151334,-14695,,
78703906502,1051666031,1027502124,1051655132,-10899,,
78704426157,1052185687,1028021779,1052174788,-10899,1052169090,
78704426165,1052185694,1028021786,1052174794,-10900,,
78704926166,1052685695,1028521787,1052669100,-16595,,
78705445386,1053204915,1029041009,1053188321,-16594,1053187945,
78705445395,1053204925,1029041018,1053188329,-16596,,
78705945396,1053704925,1029541017,1053687957,-16968,,
78706464391,1054223921,1030060014,1054206954,-16967,1054206955,
78706464400,1054223930,1030060023,1054206962,-16968,,
78706964402,1054723931,1030560023,1054706968,-16963,,
78707487904,1055247434,1031083527,1055230472,-16962,1055232439,
78707487946,1055247476,1031083569,1055230514,-16962,,
78707987948,1055747477,1031583570,1055732485,-14992,,
78708507325,1056266855,1032102948,1056251864,-14991,1056249751,
78708507335,1056266865,1032102958,1056251871,-14994,,
78709007336,1056766865,1032602958,1056749764,-17101,,
78709526745,1057286275,1033122367,1057269174,-17101,1057269375,
78709526754,1057286284,1033122377,1057269182,-17102,,
78710026756,1057786285,1033622377,1057769388,-16897,,
78710550075,1058309605,1034145698,1058292709,-16896,1058294750,
78710550215,1058309744,1034145837,1058292847,-16897,,
78711050216,1058809746,1034645838,1058794893,-14853,,
78711569417,1059328947,1035165039,1059314094,-14853,1059311938,
78711569426,1059328956,1035165048,1059314101,-14855,,
78712069428,1059828957,1035665050,1059811951,-17006,,
78712592876,1060352405,1036188498,1060335400,-17005,1060337472,
78712592885,1060352414,1036188507,1060335407,-17007,,
78713092887,1060852416,1036688508,1060837485,-14931,,
78713612129,1061371658,1037207751,1061356728,-14930,1061354524,
78713612269,1061371798,1037207892,1061356866,-14932,,
78714112270,1061871799,1037707892,1061854667,-17132,,
78714631357,1062390887,1038226980,1062373756,-17131,1062373749,
78714631366,1062390896,1038226989,1062373764,-17132,,
78715131367,1062890896,1038726989,1062873761,-17135,,
78715631368,1063390898,1039226990,1063373762,-17136,,
78715650509,1063410039,1039246132,1063392905,-17134,1063392867,
78716131369,1063890899,1039726991,1063873730,-17169,,
78716631371,1064390900,1040226992,1064373731,-17169,,
78716674001,1064433531,1040269624,1064416362,-17169,1064418480,
78717131372,1064890901,1040726993,1064875671,-15230,,
78717631373,1065390902,1041226994,1065375853,-15049,,
78717697397,1065456927,1041293020,1065441879,-15048,1065441942,
78718131374,1065890904,1041726996,1065875912,-14992,,
78718631375,1066390905,1042226997,1066375922,-14983,,
78718718170,1066477700,1042313792,1066462717,-14983,1066461550,
78719131376,1066890906,1042726998,1066874960,-15946,,
78719631378,1067390907,1043226999,1067374759,-16148,,
78719737425,1067496955,1043333048,1067480807,-16148,1067479677,
78720131380,1067890909,1043727002,1067873872,-17037,,
78720631382,1068390911,1044227003,1068373635,-17276,,
78720758608,1068518139,1044354233,1068500866,-17273,1068501734,
78721131384,1068890913,1044727006,1068874290,-16623,,
78721631385,1069390914,1045227006,1069374514,-16400,,
78721782811,1069542341,1045378433,1069525941,-16400,1069527656,
78722131386,1069890915,1045727008,1069875712,-15203,,
78722631387,1070390916,1046227008,1070376234,-14682,,
78722807342,1070566872,1046402965,1070552191,-14681,1070552347,
78723131388,1070890918,1046727010,1070876339,-14579,,
78723631389,1071390919,1047227011,1071376397,-14522,,
78723830681,1071590211,1047426304,1071575690,-14521,1071575105,
78724131390,1071890919,1047727011,1071876048,-14871,,
78724631392,1072390921,1048227014,1072375818,-15103,,
78724854510,1072614040,1048450132,1072598937,-15103,1072599044,
78725131393,1072890922,1048727015,1072875879,-15043,,
78725631394,1073390923,1049227016,1073375930,-14993,,
78725878138,1073637667,1049473760,1073622675,-14992,1073622440,
78726131396,1073890925,1049727018,1073875814,-15111,,
78726631398,1074390927,1050227020,1074375702,-15225,,
78726898695,1074658225,1050494318,1074643000,-15225,1074641693,
78727131399,1074890928,1050727021,1074875095,-15833,,
78727631400,1075390930,1051227022,1075374399,-16531,,
78727917938,1075677468,1051513561,1075660939,-16529,1075660044,
78728131401,1075890930,1051727023,1075874019,-16911,,
78728631403,1076390932,1052227024,1076373511,-17421,,
78728941633,1076701164,1052537256,1076683743,-17421,1076685959,
78729131404,1076890933,1052727025,1076874353,-16580,,
78729631405,1077390934,1053227027,1077375732,-15202,,
78729965160,1077724690,1053560783,1077709488,-15202,1077709537,
78730131406,1077890935,1053727027,1077875749,-15186,,
78730631407,1078390937,1054227029,1078375786,-15151,,
78730989238,1078748768,1054584860,1078733618,-15150,1078733724,
78731131409,1078890938,1054727031,1078875817,-15121,,
78731631410,1079390939,1055227031,1079375898,-15041,,
78732012802,1079772331,1055608424,1079757291,-15040,1079757182,
78732131412,1079890941,1055727034,1079875874,-15067,,
78732631413,1080390942,1056227035,1080375795,-15147,,
78733036455,1080795984,1056632077,1080780838,-15146,1080780667,
78733131415,1080890944,1056727037,1080875764,-15180,,
78733631417,1081390946,1057227039,1081375631,-15315,,
78734058849,1081818378,1057654471,1081803063,-15315,1081802568,
78734131418,1081890948,1057727040,1081875561,-15387,,
78734631420,1082390949,1058227042,1082375141,-15808,,
78735082006,1082841536,1058677629,1082825728,-15808,1082826135,
78735131422,1082890951,1058727043,1082875183,-15768,,
78735631423,1083390953,1059227045,1083375554,-15399,,
78736102677,1083862207,1059698299,1083846809,-15398,1083845242,
78736131428,1083890958,1059727052,1083875470,-15488,,
78736631429,1084390958,1060227051,1084373996,-16962,,
78737126303,1084885833,1060721926,1084868871,-16962,1084870478,
78737131431,1084890960,1060727053,1084874014,-16946,,
78737631433,1085390962,1061227054,1085375610,-15352,,
78738145393,1085904923,1061741016,1085889572,-15351,1085887415,
78738145402,1085904932,1061741025,1085889579,-15353,,
78738645403,1086404932,1062241025,1086387426,-17506,,
78739145404,1086904934,1062741026,1086887427,-17507,,
78739168757,1086928287,1062764380,1086910781,-17506,1086912862,
78739645405,1087404934,1063241027,1087389415,-15519,,
78740145406,1087904936,1063741028,1087889513,-15423,,
78740192363,1087951893,1063787986,1087936472,-15421,1087936476,
78740645407,1088404936,1064241029,1088389520,-15416,,
78741145408,1088904937,1064741030,1088889522,-15415,,
78741216059,1088975589,1064811682,1088960175,-15414,1088960379,
78741645409,1089404938,1065241031,1089389701,-15237,,
78742145410,1089904940,1065741032,1089889732,-15208,,
78742239253,1089998783,1065834875,1089983575,-15208,1089983346,
78742645412,1090404942,1066241034,1090389548,-15394,,
78743145414,1090904943,1066741036,1090889508,-15435,,
78743263374,1091022903,1066858996,1091007469,-15434,1091007885,
78743645416,1091404945,1067241038,1091389830,-15115,,
78744145417,1091904947,1067741039,1091889930,-15017,,
78744286820,1092046350,1067882443,1092031334,-15016,1092030918,
78744645418,1092404947,1068241040,1092389634,-15313,,
78745145420,1092904949,1068741042,1092889520,-15429,,
78745310401,1093069931,1068906024,1093054503,-15428,1093054511,
78745645421,1093404950,1069241043,1093389527,-15423,,
78746145423,1093904952,1069741045,1093889534,-15418,,
78746334275,1094093805,1069929898,1094078388,-15417,1094078559,
78746645425,1094404954,1070241047,1094389645,-15309,,
78747145426,1094904956,1070741048,1094889713,-15243,,
78747357741,1095117271,1070953364,1095102028,-15243,1095101770,
78747645427,1095404956,1071241049,1095389565,-15391,,
78748145428,1095904957,1071741049,1095889458,-15499,,
78748381260,1096140790,1071976883,1096125291,-15499,1096125226,
78748645430,1096404959,1072241052,1096389426,-15533,,
78749145431,1096904960,1072741053,1096889398,-15562,,
78749404845,1097164375,1073000468,1097148814,-15561,1097149021,
78749645433,1097404962,1073241054,1097389500,-15462,,
78750145435,1097904964,1073741057,1097889613,-15351,,
78750428292,1098187821,1074023914,1098172471,-15350,1098172224,
78750645436,1098404965,1074241057,1098389508,-15457,,
78751145437,1098904966,1074741059,1098889371,-15595,,
78751449672,1099209202,1075045295,1099193608,-15594,1099192658,
78751645438,1099404967,1075241059,1099389001,-15966,,
78752145439,1099904968,1075741060,1099888427,-16541,,
78752473777,1100233307,1076069400,1100216767,-16540,1100217976,
78752645441,1100404970,1076241063,1100388845,-16125,,
78753145442,1100904972,1076741064,1100889644,-15328,,
78753497351,1101256881,1077092974,1101241554,-15327,1101241448,
78753645443,1101404973,1077241065,1101389614,-15359,,
78754145444,1101904974,1077741066,1101889544,-15430,,
78754520928,1102280458,1078116550,1102265028,-15430,1102264838,
78754645445,1102404975,1078241067,1102389497,-15478,,
78755145447,1102904976,1078741069,1102889359,-15617,,
78755544673,1103304203,1079140296,1103288587,-15616,1103288574,
78755645448,1103404977,1079241070,1103389357,-15620,,
78756145450,1103904979,1079741072,1103889353,-15626,,
78756565461,1104324991,1080161083,1104309365,-15626,1104307859,
78756645452,1104404981,1080241074,1104389113,-15868,,
78757145454,1104904983,1080741076,1104887854,-17129,,
78757588874,1105348404,1081184497,1105331275,-17129,1105332687,
78757645455,1105404984,1081241077,1105388013,-16971,,
78758145456,1105904986,1081741078,1105889272,-15714,,
78758612535,1106372065,1082208158,1106356352,-15713,1106356304,
78758645457,1106404986,1082241079,1106389268,-15718,,
78759145458,1106904987,1082741079,1106889228,-15759,,
78759635977,1107395507,1083231600,1107379749,-15758,1107379829,
78759645459,1107404988,1083241081,1107389228,-15760,,
78760145461,1107904990,1083741083,1107889315,-15675,,
78760656086,1108415617,1084251711,1108399945,-15672,1108398010,
78760656107,1108415638,1084251732,1108399962,-15676,,
78761156108,1108915637,1084751729,1108898035,-17602,,
78761679586,1109439116,1085275209,1109421515,-17601,1109423391,
78761679721,1109439250,1085275343,1109421648,-17602,,
78762179722,1109939251,1085775344,1109923529,-15722,,
78762703130,1110462660,1086298753,1110446939,-15721,1110446913,
78762703140,1110462669,1086298762,1110446947,-15722,,
78763203141,1110962671,1086798763,1110946926,-15745,,
78763729349,1111488879,1087324971,1111473135,-15744,1111472544,
78763729358,1111488888,1087324980,1111473142,-15746,,
78764229359,1111988889,1087824981,1111972556,-16333,,
78764753367,1112512896,1088348989,1112496565,-16331,1112496607,
78764753411,1112512941,1088349034,1112496607,-16334,,
78765253412,1113012941,1088849033,1112996654,-16287,,
78765753413,1113512942,1089349034,1113496655,-16287,,
78765776924,1113536454,1089372546,1113520167,-16287,1113520671,
78766253414,1114012943,1089849036,1113997139,-15804,,
78766753416,1114512945,1090349038,1114497165,-15780,,
78766800361,1114559891,1090395984,1114544112,-15779,1114544100,
78767253417,1115012946,1090849039,1114997159,-15787,,
78767753418,1115512947,1091349039,1115497159,-15788,,
78767823997,1115583528,1091419621,1115567741,-15787,1115567646,
78768253420,1116012949,1091849042,1115997083,-15866,,
78768753421,1116512951,1092349043,1116497072,-15879,,
78768847583,1116607113,1092443206,1116591236,-15877,1116591315,
78769253423,1117012952,1092849044,1116997141,-15811,,
78769753424,1117512954,1093349046,1117497158,-15796,,
78769866798,1117626328,1093462421,1117610534,-15794,1117608317,
78770253425,1118012954,1093849047,1117995448,-17506,,
78770753426,1118512955,1094349048,1118494947,-18008,,
78770886739,1118646269,1094482362,1118628261,-18008,1118628522,
78771253427,1119012957,1094849049,1118995141,-17816,,
78771753428,1119512957,1095349049,1119495213,-17744,,
78771906786,1119666315,1095502408,1119648572,-17743,1119648472,
78772253430,1120012959,1095849052,1119995147,-17812,,
78772753431,1120512960,1096349053,1120495119,-17841,,
78772925823,1120685353,1096521445,1120667512,-17841,1120667309,
78773253433,1121012962,1096849055,1120994990,-17972,,
78773753434,1121512964,1097349056,1121494923,-18041,,
78773945266,1121704796,1097540889,1121686756,-18040,1121686559,
78774253436,1122012965,1097849058,1121994804,-18161,,
78774753437,1122512966,1098349059,1122494731,-18235,,
78774968753,1122728283,1098564376,1122710049,-18234,1122712327,
78775253438,1123012968,1098849060,1122996032,-16936,,
78775753440,1123512970,1099349062,1123497016,-15954,,
78775988785,1123748315,1099584408,1123732363,-15952,1123730377,
78776253442,1124012971,1099849063,1123995968,-17003,,
78776753444,1124512973,1100349066,1124495038,-17935,,
78777019208,1124778738,1100614831,1124760804,-17934,1124766314,
78777253445,1125012974,1100849067,1124997621,-15353,,
78777753446,1125512976,1101349068,1125500555,-12421,,
78778042579,1125802109,1101638202,1125789688,-12421,1125786154,
78778253447,1126012977,1101849069,1125999066,-13911,,
78778753448,1126512978,1102349070,1126497025,-15953,,
78779061734,1126821264,1102657357,1126805311,-15953,1126803055,
78779253449,1127012978,1102849071,1126996161,-16817,,
78779753450,1127512979,1103349071,1127494773,-18206,,
78780085252,1127844782,1103680874,1127826576,-18206,1127828734,
78780253451,1128012980,1103849072,1127995500,-17480,,
78780753452,1128512981,1104349074,1128496936,-16045,,
78781104358,1128863887,1104699980,1128847842,-16045,1128845646,
78781253453,1129012982,1104849075,1128996282,-16700,,
78781753454,1129512984,1105349076,1129494745,-18239,,
78782124486,1129884016,1105720109,1129865777,-18239,1129866252,
78782253456,1130012985,1105849077,1129994870,-18115,,
78782753458,1130512987,1106349080,1130495226,-17761,,
78783144003,1130903533,1106739626,1130885772,-17761,1130885107,
78783253459,1131012988,1106849080,1130995080,-17908,,
78783753461,1131512990,1107349083,1131494567,-18423,,
78784167438,1131926968,1107763061,1131908546,-18422,1131910686,
78784253463,1132012992,1107849085,1131994936,-18056,,
78784753464,1132512994,1108349086,1132496715,-16279,,
78785186718,1132946247,1108782340,1132929969,-16278,1132927914,
78785253465,1133012994,1108849087,1132996440,-16554,,
78785753466,1133512995,1109349088,1133494664,-18331,,
78786210265,1133969794,1109805887,1133951464,-18330,1133953676,
78786253470,1134013001,1109849094,1133994861,-18140,,
78786753471,1134513001,1110349093,1134496885,-16116,,
78787230836,1134990365,1110826458,1134974250,-16115,1134972715,
78787253472,1135013002,1110849094,1134996816,-16186,,
78787753473,1135513002,1111349095,1135495354,-17648,,
78788255590,1136015119,1111851212,1135997472,-17647,1135998369,
78788255599,1136015129,1111851222,1135997480,-17649,,
78788755601,1136515130,1112351223,1136498383,-16747,,
78789274936,1137034466,1112870558,1137017719,-16747,1137016077,
78789274943,1137034473,1112870565,1137017725,-16748,,
78789774945,1137534474,1113370566,1137516088,-18386,,
78790294542,1138054072,1113890165,1138035686,-18386,1138036001,
78790294549,1138054079,1113890172,1138035692,-18387,,
78790794551,1138554080,1114390173,1138536011,-18069,,
78791313664,1139073194,1114909287,1139055126,-18068,1139054798,
78791313764,1139073293,1114909386,1139055224,-18069,,
78791813766,1139573295,1115409388,1139554902,-18393,,
78792338880,1140098409,1115934503,1140080017,-18392,1140081917,
78792338889,1140098418,1115934511,1140080024,-18394,,
78792838890,1140598420,1116434512,1140581930,-16490,,
78793361195,1141120725,1116956818,1141104235,-16490,1141103794,
78793361203,1141120732,1116956825,1141104240,-16492,,
78793861205,1141620734,1117456826,1141603805,-16929,,
78794384305,1142143835,1117979928,1142126907,-16928,1142125787,
78794384315,1142143845,1117979938,1142126916,-16929,,
78794884316,1142643845,1118479938,1142625800,-18045,,
78795407983,1143167512,1119003605,1143149468,-18044,1143151306,
78795407992,1143167521,1119003614,1143149476,-18045,,
78795907993,1143667522,1119503615,1143651319,-16203,,
78796432004,1144191533,1120027626,1144175330,-16203,1144175586,
78796432011,1144191540,1120027633,1144175336,-16204,,
78796932012,1144691541,1120527634,1144675596,-15945,,
78797455248,1145214778,1121050870,1145198833,-15945,1145198523,
78797455255,1145214785,1121050877,1145198840,-15945,,
78797955256,1145714785,1121550878,1145698533,-16252,,
78798478215,1146237745,1122073837,1146221493,-16252,1146221439,
78798478222,1146237751,1122073844,1146221499,-16252,,
78798978224,1146737753,1122573846,1146721450,-16303,,
78799498805,1147258335,1123094428,1147242033,-16302,1147240588,
78799498815,1147258345,1123094437,1147242041,-16304,,
78799998816,1147758345,1123594438,1147740600,-17745,,
78800517763,1148277293,1124113385,1148259548,-17745,1148258811,
78800517770,1148277299,1124113392,1148259553,-17746,,
78801017772,1148777301,1124613393,1148758822,-18479,,
78801541053,1149300583,1125136675,1149282104,-18479,1149284155,
78801541063,1149300592,1125136685,1149282112,-18480,,
78802041065,1149800594,1125636686,1149784169,-16425,,
78802564784,1150324313,1126160406,1150307889,-16424,1150307921,
78802564791,1150324321,1126160413,1150307895,-16426,,
78803064793,1150824322,1126660414,1150807932,-16390,,
78803588522,1151348052,1127184145,1151331663,-16389,1151331711,
78803588532,1151348061,1127184154,1151331671,-16390,,
78804088534,1151848063,1127684156,1151831725,-16338,,
78804612242,1152371772,1128207865,1152355435,-16337,1152355453,
78804612252,1152371781,1128207874,1152355443,-16338,,
78805112253,1152871783,1128707875,1152855466,-16317,,
78805635807,1153395337,1129231430,1153379021,-16316,1153378961,
78805635816,1153395346,1129231438,1153379029,-16317,,
78806135817,1153895346,1129731438,1153878973,-16373,,
78806635818,1154395347,1130231439,1154378974,-16373,,
78806659398,1154418928,1130255021,1154402556,-16372,1154402398,
78807135819,1154895348,1130731441,1154878828,-16520,,
78807635820,1155395349,1131231441,1155378822,-16527,,
78807682965,1155442495,1131278588,1155425968,-16527,1155426028,
78808135821,1155895350,1131731443,1155878880,-16470,,
78808635822,1156395352,1132231444,1156378887,-16465,,
78808706694,1156466224,1132302317,1156449760,-16464,1156449845,
78809135823,1156895353,1132731445,1156878964,-16389,,
78809635824,1157395354,1133231446,1157378977,-16377,,
78809726893,1157486423,1133322515,1157470047,-16376,1157467232,
78810135825,1157895354,1133731447,1157876677,-18677,,
78810635826,1158395356,1134231448,1158376166,-19190,,
78810746939,1158506469,1134342562,1158487281,-19188,1158488246,
78811135827,1158895357,1134731449,1158876920,-18437,,
78811635829,1159395358,1135231451,1159377137,-18221,,
78811766308,1159525838,1135361930,1159507617,-18221,1159507096,
78812135831,1159895360,1135731452,1159876755,-18605,,
78812635832,1160395362,1136231454,1160376622,-18740,,
78812790166,1160549696,1136385790,1160530957,-18739,1160533136,
78813135833,1160895362,1136731454,1160878129,-17233,,
78813635835,1161395364,1137231457,1161378807,-16557,,
78813813804,1161573334,1137409427,1161556778,-16556,1161556725,
78814135837,1161895367,1137731459,1161878777,-16590,,
78814635838,1162395368,1138231460,1162378761,-16607,,
78814837400,1162596931,1138433024,1162580327,-16604,1162580197,
78815135839,1162895368,1138731460,1162878688,-16680,,
78815635840,1163395369,1139231462,1163378640,-16729,,
78815858753,1163618283,1139454376,1163601555,-16728,1163600466,
78816135841,1163895371,1139731463,1163878040,-17331,,
78816635843,1164395372,1140231464,1164377558,-17814,,
78816882554,1164642084,1140478177,1164624270,-17814,1164625434,
78817135844,1164895373,1140731466,1164878150,-17223,,
78817635846,1165395375,1141231468,1165378729,-16646,,
78817906156,1165665686,1141501779,1165649039,-16647,1165649003,
78818135847,1165895376,1141731468,1165878713,-16663,,
78818635848,1166395377,1142231469,1166378696,-16681,,
78818929581,1166689111,1142525204,1166672430,-16681,1166672474,
78819135849,1166895378,1142731471,1166878716,-16662,,
78819635851,1167395380,1143231473,1167378745,-16635,,
78819953938,1167713467,1143549560,1167696832,-16635,1167696836,
78820135852,1167895382,1143731474,1167878748,-16634,,
78820635853,1168395382,1144231474,1168378753,-16629,,
78820977543,1168737073,1144573165,1168720445,-16628,1168720392,
78821135854,1168895383,1144731475,1168878737,-16646,,
78821635855,1169395385,1145231477,1169378707,-16678,,
78822001034,1169760563,1145596657,1169743886,-16677,1169743859,
78822135857,1169895386,1145731479,1169878700,-16686,,
78822635859,1170395388,1146231480,1170378686,-16702,,
78823024586,1170784115,1146620208,1170767414,-16701,1170767397,
78823135861,1170895390,1146731483,1170878683,-16707,,
78823635862,1171395391,1147231484,1171378675,-16716,,
78824048104,1171807633,1147643726,1171790918,-16715,1171790874,
78824135863,1171895392,1147731484,1171878667,-16725,,
78824635864,1172395393,1148231485,1172378636,-16757,,
78825067142,1172826671,1148662764,1172809914,-16757,1172807849,
78825135865,1172895395,1148731488,1172878353,-17042,,
78825635866,1173395396,1149231488,1173376576,-18820,,
78826090664,1173850194,1149686287,1173831375,-18819,1173833348,
78826135868,1173895397,1149731489,1173876754,-18643,,
78826635870,1174395400,1150231492,1174378555,-16845,,
78827114503,1174874033,1150710126,1174857190,-16843,1174857379,
78827135874,1174895404,1150731498,1174878569,-16835,,
78827635875,1175395404,1151231497,1175378753,-16651,,
78828137625,1175897154,1151733247,1175880504,-16650,1175880320,
78828137657,1175897187,1151733280,1175880535,-16652,,
78828637658,1176397187,1152233280,1176380355,-16832,,
78829137659,1176897189,1152733281,1176880356,-16833,,
78829161097,1176920627,1152756720,1176903796,-16831,1176903793,
78829637660,1177397189,1153233282,1177380357,-16832,,
78830137661,1177897191,1153733283,1177880358,-16833,,
78830184470,1177944000,1153780093,1177927169,-16831,1177927072,
78830637663,1178397192,1154233284,1178380276,-16916,,
78831137664,1178897193,1154733286,1178880268,-16925,,
78831207967,1178967497,1154803590,1178950573,-16924,1178950468,
78831637665,1179397195,1155233287,1179380182,-17013,,
78832137667,1179897196,1155733288,1179880170,-17026,,
78832231084,1179990614,1155826706,1179973588,-17026,1179973715,
78832637668,1180397197,1156233289,1180380276,-16921,,
78833137669,1180897198,1156733290,1180880301,-16897,,
78833254944,1181014474,1156850567,1180997578,-16896,1180997777,
78833637670,1181397199,1157233291,1181380456,-16743,,
78834137671,1181897201,1157733293,1181880507,-16694,,
78834279129,1182038659,1157874752,1182021966,-16693,1182021962,
78834637672,1182397202,1158233294,1182380507,-16695,,
78835137673,1182897202,1158733295,1182880508,-16694,,
78835303262,1183062792,1158898885,1183046098,-16694,1183045694,
78835637675,1183397204,1159233297,1183380241,-16963,,
78836137676,1183897205,1159733298,1183880110,-17095,,
78836327480,1184087010,1159923103,1184069916,-17094,1184069871,
78836637678,1184397207,1160233300,1184380086,-17121,,
78837137680,1184897209,1160733301,1184880073,-17136,,
78837580903,1185340434,1161176528,1185323300,-17134,1185379148,
78837637682,1185397211,1161233304,1185386414,-10797,,
78838137683,1185897212,1161733304,1185935931,38719,,
78838604896,1186364426,1162200519,1186403146,38720,1186347296,
78838637684,1186397213,1162233305,1186432268,35055,,
78839137685,1186897214,1162733306,1186880086,-17128,,
78839628671,1187388200,1163224293,1187371073,-17127,1187371089,
78839637686,1187397215,1163233307,1187380086,-17129,,
78840137687,1187897216,1163733308,1187880107,-17109,,
78840647725,1188407255,1164243348,1188390147,-17108,1188388058,
78840647734,1188407264,1164243357,1188390154,-17110,,
78841147736,1188907265,1164743357,1188888071,-19194,,
78841672214,1189431744,1165267837,1189412551,-19193,1189415196,
78841672223,1189431753,1165267846,1189412557,-19196,,
78842172224,1189931753,1165767846,1189915207,-16546,,
78842672225,1190431754,1166267847,1190415208,-16546,,
78842691270,1190450800,1166286893,1190434254,-16546,1190431617,
78843172227,1190931756,1166767849,1190912677,-19079,,
78843672228,1191431757,1167267849,1191412577,-19180,,
78843714983,1191474513,1167310605,1191455333,-19180,1191457543,
78844172229,1191931758,1167767850,1191914602,-17156,,
78844672231,1192431760,1168267853,1192414793,-16967,,
78844734219,1192493749,1168329842,1192476783,-16966,1192474437,
78845172232,1192931762,1168767854,1192912742,-19020,,
78845672233,1193431763,1169267855,1193412453,-19310,,
78845757696,1193517226,1169353319,1193497918,-19308,1193500136,
78846172234,1193931763,1169767856,1193914296,-17467,,
78846672235,1194431765,1170267857,1194414678,-17087,,
78846776834,1194536364,1170372457,1194519278,-17086,1194517061,
78847172237,1194931767,1170767859,1194912928,-18839,,
78847672238,1195431767,1171267860,1195412466,-19301,,
78847796147,1195555677,1171391770,1195536376,-19301,1195536257,
78848172240,1195931769,1171767861,1195912380,-19389,,
78848672241,1196431770,1172267863,1196412353,-19417,,
78848819988,1196579518,1172415611,1196560102,-19416,1196562566,
78849172242,1196931771,1172767864,1196914091,-17680,,
78849672243,1197431772,1173267865,1197414822,-16950,,
78849840269,1197599798,1173435891,1197582849,-16949,1197580935,
78850172245,1197931774,1173767867,1197913554,-18220,,
78850672246,1198431775,1174267867,1198412914,-18861,,
78850859344,1198618873,1174454966,1198600013,-18860,1198599538,
78851172247,1198931777,1174767869,1198912620,-19157,,
78851672248,1199431778,1175267870,1199412445,-19333,,
78851878585,1199638115,1175474208,1199618783,-19332,1199618761,
78852172249,1199931778,1175767871,1199912434,-19344,,
78852672251,1200431780,1176267873,1200412429,-19351,,
78852901752,1200661282,1176497375,1200641931,-19351,1200644030,
78853172252,1200931782,1176767874,1200913567,-18215,,
78853672253,1201431783,1177267875,1201414533,-17250,,
78853922262,1201681792,1177517885,1201664542,-17250,1201663098,
78854172254,1201931784,1177767876,1201913813,-17971,,
78854672255,1202431784,1178267877,1202413092,-18692,,
78854946326,1202705856,1178541949,1202687164,-18692,1202688102,
78855172256,1202931785,1178767877,1202913517,-18268,,
78855672258,1203431787,1179267880,1203414035,-17752,,
78855966064,1203725594,1179561687,1203707842,-17752,1203706208,
78856172259,1203931789,1179767881,1203913363,-18426,,
78856672260,1204431789,1180267882,1204412406,-19383,,
78856985321,1204744851,1180580945,1204725469,-19382,1204725464,
78857172262,1204931791,1180767884,1204912406,-19385,,
78857672263,1205431793,1181267885,1205412407,-19386,,
78858004745,1205764274,1181600367,1205744890,-19384,1205744670,
78858172264,1205931793,1181767886,1205912334,-19459,,
78858672266,1206431796,1182267888,1206412193,-19603,,
78859023957,1206783487,1182619580,1206763886,-19601,1206764018,
78859172267,1206931797,1182767889,1206912233,-19564,,
78859672268,1207431797,1183267890,1207412331,-19466,,
78860047591,1207807121,1183643214,1207787655,-19466,1207789878,
78860172270,1207931799,1183767891,1207912887,-18912,,
78860672271,1208431801,1184267893,1208414561,-17240,,
78861066828,1208826357,1184662450,1208809118,-17239,1208806829,
78861172272,1208931802,1184767894,1208914079,-17723,,
78861672274,1209431803,1185267896,1209412278,-19525,,
78862086082,1209845612,1185681705,1209826087,-19525,1209826105,
78862172275,1209931805,1185767897,1209912282,-19523,,
78862672277,1210431806,1186267899,1210412301,-19505,,
78863105343,1210864873,1186700966,1210845369,-19504,1210845276,
78863172278,1210931807,1186767900,1210912288,-19519,,
78863672279,1211431808,1187267901,1211412214,-19594,,
78864129160,1211888689,1187724782,1211869096,-19593,1211871074,
78864172281,1211931811,1187767904,1211912388,-19423,,
78864672282,1212431812,1188267904,1212414198,-17614,,
78865148267,1212907797,1188743890,1212890184,-17613,1212888250,
78865172284,1212931813,1188767905,1212914105,-17708,,
78865672285,1213431815,1189267907,1213412271,-19544,,
78866168760,1213928290,1189764383,1213908747,-19543,1213909284,
78866172286,1213931815,1189767908,1213912273,-19542,,
78866672288,1214431817,1190267910,1214412814,-19003,,
78867192977,1214952507,1190788600,1214933505,-19002,1214935448,
78867193109,1214952638,1190788731,1214933634,-19004,,
78867693110,1215452639,1191288731,1215435583,-17056,,
78868216750,1215976279,1191812372,1215959224,-17055,1215958873,
78868216757,1215976287,1191812380,1215959230,-17057,,
78868716758,1216476287,1192312379,1216458883,-17404,,
78869216759,1216976288,1192812380,1216958884,-17404,,
78869241152,1217000682,1192836775,1216983279,-17403,1216983671,
78869716761,1217476290,1193312382,1217459262,-17028,,
78870216763,1217976292,1193812385,1217959284,-17008,,
78870265085,1218024615,1193860707,1218007607,-17008,1218007404,
78870716765,1218476294,1194312386,1218459105,-17189,,
78871216767,1218976296,1194812389,1218959088,-17208,,
78871289506,1219049035,1194885128,1219031828,-17207,1219031648,
78871716769,1219476298,1195312391,1219458939,-17359,,
78872216770,1219976299,1195812392,1219958914,-17385,,
78872313093,1220072622,1195908716,1220055238,-17384,1220055165,
78872716772,1220476301,1196312393,1220458860,-17441,,
78873216773,1220976302,1196812394,1220958847,-17455,,
78873337344,1221096874,1196932967,1221079420,-17454,1221079692,
78873716774,1221476303,1197312396,1221459057,-17246,,
78874216776,1221976305,1197812398,1221959126,-17179,,
78874357729,1222117258,1197953351,1222100080,-17178,1222098189,
78874716778,1222476307,1198312400,1222457772,-18535,,
78875216780,1222976309,1198812401,1222957242,-19067,,
78875381313,1223140843,1198976936,1223121777,-19066,1223123229,
78875716782,1223476311,1199312404,1223458220,-18091,,
78876216784,1223976313,1199812406,1223958702,-17611,,
78876400668,1224160198,1199996291,1224142587,-17611,1224140348,
78876716785,1224476314,1200312407,1224457288,-19026,,
78877216786,1224976315,1200812408,1224956468,-19847,,
78877424496,1225184026,1201020118,1225164179,-19847,1225166610,
78877716787,1225476316,1201312409,1225457891,-18425,,
78878216788,1225976317,1201812410,1225958904,-17413,,
78878443817,1226203346,1202039440,1226185934,-17412,1226183449,
78878716790,1226476319,1202312411,1226457550,-18769,,
78879216791,1226976321,1202812413,1226956425,-19896,,
78879467774,1227227304,1203063397,1227207410,-19894,1227209907,
78879716793,1227476322,1203312415,1227457671,-18651,,
78880216794,1227976324,1203812416,1227958929,-17395,,
78880491723,1228251253,1204087346,1228233859,-17394,1228233698,
78880716795,1228476324,1204312416,1228458857,-17467,,
78881216796,1228976326,1204812418,1228958773,-17553,,
78881515457,1229274987,1205111079,1229257435,-17552,1229257405,
78881716797,1229476327,1205312419,1229458762,-17565,,
78882216798,1229976328,1205812420,1229958749,-17579,,
78882538876,1230298406,1206134499,1230280828,-17578,1230280772,
78882716799,1230476329,1206312421,1230458730,-17599,,
78883216801,1230976330,1206812423,1230958699,-17631,,
78883562706,1231322235,1207158329,1231304605,-17630,1231304798,
78883716802,1231476332,1207312424,1231458760,-17572,,
78884216803,1231976332,1207812425,1231958897,-17435,,
78884585376,1232344906,1208180999,1232327472,-17434,1232326729,
78884716804,1232476333,1208312426,1232458702,-17631,,
78885216805,1232976334,1208812427,1232958159,-18175,,
78885608967,1233368497,1209204590,1233350322,-18175,1233350734,
78885716806,1233476335,1209312427,1233458248,-18087,,
78886216808,1233976337,1209812429,1233958577,-17760,,
78886632570,1234392100,1210228192,1234374340,-17760,1234374268,
78886716809,1234476338,1210312430,1234458565,-17773,,
78887216810,1234976339,1210812431,1234958510,-17829,,
78887656191,1235415721,1211251814,1235397892,-17829,1235397879,
78887716812,1235476341,1211312434,1235458509,-17832,,
78888216813,1235976343,1211812435,1235958503,-17840,,
78888676855,1236436385,1212272477,1236418545,-17840,1236417135,
78888716814,1236476344,1212312436,1236458390,-17954,,
78889216815,1236976345,1212812437,1236957098,-19247,,
78889697393,1237456923,1213293016,1237437677,-19246,1237437493,
78889716817,1237476346,1213312439,1237457091,-19255,,
78890216818,1237976347,1213812440,1237956920,-19427,,
78890720577,1238480107,1214316200,1238460680,-19427,1238462245,
78890720584,1238480114,1214316207,1238460686,-19428,,
78891220585,1238980115,1214816207,1238962255,-17860,,
78891720586,1239480115,1215316207,1239462255,-17860,,
78891739961,1239499490,1215335583,1239481630,-17860,1239479612,
78892220587,1239980116,1215816208,1239960318,-19798,,
78892720589,1240480118,1216316211,1240460242,-19876,,
78892763425,1240522955,1216359048,1240503080,-19875,1240505070,
78893220590,1240980120,1216816212,1240962066,-18054,,
78893720591,1241480120,1217316212,1241462237,-17883,,
78893786857,1241546387,1217382480,1241528505,-17882,1241528559,
78894220593,1241980122,1217816215,1241962289,-17833,,
78894720595,1242480124,1218316216,1242462299,-17825,,
78894817330,1242576860,1218412953,1242559036,-17824,1242562423,
78895220596,1242980125,1218816218,1242965034,-15091,,
78895720598,1243480127,1219316220,1243465692,-14435,,
78895836465,1243595995,1219432088,1243581560,-14435,1243575887,
78896220599,1243980128,1219816221,1243961336,-18792,,
78896720601,1244480130,1220316223,1244460024,-20106,,
78896857442,1244616972,1220453065,1244596866,-20106,1244597813,
78897220603,1244980132,1220816224,1244960715,-19417,,
78897720604,1245480133,1221316225,1245460977,-19156,,
78897876652,1245636182,1221472275,1245617027,-19155,1245616061,
78898220605,1245980134,1221816227,1245960316,-19818,,
78898720607,1246480136,1222316229,1246460018,-20118,,
78898900190,1246659720,1222495812,1246639602,-20118,1246641774,
78899220608,1246980137,1222816229,1246961412,-18725,,
78899720610,1247480139,1223316232,1247462196,-17943,,
78899919236,1247678765,1223514859,1247660823,-17942,1247658600,
78900220611,1247980141,1223816233,1247960858,-19283,,
78900720612,1248480142,1224316234,1248459978,-20164,,
78900942840,1248702370,1224538463,1248682208,-20162,1248684317,
78901220613,1248980142,1224816235,1248961151,-18991,,
78901720614,1249480143,1225316236,1249462092,-18051,,
78901962714,1249722244,1225558337,1249704194,-18050,1249702360,
78902220615,1249980144,1225816237,1249961148,-18996,,
78902720617,1250480146,1226316239,1250460265,-19881,,
78902982316,1250741845,1226577939,1250721965,-19880,1250721937,
78903220618,1250980148,1226816240,1250960253,-19895,,
78903720619,1251480148,1227316241,1251460242,-19906,,
78904002698,1251762228,1227598321,1251742323,-19905,1251742299,
78904220621,1251980150,1227816243,1251960234,-19916,,
78904720623,1252480152,1228316244,1252460225,-19927,,
78905021816,1252781345,1228617438,1252761419,-19926,1252761037,
78905220624,1252980154,1228816246,1252960076,-20078,,
78905720625,1253480154,1229316246,1253459848,-20306,,
78906041057,1253800587,1229636680,1253780282,-20305,1253780224,
78906220626,1253980155,1229816247,1253959828,-20327,,
78906720627,1254480157,1230316249,1254459797,-20360,,
78907060553,1254820083,1230656175,1254799723,-20360,1254799714,
78907220628,1254980157,1230816250,1254959795,-20362,,
78907720629,1255480158,1231316250,1255459792,-20366,,
78908084172,1255843702,1231679795,1255823337,-20365,1255825666,
78908220630,1255980159,1231816252,1255960429,-19730,,
78908720632,1256480161,1232316254,1256462128,-18033,,
78909103178,1256862707,1232698800,1256844675,-18032,1256842452,
78909220633,1256980162,1232816254,1256961606,-18556,,
78909720635,1257480164,1233316257,1257459911,-20253,,
78910126749,1257886279,1233722372,1257866027,-20252,1257868110,
78910220637,1257980167,1233816259,1257960303,-19864,,
78910720638,1258480168,1234316260,1258462001,-18167,,
78911145973,1258905503,1234741595,1258887337,-18166,1258885149,
78911220640,1258980169,1234816262,1258961675,-18494,,
78911720641,1259480170,1235316263,1259459819,-20351,,
78912169502,1259929032,1235765125,1259908682,-20350,1259910746,
78912220642,1259980172,1235816264,1259960031,-20141,,
78912720643,1260480173,1236316265,1260461889,-18284,,
78913189658,1260949188,1236785281,1260930904,-18284,1260929271,
78913220644,1260980175,1236816268,1260961790,-18385,,
78913720645,1261480175,1237316267,1261460260,-19915,,
78914209004,1261968534,1237804627,1261948620,-19914,1261948068,
78914220647,1261980176,1237816269,1261960248,-19928,,
78914720648,1262480177,1238316269,1262459713,-20464,,
78915228319,1262987849,1238823941,1262967385,-20464,1262967589,
78915228360,1262987890,1238823983,1262967425,-20465,,
78915728361,1263487891,1239323983,1263467634,-20257,,
78916253133,1264012663,1239848755,1263992406,-20257,1263993635,
78916253142,1264012672,1239848764,1263992414,-20258,,
78916753144,1264512674,1240348766,1264493648,-19026,,
78917276604,1265036134,1240872227,1265017109,-19025,1265017980,
78917276613,1265036143,1240872236,1265017116,-19027,,
78917776614,1265536143,1241372235,1265517992,-18151,,
78918295641,1266055171,1241891264,1266037021,-18150,1266034790,
78918295779,1266055308,1241891401,1266037155,-18153,,
78918795780,1266555310,1242391402,1266534931,-20379,,
78919315837,1267075366,1242911459,1267054988,-20378,1267055324,
78919315844,1267075373,1242911466,1267054994,-20379,,
78919815846,1267575375,1243411467,1267555335,-20040,,
78920339322,1268098852,1243934945,1268078813,-20039,1268080593,
78920339332,1268098861,1243934954,1268078820,-20041,,
78920839333,1268598862,1244434955,1268580606,-18256,,
78921363338,1269122867,1244958960,1269104612,-18255,1269104729,
78921363377,1269122907,1244959000,1269104650,-18257,,
78921863379,1269622908,1245459001,1269604772,-18136,,
78922386898,1270146428,1245982522,1270128293,-18135,1270128146,
78922386908,1270146438,1245982531,1270128300,-18138,,
78922886909,1270646438,1246482530,1270628158,-18280,,
78923410455,1271169984,1247006077,1271151705,-18279,1271151536,
78923410462,1271169991,1247006084,1271151711,-18280,,
78923910463,1271669992,1247506084,1271651546,-18446,,
78924433843,1272193373,1248029466,1272174928,-18445,1272174800,
78924433891,1272193421,1248029514,1272174974,-18447,,
78924933893,1272693422,1248529514,1272674851,-18571,,
78925457289,1273216818,1249052911,1273198248,-18570,1273198412,
78925457298,1273216827,1249052920,1273198255,-18572,,
78925957300,1273716829,1249552922,1273698426,-18403,,
78926480692,1274240222,1250076314,1274221818,-18404,1274221647,
78926480699,1274240229,1250076322,1274221823,-18406,,
78926980701,1274740230,1250576323,1274721657,-18573,,
78927504109,1275263639,1251099732,1275245067,-18572,1275245281,
78927504242,1275263772,1251099864,1275245197,-18575,,
78928004243,1275763772,1251599865,1275745417,-18355,,
78928528122,1276287652,1252123744,1276269297,-18355,1276269258,
78928528132,1276287661,1252123754,1276269305,-18356,,
78929028134,1276787663,1252623756,1276769272,-18391,,
78929551244,1277310774,1253146866,1277292383,-18391,1277292318,
78929551250,1277310780,1253146873,1277292388,-18392,,
78930051251,1277810781,1253646874,1277792329,-18452,,
78930574697,1278334227,1254170320,1278315774,-18453,1278315702,
78930574730,1278334260,1254170352,1278315806,-18454,,
78931074731,1278834261,1254670353,1278815739,-18522,,
78931598139,1279357669,1255193761,1279339147,-18522,1279339411,
78931598147,1279357676,1255193769,1279339153,-18523,,
78932098149,1279857679,1255693771,1279839424,-18255,,
78932618714,1280378244,1256214337,1280359990,-18254,1280358289,
78932618724,1280378253,1256214346,1280359997,-18256,,
78933118725,1280878254,1256714346,1280858302,-19952,,
78933643996,1281403526,1257239619,1281383575,-19951,1281385781,
78933644132,1281403662,1257239755,1281383709,-19953,,
78934144133,1281903662,1257739755,1281885920,-17742,,
78934667786,1282427316,1258263409,1282409575,-17741,1282408852,
78934667796,1282427325,1258263418,1282409583,-17742,,
78935167797,1282927327,1258763419,1282908866,-18461,,
78935688353,1283447882,1259283976,1283429422,-18460,1283427770,
78935688362,1283447892,1259283985,1283429430,-18462,,
78936188363,1283947892,1259783984,1283927782,-20110,,
78936708170,1284467700,1260303793,1284447591,-20109,1284447273,
78936708308,1284467838,1260303930,1284447727,-20111,,
78937208310,1284967839,1260803932,1284947415,-20424,,
78937732217,1285491747,1261327839,1285471323,-20424,1285472965,
78937732225,1285491755,1261327847,1285471329,-20426,,
78938232226,1285991756,1261827848,1285972977,-18779,,
78938755879,1286515409,1262351502,1286496631,-18778,1286496765,
78938755889,1286515418,1262351511,1286496639,-18779,,
78939255891,1287015420,1262851513,1286996779,-18641,,
78939775514,1287535043,1263371136,1287516403,-18640,1287513967,
78939775554,1287535083,1263371176,1287516442,-18641,,
78940275555,1288035084,1263871176,1288014010,-21074,,
78940800792,1288560322,1264396415,1288539248,-21074,1288541500,
78940800799,1288560329,1264396422,1288539253,-21076,,
78941300800,1289060330,1264896422,1289041511,-18819,,
78941800801,1289560330,1265396423,1289541511,-18819,,
78941820024,1289579554,1265415647,1289560736,-18818,1289558623,
78942300803,1290060332,1265896425,1290039484,-20848,,
78942800804,1290560333,1266396426,1290539404,-20929,,
78942843764,1290603293,1266439386,1290582365,-20928,1290584728,
78943300806,1291060336,1266896428,1291041569,-18767,,
78943800807,1291560336,1267396429,1291541774,-18562,,
78943867215,1291626745,1267462838,1291608183,-18562,1291608084,
78944300809,1292060338,1267896431,1292041692,-18646,,
78944800810,1292560339,1268396432,1292541681,-18658,,
78944890875,1292650405,1268486498,1292631748,-18657,1292631779,
78945300811,1293060341,1268896433,1293041712,-18629,,
78945800812,1293560341,1269396433,1293541718,-18623,,
78945910078,1293669608,1269505700,1293650985,-18623,1293648695,
78946300813,1294060342,1269896435,1294039931,-20411,,
78946800814,1294560343,1270396436,1294539433,-20910,,
78946933552,1294693082,1270529174,1294672172,-20910,1294674374,
78947300816,1295060345,1270896437,1295041054,-19291,,
78947800817,1295560346,1271396439,1295541641,-18705,,
78947957154,1295716684,1271552777,1295697980,-18704,1295697995,
78948300819,1296060348,1271896441,1296041656,-18692,,
78948800821,1296560351,1272396443,1296541665,-18686,,
78948976230,1296735760,1272571853,1296717074,-18686,1296714816,
78949300822,1297060351,1272896444,1297040201,-20150,,
78949800823,1297560352,1273396445,1297539411,-20941,,
78949999703,1297759233,1273595326,1297738292,-20941,1297740469,
78950300824,1298060354,1273896446,1298040724,-19630,,
78950800826,1298560355,1274396447,1298541594,-18761,,
78951019966,1298779496,1274615589,1298760736,-18760,1298757984,
78951300827,1299060357,1274896449,1299040051,-20306,,
78951800828,1299560357,1275396450,1299538847,-21510,,
78952039088,1299798618,1275634711,1299777109,-21509,1299777633,
78952300830,1300060359,1275896452,1300039124,-21235,,
78952800832,1300560361,1276396454,1300539379,-20982,,
78953066030,1300825559,1276661652,1300804578,-20981,1300808402,
78953300834,1301060363,1276896455,1301041177,-19186,,
78953800835,1301560364,1277396457,1301543210,-17154,,
78954086003,1301845532,1277681625,1301828378,-17154,1301824882,
78954300836,1302060366,1277896458,1302041710,-18656,,
78954800837,1302560367,1278396459,1302539719,-20648,,
78955105042,1302864572,1278700665,1302843925,-20647,1302843540,
78955300838,1303060368,1278896460,1303039569,-20799,,
78955800840,1303560369,1279396462,1303539339,-21030,,
78956263986,1304023518,1279859612,1304002491,-21027,1303979555,
78956300841,1304060371,1279896465,1304037651,-22720,,
78956800842,1304560371,1280396464,1304516414,-43957,,
78957283175,1305042705,1280878797,1304998748,-43957,1305021544,
78957300844,1305060374,1280896468,1305017224,-43150,,
78957800846,1305560376,1281396468,1305539217,-21159,,
78958302297,1306061827,1281897920,1306040669,-21158,1306040791,
78958302305,1306061834,1281897927,1306040675,-21159,,
78958802307,1306561836,1282397929,1306540802,-21034,,
78959325767,1307085297,1282921390,1307064263,-21034,1307066383,
78959325776,1307085306,1282921399,1307064272,-21034,,
78959825777,1307585306,1283421399,1307566395,-18911,,
78960325778,1308085308,1283921400,1308066396,-18912,,
78960349341,1308108871,1283944963,1308089960,-18911,1308089776,
78960825779,1308585308,1284421401,1308566224,-19084,,
78961325780,1309085310,1284921402,1309066217,-19093,,
78961368580,1309128110,1284964202,1309109018,-19092,1309106855,
78961825781,1309585311,1285421403,1309564242,-21069,,
78962325782,1310085312,1285921404,1310064059,-21253,,
78962392665,1310152194,1285988287,1310130943,-21251,1310133475,
78962825783,1310585312,1286421405,1310566255,-19057,,
78963325785,1311085314,1286921407,1311066597,-18717,,
78963416185,1311175715,1287011807,1311156998,-18717,1311156645,
78963825786,1311585315,1287421408,1311566310,-19005,,
78964325787,1312085317,1287921409,1312066248,-19069,,
78964439484,1312199014,1288035107,1312179947,-19067,1312179968,
78964825788,1312585318,1288421410,1312566267,-19051,,
78965325789,1313085318,1288921411,1313066274,-19044,,
78965462942,1313222472,1289058565,1313203429,-19043,1313203342,
78965825790,1313585319,1289421412,1313566215,-19104,,
78966325791,1314085320,1289921413,1314066193,-19127,,
78966496995,1314256525,1290092619,1314237400,-19125,1314242397,
78966825793,1314585322,1290421415,1314569484,-15838,,
78967325795,1315085324,1290921417,1315071200,-14124,,
78967520376,1315279905,1291115998,1315265782,-14123,1315260725,
78967825797,1315585326,1291421419,1315568115,-17211,,
78968325798,1316085328,1291921420,1316066150,-19178,,
78968543904,1316303434,1292139527,1316284258,-19176,1316284367,
78968825800,1316585329,1292421421,1316566214,-19115,,
78969325801,1317085331,1292921423,1317066265,-19066,,
78969567431,1317326961,1293163053,1317307896,-19065,1317307809,
78969825802,1317585332,1293421424,1317566221,-19111,,
78970325803,1318085333,1293921425,1318066182,-19151,,
78970590762,1318350292,1294186385,1318331143,-19149,1318331173,
78970825804,1318585334,1294421426,1318566198,-19136,,
78971325806,1319085335,1294921427,1319066219,-19116,,
78971611404,1319370933,1295207026,1319351818,-19115,1319350274,
78971825807,1319585336,1295421428,1319565558,-19778,,
78972325808,1320085337,1295921430,1320064680,-20657,,
78972635020,1320394549,1296230642,1320373893,-20656,1320375278,
78972825810,1320585339,1296421432,1320565211,-20128,,
78973325811,1321085340,1296921432,1321066071,-19269,,
78973658834,1321418364,1297254456,1321399095,-19269,1321399346,
78973825812,1321585341,1297421434,1321566156,-19185,,
78974325814,1322085343,1297921436,1322066328,-19015,,
78974682624,1322442154,1298278246,1322423139,-19015,1322423127,
78974825815,1322585345,1298421437,1322566326,-19019,,
78975325816,1323085345,1298921438,1323066321,-19024,,
78975706609,1323466139,1299302232,1323447115,-19024,1323446893,
78975825817,1323585346,1299421438,1323566268,-19078,,
78976325818,1324085347,1299921439,1324066104,-19243,,
78976738857,1324498387,1300334480,1324479144,-19243,1324483468,
78976825819,1324585349,1300421441,1324566857,-18492,,
78977325820,1325085349,1300921442,1325070433,-14916,,
78977763169,1325522699,1301358791,1325507783,-14916,1325503353,
78977825821,1325585351,1301421443,1325569879,-15472,,
78978325823,1326085352,1301921445,1326066009,-19343,,
78978783736,1326543266,1302379359,1326523924,-19342,1326522440,
78978825825,1326585355,1302421447,1326565884,-19471,,
78979325826,1327085355,1302921448,1327064532,-20823,,
78979807266,1327566796,1303402889,1327545974,-20822,1327547394,
78979825827,1327585356,1303421449,1327564585,-20771,,
78980325828,1328085357,1303921450,1328065958,-19399,,
78980831374,1328590904,1304426997,1328571506,-19398,1328571606,
78980831383,1328590913,1304427005,1328571513,-19400,,
78981331384,1329090913,1304927006,1329071618,-19295,,
78981859568,1329619098,1305455191,1329599804,-19294,1329602102,
78981859711,1329619240,1305455333,1329599945,-19295,,
78982359712,1330119241,1305955334,1330102248,-16993,,
78982883346,1330642875,1306478968,1330625883,-16992,1330623489,
78982883354,1330642884,1306478977,1330625888,-16996,,
78983383355,1331142885,1306978977,1331123501,-19384,,
78983883356,1331642885,1307478977,1331623501,-19384,,
78983906795,1331666325,1307502418,1331646942,-19383,1331647037,
78984383357,1332142887,1307978979,1332123597,-19290,,
78984883358,1332642888,1308478980,1332623602,-19286,,
78984930307,1332689837,1308525930,1332670553,-19284,1332670436,
78985383360,1333142889,1308978981,1333123502,-19387,,
78985883366,1333642896,1309478988,1333623498,-19398,,
78985953540,1333713070,1309549163,1333693673,-19397,1333693611,
78986383368,1334142897,1309978990,1334123449,-19448,,
78986883369,1334642898,1310478991,1334623442,-19456,,
78986980439,1334739968,1310576061,1334720513,-19455,1334722298,
78987383370,1335142900,1310978992,1335124884,-18016,,
78987883372,1335642901,1311478993,1335625233,-17668,,
78988004175,1335763705,1311599797,1335746037,-17668,1335744441,
78988383374,1336142903,1311978995,1336124027,-18876,,
78988883375,1336642904,1312478996,1336623643,-19261,,
78989027947,1336787476,1312623569,1336768216,-19260,1336768195,
78989383376,1337142906,1312978998,1337123632,-19274,,
78989883378,1337642907,1313479000,1337623628,-19279,,
78990046992,1337806522,1313642615,1337787243,-19279,1337784955,
78990383380,1338142910,1313979002,1338122091,-20819,,
78990883382,1338642911,1314479003,1338621346,-21565,,
78991070658,1338830190,1314666284,1338808628,-21562,1338810577,
78991383383,1339142912,1314979005,1339122571,-20341,,
78991883384,1339642913,1315479005,1339623306,-19607,,
78992101727,1339861257,1315697349,1339841650,-19607,1339845570,
78992383386,1340142915,1315979008,1340125517,-17398,,
78992883390,1340642920,1316479012,1340627236,-15684,,
78993121499,1340881029,1316717121,1340865346,-15683,1340859667,
78993383391,1341142921,1316979013,1341124262,-18659,,
78993883392,1341642921,1317479014,1341621562,-21359,,
78994153441,1341912971,1317749065,1341891614,-21357,1341897369,
78994383393,1342142923,1317979015,1342124211,-18712,,
78994883395,1342642924,1318479017,1342627326,-15598,,
78995176907,1342936437,1318772529,1342920839,-15598,1342916853,
78995383396,1343142926,1318979018,1343125681,-17245,,
78995883397,1343642926,1319479019,1343623345,-19581,,
78996200407,1343959936,1319796029,1343940356,-19580,1343940277,
78996383399,1344142928,1319979021,1344123318,-19610,,
78996883400,1344642929,1320479022,1344623272,-19657,,
78997219491,1344979021,1320815113,1344959365,-19656,1344957335,
78997383402,1345142931,1320979024,1345122609,-20322,,
78997883404,1345642933,1321479026,1345621250,-21683,,
78998244044,1346003574,1321839666,1345981891,-21683,1345984390,
78998383405,1346142934,1321979026,1346121947,-20987,,
78998883406,1346642936,1322479028,1346623755,-19181,,
78999267862,1347027392,1322863485,1347008212,-19180,1347007947,
78999383408,1347142937,1322979029,1347123693,-19244,,
78999883409,1347642939,1323479031,1347623496,-19443,,
79000291242,1348050771,1323886864,1348031329,-19442,1348031043,
79000383410,1348142940,1323979032,1348123444,-19496,,
79000883411,1348642940,1324479033,1348623214,-19726,,
79001320629,1349080159,1324916252,1349060433,-19726,1349053948,
79001383413,1349142942,1324979034,1349122401,-20541,,
79001883414,1349642943,1325479035,1349616735,-26208,,
79002344151,1350103681,1325939774,1350077473,-26208,1350083961,
79002383415,1350142944,1325979037,1350117245,-25699,,
79002883416,1350642946,1326479038,1350623229,-19717,,
79003368313,1351127843,1326963936,1351108127,-19716,1351107803,
79003383417,1351142946,1326979038,1351123217,-19729,,
79003883419,1351642948,1327479041,1351622910,-20038,,
79004392127,1352151657,1327987749,1352131619,-20038,1352132185,
79004392134,1352151664,1327987756,1352131625,-20039,,
79004892135,1352651664,1328487757,1352632195,-19469,,
79005416062,1353175592,1329011684,1353156123,-19469,1353155412,
79005416072,1353175601,1329011694,1353156130,-19471,,
79005916073,1353675603,1329511695,1353655426,-20177,,
79006435350,1354194880,1330030973,1354174704,-20176,1354172919,
79006435360,1354194889,1330030982,1354174712,-20177,,
79006935362,1354694891,1330530984,1354672933,-21958,,
79007464851,1355224381,1331060475,1355202425,-21956,1355207293,
79007464866,1355224396,1331060490,1355202437,-21959,,
79007964867,1355724396,1331560489,1355707312,-17084,,
79008488683,1356248213,1332084306,1356231129,-17084,1356228322,
79008488690,1356248220,1332084312,1356231135,-17085,,
79008988692,1356748221,1332584314,1356728333,-19888,,
79009512171,1357271700,1333107793,1357251813,-19887,1357251907,
79009512178,1357271707,1333107800,1357251819,-19888,,
79010012180,1357771709,1333607802,1357751919,-19790,,
79010536170,1358295700,1334131793,1358275910,-19790,1358275691,
79010536180,1358295709,1334131802,1358275917,-19792,,
79011036182,1358795711,1334631804,1358775705,-20006,,
79011560322,1359319852,1335155945,1359299847,-20005,1359299749,
79011560331,1359319861,1335155954,1359299854,-20007,,
79012060332,1359819861,1335655953,1359799761,-20100,,
79012587228,1360346757,1336182850,1360326658,-20099,1360326996,
79012587235,1360346765,1336182857,1360326664,-20101,,
79013087236,1360846765,1336682858,1360827006,-19759,,
79013587237,1361346766,1337182858,1361327007,-19759,,
79013611668,1361371198,1337207291,1361351439,-19759,1361351534,
79014087238,1361846767,1337682859,1361827100,-19667,,
79014587239,1362346768,1338182860,1362327106,-19662,,
79014635006,1362394536,1338230629,1362374875,-19661,1362374672,
79015087240,1362846770,1338682862,1362826927,-19843,,
79015587242,1363346771,1339182863,1363326910,-19861,,
79015658829,1363418359,1339254452,1363398499,-19860,1363398647,
79016087243,1363846773,1339682865,1363827042,-19731,,
79016587245,1364346774,1340182867,1364327065,-19709,,
79016680260,1364439790,1340275883,1364420082,-19708,1364417602,
79017087246,1364846775,1340682868,1364825050,-21725,,
79017587248,1365346777,1341182870,1365324592,-22185,,
79017706530,1365466059,1341302152,1365443875,-22184,1365447591,
79018087249,1365846778,1341682871,1365827424,-19354,,
79018587251,1366346780,1342182872,1366328314,-18466,,
79018731636,1366491166,1342327259,1366472700,-18466,1366470912,
79019087252,1366846781,1342682873,1366827046,-19735,,
79019587253,1367346782,1343182875,1367326531,-20251,,
79019755303,1367514833,1343350926,1367494583,-20250,1367494996,
79020087254,1367846784,1343682876,1367826809,-19975,,
79020587256,1368346785,1344182877,1368326951,-19834,,
79020778742,1368538271,1344374364,1368518438,-19833,1368518225,
79021087257,1368846786,1344682879,1368826822,-19964,,
79021587258,1369346787,1345182879,1369326743,-20044,,
79021802467,1369561996,1345398089,1369541953,-20043,1369542150,
79022087260,1369846789,1345682882,1369826859,-19930,,
79022587262,1370346791,1346182883,1370326948,-19843,,
79022827636,1370587166,1346423259,1370567323,-19843,1370567898,
79023087264,1370846793,1346682886,1370827249,-19544,,
79023587266,1371346795,1347182888,1371327529,-19266,,
79023848370,1371607899,1347443993,1371588634,-19265,1371586384,
79024087268,1371846797,1347682890,1371826457,-20340,,
79024587269,1372346798,1348182890,1372325285,-21513,,
79024872500,1372632029,1348468122,1372610517,-21512,1372611740,
79025087270,1372846800,1348682892,1372825812,-20988,,
79025587272,1373346801,1349182894,1373326515,-20286,,
79025896806,1373656336,1349492428,1373636049,-20287,1373635843,
79026087273,1373846803,1349682895,1373826438,-20365,,
79026587274,1374346803,1350182896,1374326314,-20489,,
79026920480,1374680010,1350516103,1374659520,-20490,1374659752,
79027087275,1374846804,1350682896,1374826391,-20413,,
79027587276,1375346805,1351182898,1375326550,-20255,,
79027948767,1375708297,1351544391,1375688045,-20252,1375690313,
79028087277,1375846807,1351682899,1375827181,-19626,,
79028587278,1376346808,1352182900,1376328829,-17979,,
79028972149,1376731678,1352567771,1376713700,-17978,1376711481,
79029087280,1376846809,1352682901,1376828319,-18490,,
79029587281,1377346811,1353182903,1377326616,-20195,,
79029995508,1377755038,1353591131,1377734843,-20195,1377734848,
79030087283,1377846812,1353682905,1377826617,-20195,,
79030587284,1378346813,1354182906,1378326626,-20187,,
79031019319,1378778849,1354614942,1378758662,-20187,1378758749,
79031087286,1378846815,1354682908,1378826638,-20177,,
79031587288,1379346817,1355182909,1379326719,-20098,,
79032038269,1379797798,1355633891,1379777700,-20098,1379775522,
79032087290,1379846819,1355682912,1379826506,-20313,,
79032587291,1380346821,1356182913,1380324546,-22275,,
79033070049,1380829579,1356665671,1380807305,-22274,1380813328,
79033087293,1380846823,1356682917,1380824759,-22064,,
79033587294,1381346824,1357182916,1381330574,-16250,,
79034093519,1381853049,1357689142,1381836801,-16248,1381832935,
79034093528,1381853058,1357689151,1381836809,-16249,,
79034593529,1382353058,1358189151,1382332947,-20111,,
79035093530,1382853059,1358689152,1382832948,-20111,,
79035117277,1382876807,1358712900,1382856697,-20110,1382856645,
79035593532,1383353061,1359189153,1383332904,-20157,,
79036093533,1383853063,1359689155,1383832904,-20159,,
79036138959,1383898489,1359734582,1383878330,-20159,1383877506,
79036593534,1384353063,1360189156,1384332157,-20906,,
79037093535,1384853064,1360689156,1384832083,-20981,,
79037162461,1384921991,1360758084,1384901011,-20980,1384901710,
79037593536,1385353066,1361189158,1385332691,-20375,,
79038093537,1385853067,1361689159,1385832788,-20279,,
79038192592,1385952122,1361788214,1385931844,-20278,1385933702,
79038593538,1386353068,1362189160,1386334281,-18787,,
79039093539,1386853069,1362689161,1386834652,-18417,,
79039216135,1386975665,1362811758,1386957249,-18416,1386955484,
79039593541,1387353070,1363189163,1387333322,-19748,,
79040093542,1387853071,1363689163,1387832892,-20179,,
79040239778,1387999308,1363835401,1387979130,-20178,1387979167,
79040593544,1388353073,1364189166,1388332922,-20151,,
79041093546,1388853075,1364689168,1388832937,-20138,,
79041258818,1389018347,1364854440,1388998210,-20137,1388995839,
79041593548,1389353077,1365189169,1389331353,-21724,,
79042093549,1389853078,1365689171,1389830572,-22506,,
79042282308,1390041838,1365877931,1390019332,-22506,1390021429,
79042593551,1390353080,1366189173,1390331880,-21200,,
79043093553,1390853083,1366689175,1390832675,-20408,,
79043302501,1391062031,1366898123,1391041624,-20407,1391039791,
79043593555,1391353084,1367189176,1391331611,-21473,,
79044093556,1391853085,1367689178,1391830848,-22237,,
79044326193,1392085723,1367921815,1392063486,-22237,1392065334,
79044593557,1392353086,1368189178,1392331838,-21248,,
79045093558,1392853087,1368689180,1392832701,-20386,,
79045349654,1393109184,1368945277,1393088799,-20385,1393088798,
79045593560,1393353089,1369189182,1393332703,-20386,,
79046093562,1393853091,1369689184,1393832707,-20384,,
79046368597,1394128126,1369964218,1394107742,-20384,1394105639,
79046593564,1394353093,1370189186,1394331763,-21330,,
79047093565,1394853094,1370689187,1394830610,-22484,,
79047387697,1395147226,1370983319,1395124742,-22484,1395124727,
79047593566,1395353095,1371189187,1395330605,-22490,,
79048093568,1395853097,1371689190,1395830600,-22497,,
79048408521,1396168051,1372004144,1396145555,-22496,1396146164,
79048593569,1396353099,1372189191,1396330828,-22271,,
79049093571,1396853100,1372689193,1396831216,-21884,,
79049431526,1397191056,1373027149,1397169173,-21883,1397170613,
79049593573,1397353103,1373189195,1397331686,-21417,,
79050093574,1397853103,1373689196,1397832662,-20441,,
79050455165,1398214695,1374050788,1398194254,-20441,1398194388,
79050593575,1398353104,1374189197,1398332699,-20405,,
79051093576,1398853106,1374689198,1398832800,-20306,,
79051478577,1399238107,1375074200,1399217803,-20304,1399217586,
79051593578,1399353107,1375189199,1399332751,-20356,,
79052093579,1399853108,1375689200,1399832590,-20518,,
79052497757,1400257287,1376093380,1400236770,-20517,1400234599,
79052593580,1400353109,1376189201,1400332174,-20935,,
79053093581,1400853111,1376689203,1400830426,-22685,,
79053517687,1401277217,1377113309,1401254532,-22685,1401254872,
79053593582,1401353112,1377189204,1401330478,-22634,,
79054093583,1401853112,1377689204,1401830770,-22342,,
79054541740,1402301269,1378137362,1402278928,-22341,1402280529,
79054593585,1402353114,1378189206,1402330937,-22177,,
79055093587,1402853116,1378689209,1402832378,-20738,,
79055561707,1403321238,1379157331,1403300502,-20736,1403298729,
79055593589,1403353118,1379189211,1403332264,-20854,,
79056093591,1403853120,1379689213,1403830615,-22505,,
79056580878,1404340407,1380176500,1404317904,-22503,1404317695,
79056593593,1404353122,1380189215,1404330610,-22512,,
79057093594,1404853124,1380689216,1404830413,-22711,,
79057600494,1405360023,1381196116,1405337314,-22709,1405337332,
79057600503,1405360032,1381196126,1405337322,-22710,,
79058100505,1405860034,1381696127,1405837345,-22689,,
79058619594,1406379123,1382215217,1406356435,-22688,1406356364,
79058619603,1406379132,1382215225,1406356442,-22690,,
79059119604,1406879133,1382715226,1406856376,-22757,,
79059638763,1407398293,1383234386,1407375537,-22756,1407375558,
79059638773,1407398303,1383234395,1407375545,-22758,,
79060138775,1407898304,1383734397,1407875573,-22731,,
79060661923,1408421452,1384257545,1408398720,-22732,1408400739,
79060661930,1408421459,1384257552,1408398726,-22733,,
79061161931,1408921460,1384757553,1408900749,-20711,,
79061681461,1409440991,1385277083,1409420280,-20711,1409418472,
79061681470,1409441000,1385277092,1409420288,-20712,,
79062181472,1409941001,1385777093,1409918485,-22516,,
79062704938,1410464468,1386300561,1410441953,-22515,1410443852,
79062704947,1410464477,1386300570,1410441960,-22517,,
79063204949,1410964478,1386800571,1410943865,-20613,,
79063725752,1411485281,1387321374,1411464669,-20612,1411463243,
79063725761,1411485291,1387321384,1411464676,-20615,,
79064225762,1411985291,1387821383,1411963255,-22036,,
79064744642,1412504171,1388340264,1412482136,-22035,1412481411,
79064744649,1412504178,1388340271,1412482142,-22036,,
79065244650,1413004180,1388840272,1412981422,-22758,,
79065763849,1413523379,1389359472,1413500622,-22757,1413500497,
79065763858,1413523388,1389359481,1413500630,-22758,,
79066263859,1414023388,1389859481,1414000509,-22879,,
79066790056,1414549586,1390385678,1414526707,-22879,1414530270,
79066790063,1414549593,1390385685,1414526712,-22881,,
79067290064,1415049594,1390885686,1415030279,-19315,,
79067790065,1415549594,1391385687,1415530280,-19314,,
79067813408,1415572938,1391409030,1415553624,-19314,1415552240,
79068290066,1416049595,1391885688,1416028965,-20630,,
79068790068,1416549597,1392385689,1416528902,-20695,,
79068836894,1416596423,1392432516,1416575729,-20694,1416575735,
79069290069,1417049598,1392885691,1417028910,-20688,,
79069790070,1417549599,1393385691,1417528913,-20686,,
79069860821,1417620351,1393456444,1417599666,-20685,1417599712,
79070290072,1418049601,1393885694,1418028956,-20645,,
79070790073,1418549602,1394385694,1418528965,-20637,,
79070892093,1418651623,1394487716,1418630988,-20635,1418632632,
79071290074,1419049604,1394885696,1419030280,-19324,,
79071790075,1419549604,1395385697,1419530617,-18987,,
79071911394,1419670923,1395507016,1419651937,-18986,1419647926,
79072290076,1420049605,1395885697,1420027582,-22023,,
79072790077,1420549606,1396385699,1420526612,-22994,,
79072934982,1420694512,1396530604,1420671517,-22995,1420673769,
79073290078,1421049607,1396885700,1421028213,-21394,,
79073790080,1421549609,1397385701,1421528869,-20740,,
79073955195,1421714725,1397550818,1421693986,-20739,1421691953,
79074290082,1422049611,1397885704,1422027512,-22099,,
79074790083,1422549612,1398385705,1422526843,-22769,,
79074975526,1422735056,1398571148,1422712287,-22769,1422712556,
79075290085,1423049614,1398885706,1423027015,-22599,,
79075790087,1423549616,1399385709,1423527119,-22497,,
79075999080,1423758610,1399594703,1423736114,-22496,1423737776,
79076290089,1424049618,1399885711,1424028090,-21528,,
79076790090,1424549619,1400385712,1424528788,-20831,,
79077023047,1424782577,1400618670,1424761746,-20831,1424761452,
79077290092,1425049621,1400885713,1425028634,-20987,,
79077790093,1425549623,1401385715,1425528500,-21123,,
79078042198,1425801728,1401637821,1425780606,-21122,1425778644,
79078290094,1426049623,1401885715,1426027527,-22096,,
79078790095,1426549625,1402385717,1426526542,-23083,,
79079066399,1426825928,1402662021,1426802847,-23081,1426805209,
79079290096,1427049626,1402885718,1427027600,-22026,,
79079790098,1427549627,1403385719,1427528910,-20717,,
79080086072,1427845602,1403681694,1427824885,-20717,1427822749,
79080290099,1428049628,1403885721,1428028040,-21588,,
79080790100,1428549629,1404385721,1428526780,-22849,,
79081109646,1428869176,1404705268,1428846328,-22848,1428848233,
79081290101,1429049630,1404885723,1429027468,-22162,,
79081790102,1429549631,1405385723,1429528691,-20940,,
79082133732,1429893262,1405729354,1429872322,-20940,1429872333,
79082290104,1430049633,1405885725,1430028696,-20937,,
79082790106,1430549635,1406385728,1430528709,-20926,,
79083157490,1430917021,1406753115,1430896098,-20923,1430895948,
79083290108,1431049637,1406885729,1431028671,-20966,,
79083790109,1431549638,1407385731,1431528570,-21068,,
79084181765,1431941295,1407777388,1431920228,-21067,1431920759,
79084290111,1432049640,1407885732,1432028688,-20952,,
79084790112,1432549641,1408385733,1432529108,-20533,,
79085205552,1432965082,1408801175,1432944550,-20532,1432944194,
79085290114,1433049644,1408885736,1433029049,-20595,,
79085790115,1433549644,1409385737,1433528759,-20885,,
79086229437,1433988967,1409825060,1433968083,-20884,1433968127,
79086290116,1434049645,1409885738,1434028764,-20881,,
79086790118,1434549648,1410385740,1434528810,-20838,,
79087253336,1435012865,1410848958,1434992029,-20836,1434992014,
79087290119,1435049648,1410885741,1435028808,-20840,,
79087790120,1435549649,1411385742,1435528800,-20849,,
79088277645,1436037175,1411873268,1436016327,-20848,1436016492,
79088290121,1436049651,1411885743,1436028804,-20847,,
79088790123,1436549652,1412385745,1436528972,-20680,,
79089302022,1437061552,1412897644,1437040872,-20680,1437040902,
79089302031,1437061561,1412897653,1437040879,-20682,,
79089802033,1437561562,1413397655,1437540915,-20647,,
79090326468,1438085998,1413922091,1438065352,-20646,1438065394,
79090326602,1438086132,1413922225,1438065485,-20647,,
79090826603,1438586133,1414422225,1438565531,-20602,,
79091350060,1439109589,1414945682,1439088989,-20600,1439088084,
79091350069,1439109599,1414945692,1439088997,-20602,,
79091850071,1439609600,1415445693,1439588097,-21503,,
79092373717,1440133247,1415969340,1440111744,-21503,1440112185,
79092373725,1440133254,1415969347,1440111749,-21505,,
79092873727,1440633256,1416469349,1440612197,-21059,,
79093397350,1441156880,1416992973,1441135821,-21059,1441135976,
79093397360,1441156889,1416992982,1441135827,-21062,,
79093897362,1441656891,1417492984,1441635991,-20900,,
79094420753,1442180283,1418016376,1442159383,-20900,1442159048,
79094420763,1442180292,1418016385,1442159391,-20901,,
79094920764,1442680293,1418516386,1442659061,-21232,,
79095444309,1443203839,1419039931,1443182607,-21232,1443182616,
79095444317,1443203847,1419039940,1443182613,-21234,,
79095944318,1443703848,1419539940,1443682628,-21220,,
79096463340,1444222870,1420058962,1444201650,-21220,1444199472,
79096463349,1444222879,1420058971,1444201658,-21221,,
79096963350,1444722880,1420558972,1444699484,-23396,,
79097486885,1445246415,1421082508,1445223021,-23394,1445225178,
79097486895,1445246424,1421082517,1445223028,-23396,,
79097986896,1445746426,1421582518,1445725191,-21235,,
79098505941,1446265471,1422101565,1446244237,-21234,1446242031,
79098505951,1446265481,1422101574,1446244244,-21237,,
79099005952,1446765481,1422601573,1446742043,-23438,,
79099529385,1447288915,1423125008,1447265477,-23438,1447267676,
79099529392,1447288922,1423125015,1447265483,-23439,,
79100029393,1447788922,1423625014,1447767685,-21237,,
79100529394,1448288923,1424125015,1448267686,-21237,,
79100552599,1448312128,1424148221,1448290891,-21237,1448290786,
79101029396,1448788925,1424625018,1448767589,-21336,,
79101529397,1449288926,1425125019,1449267586,-21340,,
79101573125,1449332655,1425168748,1449311316,-21339,1449309566,
79102029399,1449788928,1425625021,1449765995,-22933,,
79102529400,1450288930,1426125022,1450265843,-23087,,
79102596655,1450356185,1426192278,1450333100,-23085,1450334883,
79103029402,1450788931,1426625024,1450767390,-21541,,
79103529404,1451288933,1427125026,1451267633,-21300,,
79103620222,1451379752,1427215845,1451358453,-21299,1451358410,
79104029405,1451788934,1427625026,1451767601,-21333,,
79104529406,1452288936,1428125028,1452267597,-21339,,
79104643705,1452403235,1428239328,1452381897,-21338,1452381943,
79105029407,1452788936,1428625029,1452767635,-21301,,
79105529408,1453288938,1429125030,1453267649,-21289,,
79105662800,1453422329,1429258422,1453401041,-21288,1453398815,
79106029409,1453788938,1429625031,1453766020,-22918,,
79106529410,1454288939,1430125031,1454265428,-23511,,
79106684844,1454444373,1430280466,1454420863,-23510,1454422266,
79107029412,1454788941,1430625034,1454766398,-22543,,
79107529413,1455288942,1431125035,1455266837,-22105,,
79107706449,1455465979,1431302071,1455443874,-22105,1455443549,
79108029414,1455788943,1431625035,1455766629,-22314,,
79108529415,1456288945,1432125037,1456266518,-22427,,
79108725643,1456485173,1432321266,1456462747,-22426,1456461533,
79109029417,1456788946,1432625039,1456765784,-23162,,
79109529419,1457288948,1433125041,1457265311,-23637,,
79109749489,1457509018,1433345112,1457485382,-23636,1457487827,
79110029421,1457788950,1433625043,1457766683,-22267,,
79110529423,1458288952,1434125053,1458267772,-21180,,
79110772985,1458532515,1434368607,1458511326,-21189,1458511065,
79111029425,1458788954,1434625046,1458767632,-21322,,
79111529427,1459288956,1435125049,1459267510,-21446,,
79111805455,1459564985,1435401078,1459543538,-21447,1459547944,
79112029428,1459788957,1435625049,1459769484,-19473,,
79112529429,1460288958,1436125050,1460271920,-17038,,
79112830959,1460590489,1436426582,1460573452,-17037,1460570065,
79113029431,1460788960,1436625053,1460770578,-18382,,
79113529432,1461288962,1437125054,1461268540,-20422,,
79113851461,1461610991,1437447084,1461590570,-20421,1461587924,
79114029433,1461788962,1437625055,1461767598,-21364,,
79114529435,1462288965,1438125057,1462265900,-23065,,
79114874873,1462634402,1438470495,1462611339,-23063,1462612917,
79115029437,1462788966,1438625058,1462766389,-22577,,
79115529438,1463288967,1439125060,1463267484,-21483,,
79115894820,1463654350,1439490442,1463632867,-21483,1463630982,
79116029440,1463788969,1439625062,1463766978,-21991,,
79116529442,1464288972,1440125064,1464265606,-23366,,
79116925982,1464685511,1440521604,1464662148,-23363,1464667827,
79117029443,1464788973,1440625065,1464766781,-22192,,
79117529444,1465288973,1441125066,1465271291,-17682,,
79117949053,1465708582,1441544675,1465690900,-17682,1465687022,
79118029445,1465788974,1441625067,1465770668,-18306,,
79118529447,1466288976,1442125068,1466267418,-21558,,
79118972587,1466732117,1442568209,1466710559,-21558,1466710595,
79119029449,1466788978,1442625071,1466767423,-21555,,
79119529450,1467288980,1443125072,1467267460,-21520,,
79119991894,1467751424,1443587517,1467729904,-21520,1467727552,
79120029451,1467788980,1443625073,1467767282,-21698,,
79120529452,1468288981,1444125074,1468265111,-23870,,
79121015796,1468775326,1444611419,1468751457,-23869,1468753793,
79121029455,1468788984,1444625078,1468765179,-23805,,
79121529456,1469288985,1445125077,1469267455,-21530,,
79122035599,1469795129,1445631222,1469773599,-21530,1469771635,
79122035607,1469795136,1445631229,1469773605,-21531,,
79122535609,1470295138,1446131239,1470271655,-23483,,
79123059085,1470818615,1446654708,1470795124,-23491,1470796909,
79123059094,1470818624,1446654717,1470795131,-23493,,
79123559095,1471318625,1447154717,1471296921,-21704,,
79124082779,1471842308,1447678401,1471820605,-21703,1471820633,
79124082786,1471842315,1447678407,1471820611,-21704,,
79124582787,1472342317,1448178409,1472320643,-21674,,
79125106270,1472865800,1448701893,1472844128,-21672,1472844175,
79125106279,1472865809,1448701902,1472844135,-21674,,
79125606280,1473365810,1449201902,1473344188,-21622,,
79126125424,1473884954,1449721047,1473863332,-21622,1473861138,
79126125432,1473884961,1449721054,1473863338,-21623,,
79126625434,1474384963,1450221055,1474361149,-23814,,
79127145859,1474905389,1450741482,1474881576,-23813,1474882163,
79127145869,1474905399,1450741492,1474881583,-23816,,
79127645870,1475405399,1451241492,1475382175,-23224,,
79128165688,1475925217,1451761310,1475901994,-23223,1475900989,
79128165695,1475925224,1451761317,1475902000,-23224,,
79128665697,1476425226,1452261319,1476401000,-24226,,
79129185183,1476944712,1452780805,1476920487,-24225,1476920690,
79129185190,1476944720,1452780812,1476920493,-24227,,
79129685191,1477444720,1453280812,1477420700,-24020,,
79130208747,1477968277,1453804370,1477944258,-24019,1477946333,
79130208756,1477968286,1453804379,1477944266,-24020,,
79130708757,1478468286,1454304379,1478446345,-21941,,
79131231997,1478991527,1454827620,1478969586,-21941,1478969687,
79131232006,1478991536,1454827629,1478969594,-21942,,
79131732007,1479491536,1455327629,1479469698,-21838,,
79132255915,1480015445,1455851537,1479993607,-21838,1479993617,
79132255924,1480015454,1455851546,1479993614,-21840,,
79132755926,1480515455,1456351548,1480493630,-21825,,
79133279807,1481039336,1456875429,1481017512,-21824,1481017663,
79133279816,1481039346,1456875439,1481017520,-21826,,
79133779817,1481539346,1457375438,1481517675,-21671,,
79134299049,1482058579,1457894672,1482036909,-21670,1482034525,
79134299058,1482058588,1457894681,1482036915,-21673,,
79134799059,1482558588,1458394680,1482534536,-24052,,
79135299060,1483058589,1458894681,1483034537,-24052,,
79135322552,1483082082,1458918175,1483058030,-24052,1483060187,
79135799061,1483558591,1459394683,1483536598,-21993,,
79136299062,1484058591,1459894684,1484036699,-21892,,
79136346264,1484105793,1459941887,1484083903,-21890,1484083811,
79136799063,1484558593,1460394685,1484536620,-21973,,
79137299065,1485058594,1460894687,1485036614,-21980,,
79137369975,1485129504,1460965597,1485107525,-21979,1485107798,
79137799067,1485558597,1461394689,1485536853,-21744,,
79138299068,1486058598,1461894690,1486036893,-21705,,
79138393454,1486152984,1461989077,1486131281,-21703,1486131058,
79138799070,1486558599,1462394691,1486536717,-21882,,
79139299071,1487058600,1462894693,1487036677,-21923,,
79139417344,1487176875,1463012968,1487154953,-21922,1487155002,
79139799073,1487558602,1463394695,1487536720,-21882,,
79140299074,1488058603,1463894696,1488036734,-21869,,
79140440778,1488200308,1464036401,1488178440,-21868,1488178319,
79140799075,1488558604,1464394696,1488536649,-21955,,
79141299076,1489058605,1464894697,1489036618,-21987,,
79141459903,1489219433,1465055526,1489197446,-21987,1489195383,
79141799078,1489558607,1465394700,1489535222,-23385,,
79142299080,1490058609,1465894702,1490034561,-24048,,
79142479071,1490238601,1466074694,1490214554,-24047,1490214558,
79142799081,1490558611,1466394703,1490534567,-24044,,
79143299083,1491058612,1466894705,1491034572,-24040,,
79143498109,1491257638,1467093731,1491233599,-24039,1491233563,
79143799084,1491558613,1467394705,1491534553,-24060,,
79144299085,1492058615,1467894707,1492034542,-24073,,
79144517134,1492276664,1468112756,1492252591,-24073,1492252563,
79144799086,1492558616,1468394708,1492534527,-24089,,
79145299088,1493058617,1468894709,1493034519,-24098,,
79145539600,1493299130,1469135223,1493275032,-24098,1493276585,
79145799089,1493558618,1469394711,1493535327,-23291,,
79146299090,1494058619,1469894711,1494036077,-22542,,
79146563175,1494322705,1470158797,1494300163,-22542,1494300716,
79146799091,1494558621,1470394713,1494536341,-22280,,
79147299093,1495058622,1470894715,1495036636,-21986,,
79147582361,1495341890,1471177983,1495319905,-21985,1495317632,
79147799094,1495558623,1471394715,1495535652,-22971,,
79148299095,1496058625,1471894717,1496034369,-24256,,
79148605839,1496365368,1472201461,1496341113,-24255,1496343293,
79148799097,1496558626,1472394719,1496535213,-23413,,
79149299098,1497058628,1472894720,1497036554,-22074,,
79149625062,1497384591,1473220684,1497362519,-22072,1497360358,
79149799100,1497558629,1473394722,1497535804,-22825,,
79150299101,1498058631,1473894723,1498034399,-24232,,
79150644133,1498403663,1474239756,1498379433,-24230,1498379420,
79150799103,1498558632,1474394724,1498534398,-24234,,
79151299104,1499058633,1474894725,1499034393,-24240,,
79151665052,1499424581,1475260674,1499400342,-24239,1499400971,
79151799105,1499558634,1475394726,1499534562,-24072,,
79152299106,1500058636,1475894728,1500035028,-23608,,
79152688023,1500447553,1476283646,1500423945,-23608,1500425268,
79152799108,1500558637,1476394730,1500535322,-23315,,
79153299109,1501058638,1476894731,1501036356,-22282,,
79153711905,1501471434,1477307527,1501449153,-22281,1501449486,
79153799110,1501558639,1477394731,1501536414,-22225,,
79154299111,1502058641,1477894733,1502036695,-21946,,
79154732744,1502492273,1478328366,1502470328,-21945,1502467032,
79154799112,1502558641,1478394734,1502536257,-22384,,
79155299113,1503058643,1478894735,1503033404,-25239,,
79155756778,1503516308,1479352401,1503491069,-25239,1503494234,
79155799114,1503558645,1479394738,1503533675,-24970,,
79156299115,1504058645,1479894737,1504036574,-22071,,
79156780826,1504540356,1480376448,1504518285,-22071,1504518303,
79156799116,1504558645,1480394738,1504536573,-22072,,
79157299117,1505058647,1480894739,1505036596,-22051,,
79157804911,1505564441,1481400534,1505542391,-22050,1505542187,
79157804919,1505564449,1481400541,1505542398,-22051,,
79158304921,1506064450,1481900542,1506042199,-22251,,
79158824270,1506583800,1482419893,1506561550,-22250,1506559327,
79158824280,1506583810,1482419903,1506561558,-22252,,
79159324282,1507083811,1482919904,1507059340,-24471,,
79159847805,1507607334,1483443427,1507582865,-24469,1507585044,
79159847814,1507607344,1483443437,1507582872,-24472,,
79160347815,1508107345,1483943437,1508085056,-22289,,
79160871319,1508630848,1484466941,1508608561,-22287,1508608562,
79160871326,1508630856,1484466948,1508608567,-22289,,
79161371327,1509130856,1484966948,1509108572,-22284,,
79161894567,1509654097,1485490190,1509631814,-22283,1509631781,
79161894577,1509654107,1485490199,1509631821,-22286,,
79162394579,1510154108,1485990201,1510131794,-22314,,
79162917623,1510677153,1486513246,1510654839,-22314,1510654783,
79162917630,1510677160,1486513252,1510654845,-22315,,
79163417632,1511177162,1487013254,1511154794,-22368,,
79163941206,1511700736,1487536829,1511678369,-22367,1511678318,
79163941213,1511700743,1487536836,1511678374,-22369,,
79164441214,1512200743,1488036836,1512178327,-22416,,
79164941215,1512700744,1488536837,1512678329,-22415,,
79164964829,1512724358,1488560451,1512701943,-22415,1512702117,
79165441216,1513200745,1489036838,1513178497,-22248,,
79165941218,1513700747,1489536840,1513678508,-22239,,
79165984377,1513743907,1489579999,1513721668,-22239,1513719210,
79166441220,1514200749,1490036842,1514176266,-24483,,
79166941222,1514700752,1490536844,1514676057,-24695,,
79167011803,1514771333,1490607427,1514746640,-24693,1514750866,
79167441223,1515200752,1491036845,1515179691,-21061,,
79167941225,1515700755,1491536847,1515680292,-20463,,
79168032115,1515791645,1491627738,1515771183,-20462,1515767578,
79168441226,1516200756,1492036848,1516177346,-23410,,
79168941227,1516700757,1492536849,1516676693,-24064,,
79169056350,1516815879,1492651972,1516791817,-24062,1516793113,
79169441228,1517200757,1493036849,1517177693,-23064,,
79169941229,1517700758,1493536851,1517677994,-22764,,
79170075612,1517835142,1493671235,1517812378,-22764,1517810465,
79170441236,1518200766,1494036858,1518176603,-24163,,
79170941238,1518700767,1494536859,1518676092,-24675,,
79171099098,1518858627,1494694720,1518833953,-24674,1518836097,
79171441239,1519200769,1495036861,1519177562,-23207,,
79171941240,1519700770,1495536862,1519678241,-22529,,
79172122854,1519882383,1495718476,1519859856,-22527,1519860074,
79172441242,1520200771,1496036863,1520178383,-22388,,
79172941243,1520700773,1496536865,1520678466,-22307,,
79173146621,1520906150,1496742243,1520883844,-22306,1520883779,
79173441244,1521200773,1497036865,1521178429,-22344,,
79173941246,1521700775,1497536868,1521678406,-22369,,
79174167449,1521926979,1497763072,1521904611,-22368,1521902920,
79174441247,1522200776,1498036869,1522177482,-23294,,
79174941249,1522700779,1498536871,1522676721,-24058,,
79175192447,1522951977,1498788070,1522927921,-24056,1522930172,
79175441250,1523200780,1499036872,1523177843,-22937,,
79175941251,1523700781,1499536873,1523678978,-21803,,
79176216109,1523975639,1499811732,1523953838,-21801,1523953089,
79176441253,1524200782,1500036875,1524178644,-22138,,
79176941254,1524700783,1500536876,1524678237,-22546,,
79177235578,1524995108,1500831201,1524972562,-22546,1524970247,
79177441256,1525200785,1501036878,1525177287,-23498,,
79177941257,1525700786,1501536878,1525675928,-24858,,
79178256503,1526016033,1501852126,1525991176,-24857,1525992057,
79178441258,1526200787,1502036880,1526176254,-24533,,
79178941260,1526700789,1502536882,1526676815,-23974,,
79179275903,1527035433,1502871526,1527011460,-23973,1527010631,
79179441261,1527200791,1503036883,1527176542,-24249,,
79179941263,1527700792,1503536885,1527675993,-24799,,
79180296019,1528055549,1503891642,1528030751,-24798,1528031555,
79180441265,1528200794,1504036887,1528176229,-24565,,
79180941266,1528700796,1504536888,1528676805,-23991,,
79181319948,1529079478,1504915571,1529055487,-23991,1529056993,
79181441267,1529200796,1505036889,1529177169,-23627,,
79181941269,1529700798,1505536891,1529678315,-22483,,
79182341300,1530100829,1505936922,1530078347,-22482,1530076986,
79182441270,1530200800,1506036892,1530178045,-22755,,
79182941271,1530700801,1506536893,1530676960,-23841,,
79183364745,1531124275,1506960368,1531100435,-23840,1531101670,
79183441272,1531200801,1507036894,1531177148,-23653,,
79183941273,1531700803,1507536895,1531678201,-22602,,
79184389262,1532148792,1507984885,1532126190,-22602,1532126561,
79184441274,1532200803,1508036896,1532178239,-22564,,
79184941275,1532700805,1508536897,1532678577,-22228,,
79185409333,1533168862,1509004955,1533146635,-22227,1533144169,
79185441277,1533200806,1509036899,1533178419,-22387,,
79185941278,1533700807,1509536900,1533676116,-24691,,
79186433026,1534192556,1510028649,1534167865,-24691,1534169628,
79186441279,1534200808,1510036901,1534176145,-24663,,
79186941280,1534700809,1510536902,1534677883,-22926,,
79187452146,1535211676,1511047768,1535188750,-22926,1535186840,
79187452155,1535211685,1511047777,1535188758,-22927,,
79187952157,1535711686,1511547779,1535686854,-24832,,
79188475951,1536235481,1512071574,1536210650,-24831,1536212911,
79188475961,1536235490,1512071583,1536210657,-24833,,
79188975963,1536735492,1512571584,1536712924,-22568,,
79189499928,1537259457,1513095550,1537236889,-22568,1537236754,
79189499968,1537259497,1513095590,1537236928,-22569,,
79189999969,1537759498,1513595591,1537736798,-22700,,
79190537170,1538296700,1514132793,1538273999,-22701,1538262780,
79190537178,1538296707,1514132800,1538274006,-22701,,
79191037179,1538796708,1514632801,1538762790,-33918,,
79191556400,1539315929,1515152022,1539282012,-33917,1539290933,
79191556407,1539315937,1515152029,1539282018,-33919,,
79192056408,1539815937,1515652030,1539790943,-24994,,
79192580749,1540340279,1516176372,1540315286,-24993,1540317340,
79192580801,1540340331,1516176424,1540315337,-24994,,
79193080802,1540840331,1516676424,1540817395,-22936,,
79193600653,1541360183,1517196276,1541337248,-22935,1541335579,
79193600662,1541360192,1517196285,1541337255,-22937,,
79194100663,1541860193,1517696285,1541835592,-24601,,
79194619742,1542379272,1518215364,1542354671,-24601,1542354351,
79194619751,1542379281,1518215374,1542354679,-24602,,
79195119753,1542879282,1518715375,1542854364,-24918,,
79195640538,1543400068,1519236160,1543375150,-24918,1543375859,
79195640580,1543400110,1519236203,1543375191,-24919,,
79196140581,1543900110,1519736202,1543875904,-24206,,
79196640582,1544400112,1520236204,1544375906,-24206,,
79196664478,1544424008,1520260101,1544399803,-24205,1544401160,
79197140584,1544900113,1520736206,1544877201,-22912,,
79197640585,1545400114,1521236207,1545377268,-22846,,
79197685182,1545444712,1521280805,1545421866,-22846,1545420614,
79198140586,1545900115,1521736208,1545876130,-23985,,
79198640587,1546400116,1522236209,1546376020,-24096,,
79198708327,1546467857,1522303950,1546443761,-24096,1546444936,
79199140588,1546900117,1522736210,1546877039,-23078,,
79199640590,1547400119,1523236212,1547377200,-22919,,
79199731748,1547491278,1523327371,1547468360,-22918,1547468422,
79200140592,1547900121,1523736214,1547877256,-22865,,
79200640594,1548400123,1524236215,1548377270,-22853,,
79200750967,1548510496,1524346589,1548487644,-22852,1548485399,
79201140595,1548900125,1524736217,1548875526,-24599,,
79201640596,1549400125,1525236217,1549375031,-25094,,
79201770137,1549529666,1525365759,1549504573,-25093,1549504493,
79202140597,1549900127,1525736219,1549874976,-25151,,
79202640598,1550400128,1526236220,1550374957,-25171,,
79202793929,1550553459,1526389551,1550528289,-25170,1550530639,
79203140599,1550900128,1526736220,1550876588,-23540,,
79203640600,1551400130,1527236222,1551377312,-22818,,
79203813931,1551573461,1527409554,1551550645,-22816,1551548470,
79204140601,1551900130,1527736223,1551875894,-24236,,
79204640603,1552400132,1528236225,1552375144,-24988,,
79204833533,1552593063,1528429156,1552568076,-24987,1552568061,
79205140605,1552900134,1528736226,1552875139,-24995,,
79205640607,1553400136,1529236229,1553375137,-24999,,
79205856777,1553616307,1529452399,1553591308,-24999,1553593271,
79206140608,1553900137,1529736230,1553876253,-23884,,
79206640609,1554400139,1530236231,1554377105,-23034,,
79206880339,1554639868,1530475961,1554616836,-23032,1554616850,
79207140610,1554900140,1530736232,1554877114,-23026,,
79207640611,1555400140,1531236233,1555377124,-23016,,
79207899594,1555659123,1531495216,1555636108,-23015,1555633981,
79208140612,1555900142,1531736234,1555876101,-24041,,
79208640614,1556400143,1532236236,1556375004,-25139,,
79208918745,1556678275,1532514368,1556653137,-25138,1556652945,
79209140616,1556900145,1532736238,1556874921,-25224,,
79209640618,1557400148,1533236240,1557374819,-25329,,
79209937999,1557697529,1533533622,1557672202,-25327,1557672225,
79210140619,1557900148,1533736241,1557874830,-25318,,
79210640621,1558400150,1534236242,1558374849,-25301,,
79210961528,1558721058,1534557151,1558695758,-25300,1558698006,
79211140622,1558900152,1534736244,1558875657,-24495,,
79211640623,1559400152,1535236245,1559377103,-23049,,
79211985103,1559744632,1535580725,1559721584,-23048,1559721515,
79212140624,1559900153,1535736246,1559877082,-23071,,
79212640626,1560400155,1536236248,1560377040,-23115,,
79213008461,1560767991,1536604083,1560744876,-23115,1560744781,
79213140627,1560900157,1536736249,1560877017,-23140,,
79213640628,1561400157,1537236250,1561376950,-23207,,
79214031916,1561791446,1537627539,1561768240,-23206,1561768307,
79214140630,1561900159,1537736252,1561876967,-23192,,
79214640631,1562400161,1538236253,1562377025,-23136,,
79215055402,1562814931,1538651024,1562791795,-23136,1562791789,
79215140633,1562900162,1538736255,1562877025,-23137,,
79215640635,1563400164,1539236256,1563377024,-23140,,
79216075266,1563834795,1539670888,1563811657,-23138,1563809795,
79216140636,1563900165,1539736257,1563876780,-23385,,
79216640637,1564400166,1540236258,1564375168,-24998,,
79217102567,1564862097,1540698190,1564837100,-24997,1564836857,
79217140638,1564900168,1540736262,1564875154,-25014,,
79217640640,1565400169,1541236262,1565374932,-25237,,
79218122706,1565882236,1541718328,1565856999,-25237,1565857349,
79218140642,1565900171,1541736263,1565874945,-25226,,
79218640644,1566400173,1542236265,1566375289,-24884,,
79219147592,1566907122,1542743215,1566882239,-24883,1566883393,
79219147602,1566907132,1542743224,1566882246,-24886,,
79219647604,1567407133,1543243225,1567383407,-23726,,
79220170282,1567929812,1543765904,1567906086,-23726,1567906317,
79220170289,1567929819,1543765911,1567906092,-23727,,
79220670290,1568429820,1544265912,1568406327,-23493,,
79221193717,1568953247,1544789340,1568929756,-23491,1568930018,
79221193727,1568953256,1544789349,1568929764,-23492,,
79221693729,1569453258,1545289351,1569430032,-23226,,
79222217120,1569976650,1545812743,1569953425,-23225,1569953415,
79222217129,1569976659,1545812752,1569953432,-23227,,
79222717130,1570476660,1546312752,1570453428,-23232,,
79223217131,1570976660,1546812752,1570953428,-23232,,
79223241050,1571000580,1546836672,1570977348,-23232,1570977457,
79223717132,1571476661,1547312753,1571453535,-23126,,
79224217133,1571976662,1547812754,1571953541,-23121,,
79224262476,1572022006,1547858099,1571998886,-23120,1571997329,
79224717135,1572476664,1548312757,1572452131,-24533,,
79225217137,1572976666,1548812759,1572951992,-24674,,
79225285888,1573045417,1548881511,1573020744,-24673,1573022072,
79225717139,1573476668,1549312761,1573453142,-23526,,
79226217141,1573976670,1549812763,1573953327,-23343,,
79226305082,1574064611,1549900704,1574041269,-23342,1574039086,
79226717143,1574476672,1550312765,1574451532,-25140,,
79227217144,1574976674,1550812766,1574951150,-25524,,
79227329017,1575088547,1550924641,1575063026,-25521,1575065341,
79227717145,1575476675,1551312767,1575452951,-23724,,
79228217146,1575976676,1551812768,1575953472,-23204,,
79228352932,1576112462,1551948555,1576089260,-23202,1576089271,
79228717147,1576476677,1552312769,1576453484,-23193,,
79229217148,1576976677,1552812770,1576953489,-23188,,
79229372120,1577131649,1552967742,1577108462,-23187,1577106015,
79229717149,1577476679,1553312771,1577451804,-24875,,
79230217151,1577976680,1553812773,1577951048,-25632,,
79230395678,1578155208,1553991301,1578129577,-25631,1578131942,
79230717153,1578476682,1554312774,1578452572,-24110,,
79231217154,1578976684,1554812777,1578953420,-23264,,
79231414865,1579174395,1555010488,1579151132,-23263,1579148783,
79231717155,1579476684,1555312777,1579452001,-24683,,
79232217156,1579976686,1555812778,1579951076,-25610,,
79232435912,1580195442,1556031534,1580169832,-25610,1580170702,
79232717158,1580476687,1556312779,1580451568,-25119,,
79233217160,1580976689,1556812782,1580951952,-24737,,
79233460216,1581219746,1557055838,1581195009,-24737,1581196682,
79233717161,1581476690,1557312783,1581452814,-23876,,
79234217163,1581976692,1557812785,1581953631,-23061,,
79234485141,1582244671,1558080764,1582221611,-23060,1582221831,
79234717164,1582476693,1558312785,1582453736,-22957,,
79235217165,1582976694,1558812787,1582953857,-22837,,
79235505391,1583264921,1559101014,1583242084,-22837,1583239389,
79235717166,1583476695,1559312788,1583452716,-23979,,
79236217168,1583976697,1559812789,1583951168,-25529,,
79236528909,1584288439,1560124531,1584262911,-25528,1584264932,
79236717170,1584476699,1560312792,1584451931,-24768,,
79237217171,1584976701,1560812793,1584953196,-23505,,
79237552420,1585311949,1561148042,1585288446,-23503,1585288463,
79237717172,1585476701,1561312794,1585453203,-23498,,
79238217174,1585976703,1561812796,1585953219,-23484,,
79238575969,1586335499,1562171591,1586312015,-23484,1586311918,
79238717176,1586476705,1562312798,1586453194,-23511,,
79239217177,1586976706,1562812798,1586953128,-23578,,
79239599631,1587359161,1563195254,1587335584,-23577,1587335481,
79239717179,1587476708,1563312801,1587453105,-23603,,
79240217180,1587976710,1563812802,1587953032,-23678,,
79240623200,1588382730,1564218823,1588359053,-23677,1588359048,
79240717181,1588476711,1564312803,1588453032,-23679,,
79241217182,1588976712,1564812804,1588953033,-23679,,
79241642448,1589401977,1565238071,1589378299,-23678,1589376195,
79241717183,1589476712,1565312804,1589452717,-23995,,
79242217185,1589976714,1565812807,1589950934,-25780,,
79242666199,1590425730,1566261823,1590399952,-25778,1590402047,
79242717186,1590476716,1566312808,1590451146,-25570,,
79243217188,1590976717,1566812810,1590953038,-23679,,
79243685682,1591445211,1567281304,1591421533,-23678,1591419307,
79243717190,1591476719,1567312812,1591452900,-23819,,
79244217191,1591976720,1567812813,1591950818,-25902,,
79244709147,1592468677,1568304770,1592442776,-25901,1592444935,
79244717193,1592476722,1568312815,1592450852,-25870,,
79245217194,1592976724,1568812816,1592952985,-23739,,
79245733176,1593492706,1569328799,1593468968,-23738,1593469248,
79245733186,1593492716,1569328808,1593468975,-23741,,
79246233188,1593992717,1569828810,1593969262,-23455,,
79246755625,1594515154,1570351247,1594491699,-23455,1594490846,
79246755668,1594515197,1570351290,1594491741,-23456,,
79247255670,1595015199,1570851292,1594990893,-24306,,
79247779857,1595539387,1571375479,1595515081,-24306,1595516048,
79247779866,1595539396,1571375489,1595515089,-24307,,
79248279867,1596039397,1571875489,1596016061,-23336,,
79248800391,1596559921,1572396013,1596536585,-23336,1596534688,
79248800400,1596559930,1572396022,1596536592,-23338,,
79249300402,1597059931,1572896024,1597034701,-25230,,
79249823738,1597583268,1573419361,1597558038,-25230,1597559488,
79249823781,1597583310,1573419403,1597558081,-25229,,
79250323782,1598083312,1573919404,1598059535,-23777,,
79250847853,1598607383,1574443476,1598583607,-23776,1598583838,
79250847863,1598607393,1574443486,1598583614,-23779,,
79251347864,1599107393,1574943486,1599083851,-23542,,
79251867861,1599627390,1575463483,1599603849,-23541,1599601782,
79251867868,1599627398,1575463490,1599603855,-23543,,
79252367870,1600127399,1575963491,1600101793,-25606,,
79252887448,1600646979,1576483072,1600621375,-25604,1600621062,
79252887527,1600647057,1576483151,1600621450,-25607,,
79253387529,1601147059,1576983151,1601121145,-25914,,
79253907078,1601666608,1577502701,1601640695,-25913,1601640891,
79253907088,1601666617,1577502710,1601640703,-25914,,
79254407089,1602166618,1578002711,1602140904,-25714,,
79254930771,1602690301,1578526393,1602664587,-25714,1602666375,
79254930780,1602690310,1578526402,1602664594,-25716,,
79255430782,1603190311,1579026404,1603166388,-23923,,
79255949901,1603709431,1579545524,1603685508,-23923,1603683398,
79255949943,1603709472,1579545565,1603685548,-23924,,
79256449944,1604209473,1580045565,1604183442,-26031,,
79256973643,1604733172,1580569265,1604707142,-26030,1604709408,
79256973650,1604733179,1580569272,1604707148,-26031,,
79257473652,1605233181,1581069274,1605209419,-23762,,
79257992880,1605752410,1581588502,1605728648,-23762,1605726272,
79257992889,1605752419,1581588512,1605728656,-23763,,
79258492891,1606252420,1582088513,1606226285,-26135,,
79259011895,1606771425,1582607518,1606745291,-26134,1606745447,
79259011943,1606771472,1582607565,1606745337,-26135,,
79259511944,1607271474,1583107566,1607245498,-25976,,
79260033331,1607792861,1583628953,1607766886,-25975,1607767780,
79260033338,1607792868,1583628961,1607766891,-25977,,
79260533339,1608292868,1584128961,1608267789,-25079,,
79261033340,1608792869,1584628962,1608767790,-25079,,
79261056748,1608816278,1584652371,1608791200,-25078,1608792358,
79261533341,1609292871,1585128963,1609268899,-23972,,
79262033343,1609792872,1585628965,1609768955,-23917,,
79262082340,1609841870,1585677963,1609817954,-23916,1609816878,
79262533345,1610292874,1586128967,1610267990,-24884,,
79263033347,1610792876,1586628969,1610767888,-24988,,
79263101577,1610861106,1586697199,1610836118,-24988,1610834962,
79263533349,1611292878,1587128971,1611266893,-25985,,
79264033351,1611792881,1587628973,1611766738,-26143,,
79264120777,1611880306,1587716399,1611854165,-26141,1611854102,
79264533353,1612292882,1588128974,1612266690,-26192,,
79265033354,1612792883,1588628975,1612766681,-26202,,
79265140095,1612899624,1588735717,1612873423,-26201,1612873406,
79265533356,1613292885,1589128978,1613266672,-26213,,
79266033358,1613792887,1589628980,1613766671,-26216,,
79266159298,1613918828,1589754921,1613892613,-26215,1613892815,
79266533359,1614292889,1590128981,1614266826,-26063,,
79267033361,1614792890,1590628982,1614766880,-26010,,
79267182879,1614942409,1590778502,1614916400,-26009,1614918457,
79267533362,1615292891,1591128983,1615268324,-24567,,
79268033363,1615792892,1591628985,1615768942,-23950,,
79268206422,1615965952,1591802045,1615942002,-23950,1615942047,
79268533364,1616292893,1592128985,1616268973,-23920,,
79269033366,1616792895,1592628988,1616768993,-23902,,
79269225481,1616985011,1592821104,1616961110,-23901,1616958821,
79269533367,1617292896,1593128989,1617267587,-25309,,
79270033368,1617792897,1593628989,1617766710,-26187,,
79270246245,1618005774,1593841867,1617979588,-26186,1617980518,
79270533369,1618292898,1594128991,1618267247,-25651,,
79271033370,1618792899,1594628991,1618767645,-25254,,
79271265777,1619025307,1594861400,1619000053,-25254,1618999300,
79271533371,1619292901,1595128993,1619267245,-25656,,
79272033372,1619792901,1595628994,1619766897,-26004,,
79272289332,1620048862,1595884955,1620022859,-26003,1620024802,
79272533375,1620292905,1596128997,1620267851,-25054,,
79273033377,1620792906,1596628999,1620768849,-24057,,
79273312835,1621072365,1596908457,1621048308,-24057,1621048296,
79273533379,1621292908,1597129001,1621268847,-24061,,
79274033382,1621792911,1597629004,1621768846,-24065,,
79274336367,1622095897,1597931990,1622071831,-24066,1622071719,
79274533383,1622292913,1598129005,1622268802,-24111,,
79275033384,1622792913,1598629006,1622768737,-24176,,
79275359977,1623119507,1598955600,1623095332,-24175,1623095355,
79275533386,1623292915,1599129008,1623268747,-24168,,
79276033388,1623792917,1599629010,1623768768,-24149,,
79276383472,1624143002,1599979095,1624118854,-24148,1624118843,
79276533390,1624292919,1600129011,1624268767,-24152,,
79277033391,1624792920,1600629012,1624768764,-24156,,
79277406991,1625166521,1601002614,1625142366,-24155,1625142254,
