Current Real Time,Local Server Time,Hardware Clock Time,Software Clock Time,Error,Remote Est Time,
7011984744,5932800455,909236,909237,-5931891218,,
7012002877,5932818588,927370,927370,-5931891218,5932818548,
7012253062,5933068775,1177556,1485265546,-4447803229,,
7012503638,5933319350,1428132,2971905687,-2961413663,,
7012754014,5933569726,1678507,4457359249,-1476210477,,
7013004489,5933820201,1928983,5933820163,-38,,
7013254986,5934070698,2179479,5934070660,-38,,
7013505592,5934321304,2430086,5934321266,-38,,
7013755740,5934571453,2680234,5934571415,-38,,
7014005927,5934821639,2930420,5934821601,-38,,
7014024178,5934839890,2948671,5934839851,-39,5934839776,
7014274740,5935090452,3199234,5935090394,-58,,
7014525470,5935341182,3449964,5935341106,-76,,
7014775864,5935591576,3700358,5935591482,-94,,
7015026099,5935841811,3950602,5935841709,-102,,
7015276751,5936092463,4201244,5936092351,-112,,
7015527437,5936343150,4451932,5936343038,-112,,
7015777875,5936593587,4702369,5936593476,-111,,
7016028234,5936843946,4952727,5936843834,-112,,
7016046384,5936862096,4970877,5936861984,-112,5936862038,
7016296871,5937112583,5221365,5937112485,-98,,
7016547588,5937363300,5472082,5937363216,-84,,
7016797773,5937613485,5722267,5937613415,-70,,
7017048077,5937863789,5972571,5937863734,-55,,
7017298320,5938114032,6222814,5938113976,-56,,
7017548941,5938364653,6473435,5938364597,-56,,
7017799225,5938614937,6723718,5938614881,-56,,
7018050133,5938865845,6974627,5938865789,-56,,
7018068305,5938884016,6992797,5938883960,-56,5938884012,
7018318914,5939134626,7243408,5939134582,-44,,
7018569513,5939385225,7494007,5939385195,-30,,
7018819913,5939635625,7744407,5939635608,-17,,
7019070545,5939886257,7995039,5939886254,-3,,
7019320663,5940136375,8245157,5940136383,8,,
7019571124,5940386836,8495618,5940386833,-3,,
7019821500,5940637212,8745994,5940637210,-2,,
7020071804,5940887516,8996298,5940887513,-3,,
7020089953,5940905664,9014445,5940905661,-3,5940905607,
7020340163,5941155875,9264656,5941155859,-16,,
7020590353,5941406065,9514846,5941406035,-30,,
7020840787,5941656499,9765281,5941656458,-41,,
7021091651,5941907363,10016145,5941907308,-55,,
7021341762,5942157473,10266255,5942157418,-55,,
7021592055,5942407767,10516549,5942407712,-55,,
7021842804,5942658517,10767299,5942658462,-55,,
7022093217,5942908929,11017710,5942908874,-55,,
7022111402,5942927113,11035895,5942927058,-55,5942927042,
7022362106,5943177828,11286610,5943177769,-59,,
7022612574,5943428286,11537068,5943428223,-63,,
7022862732,5943678444,11787226,5943678379,-65,,
7023113612,5943929324,12038105,5943929254,-70,,
7023364278,5944179991,12288772,5944179921,-70,,
7023614665,5944430378,12539159,5944430308,-70,,
7023865123,5944680835,12789617,5944680766,-69,,
7024115290,5944931013,13039794,5944930943,-70,,
7024133528,5944949239,13058020,5944949169,-70,5944949153,
7024383889,5945199601,13308383,5945199529,-72,,
7024634223,5945449935,13558716,5945449858,-77,,
7024884789,5945700501,13809283,5945700421,-80,,
7025135380,5945951092,14059873,5945951008,-84,,
7025385549,5946201261,14310042,5946201177,-84,,
7025635748,5946451459,14560251,5946451385,-74,,
7025885903,5946701616,14810398,5946701532,-84,,
7026136825,5946952536,15061318,5946952462,-74,,
7026155208,5946970920,15079701,5946970835,-85,5946970814,
7026406114,5947221826,15330607,5947221737,-89,,
7026656855,5947472568,15581349,5947472474,-94,,
7026907466,5947723178,15831960,5947723079,-99,,
7027157639,5947973351,16082132,5947973247,-104,,
7027408354,5948224066,16332847,5948223961,-105,,
7027659168,5948474880,16583662,5948474776,-104,,
7027909708,5948725420,16834202,5948725316,-104,,
7028160681,5948976393,17085174,5948976289,-104,,
7028178955,5948994667,17103448,5948994562,-105,5948994597,
7028429296,5949245008,17353789,5949244912,-96,,
7028679776,5949495488,17604269,5949495400,-88,,
7028930018,5949745730,17854511,5949745653,-77,,
7029180223,5949995935,18104716,5949995867,-68,,
7029430656,5950246368,18355150,5950246300,-68,,
7029681168,5950496881,18605662,5950496812,-69,,
7029931521,5950747233,18856015,5950747165,-68,,
7030181710,5950997422,19106204,5950997354,-68,,
7030199999,5951015711,19124492,5951015643,-68,5951015632,
7030450689,5951266400,19375182,5951266329,-71,,
7030701310,5951517022,19625803,5951516949,-73,,
7030951925,5951767637,19876419,5951767562,-75,,
7031202349,5952018061,20126842,5952017994,-67,,
7031452591,5952268303,20377084,5952268236,-67,,
7031702773,5952518485,20627267,5952518408,-77,,
7031952958,5952768670,20877452,5952768593,-77,,
7032203425,5953019137,21127918,5953019060,-77,,
7032221732,5953037443,21146224,5953037366,-77,5953037410,
7032471869,5953287581,21396362,5953287515,-66,,
7032722724,5953538436,21647218,5953538382,-54,,
7032973446,5953789158,21897940,5953789115,-43,,
7033223590,5954039302,22148084,5954039271,-31,,
7033473813,5954289525,22398307,5954289494,-31,,
7033724077,5954539799,22648580,5954539768,-31,,
7033974953,5954790665,22899447,5954790635,-30,,
7034225090,5955040803,23149584,5955040772,-31,,
7034243286,5955058998,23167779,5955058967,-31,5955058932,
7034493428,5955309140,23417921,5955309101,-39,,
7034743763,5955559476,23668257,5955559429,-47,,
7034994182,5955809894,23918676,5955809840,-54,,
7035244752,5956060473,24169255,5956060409,-64,,
7035495404,5956311116,24419898,5956311052,-64,,
7035745949,5956561662,24670443,5956561598,-64,,
7035996592,5956812304,24921086,5956812241,-63,,
7036246706,5957062417,25171199,5957062353,-64,,
7036264994,5957080706,25189487,5957080641,-65,5957080537,
7036515316,5957331029,25439810,5957330938,-91,,
7036765857,5957581569,25690350,5957581453,-116,,
7037016051,5957831763,25940545,5957831621,-142,,
7037266475,5958082188,26190970,5958082021,-167,,
7037516895,5958332608,26441389,5958332440,-168,,
7037767047,5958582760,26691541,5958582593,-167,,
7038017618,5958833331,26942112,5958833164,-167,,
7038268390,5959084102,27192893,5959083945,-157,,
7038286726,5959102438,27211219,5959102270,-168,5959102312,
7038537278,5959352991,27461773,5959352834,-157,,
7038787457,5959603169,27711951,5959603023,-146,,
7039037977,5959853689,27962471,5959853554,-135,,
7039288244,5960103956,28212738,5960103833,-123,,
7039539404,5960355116,28463898,5960354992,-124,,
7039790022,5960605734,28714516,5960605611,-123,,
7040040418,5960856131,28964912,5960856006,-125,,
7040291144,5961106856,29215638,5961106732,-124,,
7040309354,5961125065,29233846,5961124941,-124,5961124962,
7040559801,5961375512,29484294,5961375394,-118,,
7040810331,5961626043,29734825,5961625931,-112,,
7041061042,5961876754,29985536,5961876648,-106,,
7041311333,5962127045,30235827,5962126944,-101,,
7041563019,5962378731,30487513,5962378630,-101,,
7041813728,5962629440,30738222,5962629340,-100,,
7042064228,5962879941,30988723,5962879840,-101,,
7042315247,5963130959,31239741,5963130858,-101,,
7042333491,5963149203,31257984,5963149101,-102,5963149086,
7042583734,5963399447,31508228,5963399341,-106,,
7042834475,5963650187,31758969,5963650078,-109,,
7043084981,5963900694,32009475,5963900582,-112,,
7043335321,5964151033,32259814,5964150918,-115,,
7043585439,5964401151,32509933,5964401036,-115,,
7043835698,5964651410,32760191,5964651295,-115,,
7044086616,5964902328,33011110,5964902213,-115,,
7044337354,5965153067,33261848,5965152952,-115,,
7044355644,5965171355,33280136,5965171240,-115,5965171219,
7044606383,5965422095,33530877,5965421974,-121,,
7044856694,5965672406,33781187,5965672281,-125,,
7045107397,5965923110,34031892,5965922980,-130,,
7045357937,5966173649,34282431,5966173515,-134,,
7045608335,5966424048,34532829,5966423914,-134,,
7045859064,5966674777,34783558,5966674643,-134,,
7046109714,5966925426,35034208,5966925292,-134,,
7046360530,5967176242,35285024,5967176108,-134,,
7046378735,5967194446,35303227,5967194311,-135,5967194344,
7046629382,5967445094,35553876,5967444967,-127,,
7046879613,5967695326,35804107,5967695208,-118,,
7047130094,5967945807,36054588,5967945698,-109,,
7047380611,5968196322,36305104,5968196223,-99,,
7047630883,5968446596,36555378,5968446496,-100,,
7047881477,5968697189,36805970,5968697089,-100,,
7048131794,5968947507,37056289,5968947407,-100,,
7048382233,5969197946,37306728,5969197846,-100,,
7048400543,5969216254,37325036,5969216154,-100,5969216117,
7048650867,5969466579,37575361,5969466469,-110,,
7048901325,5969717037,37825818,5969716918,-119,,
7049152165,5969967877,38076659,5969967750,-127,,
7049402583,5970218296,38327078,5970218160,-136,,
7049652833,5970468546,38577327,5970468410,-136,,
7049903326,5970719038,38827820,5970718903,-135,,
7050153882,5970969595,39078376,5970969459,-136,,
7050404486,5971220198,39328980,5971220062,-136,,
7050422723,5971238434,39347215,5971238298,-136,5971238299,
7050673659,5971489371,39598153,5971489235,-136,,
7050923973,5971739685,39848467,5971739550,-135,,
7051174764,5971990477,40099259,5971990343,-134,,
7051425535,5972241247,40350029,5972241114,-133,,
7051676090,5972491802,40600584,5972491670,-132,,
7051926419,5972742132,40850914,5972741999,-133,,
7052177221,5972992933,41101715,5972992800,-133,,
7052427825,5973243537,41352318,5973243404,-133,,
7052446207,5973261919,41370700,5973261785,-134,5973261706,
7052696946,5973512664,41621446,5973512511,-153,,
7052947487,5973763199,41871981,5973763027,-172,,
7053198137,5974013849,42122631,5974013658,-191,,
7053449137,5974264850,42373631,5974264639,-211,,
7053699598,5974515311,42624093,5974515100,-211,,
7053950042,5974765754,42874536,5974765543,-211,,
7054200744,5975016455,43125237,5975016245,-210,,
7054451042,5975266754,43375536,5975266543,-211,,
7054469915,5975285627,43394408,5975285415,-212,5975285190,
7054720549,5975536261,43645043,5975535994,-267,,
7054971104,5975786816,43895598,5975786492,-324,,
7055221728,5976037440,44146222,5976037060,-380,,
7055472329,5976288041,44396823,5976287607,-434,,
7055723253,5976538964,44647746,5976538530,-434,,
7055973847,5976789560,44898341,5976789125,-435,,
7056224632,5977040344,45149126,5977039909,-435,,
7056474952,5977290665,45399446,5977290230,-435,,
7056493122,5977308833,45417614,5977308398,-435,5977308646,
7056743992,5977559705,45668486,5977559332,-373,,
7056994597,5977810309,45919090,5977809999,-310,,
7057244864,5978060576,46169357,5978060329,-247,,
7057495618,5978311331,46420113,5978311146,-185,,
7057746168,5978561880,46670662,5978561695,-185,,
7057996630,5978812342,46921123,5978812157,-185,,
7058247224,5979062936,47171717,5979062751,-185,,
7058497674,5979313386,47422168,5979313201,-185,,
7058521376,5979337087,47445868,5979336902,-185,5979334155,
7058771870,5979587582,47696364,5979586709,-873,,
7059022082,5979837795,47946576,5979836235,-1560,,
7059272391,5980088104,48196885,5980085857,-2247,,
7059522977,5980338689,48447471,5980335759,-2930,,
7059773917,5980589629,48698411,5980586699,-2930,,
7060024352,5980840065,48948846,5980837135,-2930,,
7060274813,5981090525,49199307,5981087595,-2930,,
7060525529,5981341241,49450023,5981338312,-2929,,
7060543709,5981359420,49468202,5981356490,-2930,5981359214,
7060794038,5981609751,49718532,5981607503,-2248,,
7061044873,5981860586,49969367,5981859021,-1565,,
7061295455,5982111167,50219949,5982110287,-880,,
7061546068,5982361780,50470562,5982361575,-205,,
7061800381,5982616093,50724875,5982615888,-205,,
7062050649,5982866361,50975143,5982866156,-205,,
7062300793,5983116505,51225286,5983116300,-205,,
7062551715,5983367427,51476209,5983367222,-205,,
7062569926,5983385638,51494419,5983385433,-205,5983385435,
7062820832,5983636544,51745326,5983636341,-203,,
7063071348,5983887061,51995843,5983886858,-203,,
7063322053,5984137765,52246546,5984137563,-202,,
7063572928,5984388640,52497421,5984388439,-201,,
7063823588,5984639301,52748082,5984639100,-201,,
7064074433,5984890146,52998927,5984889945,-201,,
7064326826,5985142538,53251319,5985142337,-201,,
7064577366,5985393079,53501860,5985392878,-201,,
7064595560,5985411272,53520053,5985411070,-202,5985411074,
7064846604,5985662316,53771098,5985662116,-200,,
7065097526,5985913239,54022020,5985913040,-199,,
7065349249,5986164961,54273743,5986164764,-197,,
7065599901,5986415613,54524394,5986415417,-196,,
7065850079,5986665791,54774573,5986665596,-195,,
7066101053,5986916765,55025547,5986916570,-195,,
7066351852,5987167564,55276345,5987167368,-196,,
7066602383,5987418095,55526876,5987417899,-196,,
7066620575,5987436286,55545067,5987436090,-196,5987436107,
7066871115,5987686828,55795609,5987686636,-192,,
7067121861,5987937573,56046355,5987937387,-186,,
7067372256,5988187968,56296749,5988187787,-181,,
7067622894,5988438607,56547389,5988438430,-177,,
7067873883,5988689595,56798377,5988689418,-177,,
7068124144,5988939856,57048638,5988939679,-177,,
7068375116,5989190828,57299610,5989190652,-176,,
7068625754,5989441466,57550248,5989441290,-176,,
7068643986,5989459697,57568479,5989459520,-177,5989459456,
7068895377,5989711089,57819871,5989710896,-193,,
7069145812,5989961524,58070306,5989961315,-209,,
7069396389,5990212102,58320883,5990211877,-225,,
7069647316,5990463028,58571810,5990462788,-240,,
7069897875,5990713588,58822369,5990713348,-240,,
7070148441,5990964153,59072934,5990963913,-240,,
7070399039,5991214751,59323533,5991214511,-240,,
7070649578,5991465290,59574072,5991465050,-240,,
7070667855,5991483566,59592348,5991483326,-240,5991483342,
7070918322,5991734034,59842816,5991733797,-237,,
7071168499,5991984212,60092993,5991983980,-232,,
7071418898,5992234610,60343392,5992234382,-228,,
7071669267,5992484979,60593761,5992484756,-223,,
7071919781,5992735494,60844276,5992735271,-223,,
7072170606,5992986318,61095100,5992986095,-223,,
7072420855,5993236567,61345349,5993236344,-223,,
7072671057,5993486769,61595551,5993486546,-223,,
7072689696,5993505407,61614189,5993505184,-223,5993505002,
7072940302,5993756015,61864796,5993755746,-269,,
7073191066,5994006778,62115559,5994006464,-314,,
7073441425,5994257138,62365919,5994256779,-359,,
7073691619,5994507331,62616113,5994506928,-403,,
7073942587,5994758300,62867081,5994757896,-404,,
7074193136,5995008848,63117630,5995008444,-404,,
7074443357,5995259069,63367851,5995258666,-403,,
7074693892,5995509604,63618386,5995509200,-404,,
7074713251,5995528963,63637744,5995528559,-404,5995528126,
7074964269,5995779981,63888763,5995779468,-513,,
7075214939,5996030652,64139433,5996030031,-621,,
7075465088,5996280801,64389582,5996280072,-729,,
7075715500,5996531212,64639994,5996530377,-835,,
7075965822,5996781534,64890316,5996780699,-835,,
7076216670,5997032382,65141164,5997031547,-835,,
7076466909,5997282622,65391404,5997281787,-835,,
7076717236,5997532948,65641729,5997532113,-835,,
7076737704,5997553415,65662196,5997552580,-835,5997552038,
7076988285,5997803997,65912779,5997803026,-971,,
7077238572,5998054284,66163066,5998053179,-1105,,
7077488739,5998304452,66413234,5998303211,-1241,,
7077739274,5998554987,66663769,5998553612,-1375,,
7077989899,5998805611,66914393,5998804236,-1375,,
7078259307,5999075020,67183802,5999073645,-1375,,
7078510095,5999325807,67434589,5999324432,-1375,,
7078761098,5999576811,67685593,5999575436,-1375,,
7078779654,5999595366,67704147,5999593991,-1375,5999594936,
7079030073,5999845785,67954567,5999844646,-1139,,
7079281064,6000096776,68205562,6000095880,-896,,
7079531588,6000347300,68456082,6000346637,-663,,
7079781806,6000597518,68706300,6000597090,-428,,
7080031958,6000847670,68956452,6000847253,-417,,
7080282407,6001098120,69206901,6001097691,-429,,
7080533050,6001348763,69457544,6001348335,-428,,
7080783891,6001599604,69708385,6001599176,-428,,
7080802249,6001617960,69726741,6001617531,-429,6001617709,
7081052576,6001868287,69977069,6001867904,-383,,
7081303525,6002119237,70228019,6002118899,-338,,
7081554120,6002369833,70478614,6002369538,-295,,
7081805038,6002620750,70729532,6002620501,-249,,
7082055597,6002871309,70980091,6002871060,-249,,
7082305998,6003121710,71230491,6003121461,-249,,
7082556547,6003372259,71481041,6003372011,-248,,
7082807181,6003622894,71731676,6003622645,-249,,
7082825663,6003641374,71750156,6003641125,-249,6003640956,
7083075909,6003891621,72000403,6003891329,-292,,
7083326691,6004142403,72251185,6004142069,-334,,
7083576880,6004392592,72501374,6004392216,-376,,
7083827376,6004643088,72751869,6004642671,-417,,
7084078027,6004893740,73002522,6004893323,-417,,
7084328607,6005144320,73253102,6005143903,-417,,
7084579031,6005394744,73503526,6005394327,-417,,
7084831322,6005647034,73755816,6005646617,-417,,
7084849851,6005665562,73774343,6005665145,-417,6005665189,
7085100666,6005916378,74025160,6005915972,-406,,
7085351175,6006166887,74275669,6006166493,-394,,
7085601930,6006417641,74526423,6006417260,-381,,
7085852542,6006668254,74777035,6006667883,-371,,
7086102800,6006918512,75027294,6006918141,-371,,
7086353786,6007169498,75278280,6007169127,-371,,
7086604373,6007420085,75528867,6007419714,-371,,
7086854972,6007670684,75779466,6007670313,-371,,
7086873184,6007688895,75797676,6007688524,-371,6007688628,
7087123329,6007939041,76047823,6007938696,-345,,
7087373989,6008189701,76298483,6008189383,-318,,
7087624828,6008440540,76549322,6008440249,-291,,
7087875803,6008691516,76800298,6008691251,-265,,
7088126031,6008941743,77050524,6008941478,-265,,
7088376694,6009192407,77301189,6009192142,-265,,
7088626852,6009442564,77551346,6009442300,-264,,
7088877163,6009692875,77801657,6009692610,-265,,
7088895304,6009711015,77819796,6009710750,-265,6009710683,
7089145483,6009961195,78069976,6009960913,-282,,
7089395680,6010211392,78320174,6010211094,-298,,
7089645991,6010461704,78570485,6010461390,-314,,
7089896271,6010711983,78820765,6010711653,-330,,
7090146898,6010962610,79071392,6010962280,-330,,
7090397465,6011213177,79321959,6011212847,-330,,
7090648281,6011463994,79572776,6011463664,-330,,
7090898859,6011714571,79823353,6011714241,-330,,
7090918103,6011733814,79842596,6011733484,-330,6011733003,
7091168951,6011984663,80093445,6011984213,-450,,
7091419254,6012234966,80343748,6012234396,-570,,
7091669837,6012485550,80594331,6012484859,-691,,
7091920272,6012735985,80844766,6012735175,-810,,
7092170453,6012986165,81094947,6012985355,-810,,
7092421223,6013236935,81345717,6013236125,-810,,
7092671786,6013487498,81596280,6013486688,-810,,
7092921957,6013737669,81846451,6013736859,-810,,
7092940551,6013756262,81865044,6013755452,-810,6013755796,
7093190811,6014006524,82115305,6014005799,-725,,
7093441156,6014256869,82365651,6014256232,-637,,
7093691967,6014507679,82616461,6014507128,-551,,
7093942368,6014758079,82866861,6014757614,-465,,
7094193001,6015008713,83117494,6015008248,-465,,
7094443177,6015258890,83367672,6015258425,-465,,
7094693827,6015509540,83618321,6015509075,-465,,
7094944725,6015760438,83869220,6015759973,-465,,
7094962968,6015778679,83887460,6015778214,-465,6015778377,
7095213818,6016029531,84138313,6016029107,-424,,
7095465582,6016281295,84390079,6016280916,-379,,
7095719384,6016535096,84643878,6016534756,-340,,
7095970231,6016785943,84894724,6016785643,-300,,
7096225091,6017040804,85149586,6017040504,-300,,
7096476607,6017292319,85401101,6017292019,-300,,
7096726974,6017542686,85651468,6017542386,-300,,
7096977212,6017792924,85901706,6017792624,-300,,
7096995428,6017811140,85919921,6017810839,-301,6017810835,
7097245962,6018061674,86170456,6018061373,-301,,
7097496255,6018311967,86420749,6018311665,-302,,
7097746774,6018562486,86671268,6018562184,-302,,
7097997363,6018813075,86921857,6018812772,-303,,
7098247811,6019063524,87172305,6019063221,-303,,
7098498321,6019314033,87422815,6019313730,-303,,
7098749330,6019565042,87673823,6019564739,-303,,
7098999673,6019815385,87924167,6019815082,-303,,
7099017967,6019833679,87942460,6019833376,-303,6019833329,
7099268782,6020084494,88193275,6020084178,-316,,
7099519753,6020335466,88444247,6020335139,-327,,
7099770290,6020586002,88694784,6020585664,-338,,
7100020482,6020836195,88944976,6020835846,-349,,
7100271226,6021086938,89195719,6021086590,-348,,
7100521804,6021337516,89446298,6021337168,-348,,
7100772404,6021588117,89696898,6021587769,-348,,
7101026160,6021841873,89950654,6021841525,-348,,
7101044329,6021860041,89968822,6021859693,-348,6021859786,
7101295039,6022110751,90219533,6022110427,-324,,
7101545505,6022361218,90470000,6022360917,-301,,
7101795609,6022611322,90720103,6022611045,-277,,
7102045817,6022861529,90970311,6022861276,-253,,
7102296242,6023111954,91220735,6023111701,-253,,
7102547390,6023363102,91471883,6023362849,-253,,
7102797655,6023613367,91722148,6023613114,-253,,
7103048033,6023863745,91972527,6023863492,-253,,
7103066241,6023881952,91990733,6023881699,-253,6023881626,
7103316323,6024132035,92240817,6024131764,-271,,
7103566863,6024382575,92491357,6024382286,-289,,
7103817102,6024632815,92741596,6024632508,-307,,
7104068035,6024883747,92992529,6024883423,-324,,
7104318576,6025134287,93243069,6025133964,-323,,
7104569167,6025384879,93493661,6025384555,-324,,
7104819524,6025635237,93744018,6025634913,-324,,
7105072090,6025887802,93996584,6025887478,-324,,
7105090197,6025905908,94014690,6025905584,-324,6025905622,
7105340467,6026156180,94264961,6026155865,-315,,
7105590819,6026406531,94515313,6026406226,-305,,
7105841572,6026657284,94766066,6026656989,-295,,
7106092874,6026908586,95017368,6026908302,-284,,
7106343599,6027159311,95268093,6027159026,-285,,
7106594139,6027409852,95518633,6027409567,-285,,
7106844379,6027660091,95768873,6027659807,-284,,
7107094888,6027910601,96019382,6027910316,-285,,
7107113024,6027928736,96037517,6027928450,-286,6027928363,
7107363344,6028179057,96287838,6028178750,-307,,
7107613975,6028429687,96538469,6028429358,-329,,
7107864629,6028680341,96789123,6028679991,-350,,
7108115114,6028930826,97039608,6028930455,-371,,
7108365717,6029181429,97290210,6029181058,-371,,
7108616316,6029432029,97540810,6029431658,-371,,
7108867185,6029682897,97791679,6029682526,-371,,
7109117661,6029933373,98042165,6029933012,-361,,
7109135977,6029951689,98060470,6029951318,-371,6029951340,
7109386857,6030202569,98311351,6030202204,-365,,
7109637626,6030453344,98562126,6030452986,-358,,
7109888316,6030704028,98812810,6030703677,-351,,
7110138744,6030954456,99063238,6030954109,-347,,
7110389416,6031205128,99313910,6031204781,-347,,
7110639756,6031455469,99564250,6031455122,-347,,
7110890141,6031705853,99814634,6031705506,-347,,
7111141069,6031956781,100065563,6031956434,-347,,
7111159349,6031975060,100083842,6031974713,-347,6031974700,
7111410428,6032226140,100334922,6032225789,-351,,
7111661360,6032477072,100585853,6032476719,-353,,
7111911743,6032727455,100836236,6032727099,-356,,
7112162199,6032977911,101086693,6032977552,-359,,
7112412696,6033228409,101337190,6033228049,-360,,
7112663280,6033478992,101587774,6033478633,-359,,
7112913610,6033729322,101838104,6033728963,-359,,
7113164569,6033980293,102089074,6033979934,-359,,
7113184107,6033999818,102108600,6033999459,-359,6033998810,
7113434964,6034250676,102359458,6034250153,-523,,
7113685036,6034500748,102609530,6034500064,-684,,
7113936014,6034751727,102860509,6034750880,-847,,
7114186442,6035002154,103110935,6035001147,-1007,,
7114436541,6035252253,103361035,6035251246,-1007,,
7114686994,6035502706,103611488,6035501699,-1007,,
7114937542,6035753254,103862036,6035752247,-1007,,
7115188264,6036003976,104112758,6036002969,-1007,,
7115206727,6036022439,104131220,6036021432,-1007,6036021940,
7115457497,6036273209,104381991,6036272329,-880,,
7115708096,6036523808,104632590,6036523057,-751,,
7115958521,6036774233,104883015,6036773609,-624,,
7116209036,6037024748,105133530,6037024251,-497,,
7116459901,6037275613,105384395,6037275116,-497,,
7116710519,6037526231,105635013,6037525735,-496,,
7116963499,6037779211,105887993,6037778714,-497,,
7117213871,6038029583,106138365,6038029086,-497,,
7117242216,6038057928,106166709,6038057431,-497,6038052512,
7117493163,6038308875,106417657,6038307144,-1731,,
7117743582,6038559294,106668076,6038556332,-2962,,
7117994088,6038809800,106918581,6038805606,-4194,,
7118244366,6039060079,107168860,6039054665,-5414,,
7118494650,6039310362,107419144,6039304948,-5414,,
7118745585,6039561297,107670079,6039555883,-5414,,
7118996051,6039811763,107920545,6039806349,-5414,,
7119246381,6040062093,108170875,6040056679,-5414,,
7119264537,6040080248,108189030,6040074834,-5414,6040079852,
7119515500,6040331212,108439994,6040327057,-4155,,
7119767336,6040583051,108691842,6040580170,-2881,,
7120018152,6040833864,108942645,6040832232,-1632,,
7120268717,6041084429,109193211,6041084034,-395,,
7120519569,6041335281,109444063,6041334886,-395,,
7120769679,6041585392,109694174,6041584997,-395,,
7121020746,6041836458,109945240,6041836063,-395,,
7121272941,6042088653,110197435,6042088258,-395,,
7121292011,6042107723,110216504,6042107327,-396,6042106930,
7121542649,6042358360,110467142,6042357864,-496,,
7121793132,6042608844,110717626,6042608249,-595,,
7122043420,6042859133,110967915,6042858440,-693,,
7122294026,6043109739,111218520,6043108948,-791,,
7122544423,6043360135,111468917,6043359344,-791,,
7122794579,6043610292,111719073,6043609501,-791,,
7123045081,6043860793,111969575,6043860002,-791,,
7123295663,6044111375,112220156,6044110584,-791,,
7123313866,6044129577,112238359,6044128786,-791,6044129125,
7123564476,6044380188,112488970,6044379483,-705,,
7123815378,6044631090,112739871,6044630469,-621,,
7124065998,6044881710,112990492,6044881175,-535,,
7124316207,6045131919,113240701,6045131468,-451,,
7124566798,6045382511,113491292,6045382060,-451,,
7124817300,6045633013,113741794,6045632562,-451,,
7125068136,6045883848,113992629,6045883397,-451,,
7125318517,6046134229,114243011,6046133778,-451,,
7125336653,6046152365,114261146,6046151914,-451,6046151934,
7125587279,6046402992,114511774,6046402546,-446,,
7125837471,6046653184,114761965,6046652743,-441,,
7126087708,6046903420,115012201,6046902985,-435,,
7126337954,6047153666,115262448,6047153238,-428,,
7126588139,6047403852,115512633,6047403423,-429,,
7126838747,6047654459,115763240,6047654030,-429,,
7127089319,6047905032,116013813,6047904603,-429,,
7127339437,6048155149,116263930,6048154720,-429,,
7127357891,6048173603,116282384,6048173174,-429,6048173068,
7127608691,6048424404,116533185,6048423948,-456,,
7127859239,6048674952,116783734,6048674470,-482,,
7128110134,6048925846,117034628,6048925338,-508,,
7128360362,6049176074,117284856,6049175542,-532,,
7128610703,6049426415,117535197,6049425883,-532,,
7128861223,6049676935,117785717,6049676402,-533,,
7129111615,6049927328,118036109,6049926795,-533,,
7129362134,6050177847,118286628,6050177314,-533,,
7129381037,6050196748,118305529,6050196215,-533,6050196112,
7129631931,6050447643,118556425,6050447086,-557,,
7129882407,6050698120,118806901,6050697537,-583,,
7130133113,6050948826,119057607,6050948217,-609,,
7130383732,6051199444,119308226,6051198811,-633,,
7130633898,6051449610,119558392,6051448976,-634,,
7130884457,6051700169,119808951,6051699536,-633,,
7131135331,6051951043,120059825,6051950409,-634,,
7131385966,6052201679,120310460,6052201045,-634,,
7131404139,6052219850,120328631,6052219216,-634,6052219478,
7131655073,6052470785,120579566,6052470217,-568,,
7131905827,6052721539,120830321,6052721037,-502,,
7132156141,6052971853,121080635,6052971417,-436,,
7132406840,6053222552,121331334,6053222183,-369,,
7132657067,6053472779,121581561,6053472409,-370,,
7132907353,6053723065,121831847,6053722695,-370,,
7133157942,6053973655,122082437,6053973285,-370,,
7133408547,6054224259,122333041,6054223889,-370,,
7133426782,6054242493,122351275,6054242123,-370,6054242073,
7133677309,6054493022,122601803,6054492640,-382,,
7133928064,6054743776,122852558,6054743382,-394,,
7134178969,6054994682,123103463,6054994276,-406,,
7134430432,6055246144,123354926,6055245726,-418,,
7134681332,6055497043,123605825,6055496626,-417,,
7134931785,6055747498,123856279,6055747080,-418,,
7135182798,6055998510,124107292,6055998092,-418,,
7135433289,6056249001,124357783,6056248583,-418,,
7135451428,6056267139,124375921,6056266721,-418,6056266719,
7135702433,6056518145,124626927,6056517726,-419,,
7135953257,6056768970,124877752,6056768551,-419,,
7136210590,6057026302,125135084,6057025883,-419,,
7136461409,6057277121,125386001,6057276802,-319,,
7136712357,6057528069,125636851,6057527651,-418,,
7136962889,6057778601,125887383,6057778182,-419,,
7137213322,6058029034,126137815,6058028615,-419,,
7137464124,6058279836,126388617,6058279417,-419,,
7137483525,6058299237,126408018,6058298818,-419,6058298094,
7137734377,6058550090,126658872,6058549489,-601,,
7137984783,6058800495,126909277,6058799713,-782,,
7138235297,6059051009,127159790,6059050047,-962,,
7138485517,6059301229,127410011,6059300088,-1141,,
7138735705,6059551417,127660199,6059550276,-1141,,
7138986176,6059801888,127910670,6059800747,-1141,,
7139236378,6060052090,128160872,6060050949,-1141,,
7139486444,6060302157,128410938,6060301016,-1141,,
7139504578,6060320289,128429071,6060319148,-1141,6060319835,
7139754727,6060570440,128679222,6060569470,-970,,
7140004891,6060820603,128929385,6060819805,-798,,
7140255038,6061070751,129179533,6061070126,-625,,
7140505600,6061321312,129430094,6061320859,-453,,
7140756597,6061572310,129681091,6061571857,-453,,
7141007265,6061822977,129931759,6061822524,-453,,
7141257592,6062073304,130182086,6062072852,-452,,
7141508009,6062323721,130432502,6062323268,-453,,
7141526073,6062341785,130450566,6062341331,-454,6062341332,
7141776583,6062592295,130701077,6062591842,-453,,
7142027549,6062843261,130952043,6062842809,-452,,
7142278561,6063094273,131203055,6063093822,-451,,
7142529400,6063345112,131453893,6063344661,-451,,
7142779646,6063595358,131704139,6063594907,-451,,
7143030011,6063845723,131954504,6063845272,-451,,
7143280721,6064096433,132205214,6064095982,-451,,
7143530973,6064346685,132455466,6064346234,-451,,
7143549243,6064364955,132473736,6064364504,-451,6064364504,
7143799812,6064615525,132724306,6064615074,-451,,
7144050288,6064866000,132974781,6064865550,-450,,
7144300923,6065116635,133225416,6065116186,-449,,
7144551274,6065366986,133475768,6065366537,-449,,
7144801969,6065617682,133726463,6065617233,-449,,
7145052298,6065868011,133976793,6065867562,-449,,
7145303231,6066118943,134227725,6066118494,-449,,
7145553397,6066369109,134477890,6066368660,-449,,
7145571653,6066387364,134496146,6066386915,-449,6066386897,
7145822029,6066637742,134746524,6066637288,-454,,
7146072538,6066888250,134997032,6066887792,-458,,
7146323097,6067138810,135247592,6067138348,-462,,
7146573624,6067389336,135498118,6067388870,-466,,
7146823963,6067639675,135748457,6067639209,-466,,
7147074577,6067890290,135999071,6067889824,-466,,
7147325185,6068140897,136249679,6068140431,-466,,
7147575477,6068391189,136499971,6068390723,-466,,
7147594697,6068410408,136519189,6068409942,-466,6068409488,
7147845188,6068660900,136769682,6068660321,-579,,
7148095767,6068911479,137020261,6068910788,-691,,
7148346365,6069162078,137270859,6069161273,-805,,
7148596883,6069412596,137521377,6069411678,-918,,
7148847375,6069663088,137771869,6069662170,-918,,
7149097984,6069913697,138022478,6069912779,-918,,
7149348509,6070164221,138273003,6070163303,-918,,
7149599078,6070414790,138523572,6070413872,-918,,
7149621533,6070437247,138546031,6070436333,-914,6070434594,
7149871792,6070687504,138796286,6070686150,-1354,,
7150122345,6070938057,139046839,6070936271,-1786,,
7150372969,6071188681,139297463,6071186464,-2217,,
7150623536,6071439248,139548030,6071436602,-2646,,
7150874048,6071689760,139798541,6071687113,-2647,,
7151124960,6071940677,140049465,6071938044,-2633,,
7151377341,6072193053,140301834,6072190406,-2647,,
7151627938,6072443650,140552431,6072441003,-2647,,
7151647938,6072463650,140572431,6072461002,-2648,6072462193,
7151898656,6072714368,140823150,6072712020,-2348,,
7152149212,6072964925,141073706,6072962875,-2050,,
7152399684,6073215396,141324178,6073213645,-1751,,
7152650152,6073465864,141574646,6073464409,-1455,,
7152900698,6073716411,141825193,6073714956,-1455,,
7153151047,6073966759,142075541,6073965304,-1455,,
7153401621,6074217334,142326115,6074215879,-1455,,
7153652065,6074467778,142576560,6074466323,-1455,,
7153670204,6074485915,142594696,6074484460,-1455,6074485404,
7153920598,6074736310,142845091,6074735091,-1219,,
7154170904,6074986616,143095398,6074985634,-982,,
7154421457,6075237170,143345951,6075236425,-745,,
7154671785,6075487497,143596278,6075486988,-509,,
7154922329,6075738041,143846823,6075737533,-508,,
7155172629,6075988341,144097122,6075987832,-509,,
7155422976,6076238688,144347470,6076238179,-509,,
7155673581,6076489294,144598075,6076488785,-509,,
7155691889,6076507601,144616382,6076507091,-510,6076507138,
7155942681,6076758393,144867175,6076757895,-498,,
7156193518,6077009230,145118012,6077008745,-485,,
7156443997,6077259709,145368491,6077259236,-473,,
7156694397,6077510109,145618891,6077509648,-461,,
7156944952,6077760664,145869446,6077760203,-461,,
7157195734,6078011446,146120227,6078010985,-461,,
7157446244,6078261957,146370738,6078261496,-461,,
7157696426,6078512138,146620920,6078511677,-461,,
7157714616,6078530328,146639109,6078529867,-461,6078529815,
7157965354,6078781065,146889847,6078780591,-474,,
7158215835,6079031548,147140329,6079031061,-487,,
7158465978,6079281690,147390472,6079281192,-498,,
7158716229,6079531941,147640723,6079531430,-511,,
7158967068,6079782780,147891562,6079782279,-501,,
7159217568,6080033281,148142063,6080032770,-511,,
7159468106,6080283819,148392600,6080283307,-512,,
7159718618,6080534330,148643112,6080533819,-511,,
7159736844,6080552556,148661337,6080552044,-512,6080552017,
7159987833,6080803546,148912327,6080803028,-518,,
7160238061,6081053774,149162555,6081053250,-524,,
7160488530,6081304242,149413024,6081303712,-530,,
7160738867,6081554579,149663361,6081554042,-537,,
7160989083,6081804795,149913577,6081804258,-537,,
7161239200,6082054913,150163694,6082054376,-537,,
7161489684,6082305396,150414178,6082304859,-537,,
7161740675,6082556387,150665168,6082555850,-537,,
7161760140,6082575851,150684633,6082575314,-537,6082574752,
7162010830,6082826542,150935324,6082825863,-679,,
7162261380,6083077091,151185873,6083076273,-818,,
7162512570,6083328283,151437064,6083327323,-960,,
7162763296,6083579008,151687789,6083577910,-1098,,
7163013756,6083829469,151938250,6083828371,-1098,,
7163264381,6084080094,152188875,6084078995,-1099,,
7163514695,6084330407,152439189,6084329309,-1098,,
7163765272,6084580984,152689765,6084579886,-1098,,
7163785038,6084600749,152709530,6084599650,-1099,6084599457,
7164035633,6084851345,152960127,6084850199,-1146,,
7164286507,6085102220,153211001,6085101026,-1194,,
7164537371,6085353084,153461865,6085351842,-1242,,
7164788213,6085603926,153712707,6085602636,-1290,,
7165038314,6085854026,153962808,6085852736,-1290,,
7165288861,6086104573,154213355,6086103283,-1290,,
7165539196,6086354908,154463690,6086353619,-1289,,
7165790273,6086605986,154714767,6086604696,-1290,,
7165810730,6086626441,154735222,6086625151,-1290,6086624755,
7166061270,6086876982,154985764,6086875594,-1388,,
7166312377,6087128089,155236871,6087126601,-1488,,
7166563294,6087379006,155487788,6087377419,-1587,,
7166813594,6087629306,155738088,6087627623,-1683,,
7167063862,6087879574,155988356,6087877891,-1683,,
7167314022,6088129735,156238516,6088128051,-1684,,
7167564449,6088380161,156488943,6088378477,-1684,,
7167815260,6088630973,156739754,6088629289,-1684,,
7167833363,6088649075,156757856,6088647390,-1685,6088648612,
7168084338,6088900050,157008831,6088898672,-1378,,
7168335034,6089150746,157259527,6089149675,-1071,,
7168585747,6089401516,157510298,6089400753,-763,,
7168836199,6089651912,157760693,6089651451,-461,,
7169086995,6089902707,158011488,6089902246,-461,,
7169337787,6090153499,158262281,6090153038,-461,,
7169590760,6090406473,158515254,6090406012,-461,,
7169841025,6090656737,158765518,6090656276,-461,,
7169859928,6090675640,158784421,6090675178,-462,6090674703,
7170110381,6090926093,159034875,6090925513,-580,,
7170360537,6091176249,159285031,6091175550,-699,,
7170611557,6091427269,159536051,6091426452,-817,,
7170862352,6091678064,159786846,6091677129,-935,,
7171112807,6091928519,160037301,6091927584,-935,,
7171364352,6092180065,160288846,6092179130,-935,,
7171614420,6092430132,160538913,6092429197,-935,,
7171864564,6092680276,160789058,6092679342,-934,,
7171882896,6092698607,160807389,6092697672,-935,6092698002,
7172133242,6092948954,161057735,6092948101,-853,,
7172384101,6093199813,161308595,6093199043,-770,,
7172635609,6093451321,161560102,6093450635,-686,,
7172886427,6093702140,161810921,6093701536,-604,,
7173136840,6093952552,162061333,6093951948,-604,,
7173387482,6094203195,162311976,6094202591,-604,,
7173638296,6094454008,162562789,6094453404,-604,,
7173889153,6094704865,162813647,6094704261,-604,,
7173907302,6094723013,162831794,6094722409,-604,6094722432,
7174157909,6094973622,163082404,6094973023,-599,,
7174408527,6095224240,163333022,6095223649,-591,,
7174658817,6095474529,163583311,6095473944,-585,,
7174909475,6095725187,163833969,6095724608,-579,,
7175159950,6095975662,164084444,6095975083,-579,,
7175410366,6096226078,164334860,6096225499,-579,,
7175660495,6096476207,164584989,6096475628,-579,,
7175911113,6096726825,164835607,6096726246,-579,,
7175929236,6096744947,164853728,6096744368,-579,6096744374,
7176179814,6096995526,165104308,6096994948,-578,,
7176430195,6097245907,165354688,6097245331,-576,,
7176680737,6097496449,165605231,6097495875,-574,,
7176931428,6097747140,165855921,6097746569,-571,,
7177181931,6097997659,166106442,6097997089,-570,,
7177432468,6098248181,166356962,6098247610,-571,,
7177682709,6098498421,166607203,6098497850,-571,,
7177933118,6098748830,166857611,6098748259,-571,,
7177952035,6098767746,166876528,6098767175,-571,6098766818,
7178203325,6099019037,167127818,6099018375,-662,,
7178453670,6099269383,167378164,6099268631,-752,,
7178704384,6099520096,167628878,6099519256,-840,,
7178954984,6099770696,167879478,6099769770,-926,,
7179205911,6100021623,168130405,6100020697,-926,,
7179456313,6100272025,168380806,6100271098,-927,,
7179706828,6100522540,168631322,6100521613,-927,,
7179957278,6100772990,168881771,6100772063,-927,,
7179975520,6100791231,168900012,6100790304,-927,6100790618,
7180225915,6101041641,169150423,6101040794,-847,,
7180476468,6101292180,169400961,6101291412,-768,,
7180727539,6101543252,169652034,6101542563,-689,,
7180977833,6101793545,169902326,6101792934,-611,,
7181228418,6102044130,170152912,6102043519,-611,,
7181479003,6102294715,170403497,6102294104,-611,,
7181729248,6102544960,170653742,6102544349,-611,,
7181979828,6102795540,170904322,6102794929,-611,,
7181998297,6102814008,170922790,6102813397,-611,6102813290,
7182249171,6103064883,171173665,6103064246,-637,,
7182499389,6103315101,171423883,6103314437,-664,,
7182749822,6103565534,171674315,6103564844,-690,,
7183000399,6103816111,171924893,6103815395,-716,,
7183251068,6104066780,172175561,6104066064,-716,,
7183501477,6104317190,172425971,6104316474,-716,,
7183751726,6104567438,172676220,6104566722,-716,,
7184002435,6104818147,172926928,6104817431,-716,,
7184020980,6104836691,172945480,6104835983,-708,6104835960,
7184271610,6105087322,173196103,6105086588,-734,,
7184522400,6105338112,173446894,6105337379,-733,,
7184773003,6105588715,173697497,6105587984,-731,,
7185023593,6105839305,173948087,6105838576,-729,,
7185274177,6106089889,174198671,6106089159,-730,,
7185524424,6106340136,174448918,6106339406,-730,,
7185775067,6106590779,174699561,6106590049,-730,,
7186025353,6106841065,174949847,6106840335,-730,,
7186043906,6106859617,174968399,6106858887,-730,6106858874,
7186294464,6107110176,175218958,6107109443,-733,,
7186545257,6107360970,175469751,6107360233,-737,,
7186795388,6107611100,175719882,6107610362,-738,,
7187045812,6107861525,175970307,6107860784,-741,,
7187296460,6108112172,176220954,6108111431,-741,,
7187546833,6108362545,176471327,6108361804,-741,,
7187797554,6108613267,176722048,6108612526,-741,,
7188048170,6108863882,176972664,6108863141,-741,,
7188067138,6108882849,176991630,6108882108,-741,6108881827,
7188317493,6109133205,177241987,6109132394,-811,,
7188568000,6109383713,177492494,6109382832,-881,,
7188818547,6109634259,177743041,6109633309,-950,,
7189068699,6109884412,177993193,6109883391,-1021,,
7189319443,6110135156,178243937,6110134136,-1020,,
7189569747,6110385460,178494242,6110384440,-1020,,
7189820289,6110636001,178744783,6110634982,-1019,,
7190070407,6110886119,178994901,6110885099,-1020,,
7190088930,6110904642,179013423,6110903621,-1021,6110903812,
7190339298,6111155010,179263792,6111154037,-973,,
7190589780,6111405493,179514275,6111404568,-925,,
7190840386,6111656098,179764880,6111655222,-876,,
7191090624,6111906336,180015118,6111905508,-828,,
7191341230,6112156943,180265724,6112156114,-829,,
7191591666,6112407378,180516160,6112406550,-828,,
7191842041,6112657753,180766535,6112656925,-828,,
7192092714,6112908427,181017208,6112907599,-828,,
7192110903,6112926614,181035396,6112925786,-828,6112925993,
7192361696,6113177407,181286189,6113176632,-775,,
7192612101,6113427813,181536595,6113427090,-723,,
7192862257,6113677969,181786750,6113677297,-672,,
7193112869,6113928581,182037363,6113927961,-620,,
7193363879,6114179591,182288373,6114178971,-620,,
7193614626,6114430338,182539119,6114429718,-620,,
7193865400,6114681112,182789894,6114680493,-619,,
7194115599,6114931311,183040093,6114930691,-620,,
7194133863,6114949575,183058356,6114948954,-621,6114948936,
7194384726,6115200438,183309220,6115199813,-625,,
7194636302,6115452014,183560796,6115451386,-628,,
7194887281,6115702993,183811775,6115702360,-633,,
7195137625,6115953337,184062119,6115952700,-637,,
7195388264,6116203976,184312758,6116203339,-637,,
7195638591,6116454303,184563085,6116453666,-637,,
7195888881,6116704593,184813375,6116703956,-637,,
7196139275,6116954987,185063769,6116954350,-637,,
WARN: A server response timed out.
7200139437,6120955148,189063930,6120954511,-637,,
7200157628,6120973340,189082121,6120972702,-638,6120972670,
7200407986,6121223698,189332480,6121223053,-645,,
7200658677,6121474390,189583171,6121473737,-653,,
7200909095,6121724808,189833589,6121724147,-661,,
7201159226,6121974939,190083720,6121974271,-668,,
7201409559,6122225271,190334053,6122224603,-668,,
7201660419,6122476130,190584912,6122475462,-668,,
7201910670,6122726382,190835164,6122725714,-668,,
7202161058,6122976770,191085552,6122976102,-668,,
7202179436,6122995147,191103929,6122994479,-668,6122994439,
7202429894,6123245606,191354388,6123244928,-678,,
7202680411,6123496124,191604906,6123495436,-688,,
7202930755,6123746468,191855249,6123745771,-697,,
7203181387,6123997099,192105881,6123996392,-707,,
7203431548,6124247261,192356043,6124246554,-707,,
7203681687,6124497399,192606181,6124496693,-706,,
7203931918,6124747630,192856411,6124746923,-707,,
7204182142,6124997854,193106636,6124997147,-707,,
7204200385,6125016097,193124878,6125015389,-708,6125015476,
7204450500,6125266213,193374995,6125265527,-686,,
7204701702,6125517416,193626198,6125516754,-662,,
7204953277,6125768990,193877772,6125768349,-641,,
7205203479,6126019192,194127974,6126018573,-619,,
7205453797,6126269509,194378291,6126268891,-618,,
7205704256,6126519968,194628750,6126519349,-619,,
7205954441,6126770153,194878935,6126769534,-619,,
7206205006,6127020718,195129500,6127020099,-619,,
7206223148,6127038859,195147641,6127038240,-619,6127038144,
7206473741,6127289453,195398235,6127288810,-643,,
7206723863,6127539576,195648357,6127538908,-668,,
7206974228,6127789941,195898722,6127789251,-690,,
7207224998,6128040711,196149493,6128039997,-714,,
7207475339,6128291051,196399833,6128290337,-714,,
7207725717,6128541429,196650211,6128540715,-714,,
7207976178,6128791891,196900672,6128791177,-714,,
7208227036,6129042748,197151529,6129042034,-714,,
7208245229,6129060940,197169722,6129060226,-714,6129060279,
7208495651,6129311363,197420145,6129310675,-688,,
7208745792,6129561504,197670286,6129560818,-686,,
7208995997,6129811709,197920491,6129811037,-672,,
7209249179,6130064891,198173673,6130064232,-659,,
7209499766,6130315479,198424260,6130314820,-659,,
7209750073,6130565786,198674567,6130565127,-659,,
7210000216,6130815929,198924711,6130815270,-659,,
7210250614,6131066327,199175108,6131065668,-659,,
7210268895,6131084606,199193388,6131083947,-659,6131083942,
7210519052,6131334764,199443546,6131334104,-660,,
7210769382,6131585094,199693876,6131584434,-660,,
7211019791,6131835503,199944285,6131834841,-662,,
7211270635,6132086348,200195129,6132085685,-663,,
7211520985,6132336697,200445479,6132336034,-663,,
7211771471,6132587184,200695965,6132586520,-664,,
7212022055,6132837767,200946549,6132837104,-663,,
7212272772,6133088484,201197266,6133087821,-663,,
7212290965,6133106676,201215458,6133106013,-663,6133106005,
7212541404,6133357117,201465898,6133356452,-665,,
7212792329,6133608042,201716823,6133607376,-666,,
7213042733,6133858445,201967226,6133857777,-668,,
7213293024,6134108736,202217518,6134108067,-669,,
7213543522,6134359234,202468015,6134358565,-669,,
7213794249,6134609961,202718742,6134609292,-669,,
7214044335,6134860047,202968829,6134859378,-669,,
7214295352,6135111065,203219846,6135110396,-669,,
7214313544,6135129255,203238036,6135128585,-670,6135128570,
7214564167,6135379879,203488661,6135379207,-672,,
7214814338,6135630051,203738833,6135629374,-677,,
7215064516,6135880229,203989010,6135879548,-681,,
7215315110,6136130822,204239604,6136130139,-683,,
7215565923,6136381635,204490417,6136380953,-682,,
7215816344,6136632056,204740838,6136631373,-683,,
7216067555,6136883268,204992050,6136882585,-683,,
7216318570,6137134282,205243064,6137133600,-682,,
7216336811,6137152522,205261304,6137151839,-683,6137151850,
7216587563,6137403275,205512056,6137402595,-680,,
7216838022,6137653734,205762515,6137653057,-677,,
7217088861,6137904573,206013355,6137903899,-674,,
7217339101,6138154814,206263595,6138154143,-671,,
7217589952,6138405665,206514446,6138404994,-671,,
7217840607,6138656319,206765100,6138655648,-671,,
7218090848,6138906561,207015342,6138905890,-671,,
7218341359,6139157071,207265853,6139156400,-671,,
7218359570,6139175281,207284062,6139174610,-671,6139174524,
7218610610,6139426323,207535105,6139425631,-692,,
7218861358,6139677071,207785853,6139676358,-713,,
7219112129,6139927840,208036622,6139927107,-733,,
7219363024,6140178736,208287518,6140177981,-755,,
7219613232,6140428944,208537726,6140428189,-755,,
7219863364,6140679076,208787858,6140678321,-755,,
7220114268,6140929981,209038762,6140929226,-755,,
7220364496,6141180208,209288990,6141179453,-755,,
7220382786,6141198497,209307279,6141197742,-755,6141197755,
7220633103,6141448816,209557597,6141448064,-752,,
7220883601,6141699314,209808096,6141698566,-748,,
7221134499,6141950211,210058993,6141949467,-744,,
7221384936,6142200649,210309430,6142199909,-740,,
7221635803,6142451516,210560297,6142450776,-740,,
7221886729,6142702441,210811222,6142701701,-740,,
7222137315,6142953028,211061809,6142952288,-740,,
7222388107,6143203819,211312601,6143203079,-740,,
7222406282,6143221993,211330775,6143221253,-740,6143221302,
7222656790,6143472503,211581285,6143471775,-728,,
7222907506,6143723218,211832000,6143722502,-716,,
7223158430,6143974142,212082923,6143973439,-703,,
7223413310,6144229023,212337804,6144228333,-690,,
7223664172,6144479886,212588668,6144479196,-690,,
7223919555,6144735274,212844056,6144734585,-689,,
7224170444,6144986157,213094938,6144985466,-691,,
7224421282,6145236995,213345777,6145236305,-690,,
7224439508,6145255219,213364000,6145254529,-690,6145254508,
7224689732,6145505444,213614226,6145504748,-696,,
7224940446,6145756158,213864940,6145755458,-700,,
7225191288,6146007000,214115781,6146006295,-705,,
7225442017,6146257729,214366511,6146257019,-710,,
7225692503,6146508216,214616997,6146507506,-710,,
7225943025,6146758737,214867519,6146758027,-710,,
7226193505,6147009217,215117999,6147008507,-710,,
7226444081,6147259793,215368575,6147259083,-710,,
7226462299,6147278011,215386792,6147277301,-710,6147277245,
7226712988,6147528701,215637482,6147527976,-725,,
7226963568,6147779280,215888062,6147778543,-737,,
7227213758,6148029470,216138252,6148028719,-751,,
7227464672,6148280384,216389166,6148279620,-764,,
7227715315,6148531028,216639809,6148530264,-764,,
7227966015,6148781727,216890509,6148780963,-764,,
7228216617,6149032329,217141111,6149031565,-764,,
7228466984,6149282696,217391478,6149281932,-764,,
7228485149,6149300860,217409642,6149300096,-764,6149300139,
7228736033,6149551745,217660526,6149550991,-754,,
7228987032,6149802744,217911526,6149802003,-741,,
7229237477,6150053190,218161971,6150052459,-731,,
7229488032,6150303744,218412526,6150303025,-719,,
7229738526,6150554238,218663020,6150553519,-719,,
7229989102,6150804814,218913595,6150804095,-719,,
7230239631,6151055343,219164125,6151054624,-719,,
7230490230,6151305943,219414725,6151305224,-719,,
7230508499,6151324210,219432991,6151323491,-719,6151323410,
7230759101,6151574813,219683595,6151574075,-738,,
7231009835,6151825548,219934329,6151824789,-759,,
7231260378,6152076090,220184872,6152075312,-778,,
7231510831,6152326544,220435325,6152325746,-798,,
7231761133,6152576845,220685627,6152576048,-797,,
7232012076,6152827788,220936570,6152826990,-798,,
7232262708,6153078421,221187202,6153077623,-798,,
7232513662,6153329375,221438157,6153328577,-798,,
7232531794,6153347505,221456287,6153346707,-798,6153346802,
7232782344,6153598056,221706838,6153597283,-773,,
7233032995,6153848707,221957489,6153847957,-750,,
7233283358,6154099070,222207852,6154098344,-726,,
7233533560,6154349272,222458054,6154348570,-702,,
7233784287,6154600000,222708781,6154599298,-702,,
7234034599,6154850312,222959094,6154849610,-702,,
7234285026,6155100739,223209521,6155100038,-701,,
7234536016,6155351729,223460510,6155351027,-702,,
7234554267,6155369979,223478760,6155369276,-703,6155369237,
7234804660,6155620373,223729154,6155619661,-712,,
7235055298,6155871011,223979793,6155870290,-721,,
7235305495,6156121207,224229988,6156120476,-731,,
7235556348,6156372060,224480842,6156371321,-739,,
7235806788,6156622500,224731282,6156621760,-740,,
7236057606,6156873318,224982099,6156872578,-740,,
7236309098,6157124810,225233592,6157124070,-740,,
7236559666,6157375378,225484159,6157374638,-740,,
7236577823,6157393534,225502315,6157392793,-741,6157392761,
7236828537,6157644250,225753031,6157643501,-749,,
7237078835,6157894547,226003329,6157893791,-756,,
7237329690,6158145403,226254184,6158144639,-764,,
7237579903,6158395616,226504398,6158394845,-771,,
7237830506,6158646219,226755001,6158645448,-771,,
7238081424,6158897137,227005919,6158896366,-771,,
7238332502,6159148214,227256996,6159147443,-771,,
7238582895,6159398608,227507390,6159397847,-761,,
7238601068,6159416779,227525561,6159416008,-771,6159416035,
7238851999,6159667712,227776494,6159666949,-763,,
7239102708,6159918421,228027202,6159917665,-756,,
7239353046,6160169608,228278390,6160168859,-749,,
7239604544,6160420257,228529038,6160419514,-743,,
7239855236,6160670948,228779730,6160670206,-742,,
7240106163,6160921875,229030656,6160921133,-742,,
7240357051,6161172763,229281545,6161172021,-742,,
7240607569,6161423281,229532063,6161422539,-742,,
7240625793,6161441505,229550286,6161440762,-743,6161440764,
7240876153,6161691866,229800647,6161691124,-742,,
7241126499,6161942212,230050993,6161941471,-741,,
7241376864,6162192576,230301357,6162191836,-740,,
7241627525,6162443237,230552019,6162442498,-739,,
7241878007,6162693719,230802501,6162692980,-739,,
7242131113,6162946825,231055607,6162946086,-739,,
7242381244,6163196956,231305738,6163196218,-738,,
7242632265,6163447977,231556758,6163447238,-739,,
7242651403,6163467114,231575895,6163466375,-739,6163465800,
7242901967,6163717680,231826462,6163716796,-884,,
7243152167,6163967880,232076672,6163966863,-1017,,
7243402888,6164218600,232327381,6164217430,-1170,,
7243653021,6164468744,232577525,6164467432,-1312,,
7243903957,6164719669,232828451,6164718357,-1312,,
7244154483,6164970195,233078977,6164968884,-1311,,
7244404593,6165220306,233329087,6165218994,-1312,,
7244654897,6165470609,233579391,6165469297,-1312,,
7244673300,6165489011,233597793,6165487699,-1312,6165488215,
7244923590,6165739303,233848084,6165738119,-1184,,
7245174091,6165989803,234098584,6165988749,-1054,,
7245424154,6166239866,234348647,6166238942,-924,,
7245674412,6166490124,234598906,6166489329,-795,,
7245924560,6166740272,234849054,6166739477,-795,,
7246174935,6166990647,235099429,6166989853,-794,,
7246425273,6167240986,235349767,6167240191,-795,,
7246675681,6167491393,235600174,6167490598,-795,,
7246694021,6167509732,235618514,6167508937,-795,6167508968,
7246944941,6167760653,235869435,6167759867,-786,,
7247195570,6168011283,236120065,6168010514,-769,,
7247446369,6168262081,236370862,6168261310,-771,,
7247696848,6168512560,236621342,6168511797,-763,,
7247947211,6168762923,236871705,6168762160,-763,,
7248197505,6169013217,237121999,6169012454,-763,,
7248447940,6169263652,237372434,6169262889,-763,,
7248698965,6169514677,237623459,6169513914,-763,,
7248717090,6169532801,237641582,6169532037,-764,6169531998,
7248967475,6169783187,237891969,6169782414,-773,,
7249218564,6170034277,238143058,6170033495,-782,,
7249469326,6170285038,238393820,6170284246,-792,,
7249719782,6170535495,238644277,6170534694,-801,,
7249970191,6170785903,238894685,6170785102,-801,,
7250220589,6171036301,239145083,6171035500,-801,,
7250471232,6171286944,239395726,6171286143,-801,,
7250721798,6171537510,239646292,6171536709,-801,,
7250740059,6171555771,239664552,6171554969,-802,6171554927,
7250990693,6171806406,239915187,6171805594,-812,,
7251241277,6172056989,240165771,6172056168,-821,,
7251491872,6172307585,240416366,6172306753,-832,,
7251742104,6172557817,240666599,6172556975,-842,,
7251992662,6172808374,240917156,6172807532,-842,,
7252243327,6173059039,241167821,6173058197,-842,,
7252493938,6173309654,241418436,6173308817,-837,,
7252745327,6173561041,241669823,6173560199,-842,,
7252770965,6173586676,241695457,6173585834,-842,6173582182,
7253021442,6173837154,241945936,6173835397,-1757,,
7253272148,6174087861,242196643,6174085189,-2672,,
7253523567,6174339279,242448060,6174335690,-3589,,
7253774413,6174590125,242698907,6174585633,-4492,,
7254025381,6174841093,242949874,6174836601,-4492,,
7254276018,6175091730,243200512,6175087238,-4492,,
7254526494,6175342206,243450988,6175337714,-4492,,
7254777166,6175592878,243701660,6175588386,-4492,,
7254795986,6175611697,243720478,6175607205,-4492,6175610525,
7255046513,6175862225,243971007,6175858566,-3659,,
7255297138,6176112850,244221631,6176110023,-2827,,
7255547350,6176363062,244471844,6176361066,-1996,,
7255797853,6176613566,244722347,6176612396,-1170,,
7256048150,6176863862,244972644,6176862692,-1170,,
7256299027,6177114740,245223522,6177113570,-1170,,
7256549577,6177365289,245474071,6177364119,-1170,,
7256799684,6177615396,245724177,6177614226,-1170,,
7256817973,6177633685,245742466,6177632514,-1171,6177632893,
7257068807,6177884519,245993300,6177883443,-1076,,
7257319345,6178135057,246243839,6178134077,-980,,
7257569747,6178385459,246494241,6178384574,-885,,
7257820775,6178636487,246745269,6178635697,-790,,
7258070943,6178886655,246995437,6178885865,-790,,
7258321883,6179137595,247246377,6179136805,-790,,
7258572375,6179388087,247496869,6179387297,-790,,
7258822957,6179638669,247747451,6179637879,-790,,
7258841563,6179657274,247766055,6179656483,-791,6179656274,
7259091737,6179907449,248016231,6179906607,-842,,
7259342353,6180158066,248266847,6180157172,-894,,
7259592613,6180408325,248517106,6180407379,-946,,
7259843339,6180659050,248767832,6180658053,-997,,
7260094018,6180909730,249018512,6180908733,-997,,
7260344302,6181160014,249268795,6181159016,-998,,
7260594731,6181410443,249519225,6181409445,-998,,
7260844953,6181660664,249769446,6181659667,-997,,
7260863141,6181678853,249787634,6181677854,-999,6181678022,
7261125176,6181940888,250049670,6181939933,-955,,
7261375351,6182191063,250299845,6182190151,-912,,
7261626172,6182441884,250550666,6182441015,-869,,
7261876400,6182692112,250800894,6182691284,-828,,
7262127202,6182942915,251051696,6182942086,-829,,
7262378067,6183193779,251302561,6183192950,-829,,
7262628266,6183443978,251552760,6183443149,-829,,
7262879136,6183694848,251803630,6183694019,-829,,
7262897426,6183713138,251821919,6183712308,-830,6183712334,
7263147977,6183963689,252072471,6183962866,-823,,
7263398301,6184214013,252322795,6184213197,-816,,
7263649096,6184464808,252573590,6184463999,-809,,
7263899821,6184715533,252824315,6184714731,-802,,
7264150043,6184965756,253074537,6184964954,-802,,
7264400828,6185216540,253325322,6185215738,-802,,
7264651147,6185466860,253575641,6185466058,-802,,
7264901653,6185717366,253826148,6185716564,-802,,
7264919764,6185735476,253844257,6185734674,-802,6185734632,
7265169980,6185985692,254094474,6185984879,-813,,
7265420183,6186235895,254344677,6186235073,-822,,
7265670580,6186486292,254595074,6186485460,-832,,
7265921464,6186737177,254845958,6186736335,-842,,
7266171776,6186987488,255096270,6186986647,-841,,
7266422116,6187237829,255346611,6187236987,-842,,
7266672596,6187488308,255597090,6187487466,-842,,
7266923459,6187739172,255847954,6187738330,-842,,
7266941795,6187757506,255866287,6187756664,-842,6187756626,
7267192541,6188008254,256117035,6188007403,-851,,
7267443292,6188259005,256367787,6188258145,-860,,
7267693513,6188509225,256618007,6188508356,-869,,
7267943807,6188759520,256868301,6188758642,-878,,
7268194003,6189009715,257118496,6189008837,-878,,
7268444328,6189260040,257368822,6189259163,-877,,
7268694610,6189510323,257619105,6189509445,-878,,
7268944776,6189760488,257869270,6189759611,-877,,
7268962978,6189778690,257887471,6189777811,-879,6189777856,
7269213788,6190029501,258138282,6190028633,-868,,
7269464191,6190279903,258388684,6190279047,-856,,
7269714841,6190530553,258639335,6190529710,-843,,
7269965226,6190780938,258889720,6190780106,-832,,
7270215946,6191031659,259140441,6191030827,-832,,
7270466260,6191281972,259390754,6191281141,-831,,
7270716871,6191532583,259641365,6191531752,-831,,
7270966981,6191782694,259891475,6191781862,-832,,
7270985223,6191800934,259909716,6191800102,-832,6191800032,
7271236302,6192052014,260160796,6192051165,-849,,
7271486795,6192302508,260411289,6192301642,-866,,
7271737671,6192553384,260662165,6192552501,-883,,
7271988320,6192804032,260912814,6192803132,-900,,
7272238920,6193054632,261163414,6193053732,-900,,
7272489115,6193304828,261413610,6193303928,-900,,
7272739422,6193555134,261663916,6193554234,-900,,
7272989951,6193805663,261914445,6193804763,-900,,
7273009103,6193824815,261933596,6193823914,-901,6193823443,
7273259817,6194075530,262184311,6194074512,-1018,,
7273510588,6194326301,262435082,6194325164,-1137,,
7273761154,6194576867,262685648,6194575613,-1254,,
7274012093,6194827806,262936587,6194826436,-1370,,
7274262360,6195078073,263186855,6195076703,-1370,,
7274512618,6195328330,263437112,6195326960,-1370,,
7274763251,6195578963,263687745,6195577593,-1370,,
7275013766,6195829478,263938260,6195828108,-1370,,
7275031976,6195847687,263956469,6195846317,-1370,6195846814,
7275282877,6196098589,264207371,6196097344,-1245,,
7275533207,6196348920,264457701,6196347799,-1121,,
7275783371,6196599084,264707866,6196598088,-996,,
7276033746,6196849458,264958240,6196848586,-872,,
7276284406,6197100119,265208900,6197099247,-872,,
7276535302,6197351014,265459796,6197350143,-871,,
7276786101,6197601813,265710595,6197600941,-872,,
7277037070,6197852782,265961564,6197851910,-872,,
7277055380,6197871092,265979873,6197870220,-872,6197870240,
7277306014,6198121726,266230508,6198120858,-868,,
7277556536,6198372248,266481030,6198371386,-862,,
7277807190,6198622902,266731684,6198622046,-856,,
7278057343,6198873055,266981836,6198872205,-850,,
7278308050,6199123762,267232544,6199122912,-850,,
7278558461,6199374173,267482955,6199373323,-850,,
7278809068,6199624780,267733562,6199623930,-850,,
7279059334,6199875046,267983828,6199874196,-850,,
7279078567,6199894279,268003060,6199893428,-851,6199892912,
7279329046,6200144758,268253540,6200143780,-978,,
7279579893,6200395605,268504387,6200394497,-1108,,
7279830100,6200645812,268754594,6200644575,-1237,,
7280080926,6200896638,269005420,6200895274,-1364,,
7280331117,6201146830,269255612,6201145475,-1355,,
7280581656,6201397368,269506150,6201396004,-1364,,
7280832100,6201647813,269756595,6201646448,-1365,,
7281082347,6201898060,270006842,6201896695,-1365,,
7281100599,6201916311,270025092,6201914945,-1366,6201915418,
7281351118,6202166830,270275612,6202165584,-1246,,
7281601627,6202417339,270526121,6202416211,-1128,,
7281852376,6202668088,270776870,6202667080,-1008,,
7282102595,6202918308,271027090,6202917417,-891,,
7282352776,6203168487,271277269,6203167597,-890,,
7282603328,6203419041,271527822,6203418150,-891,,
7282854306,6203670018,271778800,6203669127,-891,,
7283104508,6203920220,272029002,6203919329,-891,,
7283122678,6203938390,272047171,6203937498,-892,6203937468,
7283373679,6204189392,272298173,6204188493,-899,,
7283624129,6204439841,272548623,6204438935,-906,,
7283874688,6204690400,272799182,6204689487,-913,,
7284125530,6204941242,273050024,6204940322,-920,,
7284376278,6205191990,273300772,6205191070,-920,,
7284626461,6205442173,273550965,6205441264,-909,,
7284876931,6205692643,273801425,6205691723,-920,,
7285127726,6205943438,274052220,6205942518,-920,,
7285146060,6205961772,274070553,6205960851,-921,6205960840,
7285396968,6206212680,274321462,6206211757,-923,,
7285647194,6206462906,274571688,6206461981,-925,,
7285897459,6206713171,274821952,6206712244,-927,,
7286148131,6206963851,275072633,6206962921,-930,,
7286398716,6207214429,275323211,6207213499,-930,,
7286648946,6207464657,275573439,6207463728,-929,,
7286899189,6207714901,275823683,6207713971,-930,,
7287149466,6207965178,276073959,6207964248,-930,,
7287167572,6207983283,276092065,6207982353,-930,6207982392,
7287418353,6208234065,276342846,6208233145,-920,,
7287668572,6208484284,276593066,6208483374,-910,,
7287918821,6208734533,276843315,6208733634,-899,,
7288169072,6208984784,277093566,6208983895,-889,,
7288419793,6209235505,277344286,6209234616,-889,,
7288670196,6209485908,277594689,6209485019,-889,,
7288920785,6209736497,277845279,6209735608,-889,,
7289171313,6209987025,278095807,6209986137,-888,,
7289189502,6210005213,278113994,6210004324,-889,6210004246,
7289440307,6210256019,278364801,6210255111,-908,,
7289690604,6210506317,278615098,6210505389,-928,,
7289940863,6210756575,278865357,6210755628,-947,,
7290191525,6211007237,279116019,6211006271,-966,,
7290441852,6211257564,279366346,6211256598,-966,,
7290692880,6211508592,279617374,6211507627,-965,,
7290943452,6211759164,279867946,6211758198,-966,,
7291193638,6212009350,280118131,6212008384,-966,,
7291211819,6212027530,280136312,6212026564,-966,6212026601,
7291462432,6212278144,280386926,6212277188,-956,,
7291712579,6212528292,280637073,6212527346,-946,,
7291963257,6212778970,280887751,6212778034,-936,,
7292213905,6213029617,281138399,6213028690,-927,,
7292464080,6213279792,281388574,6213278866,-926,,
7292714719,6213530431,281639213,6213529504,-927,,
7292965098,6213780810,281889592,6213779884,-926,,
7293215245,6214030957,282139739,6214030031,-926,,
7293233505,6214049216,282157997,6214048289,-927,6214048263,
7293484372,6214300085,282408866,6214299143,-942,,
7293734885,6214550597,282659379,6214549651,-946,,
7293985412,6214801124,282909906,6214800175,-949,,
7294236108,6215051820,283160602,6215050868,-952,,
7294486655,6215302367,283411149,6215301415,-952,,
7294737148,6215552860,283661642,6215551909,-951,,
7294987909,6215803621,283912403,6215802670,-951,,
7295238330,6216054043,284162825,6216053091,-952,,
7295256484,6216072196,284180977,6216071243,-953,6216071248,
7295506748,6216322460,284431242,6216321509,-951,,
7295757276,6216572988,284681770,6216572039,-949,,
7296008172,6216823885,284932667,6216822938,-947,,
7296271168,6217086880,285195661,6217085934,-946,,
7296521584,6217337296,285446078,6217336350,-946,,
7296772605,6217588317,285697099,6217587371,-946,,
7297022816,6217838529,285947310,6217837583,-946,,
7297273135,6218088847,286197629,6218087901,-946,,
7297291312,6218107023,286215805,6218106077,-946,6218106108,
7297541800,6218357512,286466294,6218356573,-939,,
7297792505,6218608217,286716999,6218607287,-930,,
7298043491,6218859203,286967985,6218858281,-922,,
7298293984,6219109696,287218478,6219108783,-913,,
7298544401,6219360114,287468895,6219359199,-915,,
7298794751,6219610464,287719245,6219609550,-914,,
7299044980,6219860693,287969474,6219859779,-914,,
7299295514,6220111226,288220008,6220110312,-914,,
7299313746,6220129457,288238238,6220128543,-914,6220128544,
7299564083,6220379795,288488577,6220378881,-914,,
7299814409,6220630121,288738903,6220629208,-913,,
7300064899,6220880610,288989392,6220879699,-911,,
7300315017,6221130729,289239511,6221129819,-910,,
7300565754,6221381467,289490249,6221380556,-911,,
7300815891,6221631604,289740386,6221630693,-911,,
7301066110,6221881822,289990604,6221880912,-910,,
7301316400,6222132112,290240894,6222131201,-911,,
7301334651,6222150362,290259143,6222149451,-911,6222149356,
7301584879,6222400591,290509373,6222399656,-935,,
7301835571,6222651283,290760065,6222650326,-957,,
7302086133,6222901845,291010627,6222900864,-981,,
7302336790,6223152503,291261284,6223151499,-1004,,
7302587513,6223403225,291512007,6223402221,-1004,,
7302838110,6223653822,291762604,6223652819,-1003,,
7303088818,6223904530,292013312,6223903526,-1004,,
7303339496,6224155209,292263990,6224154205,-1004,,
7303359057,6224174769,292283550,6224173764,-1005,6224173115,
7303609589,6224425301,292534083,6224424133,-1168,,
7303860424,6224676136,292784917,6224674806,-1330,,
7304110712,6224926424,293035206,6224924932,-1492,,
7304361377,6225177088,293285870,6225175437,-1651,,
7304612220,6225427932,293536713,6225426280,-1652,,
7304862465,6225678178,293786960,6225676526,-1652,,
7305113575,6225929287,294038069,6225927635,-1652,,
7305364106,6226179819,294288600,6226178167,-1652,,
7305382458,6226198169,294306951,6226196517,-1652,6226197054,
7305633093,6226448805,294557587,6226447288,-1517,,
7305883786,6226699498,294808280,6226698116,-1382,,
7306134125,6226949838,295058620,6226948591,-1247,,
7306384298,6227200011,295308792,6227198897,-1114,,
7306634481,6227450193,295558975,6227449080,-1113,,
7306884692,6227700405,295809186,6227699291,-1114,,
7307135009,6227950721,296059502,6227949607,-1114,,
7307385740,6228201452,296310234,6228200339,-1113,,
7307403883,6228219595,296328376,6228218480,-1115,6228218578,
7307654087,6228469799,296578581,6228468709,-1090,,
7307904482,6228720195,296828976,6228719129,-1066,,
7308154900,6228970613,297079395,6228969573,-1040,,
7308405608,6229221320,297330102,6229220305,-1015,,
7308655984,6229471697,297580478,6229470681,-1016,,
7308906894,6229722606,297831388,6229721591,-1015,,
7309157628,6229973340,298082122,6229972325,-1015,,
7309408056,6230223768,298332550,6230222754,-1014,,
7309426334,6230242045,298350827,6230241030,-1015,6230241041,
7309677230,6230492942,298601724,6230491929,-1013,,
7309927765,6230743477,298852259,6230742467,-1010,,
7310178613,6230994325,299103107,6230993318,-1007,,
7310429499,6231245211,299353994,6231244209,-1002,,
7310679939,6231495651,299604433,6231494648,-1003,,
7310930821,6231746533,299855315,6231745530,-1003,,
7311181702,6231997414,300106196,6231996411,-1003,,
7311432110,6232247822,300356604,6232246819,-1003,,
7311450315,6232266026,300374807,6232265023,-1003,6232265048,
7311700949,6232516661,300625442,6232515665,-996,,
7311951318,6232767031,300875812,6232766042,-989,,
7312201403,6233017114,301125896,6233016133,-981,,
7312452374,6233268086,301376867,6233267110,-976,,
7312703518,6233519230,301628012,6233518254,-976,,
7312954352,6233770064,301878846,6233769088,-976,,
7313206213,6234021925,302130706,6234020949,-976,,
7313456406,6234272118,302380900,6234271142,-976,,
7313474669,6234290381,302399162,6234289404,-977,6234289367,
7313725353,6234541066,302649847,6234540080,-986,,
7313975696,6234791408,302900190,6234790413,-995,,
7314226304,6235042016,303150798,6235041013,-1003,,
7314476797,6235292510,303401291,6235291498,-1012,,
7314727432,6235543144,303651926,6235542133,-1011,,
7314978210,6235793922,303902704,6235792911,-1011,,
7315228358,6236044071,304152852,6236043059,-1012,,
7315478963,6236294675,304403457,6236293664,-1011,,
7315497227,6236312939,304421720,6236311927,-1012,6236311945,
7315749003,6236564731,304673512,6236563723,-1008,,
7315999658,6236815370,304924153,6236814368,-1002,,
7316250272,6237065985,305174766,6237064988,-997,,
7316500447,6237316159,305424941,6237315167,-992,,
7316751463,6237567176,305675957,6237566183,-993,,
7317002069,6237817781,305926563,6237816789,-992,,
7317253036,6238068748,306177530,6238067756,-992,,
7317503992,6238319704,306428486,6238318712,-992,,
7317528213,6238343925,306452706,6238342933,-992,6238339955,
7317779238,6238594950,306703732,6238593209,-1741,,
7318029767,6238845479,306954261,6238842993,-2486,,
7318280351,6239096064,307204846,6239092833,-3231,,
7318530761,6239346473,307455255,6239342505,-3968,,
7318781363,6239597075,307705857,6239593107,-3968,,
7319032333,6239848045,307956827,6239844078,-3967,,
7319282526,6240098239,308207020,6240094271,-3968,,
7319533467,6240349180,308457961,6240345212,-3968,,
7319551671,6240367382,308476164,6240363414,-3968,6240366397,
7319802226,6240617938,308726720,6240614717,-3221,,
7320052794,6240868506,308977288,6240866033,-2473,,
7320303847,6241119559,309228340,6241117836,-1723,,
7320554630,6241370342,309479124,6241369359,-983,,
7320805240,6241620953,309729735,6241619969,-984,,
7321055948,6241871660,309980442,6241870676,-984,,
7321306562,6242122274,310231056,6242121290,-984,,
7321557316,6242373028,310481810,6242372044,-984,,
7321575510,6242391221,310500002,6242390237,-984,6242390187,
7321826147,6242641859,310750641,6242640862,-997,,
7322076598,6242892310,311001092,6242891302,-1008,,
7322327409,6243143122,311251903,6243142101,-1021,,
7322578446,6243394159,311502941,6243393126,-1033,,
7322829096,6243644808,311753590,6243643775,-1033,,
7323079890,6243895602,312004384,6243894570,-1032,,
7323330633,6244146345,312255127,6244145313,-1032,,
7323580921,6244396633,312505415,6244395600,-1033,,
7323599217,6244414929,312523710,6244413896,-1033,6244413966,
7323850254,6244665966,312774748,6244664952,-1014,,
7324100628,6244916340,313025122,6244915344,-996,,
7324350962,6245166674,313275456,6245165696,-978,,
7324601281,6245416994,313525776,6245416033,-961,,
7324852271,6245667984,313776765,6245667023,-961,,
7325102890,6245918602,314027384,6245917641,-961,,
7325353120,6246168832,314277614,6246167871,-961,,
7325603660,6246419373,314528155,6246418412,-961,,
7325622571,6246438282,314547064,6246437321,-961,6246436890,
7325873203,6246688916,314797698,6246687847,-1069,,
7326123860,6246939573,315048354,6246938396,-1177,,
7326374432,6247190144,315298926,6247188861,-1283,,
7326625107,6247440819,315549601,6247439429,-1390,,
7326875471,6247691183,315799964,6247689792,-1391,,
7327125764,6247941476,316050258,6247940085,-1391,,
7327376246,6248191958,316300740,6248190567,-1391,,
7327626971,6248442683,316551465,6248441293,-1390,,
7327645174,6248460885,316569666,6248459494,-1391,6248459844,
7327895841,6248711554,316820335,6248710251,-1303,,
7328146516,6248962228,317071009,6248961013,-1215,,
7328396895,6249212608,317321390,6249211481,-1127,,
7328647568,6249463280,317572062,6249462242,-1038,,
7328897757,6249713470,317822251,6249712431,-1039,,
7329148562,6249964275,318073056,6249963236,-1039,,
7329399011,6250214723,318323505,6250213684,-1039,,
7329649599,6250465312,318574093,6250464283,-1029,,
7329667910,6250483621,318592402,6250482582,-1039,6250482521,
7329918161,6250733874,318842655,6250732819,-1055,,
7330168504,6250984217,319092998,6250983148,-1069,,
7330419263,6251234975,319343756,6251233891,-1084,,
7330669877,6251485589,319594371,6251484492,-1097,,
7330920284,6251735996,319844778,6251734898,-1098,,
7331171152,6251986865,320095647,6251985767,-1098,,
7331421482,6252237194,320345976,6252236097,-1097,,
7331672386,6252488099,320596880,6252487001,-1098,,
7331690642,6252506354,320615135,6252505256,-1098,6252505284,
7331940833,6252756546,320865328,6252755455,-1091,,
7332191397,6253007110,321115892,6253006027,-1083,,
7332441540,6253257252,321366033,6253256176,-1076,,
7332691910,6253507622,321616403,6253506554,-1068,,
7332942657,6253758369,321867150,6253757301,-1068,,
7333193238,6254008950,322117731,6254007882,-1068,,
7333443692,6254259404,322368186,6254258336,-1068,,
7333694697,6254510409,322619191,6254509341,-1068,,
7333712983,6254528694,322637476,6254527626,-1068,6254527661,
7333963484,6254779196,322887978,6254778138,-1058,,
7334213912,6255029624,323138406,6255028574,-1050,,
7334464520,6255280232,323389014,6255279192,-1040,,
7334715081,6255530794,323639575,6255529763,-1031,,
7334965687,6255781400,323890182,6255780369,-1031,,
7335216256,6256031968,324140750,6256030938,-1030,,
7335466637,6256282349,324391131,6256281319,-1030,,
7335716785,6256532498,324641279,6256531467,-1031,,
7335734951,6256550662,324659444,6256549631,-1031,6256549595,
7335985555,6256801267,324910049,6256800226,-1041,,
7336236104,6257051816,325160598,6257050767,-1049,,
7336486480,6257302193,325410974,6257301135,-1058,,
7336736809,6257552522,325661303,6257551456,-1066,,
7336986996,6257802708,325911490,6257801642,-1066,,
7337237401,6258053113,326161895,6258052047,-1066,,
7337487803,6258303515,326412297,6258302449,-1066,,
7337738344,6258554056,326662838,6258552990,-1066,,
7337756581,6258572292,326681074,6258571226,-1066,6258571189,
7338007188,6258822900,326931681,6258821824,-1076,,
7338257859,6259073571,327182352,6259072487,-1084,,
7338508638,6259324350,327433132,6259323257,-1093,,
7338758886,6259574599,327683381,6259573497,-1102,,
7339009511,6259825224,327934005,6259824122,-1102,,
7339259914,6260075627,328184408,6260074525,-1102,,
7339510195,6260325908,328434689,6260324806,-1102,,
7339760694,6260576406,328685188,6260575304,-1102,,
7339778994,6260594706,328703487,6260593603,-1103,6260593550,
7340029786,6260845498,328954280,6260844383,-1115,,
7340280190,6261095902,329204683,6261094774,-1128,,
7340530973,6261346686,329455468,6261345545,-1141,,
7340781357,6261597069,329705851,6261595915,-1154,,
7341032017,6261847729,329956511,6261846575,-1154,,
7341282275,6262097987,330206769,6262096833,-1154,,
7341532476,6262348189,330456970,6262347035,-1154,,
7341782627,6262598340,330707122,6262597186,-1154,,
7341800783,6262616494,330725276,6262615340,-1154,6262615408,
7342051113,6262866825,330975607,6262865687,-1138,,
7342301990,6263117702,331226484,6263116582,-1120,,
7342552467,6263368179,331476960,6263367076,-1103,,
7342802998,6263618711,331727492,6263617626,-1085,,
7343053094,6263868806,331977587,6263867721,-1085,,
7343303565,6264119277,332228059,6264118193,-1084,,
7343553972,6264369685,332478466,6264368600,-1085,,
7343804631,6264620343,332729124,6264619258,-1085,,
7343822948,6264638659,332747441,6264637574,-1085,6264637627,
7344073470,6264889183,332997965,6264888111,-1072,,
7344324117,6265139830,333248612,6265138772,-1058,,
7344574710,6265390422,333499204,6265389377,-1045,,
7344824942,6265640654,333749436,6265639623,-1031,,
7345075416,6265891128,333999910,6265890097,-1031,,
7345326129,6266141841,334250623,6266140810,-1031,,
7345576526,6266392239,334501020,6266391207,-1032,,
7345827076,6266642788,334751569,6266641757,-1031,,
7345845353,6266661065,334769846,6266660034,-1031,6266660005,
7346095612,6266911324,335020106,6266910285,-1039,,
7346346613,6267162326,335271107,6267161281,-1045,,
7346596979,6267412692,335521484,6267411650,-1042,,
7346847498,6267663210,335771992,6267662152,-1058,,
7347097779,6267913491,336022273,6267912433,-1058,,
7347347973,6268163686,336272467,6268162628,-1058,,
7347598492,6268414204,336522985,6268413146,-1058,,
7347849098,6268664811,336773592,6268663753,-1058,,
7347867402,6268683114,336791895,6268682056,-1058,6268682048,
7348118135,6268933847,337042629,6268932789,-1058,,
7348368727,6269184440,337293221,6269183379,-1061,,
7348619353,6269435066,337543848,6269434005,-1061,,
7348869543,6269685256,337794037,6269684192,-1064,,
7349120145,6269935857,338044639,6269934793,-1064,,
7349370806,6270186518,338295300,6270185454,-1064,,
7349621028,6270436741,338545522,6270435677,-1064,,
7349871348,6270687060,338795842,6270685997,-1063,,
7349889861,6270705572,338814353,6270704507,-1065,6270704362,
7350140532,6270956244,339065025,6270955143,-1101,,
7350390944,6271206657,339315438,6271205520,-1137,,
7350641337,6271457049,339565830,6271455876,-1173,,
7350891530,6271707242,339816024,6271706035,-1207,,
7351141834,6271957546,340066328,6271956338,-1208,,
7351392594,6272208306,340317088,6272207098,-1208,,
7351643203,6272458916,340567698,6272457708,-1208,,
7351893559,6272709271,340818053,6272708063,-1208,,
7351911867,6272727578,340836360,6272726370,-1208,6272726499,
7352162100,6272977812,341086593,6272976635,-1177,,
7352412735,6273228447,341337229,6273227304,-1143,,
7352663119,6273478831,341587613,6273477720,-1111,,
7352913340,6273729052,341837833,6273727974,-1078,,
7353164026,6273979739,342088520,6273978661,-1078,,
7353414284,6274229996,342338778,6274228919,-1077,,
7353664891,6274480603,342589385,6274479525,-1078,,
7353915441,6274731153,342839935,6274730076,-1077,,
7353933685,6274749396,342858178,6274748318,-1078,6274748239,
7354184421,6275000133,343108915,6274999035,-1098,,
7354434953,6275250665,343359446,6275249547,-1118,,
7354685435,6275501148,343609929,6275500011,-1137,,
7354935571,6275751283,343860065,6275750127,-1156,,
7355186042,6276001754,344110535,6276000598,-1156,,
7355436432,6276252144,344360926,6276250988,-1156,,
7355687071,6276502784,344611565,6276501628,-1156,,
7355937710,6276753423,344862204,6276752267,-1156,,
7355956234,6276771945,344880726,6276770789,-1156,6276770665,
7356206459,6277022171,345130953,6277020984,-1187,,
7356456693,6277272405,345381187,6277271187,-1218,,
7356706876,6277522588,345631370,6277521340,-1248,,
7356957570,6277773282,345882064,6277772004,-1278,,
7357207748,6278023460,346132241,6278022182,-1278,,
7357458472,6278274184,346382966,6278272906,-1278,,
7357709168,6278524880,346633662,6278523602,-1278,,
7357959753,6278775465,346884247,6278774188,-1277,,
7357978045,6278793756,346902537,6278792477,-1279,6278792609,
7358228464,6279044177,347152958,6279042930,-1247,,
7358479407,6279295119,347403901,6279293907,-1212,,
7358729811,6279545523,347654304,6279544345,-1178,,
7358980020,6279795732,347904513,6279794587,-1145,,
7359230338,6280046050,348154831,6280044905,-1145,,
7359480685,6280296397,348405178,6280295252,-1145,,
7359731148,6280546861,348655642,6280545716,-1145,,
7359981540,6280797252,348906034,6280796108,-1144,,
7359999870,6280815581,348924362,6280814446,-1135,6280814396,
7360250428,6281066140,349174921,6281064985,-1155,,
7360500950,6281316662,349425444,6281315497,-1165,,
7360751794,6281567507,349676289,6281566333,-1174,,
7361002069,6281817781,349926563,6281816598,-1183,,
7361252909,6282068621,350177403,6282067438,-1183,,
7361503590,6282319302,350428084,6282318119,-1183,,
7361754516,6282570228,350679010,6282569045,-1183,,
7362005148,6282820860,350929642,6282819678,-1182,,
7362023426,6282839138,350947919,6282837954,-1184,6282838032,
7362273713,6283089426,351198207,6283088261,-1165,,
7362524067,6283339779,351448560,6283338635,-1144,,
7362774226,6283589938,351698720,6283588814,-1124,,
7363024869,6283840581,351949363,6283839477,-1104,,
7363275310,6284091022,352199804,6284089918,-1104,,
7363525635,6284341347,352450129,6284340243,-1104,,
7363776187,6284591899,352700681,6284590795,-1104,,
7364026792,6284842504,352951286,6284841400,-1104,,
7364044963,6284860674,352969456,6284859570,-1104,6284859559,
7364295298,6285111011,353219792,6285109904,-1107,,
7364545721,6285361433,353470215,6285360325,-1108,,
7364796373,6285612085,353720867,6285610974,-1111,,
7365046779,6285862491,353971273,6285861378,-1113,,
7365296872,6286112584,354221366,6286111470,-1114,,
7365547132,6286362845,354471626,6286361731,-1114,,
7365797222,6286612934,354721716,6286611821,-1113,,
7366047865,6286863577,354972359,6286862463,-1114,,
7366066052,6286881763,354990545,6286880649,-1114,6286880616,
7366316653,6287132365,355241147,6287131245,-1120,,
7366567119,6287382831,355491613,6287381702,-1129,,
7366817498,6287633210,355741992,6287632073,-1137,,
7367067843,6287883555,355992337,6287882411,-1144,,
7367318215,6288133927,356242709,6288132782,-1145,,
7367568711,6288384423,356493205,6288383278,-1145,,
7367818905,6288634617,356743399,6288633472,-1145,,
7368069289,6288885001,356993783,6288883856,-1145,,
7368087612,6288903323,357012105,6288902178,-1145,6288902124,
7368338228,6289153940,357262722,6289152782,-1158,,
7368588757,6289404469,357513251,6289403297,-1172,,
7368839013,6289654726,357763507,6289653541,-1185,,
7369089380,6289905093,358013874,6289903895,-1198,,
7369340202,6290155914,358264696,6290154716,-1198,,
7369590489,6290406201,358514983,6290405003,-1198,,
7369840695,6290656407,358765189,6290655209,-1198,,
7370090860,6290906572,359015354,6290905375,-1197,,
7370109118,6290924830,359033611,6290923631,-1199,6290923676,
7370359658,6291175371,359284152,6291174182,-1189,,
7370609816,6291425529,359534310,6291424353,-1176,,
7370860941,6291676654,359785435,6291675490,-1164,,
7371111837,6291927550,360036331,6291926398,-1152,,
7371362389,6292178101,360286883,6292176950,-1151,,
7371612835,6292428547,360537329,6292427396,-1151,,
7371863050,6292678762,360787544,6292677610,-1152,,
7372114023,6292929735,361038517,6292928584,-1151,,
7372132277,6292947989,361056770,6292946836,-1153,6292946786,
7372383286,6293198998,361307780,6293197833,-1165,,
7372633756,6293449468,361558250,6293448291,-1177,,
7372883954,6293699666,361808448,6293698478,-1188,,
7373134675,6293950387,362059169,6293949187,-1200,,
7373385125,6294200838,362309619,6294199637,-1201,,
7373635295,6294451007,362559789,6294449806,-1201,,
7373885834,6294701546,362810328,6294700345,-1201,,
7374136712,6294952425,363061206,6294951224,-1201,,
7374155795,6294971506,363080288,6294970305,-1201,6294970015,
7374406692,6295222404,363331186,6295221130,-1274,,
7374657266,6295472977,363581759,6295471631,-1346,,
7374907387,6295723100,363831881,6295721681,-1419,,
7375157676,6295973388,364082170,6295971898,-1490,,
7375407910,6296223622,364332403,6296222132,-1490,,
7375658535,6296474248,364583029,6296472758,-1490,,
7375908728,6296724440,364833222,6296722950,-1490,,
7376159019,6296974731,365083512,6296973241,-1490,,
7376177116,6296992828,365101609,6296991337,-1491,6296991679,
7376427262,6297242975,365351756,6297241570,-1405,,
7376677816,6297493528,365602310,6297492210,-1318,,
7376928157,6297743870,365852652,6297742637,-1233,,
7377178930,6297994642,366103424,6297993495,-1147,,
7377429641,6298245353,366354135,6298244206,-1147,,
7377680064,6298495777,366604559,6298494630,-1147,,
7377930358,6298746070,366854852,6298744923,-1147,,
7378180888,6298996600,367105382,6298995453,-1147,,
7378199220,6299014931,367123713,6299013784,-1147,6299013725,
7378449837,6299265550,367374332,6299264388,-1162,,
7378700305,6299516018,367624799,6299514841,-1177,,
7378950775,6299766488,367875270,6299765297,-1191,,
7379201735,6300017447,368126229,6300016242,-1205,,
7379452229,6300267941,368376722,6300266736,-1205,,
7379702687,6300518399,368627181,6300517194,-1205,,
7379953266,6300768978,368877760,6300767774,-1204,,
7380203907,6301019620,369128401,6301018415,-1205,,
7380222061,6301037772,369146553,6301036567,-1205,6301036509,
7380472299,6301288012,369396793,6301286793,-1219,,
7380722943,6301538655,369647436,6301537422,-1233,,
7380973340,6301789053,369897834,6301787806,-1247,,
7381224232,6302039944,370148726,6302038684,-1260,,
7381475233,6302290945,370399727,6302289684,-1261,,
7381725368,6302541080,370649861,6302539819,-1261,,
7381975919,6302791631,370900413,6302790371,-1260,,
7382226436,6303042148,371150930,6303040887,-1261,,
7382244517,6303060228,371169009,6303058967,-1261,6303058985,
7382494923,6303310635,371419417,6303309379,-1256,,
7382745730,6303561441,371670223,6303560191,-1250,,
7382996060,6303811772,371920554,6303810526,-1246,,
7383246996,6304062708,372171489,6304061467,-1241,,
7383497179,6304312891,372421673,6304311650,-1241,,
7383747960,6304563672,372672454,6304562431,-1241,,
7383998103,6304813815,372922597,6304812574,-1241,,
7384248756,6305064468,373173250,6305063227,-1241,,
7384266967,6305082678,373191460,6305081437,-1241,6305081485,
7384517230,6305332942,373441724,6305331713,-1229,,
7384768298,6305584011,373692792,6305582795,-1216,,
7385018779,6305834491,373943273,6305833287,-1204,,
7385269346,6306085058,374193840,6306083868,-1190,,
7385519901,6306335614,374444396,6306334423,-1191,,
7385770774,6306586486,374695268,6306585295,-1191,,
7386020912,6306836625,374945407,6306835434,-1191,,
7386271495,6307087207,375195989,6307086016,-1191,,
7386289784,6307105496,375214277,6307104304,-1192,6307104370,
7386540325,6307356038,375464820,6307354863,-1175,,
7386790618,6307606330,375715112,6307605172,-1158,,
7387040825,6307856537,375965319,6307855397,-1140,,
7387291068,6308106781,376215562,6308105657,-1124,,
7387541793,6308357505,376466287,6308356381,-1124,,
7387792710,6308608423,376717204,6308607299,-1124,,
7388043117,6308858830,376967612,6308857706,-1124,,
7388293771,6309109483,377218265,6309108359,-1124,,
7388312042,6309127753,377236534,6309126628,-1125,6309126533,
7388562620,6309378332,377487114,6309377184,-1148,,
7388813162,6309628875,377737657,6309627703,-1172,,
7389063433,6309879145,377987927,6309877951,-1194,,
7389313915,6310129628,378238410,6310128410,-1218,,
7389564469,6310380181,378488963,6310378963,-1218,,
7389814964,6310630677,378739459,6310629459,-1218,,
7390065483,6310881196,378989977,6310879978,-1218,,
7390316042,6311131755,379240536,6311130537,-1218,,
7390334332,6311150043,379258824,6311148825,-1218,6311148795,
7390585214,6311400927,379509709,6311399701,-1226,,
7390835690,6311651402,379760183,6311650169,-1233,,
7391086440,6311902152,380010933,6311900912,-1240,,
7391336569,6312152281,380261063,6312151034,-1247,,
7391587431,6312403143,380511924,6312401895,-1248,,
7391838372,6312654084,380762866,6312652837,-1247,,
7392088895,6312904607,381013388,6312903360,-1247,,
7392339816,6313155528,381264309,6313154281,-1247,,
7392369353,6313185064,381293845,6313183817,-1247,6313178117,
7392619605,6313435317,381544099,6313432644,-2673,,
7392870165,6313685878,381794659,6313681777,-4101,,
7393120960,6313936672,382045454,6313931142,-5530,,
7393372838,6314188550,382297332,6314181605,-6945,,
7393623584,6314439297,382548079,6314432352,-6945,,
7393874221,6314689933,382798715,6314682988,-6945,,
7394126011,6314941723,383050505,6314934778,-6945,,
7394377157,6315192869,383301654,6315185928,-6941,,
7394395381,6315211092,383319873,6315204147,-6945,6315209799,
7394645670,6315461382,383570164,6315455851,-5531,,
7394895771,6315711484,383820265,6315707367,-4117,,
7395146445,6315962158,384070940,6315959458,-2700,,
7395396963,6316212675,384321456,6316211383,-1292,,
7395647569,6316463281,384572063,6316461989,-1292,,
7395898191,6316713904,384822685,6316712611,-1293,,
7396148509,6316964221,385073003,6316962929,-1292,,
7396399543,6317215256,385324037,6317213964,-1292,,
7396417880,6317233591,385342372,6317232299,-1292,6317232346,
7396668454,6317484167,385592949,6317482887,-1280,,
7396919064,6317734777,385843558,6317733509,-1268,,
7397169701,6317985414,386094195,6317984159,-1255,,
7397419965,6318235677,386344459,6318234434,-1243,,
7397670553,6318486265,386595047,6318485022,-1243,,
7397920737,6318736449,386845231,6318735206,-1243,,
7398171094,6318986806,387095588,6318985564,-1242,,
7398421544,6319237256,387346038,6319236014,-1242,,
7398439881,6319255592,387364374,6319254349,-1243,6319254337,
7398690482,6319506194,387614976,6319504948,-1246,,
7398941179,6319756890,387865672,6319755642,-1248,,
7399191642,6320007354,388116135,6320006103,-1251,,
7399442489,6320258201,388366983,6320256947,-1254,,
7399693345,6320509057,388617839,6320507803,-1254,,
7399944137,6320759849,388868631,6320758595,-1254,,
7400194975,6321010687,389119468,6321009433,-1254,,
7400446410,6321262122,389370904,6321260868,-1254,,
7400464706,6321280417,389389199,6321279163,-1254,6321279194,
7400714974,6321530687,389639469,6321529440,-1247,,
7400965910,6321781622,389890403,6321780383,-1239,,
7401218616,6322034328,390143110,6322033098,-1230,,
7401469064,6322284776,390393558,6322283554,-1222,,
7401719813,6322535526,390644307,6322534304,-1222,,
7401970596,6322786308,390895089,6322785086,-1222,,
7402221087,6323036799,391145580,6323035577,-1222,,
7402471826,6323287539,391396321,6323286317,-1222,,
7402490209,6323305920,391414702,6323304698,-1222,6323304695,
7402740824,6323556537,391665318,6323555313,-1224,,
7402991740,6323807452,391916234,6323806229,-1223,,
7403242024,6324057737,392166519,6324056514,-1223,,
7403492362,6324308074,392416855,6324306851,-1223,,
7403743393,6324559105,392667887,6324557882,-1223,,
7403993919,6324809631,392918412,6324808408,-1223,,
7404244235,6325059947,393168729,6325058724,-1223,,
7404495092,6325310804,393419586,6325309581,-1223,,
7404513802,6325329513,393438295,6325328290,-1223,6325327993,
7404764285,6325579997,393688779,6325578700,-1297,,
7405014453,6325830165,393938947,6325828794,-1371,,
7405265734,6326081446,394190227,6326080001,-1445,,
7405515876,6326331588,394440369,6326330070,-1518,,
7405766102,6326581814,394690596,6326580296,-1518,,
7406016483,6326832196,394940978,6326830678,-1518,,
7406267223,6327082935,395191717,6327081417,-1518,,
7406517628,6327333340,395442122,6327331822,-1518,,
7406536612,6327352323,395461105,6327350805,-1518,6327350642,
7406787084,6327602796,395711578,6327601236,-1560,,
7407037327,6327853039,395961821,6327851439,-1600,,
7407287913,6328103625,396212407,6328101986,-1639,,
7407538465,6328354177,396462959,6328352497,-1680,,
7407789113,6328604826,396713607,6328603146,-1680,,
7408039547,6328855259,396964041,6328853579,-1680,,
7408289839,6329105552,397214334,6329103872,-1680,,
7408540323,6329356035,397464816,6329354355,-1680,,
7408558698,6329374410,397483191,6329372729,-1681,6329373092,
7408809182,6329624895,397733676,6329623306,-1589,,
7409059754,6329875466,397984248,6329873968,-1498,,
7409310001,6330125714,398234495,6330124308,-1406,,
7409560474,6330376186,398484967,6330374870,-1316,,
7409811086,6330626798,398735580,6330625482,-1316,,
7410061837,6330877550,398986331,6330876234,-1316,,
7410312255,6331127967,399236749,6331126651,-1316,,
7410562641,6331378354,399487135,6331377038,-1316,,
7410580804,6331396515,399505297,6331395199,-1316,6331395204,
7410831402,6331647114,399755896,6331645798,-1316,,
7411082055,6331897767,400006549,6331896454,-1313,,
7411332471,6332148183,400256973,6332146879,-1304,,
7411582922,6332398635,400507416,6332397324,-1311,,
7411833613,6332649325,400758107,6332648015,-1310,,
7412084450,6332900163,401008944,6332898853,-1310,,
7412334874,6333150586,401259368,6333149276,-1310,,
7412585434,6333401147,401509929,6333399837,-1310,,
7412603578,6333419289,401528071,6333417979,-1310,6333418031,
7412853888,6333669600,401778382,6333668302,-1298,,
7413104268,6333919980,402028762,6333918696,-1284,,
7413354847,6334170559,402279341,6334169288,-1271,,
7413605465,6334421178,402529959,6334419921,-1257,,
7413855966,6334671678,402780460,6334670421,-1257,,
7414106648,6334922360,403031142,6334921104,-1256,,
7414357240,6335172952,403281733,6335171695,-1257,,
7414608249,6335423961,403532743,6335422704,-1257,,
7414626375,6335442086,403550867,6335440828,-1258,6335440761,
7414876574,6335692287,403801069,6335691013,-1274,,
7415127116,6335942829,404051610,6335941539,-1290,,
7415377936,6336193648,404302430,6336192341,-1307,,
7415628148,6336443859,404552641,6336442537,-1322,,
7415878456,6336694168,404802950,6336692845,-1323,,
7416128593,6336944305,405053086,6336942982,-1323,,
7416378931,6337194644,405303425,6337193321,-1323,,
7416629172,6337444884,405553666,6337443562,-1322,,
7416647315,6337463027,405571808,6337461703,-1324,6337461708,
7416897635,6337713348,405822130,6337712026,-1322,,
7417148100,6337963813,406072594,6337962493,-1320,,
7417398334,6338214046,406322827,6338212727,-1319,,
7417648867,6338464579,406573361,6338463263,-1316,,
7417899994,6338715706,406824488,6338714390,-1316,,
7418155994,6338972820,407081605,6338971507,-1313,,
7418407737,6339223448,407332230,6339222132,-1316,,
7418658740,6339474453,407583234,6339473136,-1317,,
7418677046,6339492757,407601538,6339491440,-1317,6339491454,
7418927864,6339743580,407852362,6339742267,-1313,,
7419178656,6339994368,408103150,6339993059,-1309,,
7419428996,6340244708,408353490,6340243403,-1305,,
7419680240,6340495953,408604735,6340494651,-1302,,
7419930674,6340746387,408855168,6340745085,-1302,,
7420181597,6340997310,409106091,6340996008,-1302,,
7420432569,6341248282,409357063,6341246980,-1302,,
7420683003,6341498715,409607497,6341497413,-1302,,
7420701275,6341516986,409625768,6341515684,-1302,6341515681,
7420952236,6341767949,409876730,6341766646,-1303,,
7421202700,6342018412,410127194,6342017109,-1303,,
7421452913,6342268625,410377407,6342267323,-1302,,
7421703287,6342518999,410627781,6342517695,-1304,,
7421953607,6342769319,410878101,6342768015,-1304,,
7422204565,6343020277,411129059,6343018974,-1303,,
7422454675,6343270388,411379169,6343269084,-1304,,
7422704937,6343520650,411629431,6343519346,-1304,,
7422723171,6343538883,411647664,6343537578,-1305,6343537530,
7422973689,6343789402,411898183,6343788086,-1316,,
7423224084,6344039797,412148578,6344038469,-1328,,
7423474606,6344290318,412399100,6344288979,-1339,,
7423725187,6344540899,412649681,6344539549,-1350,,
7423975759,6344791471,412900253,6344790121,-1350,,
7424225939,6345041651,413150433,6345040300,-1351,,
7424476300,6345292013,413400795,6345290662,-1351,,
7424726890,6345542602,413651384,6345541252,-1350,,
7424745157,6345560869,413669650,6345559518,-1351,6345559556,
7424996014,6345811726,413920508,6345810385,-1341,,
7425246417,6346062130,414170911,6346060799,-1331,,
7425497019,6346312731,414421512,6346311410,-1321,,
7425747591,6346563303,414672085,6346561992,-1311,,
7425998170,6346813883,414922664,6346812572,-1311,,
7426249251,6347064963,415173745,6347063653,-1310,,
7426499427,6347315140,415423921,6347313829,-1311,,
7426750012,6347565724,415674506,6347564414,-1310,,
7426768264,6347583975,415692756,6347582664,-1311,6347582649,
7427018708,6347834421,415943202,6347833106,-1315,,
7427269352,6348085064,416193846,6348083745,-1319,,
7427519990,6348335703,416444485,6348334381,-1322,,
7427770561,6348586273,416695055,6348584949,-1324,,
7428020949,6348836662,416945444,6348835337,-1325,,
7428271531,6349087243,417196025,6349085918,-1325,,
7428522101,6349337813,417446595,6349336489,-1324,,
7428772840,6349588552,417697334,6349587227,-1325,,
7428791023,6349606734,417715515,6349605409,-1325,6349605278,
7429041672,6349857384,417966166,6349856026,-1358,,
7429292435,6350108147,418216928,6350106757,-1390,,
7429542564,6350358276,418467058,6350356854,-1422,,
7429793593,6350609305,418718087,6350607851,-1454,,
7430043750,6350859462,418968244,6350858009,-1453,,
7430294282,6351109995,419218777,6351108541,-1454,,
7430544882,6351360595,419469376,6351359141,-1454,,
7430795057,6351610770,419719552,6351609316,-1454,,
7430813372,6351629083,419737864,6351627629,-1454,6351627707,
7431063967,6351879679,419988461,6351878245,-1434,,
7431314864,6352130577,420239358,6352129163,-1414,,
7431565457,6352381168,420489950,6352379775,-1393,,
7431815684,6352631396,420740178,6352630022,-1374,,
7432066453,6352882165,420990947,6352880791,-1374,,
7432324278,6353139991,421248772,6353138616,-1375,,
7432574408,6353390120,421498902,6353388746,-1374,,
7432824961,6353640673,421749455,6353639299,-1374,,
7432843150,6353658862,421767643,6353657488,-1374,6353657494,
7433093592,6353909304,422018086,6353907931,-1373,,
7433344496,6354160208,422268990,6354158837,-1371,,
7433595566,6354411278,422520060,6354409910,-1368,,
7433847770,6354663483,422772264,6354662116,-1367,,
7434099127,6354914839,423023620,6354913473,-1366,,
7434349697,6355165409,423274191,6355164044,-1365,,
7434601418,6355417130,423525912,6355415764,-1366,,
7434855425,6355671137,423779919,6355669771,-1366,,
7434878553,6355694264,423803045,6355692898,-1366,6355690403,
7435129217,6355944930,424053711,6355942938,-1992,,
7435380492,6356196205,424304986,6356193587,-2618,,
7435630901,6356446613,424555394,6356443371,-3242,,
7435881140,6356696854,424805635,6356692995,-3859,,
7436131427,6356947139,425055921,6356943280,-3859,,
7436381599,6357197311,425306093,6357193452,-3859,,
7436632220,6357447933,425556714,6357444074,-3859,,
7436882475,6357698187,425806969,6357694329,-3858,,
7436901507,6357717218,425825999,6357713359,-3859,6357715479,
7437151710,6357967422,426076204,6357964094,-3328,,
7437402034,6358217746,426326528,6358214949,-2797,,
7437652282,6358467994,426576776,6358465728,-2266,,
7437902781,6358718493,426827275,6358716756,-1737,,
7438153723,6358969435,427078217,6358967698,-1737,,
7438403951,6359219663,427328445,6359217926,-1737,,
7438654316,6359470028,427578810,6359468291,-1737,,
7438904789,6359720501,427829282,6359718764,-1737,,
7438923053,6359738765,427847546,6359737027,-1738,6359737377,
7439173288,6359989004,428097787,6359987355,-1649,,
7439436983,6360252696,428361477,6360251139,-1557,,
7439692871,6360508583,428617365,6360507116,-1467,,
7439943496,6360759208,428867989,6360757822,-1386,,
7440194155,6361009867,429118649,6361008481,-1386,,
7440448074,6361263786,429372568,6361262401,-1385,,
7440698375,6361514087,429622869,6361512702,-1385,,
7440949004,6361764716,429873498,6361763330,-1386,,
7440975158,6361790870,429899651,6361789484,-1386,6361785498,
7441225711,6362041423,430150205,6362039038,-2385,,
7441476837,6362292549,430401331,6362289163,-3386,,
7441731264,6362546977,430655759,6362542578,-4399,,
7441981658,6362797370,430906152,6362792000,-5370,,
7442232045,6363047767,431156549,6363042397,-5370,,
7442482575,6363298287,431407069,6363292917,-5370,,
7442733420,6363549132,431657913,6363543762,-5370,,
7442983700,6363799412,431908194,6363794042,-5370,,
7443001838,6363817550,431926331,6363812179,-5371,6363816144,
7443252420,6364068133,432176914,6364063756,-4377,,
7443502936,6364318648,432427430,6364315265,-3383,,
7443753558,6364569270,432678051,6364566881,-2389,,
7444004127,6364819839,432928621,6364818435,-1404,,
7444254704,6365070417,433179199,6365069013,-1404,,
7444505086,6365320798,433429580,6365319394,-1404,,
7444756003,6365571715,433680497,6365570311,-1404,,
7445007410,6365823122,433931904,6365821718,-1404,,
7445026464,6365842175,433950957,6365840771,-1404,6365840349,
7445277211,6366092923,434201705,6366091413,-1510,,
7445527969,6366343681,434452463,6366342065,-1616,,
7445781383,6366597095,434705877,6366595373,-1722,,
7446032247,6366847959,434956741,6366846135,-1824,,
7446282899,6367098611,435207393,6367096786,-1825,,
7446533943,6367349656,435458437,6367347831,-1825,,
7446790057,6367605769,435714550,6367603944,-1825,,
7447040763,6367856475,435965257,6367854650,-1825,,
7447058919,6367874631,435983412,6367872805,-1826,6367873234,
7447317062,6368132774,436241555,6368131059,-1715,,
7447567570,6368383282,436492064,6368381675,-1607,,
7447818550,6368634262,436743044,6368632763,-1499,,
7448069075,6368884787,436993568,6368883392,-1395,,
7448319331,6369135043,437243825,6369133648,-1395,,
7448570107,6369385819,437494601,6369384424,-1395,,
7448820345,6369636057,437744839,6369634663,-1394,,
7449071065,6369886778,437995559,6369885382,-1396,,
7449089315,6369905027,438013808,6369903632,-1395,6369903681,
7449339910,6370155623,438264405,6370154240,-1383,,
7449591496,6370407209,438515990,6370405839,-1370,,
7449842188,6370657900,438766682,6370656543,-1357,,
7450092325,6370908037,439016818,6370906693,-1344,,
7450343239,6371158951,439267733,6371157607,-1344,,
7450593709,6371409422,439518203,6371408078,-1344,,
7450844307,6371660019,439768801,6371658675,-1344,,
7451094440,6371910152,440018934,6371908808,-1344,,
7451112597,6371928309,440037090,6371926964,-1345,6371926955,
7451363524,6372179237,440288019,6372177890,-1347,,
7451614185,6372429897,440538679,6372428548,-1349,,
7451864699,6372680411,440789192,6372679060,-1351,,
7452115183,6372930895,441039677,6372929543,-1352,,
7452365302,6373181014,441289796,6373179662,-1352,,
7452615423,6373431136,441539917,6373429784,-1352,,
7452865583,6373681296,441790078,6373679944,-1352,,
7453115741,6373931454,442040235,6373930102,-1352,,
7453133984,6373949696,442058477,6373948344,-1352,6373948310,
7453384583,6374200296,442309077,6374198935,-1361,,
7453635119,6374450831,442559612,6374449463,-1368,,
7453885298,6374701010,442809792,6374699634,-1376,,
7454135853,6374951566,443060348,6374950182,-1384,,
7454386018,6375201731,443310512,6375200347,-1384,,
7454636344,6375452057,443560838,6375450673,-1384,,
7454886884,6375702596,443811377,6375701212,-1384,,
7455137480,6375953193,444061974,6375951808,-1385,,
7455155890,6375971601,444080382,6375970217,-1384,6375970305,
7455406498,6376222210,444330992,6376220849,-1361,,
7455657080,6376472792,444581573,6376471453,-1339,,
7455907855,6376723567,444832348,6376722251,-1316,,
7456158256,6376973969,445082750,6376972675,-1294,,
7456408431,6377224143,445332925,6377222849,-1294,,
7456659093,6377474805,445583587,6377473511,-1294,,
7456909551,6377725263,445834045,6377723969,-1294,,
7457160127,6377975839,446084621,6377974545,-1294,,
7457178699,6377994411,446103192,6377993116,-1295,6377992761,
7457428770,6378244482,446353264,6378243098,-1384,,
7457679084,6378494796,446603578,6378493324,-1472,,
7457929509,6378745221,446854003,6378743662,-1559,,
7458179762,6378995475,447104256,6378993827,-1648,,
7458430448,6379246160,447354942,6379244513,-1647,,
7458681173,6379496886,447605667,6379495238,-1648,,
7458931623,6379747335,447856117,6379745687,-1648,,
7459182335,6379998047,448106829,6379996399,-1648,,
7459200544,6380016256,448125037,6380014608,-1648,6380014780,
7459451425,6380267137,448375919,6380265533,-1604,,
7459701840,6380517553,448626335,6380515992,-1561,,
7459952780,6380768492,448877274,6380766975,-1517,,
7460203468,6381019180,449127962,6381017706,-1474,,
7460453901,6381269613,449378395,6381268140,-1473,,
7460704148,6381519860,449628642,6381518386,-1474,,
7460954418,6381770130,449878912,6381768656,-1474,,
7461204826,6382020538,450129320,6382019064,-1474,,
7461223084,6382038795,450147576,6382037320,-1475,6382037374,
7461473493,6382289206,450397988,6382287745,-1461,,
7461724483,6382540195,450648977,6382538748,-1447,,
7461975021,6382790734,450899515,6382789301,-1433,,
7462225562,6383041274,451150056,6383039855,-1419,,
7462477433,6383293145,451401927,6383291726,-1419,,
7462728135,6383543848,451652629,6383542429,-1419,,
7462978324,6383794037,451902818,6383792617,-1420,,
7463228949,6384044661,452153443,6384043242,-1419,,
7463247146,6384062857,452171639,6384061438,-1419,6384061398,
7463497764,6384313476,452422258,6384312047,-1429,,
7463748157,6384563869,452672651,6384562430,-1439,,
7463998737,6384814449,452923231,6384813002,-1447,,
7464249390,6385065102,453173883,6385063644,-1458,,
7464499797,6385315509,453424290,6385314051,-1458,,
7464750096,6385565809,453674591,6385564351,-1458,,
7465000805,6385816517,453925299,6385815059,-1458,,
7465250972,6386066685,454175466,6386065227,-1458,,
7465269267,6386084979,454193760,6386083520,-1459,6386083546,
7465519633,6386335345,454444127,6386333894,-1451,,
7465769947,6386585659,454694440,6386584214,-1445,,
7466020961,6386836673,454945454,6386835235,-1438,,
7466270999,6387086711,455195493,6387085280,-1431,,
7466521549,6387337268,455446051,6387335838,-1430,,
7466773473,6387589185,455697967,6387587755,-1430,,
7467023653,6387839365,455948146,6387837934,-1431,,
7467274208,6388089921,456198703,6388088490,-1431,,
7467292503,6388108215,456216996,6388106783,-1432,6388106729,
7467543023,6388358735,456467517,6388357291,-1444,,
7467793983,6388609695,456718477,6388608237,-1458,,
7468044559,6388860271,456969052,6388858800,-1471,,
7468295407,6389111119,457219901,6389109635,-1484,,
7468546119,6389361831,457470613,6389360347,-1484,,
7468796430,6389612142,457720924,6389610658,-1484,,
7469046777,6389862489,457971271,6389861005,-1484,,
7469296945,6390112658,458221439,6390111174,-1484,,
7469315298,6390131009,458239790,6390129524,-1485,6390129512,
7469565829,6390381541,458490323,6390380054,-1487,,
7469816079,6390631791,458740573,6390630301,-1490,,
7470066541,6390882253,458991035,6390880760,-1493,,
7470316761,6391132473,459241255,6391130978,-1495,,
7470567466,6391383179,459491960,6391381683,-1496,,
7470817536,6391633248,459742030,6391631753,-1495,,
7471067849,6391883561,459992343,6391882066,-1495,,
7471318781,6392134493,460243275,6392132998,-1495,,
7471337104,6392152816,460261597,6392151321,-1495,6392151338,
7471587350,6392403062,460511844,6392401571,-1491,,
7471837877,6392653590,460762371,6392652104,-1486,,
7472088615,6392904328,461013110,6392902847,-1481,,
7472339246,6393154958,461263740,6393153482,-1476,,
7472589396,6393405109,461513891,6393403633,-1476,,
7472839554,6393655266,461764047,6393653790,-1476,,
7473089661,6393905373,462014154,6393903897,-1476,,
7473340277,6394155989,462264771,6394154513,-1476,,
7473358398,6394174110,462282891,6394172633,-1477,6394172647,
7473609169,6394424881,462533663,6394423408,-1473,,
7473859636,6394675349,462784130,6394673880,-1469,,
7474110097,6394925809,463034590,6394924344,-1465,,
7474360516,6395176228,463285010,6395174767,-1461,,
7474611114,6395426826,463535608,6395425365,-1461,,
7474861663,6395677375,463786157,6395675915,-1460,,
7475112016,6395927728,464036510,6395926267,-1461,,
7475362281,6396177993,464286775,6396176532,-1461,,
7475380836,6396196548,464305329,6396195086,-1462,6396194925,
7475631339,6396447053,464555834,6396445552,-1501,,
7475881905,6396697618,464806399,6396696076,-1542,,
7476133995,6396949707,465058488,6396948126,-1581,,
7476384232,6397199945,465308726,6397198324,-1621,,
7476634844,6397450557,465559338,6397448936,-1621,,
7476885085,6397700797,465809579,6397699176,-1621,,
7477135324,6397951036,466059818,6397949416,-1620,,
7477385697,6398201409,466310191,6398199788,-1621,,
7477403912,6398219623,466328404,6398218002,-1621,6398218103,
7477654274,6398469986,466578768,6398468390,-1596,,
7477904621,6398720332,466829114,6398718763,-1569,,
7478154866,6398970578,467079360,6398969034,-1544,,
7478405348,6399221060,467329841,6399219542,-1518,,
7478655889,6399471602,467580384,6399470084,-1518,,
7478906553,6399722265,467831047,6399720747,-1518,,
7479156676,6399972388,468081170,6399970870,-1518,,
7479407257,6400222970,468331751,6400221451,-1519,,
7479425494,6400241205,468349986,6400239687,-1518,6400239695,
7479675742,6400491455,468600236,6400489939,-1516,,
7479925920,6400741633,468850414,6400740120,-1513,,
7480176239,6400991951,469100733,6400990440,-1511,,
7480426368,6401242080,469350862,6401240571,-1509,,
7480676723,6401492435,469601217,6401490926,-1509,,
7480927291,6401743004,469851786,6401741495,-1509,,
7481178413,6401994125,470102906,6401992616,-1509,,
7481428524,6402244236,470353018,6402242727,-1509,,
7481447057,6402262768,470371550,6402261259,-1509,6402261112,
7481697679,6402513391,470622173,6402511845,-1546,,
7481948080,6402763792,470872574,6402762209,-1583,,
7482199194,6403014907,471123688,6403013288,-1619,,
7482449454,6403265166,471373948,6403263511,-1655,,
7482699620,6403515332,471624114,6403513688,-1644,,
7482949873,6403765585,471874367,6403763931,-1654,,
7483200091,6404015804,472124585,6404014149,-1655,,
7483450441,6404266152,472374934,6404264498,-1654,,
7483468705,6404284417,472393198,6404282761,-1656,6404282861,
7483719126,6404534838,472643620,6404533208,-1630,,
7483969534,6404785246,472894028,6404783642,-1604,,
7484219807,6405035519,473144301,6405033940,-1579,,
7484470871,6405286583,473395365,6405285029,-1554,,
7484721148,6405536860,473645642,6405535306,-1554,,
7484972129,6405787841,473896623,6405786287,-1554,,
7485222665,6406038378,474147160,6406036834,-1544,,
7485472880,6406288592,474397374,6406287038,-1554,,
7485490991,6406306702,474415484,6406305148,-1554,6406305185,
7485743509,6406559222,474668003,6406557676,-1546,,
7485993778,6406809491,474918273,6406807956,-1535,,
7486244269,6407059981,475168763,6407058456,-1525,,
7486494911,6407310623,475419405,6407309107,-1516,,
7486745538,6407561250,475670032,6407559734,-1516,,
7486996146,6407811859,475920640,6407810343,-1516,,
7487246299,6408062011,476170792,6408060495,-1516,,
7487496903,6408312615,476421397,6408311099,-1516,,
7487515079,6408330790,476439572,6408329274,-1516,6408329277,
7487765947,6408581659,476690440,6408580144,-1515,,
7488016747,6408832459,476941240,6408830946,-1513,,
7488267105,6409082817,477191599,6409081305,-1512,,
7488517678,6409333391,477442172,6409331879,-1512,,
7488768003,6409583716,477692497,6409582205,-1511,,
7489018891,6409834603,477943385,6409833103,-1500,,
7489269553,6410085264,478194046,6410083754,-1510,,
7489519780,6410335492,478444273,6410333981,-1511,,
7489537929,6410353641,478462422,6410352129,-1512,6410352079,
7489788136,6410603848,478712630,6410602317,-1531,,
7490038536,6410854248,478963030,6410852707,-1541,,
7490288716,6411104428,479213210,6411102879,-1549,,
7490539102,6411354815,479463597,6411353255,-1560,,
7490790119,6411605834,479714615,6411604273,-1561,,
7491040812,6411856524,479965306,6411854964,-1560,,
7491291431,6412107143,480215924,6412105583,-1560,,
7491541958,6412357670,480466452,6412356110,-1560,,
7491566334,6412382045,480490826,6412380485,-1560,6412377445,
7491816630,6412632342,480741124,6412630021,-2321,,
7492066964,6412882677,480991458,6412879596,-3081,,
7492317637,6413133349,481242131,6413129507,-3842,,
7492568377,6413384090,481492871,6413379492,-4598,,
7492818627,6413634339,481743121,6413629741,-4598,,
7493068980,6413884693,481993474,6413880094,-4599,,
7493319224,6414134936,482243717,6414130338,-4598,,
7493569815,6414385527,482494308,6414380929,-4598,,
7493588148,6414403860,482512641,6414399261,-4599,6414402292,
7493838731,6414654444,482763226,6414650605,-3839,,
7494089411,6414905123,483013905,6414902044,-3079,,
7494340058,6415155770,483264552,6415153452,-2318,,
7494591130,6415406842,483515624,6415405276,-1566,,
7494841890,6415657602,483766384,6415656037,-1565,,
7495092493,6415908205,484016987,6415906639,-1566,,
7495342805,6416158518,484267299,6416156952,-1566,,
7495593422,6416409134,484517916,6416407568,-1566,,
7495611686,6416427398,484536179,6416425832,-1566,6416425792,
7495862135,6416677848,484786630,6416676272,-1576,,
7496112601,6416928313,485037095,6416926728,-1585,,
7496362938,6417178650,485287432,6417177056,-1594,,
7496613650,6417429362,485538144,6417427758,-1604,,
7496864143,6417679855,485788636,6417678251,-1604,,
7497114659,6417930371,486039153,6417928767,-1604,,
7497365136,6418180848,486289630,6418179245,-1603,,
7497615939,6418431651,486540433,6418430047,-1604,,
7497634102,6418449813,486558595,6418448209,-1604,6418448273,
7497884356,6418700069,486808850,6418698480,-1589,,
7498134637,6418950349,487059130,6418948777,-1572,,
7498385245,6419200970,487309752,6419199415,-1555,,
7498635840,6419451552,487560333,6419450013,-1539,,
7498886397,6419702110,487810891,6419700570,-1540,,
7499136825,6419952538,488061320,6419950999,-1539,,
7499387686,6420203399,488312180,6420201860,-1539,,
7499637903,6420453615,488562397,6420452076,-1539,,
7499656106,6420471818,488580599,6420470278,-1540,6420470281,
7499906670,6420722382,488831164,6420720843,-1539,,
7500156909,6420972621,489081403,6420971083,-1538,,
7500407046,6421222758,489331539,6421221222,-1536,,
7500657439,6421473151,489581933,6421471616,-1535,,
7500907721,6421723433,489832215,6421721898,-1535,,
7501158215,6421973927,490082709,6421972392,-1535,,
7501408833,6422224544,490333326,6422223009,-1535,,
7501659165,6422474877,490583659,6422473342,-1535,,
7501677358,6422493069,490601851,6422491534,-1535,6422491491,
7501927925,6422743638,490852420,6422742092,-1546,,
7502178970,6422994682,491103464,6422993126,-1556,,
7502429393,6423245106,491353887,6423243539,-1567,,
7502679654,6423495366,491604148,6423493789,-1577,,
7502930174,6423745887,491854669,6423744310,-1577,,
7503180738,6423996450,492105231,6423994873,-1577,,
7503431574,6424247287,492356068,6424245709,-1578,,
7503681826,6424497538,492606320,6424495961,-1577,,
7503700487,6424516198,492624979,6424514621,-1577,6424514277,
7503951167,6424766880,492875661,6424765215,-1665,,
7504201399,6425017111,493125892,6425015362,-1749,,
7504451624,6425267335,493376117,6425265502,-1833,,
7504702255,6425517967,493626749,6425516049,-1918,,
7504952397,6425768110,493876891,6425766201,-1909,,
7505203097,6426018809,494127590,6426016890,-1919,,
7505454109,6426269821,494378603,6426267903,-1918,,
7505704874,6426520586,494629368,6426518668,-1918,,
7505723072,6426538783,494647564,6426536864,-1919,6426537266,
7505973342,6426789054,494897836,6426787235,-1819,,
7506224102,6427039814,495148595,6427038096,-1718,,
7506474230,6427289942,495398724,6427288325,-1617,,
7506724881,6427540594,495649375,6427539078,-1516,,
7506975051,6427790763,495899545,6427789248,-1515,,
7507225303,6428041015,496149796,6428039499,-1516,,
7507475816,6428291528,496400309,6428290012,-1516,,
7507726610,6428542322,496651104,6428540806,-1516,,
7507744853,6428560565,496669346,6428559049,-1516,6428558922,
7507995300,6428811013,496919794,6428809465,-1548,,
7508245524,6429061235,497170017,6429059657,-1578,,
7508496234,6429311946,497420727,6429310336,-1610,,
7508746790,6429562502,497671284,6429560861,-1641,,
7508997208,6429812921,497921702,6429811280,-1641,,
7509248110,6430063822,498172604,6430062181,-1641,,
7509498334,6430314046,498422828,6430312405,-1641,,
7509748824,6430564536,498673318,6430562895,-1641,,
7509766980,6430582692,498691473,6430581050,-1642,6430581084,
7510017591,6430833304,498942086,6430831671,-1633,,
7510267766,6431083479,499192260,6431081855,-1624,,
7510517929,6431333641,499442423,6431332026,-1615,,
7510768442,6431584154,499692936,6431582548,-1606,,
7511018613,6431834326,499943107,6431832720,-1606,,
7511268748,6432084460,500193242,6432082854,-1606,,
7511518921,6432334633,500443415,6432333027,-1606,,
7511769015,6432584727,500693509,6432583121,-1606,,
7511787375,6432603086,500711868,6432601480,-1606,6432601466,
7512037782,6432853494,500962276,6432851884,-1610,,
7512288185,6433103897,501212679,6433102284,-1613,,
7512538759,6433354472,501463254,6433352856,-1616,,
7512788923,6433604636,501713417,6433603017,-1619,,
7513039066,6433854779,501963560,6433853160,-1619,,
7513289196,6434104909,502213690,6434103290,-1619,,
7513539885,6434355597,502464379,6434353978,-1619,,
7513790613,6434606326,502715107,6434604707,-1619,,
7513808740,6434624451,502733233,6434622832,-1619,6434622855,
7514059267,6434874979,502983760,6434873366,-1613,,
7514309402,6435125114,503233896,6435123507,-1607,,
7514559518,6435375231,503484012,6435373630,-1601,,
7514810051,6435625764,503734545,6435624168,-1596,,
7515060165,6435875877,503984658,6435874282,-1595,,
7515310501,6436126214,504234996,6436124619,-1595,,
7515560639,6436376351,504485133,6436374756,-1595,,
7515810725,6436626438,504735219,6436624843,-1595,,
7515828954,6436644665,504753447,6436643070,-1595,6436643025,
7516079479,6436895192,505003973,6436893585,-1607,,
7516329895,6437145607,505254389,6437143989,-1618,,
7516579982,6437395694,505504475,6437394065,-1629,,
7516835327,6437651040,505759822,6437649412,-1628,,
7517085882,6437901594,506010376,6437899955,-1639,,
7517336068,6438151780,506260561,6438150141,-1639,,
7517586232,6438401944,506510726,6438400305,-1639,,
7517837172,6438652884,506761666,6438651245,-1639,,
7517855507,6438671219,506780000,6438669579,-1640,6438669568,
7518105946,6438921658,507030440,6438920016,-1642,,
7518356670,6439172382,507281164,6439170737,-1645,,
7518606834,6439422546,507531328,6439420899,-1647,,
7518857566,6439673278,507782059,6439671629,-1649,,
7519108101,6439923813,508032595,6439922165,-1648,,
7519358336,6440174049,508282830,6440172400,-1649,,
7519608777,6440424490,508533272,6440422841,-1649,,
7519859338,6440675051,508783833,6440673412,-1639,,
7519877519,6440693230,508802012,6440691581,-1649,6440691622,
7520127651,6440943363,509052145,6440941725,-1638,,
7520378288,6441194001,509302782,6441192373,-1628,,
7520628468,6441444180,509552962,6441442564,-1616,,
7520878909,6441694622,509803404,6441693015,-1607,,
7521129164,6441944876,510053658,6441943269,-1607,,
7521379686,6442195398,510304179,6442193791,-1607,,
7521629787,6442445500,510554281,6442443893,-1607,,
7521880474,6442696187,510804969,6442694580,-1607,,
7521899103,6442714814,510823596,6442713207,-1607,6442712987,
7522149309,6442965021,511073803,6442963360,-1661,,
7522399578,6443215290,511324071,6443213574,-1716,,
7522649835,6443465548,511574329,6443463778,-1770,,
7522900088,6443715800,511824581,6443713975,-1825,,
7523150348,6443966060,512074842,6443964235,-1825,,
7523401090,6444216803,512325584,6444214978,-1825,,
7523651905,6444467617,512576399,6444465792,-1825,,
7523902066,6444717779,512826560,6444715954,-1825,,
7523920321,6444736033,512844814,6444734207,-1826,6444734341,
7524171302,6444987014,513095796,6444985222,-1792,,
7524421900,6445237612,513346393,6445235854,-1758,,
7524672588,6445488300,513597082,6445486576,-1724,,
7524923086,6445738848,513847630,6445737158,-1690,,
7525173291,6445989003,514097785,6445987313,-1690,,
7525423448,6446239160,514347941,6446237470,-1690,,
7525673827,6446489539,514598321,6446487849,-1690,,
7525924549,6446740261,514849043,6446738571,-1690,,
7525942621,6446758332,514867113,6446756642,-1690,6446756712,
7526192911,6447008623,515117404,6447006951,-1672,,
7526443778,6447259490,515368272,6447257837,-1653,,
7526693940,6447509652,515618434,6447508016,-1636,,
7526944432,6447760144,515868926,6447758526,-1618,,
7527195231,6448010943,516119724,6448009325,-1618,,
7527445388,6448261101,516369882,6448259483,-1618,,
7527695873,6448511585,516620367,6448509967,-1618,,
7527950531,6448766243,516875025,6448764625,-1618,,
7527968698,6448784410,516893191,6448782791,-1619,6448782759,
7528219558,6449035283,517144076,6449033668,-1615,,
7528470062,6449285775,517394556,6449284141,-1634,,
7528720663,6449536375,517645157,6449534734,-1641,,
7528970825,6449786537,517895319,6449784888,-1649,,
7529221375,6450037087,518145869,6450035438,-1649,,
7529471924,6450287636,518396418,6450285987,-1649,,
7529722716,6450538429,518647210,6450536780,-1649,,
7529973481,6450789194,518897975,6450787545,-1649,,
7529992043,6450807754,518916535,6450806105,-1649,6450805917,
7530243170,6451058882,519167664,6451057185,-1697,,
7530493922,6451309634,519418416,6451307891,-1743,,
7530744444,6451560156,519668938,6451558366,-1790,,
7530995140,6451810852,519919634,6451809016,-1836,,
7531245607,6452061319,520170101,6452059483,-1836,,
7531496027,6452311740,520420521,6452309904,-1836,,
7531746472,6452562184,520670965,6452560348,-1836,,
7531997056,6452812768,520921550,6452810932,-1836,,
7532016146,6452831857,520940639,6452830021,-1836,6452829741,
7532267036,6453082748,521191530,6453080841,-1907,,
7532517307,6453333020,521441801,6453331042,-1978,,
7532768054,6453583766,521692548,6453581719,-2047,,
7533018546,6453834259,521943041,6453832144,-2115,,
7533269306,6454085018,522193800,6454082903,-2115,,
7533519449,6454335161,522443943,6454333046,-2115,,
7533769867,6454585580,522694361,6454583465,-2115,,
7534020429,6454836141,522944923,6454834026,-2115,,
7534038590,6454854301,522963082,6454852185,-2116,6454852657,
7534288942,6455104654,523213436,6455102656,-1998,,
7534539096,6455354809,523463591,6455352930,-1879,,
7534789564,6455605276,523714058,6455603515,-1761,,
7535039894,6455855606,523964388,6455853964,-1642,,
7535290120,6456105832,524214613,6456104190,-1642,,
7535540401,6456356114,524464895,6456354472,-1642,,
7535790927,6456606639,524715421,6456604997,-1642,,
7536041074,6456856786,524965568,6456855145,-1641,,
7536059271,6456874982,524983763,6456873340,-1642,6456873302,
7536309838,6457125550,525234331,6457123899,-1651,,
7536559953,6457375664,525484446,6457374004,-1660,,
7536810896,6457626608,525735389,6457624939,-1669,,
7537061727,6457877439,525986221,6457875761,-1678,,
7537312490,6458128202,526236983,6458126524,-1678,,
7537563321,6458379033,526487815,6458377356,-1677,,
7537813742,6458629454,526738236,6458627777,-1677,,
7538064034,6458879747,526988529,6458878069,-1678,,
7538082663,6458898374,527007156,6458896696,-1678,6458896565,
7538333035,6459148747,527257529,6459147037,-1710,,
7538583609,6459399321,527508103,6459397578,-1743,,
7538834510,6459650222,527759004,6459648447,-1775,,
7539085247,6459900959,528009740,6459899152,-1807,,
7539336031,6460151743,528260525,6460149936,-1807,,
7539586589,6460402301,528511083,6460400495,-1806,,
7539837263,6460652975,528761757,6460651168,-1807,,
7540087595,6460903317,529012099,6460901510,-1807,,
7540105813,6460921524,529030306,6460919717,-1807,6460919823,
7540356649,6461172362,529281154,6461170591,-1771,,
7540607585,6461423297,529532078,6461421543,-1754,,
7540858165,6461673883,529782665,6461672157,-1726,,
7541108937,6461924649,530033431,6461922949,-1700,,
7541359664,6462175377,530284158,6462173676,-1701,,
7541609974,6462425686,530534468,6462423987,-1699,,
7541860575,6462676287,530785069,6462674587,-1700,,
7542111425,6462927137,531035919,6462925437,-1700,,
7542129987,6462945698,531054480,6462943998,-1700,6462943953,
7542380331,6463196044,531304825,6463194332,-1712,,
7542630681,6463446394,531555175,6463444671,-1723,,
7542881196,6463696908,531805690,6463695174,-1734,,
7543131416,6463947128,532055910,6463945384,-1744,,
7543382226,6464197939,532306720,6464196194,-1745,,
7543632413,6464448126,532556907,6464446381,-1745,,
7543883295,6464699008,532807790,6464697264,-1744,,
7544133553,6464949265,533058047,6464947521,-1744,,
7544151768,6464967479,533076260,6464965735,-1744,6464965748,
7544402749,6465218462,533327243,6465216721,-1741,,
7544653011,6465468723,533577505,6465466987,-1736,,
7544903385,6465719098,533827880,6465717365,-1733,,
7545153986,6465969698,534078480,6465967969,-1729,,
7545404340,6466220052,534328834,6466218323,-1729,,
7545654921,6466470633,534579415,6466468904,-1729,,
7545905278,6466720990,534829772,6466719261,-1729,,
7546156160,6466971872,535080654,6466970143,-1729,,
7546174393,6466990105,535098886,6466988375,-1730,6466988379,
7546425001,6467240713,535349495,6467238984,-1729,,
7546675227,6467490939,535599721,6467489212,-1727,,
7546925306,6467741018,535849799,6467739292,-1726,,
7547175668,6467991380,536100162,6467989656,-1724,,
7547425944,6468241656,536350438,6468239932,-1724,,
7547676306,6468492018,536600800,6468490295,-1723,,
7547927025,6468742737,536851519,6468741013,-1724,,
7548177393,6468993105,537101887,6468991381,-1724,,
7548195576,6469011288,537120069,6469009563,-1725,6469009599,
7548446453,6469262165,537370946,6469260449,-1716,,
7548697011,6469512723,537621505,6469511017,-1706,,
7548947308,6469763020,537871802,6469761323,-1697,,
7549197453,6470013165,538121947,6470011478,-1687,,
7549448155,6470263867,538372649,6470262180,-1687,,
7549699217,6470514929,538623711,6470513242,-1687,,
7549950086,6470765798,538874580,6470764111,-1687,,
7550200667,6471016380,539125162,6471014693,-1687,,
7550218845,6471034556,539143337,6471032869,-1687,6471032829,
7550469397,6471285109,539393890,6471283411,-1698,,
7550719536,6471535249,539644031,6471533542,-1707,,
7550970484,6471786195,539894977,6471784479,-1716,,
7551221197,6472036909,540145691,6472035183,-1726,,
7551471816,6472287529,540396311,6472285803,-1726,,
7551722557,6472538268,540647050,6472536543,-1725,,
7551973401,6472789113,540897895,6472787387,-1726,,
7552224160,6473039873,541148655,6473038147,-1726,,
7552242569,6473058281,541167062,6473056555,-1726,6473056452,
7552493256,6473308969,541417750,6473307217,-1752,,
7552743849,6473559562,541668343,6473557784,-1778,,
7552994314,6473810027,541918808,6473808224,-1803,,
7553245099,6474060811,542169593,6474058984,-1827,,
7553495888,6474311600,542420382,6474309773,-1827,,
7553746302,6474562014,542670796,6474560187,-1827,,
7553996862,6474812574,542921356,6474810747,-1827,,
7554247681,6475063394,543172176,6475061567,-1827,,
7554265808,6475081519,543190300,6475079692,-1827,6475079759,
7554515904,6475331616,543440398,6475329807,-1809,,
7554766426,6475582138,543690919,6475580345,-1793,,
7555016901,6475832614,543941395,6475830839,-1775,,
7555267431,6476083143,544191925,6476081386,-1757,,
7555517889,6476333601,544442383,6476331843,-1758,,
7555768662,6476584374,544693156,6476582616,-1758,,
7556018932,6476834644,544943426,6476832886,-1758,,
7556278333,6477094045,545202827,6477092287,-1758,,
7556321127,6477136838,545245620,6477135080,-1758,6477122755,
7556572725,6477388437,545497219,6477383577,-4860,,
7556822943,6477638656,545747437,6477630713,-7943,,
7557073163,6477888876,545997657,6477877849,-11027,,
7557323721,6478139433,546248215,6478125352,-14081,,
7557575542,6478391254,546500036,6478377172,-14082,,
7557825999,6478641711,546750492,6478627629,-14082,,
7558077388,6478893100,547001882,6478879018,-14082,,
7558327896,6479143608,547252390,6479129526,-14082,,
7558347137,6479162848,547271630,6479148766,-14082,6479160624,
7558598157,6479413869,547522651,6479402764,-11105,,
7558848733,6479664446,547773227,6479656312,-8134,,
7559100370,6479916083,548024864,6479910934,-5149,,
7559350896,6480166608,548275390,6480164386,-2222,,
7559614512,6480430224,548539006,6480428002,-2222,,
7559865331,6480681043,548789825,6480678821,-2222,,
7560117338,6480933050,549041831,6480930828,-2222,,
7560370992,6481186704,549295486,6481184483,-2221,,
7560389998,6481205710,549314491,6481203488,-2222,6481203764,
7560642674,6481458386,549567168,6481456234,-2152,,
7560893142,6481708854,549817635,6481706771,-2083,,
7561159171,6481974883,550083665,6481972874,-2009,,
7561414986,6482230698,550339480,6482228754,-1944,,
7561665202,6482480915,550589696,6482478971,-1944,,
7561915694,6482731406,550840188,6482729462,-1944,,
7562166530,6482982242,551091024,6482980299,-1943,,
7562417468,6483233181,551341962,6483231237,-1944,,
7562435625,6483251336,551360117,6483249391,-1945,6483249598,
7562686226,6483501939,551610720,6483500047,-1892,,
7562937095,6483752808,551861589,6483750968,-1840,,
7563187706,6484003418,552112200,6484001630,-1788,,
7563438306,6484254018,552362800,6484252282,-1736,,
7563688644,6484504357,552613138,6484502621,-1736,,
7563939269,6484754981,552863763,6484753245,-1736,,
7564189868,6485005580,553114362,6485003844,-1736,,
7564440663,6485256375,553365157,6485254640,-1735,,
7564458867,6485274578,553383360,6485272842,-1736,6485272804,
7564709499,6485525211,553633993,6485523465,-1746,,
7564960191,6485775904,553884686,6485774149,-1755,,
7565211648,6486027360,554136142,6486025596,-1764,,
7565462690,6486278402,554387184,6486276630,-1772,,
7565712801,6486528514,554637306,6486526751,-1763,,
7565963301,6486779013,554887795,6486777240,-1773,,
7566214065,6487029777,555138558,6487028004,-1773,,
7566464320,6487280032,555388814,6487278259,-1773,,
7566482598,6487298310,555407091,6487296537,-1773,6487296597,
7566733396,6487549108,555657890,6487547349,-1759,,
7566983583,6487799295,555908077,6487797552,-1743,,
7567234366,6488050078,556158859,6488048351,-1727,,
7567484854,6488300567,556409348,6488298856,-1711,,
7567735148,6488550861,556659642,6488549150,-1711,,
7567985494,6488801207,556909989,6488799496,-1711,,
7568235837,6489051549,557160331,6489049838,-1711,,
7568486903,6489302616,557411397,6489300905,-1711,,
7568505045,6489320756,557429537,6489319045,-1711,6489318975,
7568755427,6489571138,557679920,6489569409,-1729,,
7569006084,6489821796,557930577,6489820051,-1745,,
7569257106,6490072818,558181600,6490071056,-1762,,
7569507398,6490323110,558431892,6490321331,-1779,,
7569757626,6490573339,558682121,6490571560,-1779,,
7570008608,6490824321,558933103,6490822542,-1779,,
7570259459,6491075171,559183953,6491073392,-1779,,
7570510503,6491326216,559434997,6491324437,-1779,,
7570528780,6491344491,559453272,6491342712,-1779,6491342742,
7570778941,6491594653,559703435,6491592882,-1771,,
7571029590,6491845302,559954084,6491843538,-1764,,
7571280215,6492095927,560204709,6492094173,-1754,,
7571530657,6492346370,560455151,6492344623,-1747,,
7571781261,6492596973,560705755,6492595226,-1747,,
7572031957,6492847670,560956452,6492845923,-1747,,
7572282516,6493098228,561207010,6493096481,-1747,,
7572532913,6493348625,561457407,6493346878,-1747,,
7572551064,6493366775,561475556,6493365028,-1747,6493364933,
7572801709,6493617422,561726203,6493615651,-1771,,
7573052392,6493868104,561976886,6493866310,-1794,,
7573302655,6494118368,562227150,6494116551,-1817,,
7573553729,6494369442,562478224,6494367602,-1840,,
7573803957,6494619669,562728451,6494617829,-1840,,
7574054748,6494870460,562979241,6494868620,-1840,,
7574305355,6495121067,563229849,6495119227,-1840,,
7574555517,6495371229,563480011,6495369390,-1839,,
7574573915,6495389626,563498407,6495387786,-1840,6495387776,
7574824545,6495640258,563749039,6495638416,-1842,,
7575075159,6495890871,563999653,6495889027,-1844,,
7575325803,6496141516,564250297,6496139670,-1846,,
7575576069,6496391781,564500563,6496389934,-1847,,
7575826630,6496642342,564751124,6496640494,-1848,,
7576077043,6496892756,565001537,6496890908,-1848,,
7576327661,6497143373,565252155,6497141525,-1848,,
7576578206,6497393918,565502700,6497392070,-1848,,
7576596356,6497412067,565520848,6497410219,-1848,6497410241,
7576846867,6497662579,565771361,6497660737,-1842,,
7577097183,6497912896,566021677,6497911060,-1836,,
7577347803,6498163515,566272297,6498161685,-1830,,
7577598281,6498413994,566522776,6498412170,-1824,,
7577848767,6498664479,566773261,6498662655,-1824,,
7578099211,6498914924,567023706,6498913100,-1824,,
7578349877,6499165590,567274371,6499163766,-1824,,
7578600929,6499416641,567525423,6499414817,-1824,,
7578619233,6499434944,567543725,6499433120,-1824,6499433101,
7578869869,6499685581,567794363,6499683750,-1831,,
7579120343,6499936055,568044837,6499934220,-1835,,
7579370512,6500186225,568295007,6500184387,-1838,,
7579621477,6500437189,568545971,6500435348,-1841,,
7579871743,6500687455,568796237,6500685614,-1841,,
7580122475,6500938187,569046969,6500936347,-1840,,
7580373235,6501188947,569297729,6501187106,-1841,,
7580623535,6501439247,569548029,6501437406,-1841,,
7580641806,6501457517,569566298,6501455676,-1841,6501455759,
7580892196,6501707908,569816690,6501706088,-1820,,
7581142799,6501958511,570067293,6501956712,-1799,,
7581393401,6502209113,570317895,6502207335,-1778,,
7581643691,6502459403,570568185,6502457647,-1756,,
7581894452,6502710164,570818946,6502708408,-1756,,
7582144874,6502960586,571069367,6502958830,-1756,,
7582395838,6503211550,571320332,6503209794,-1756,,
7582646512,6503462224,571571006,6503460468,-1756,,
7582664799,6503480511,571589292,6503478754,-1757,6503478691,
7582915266,6503730979,571839761,6503729207,-1772,,
7583165620,6503981332,572090114,6503979546,-1786,,
7583416035,6504231748,572340530,6504229945,-1803,,
7583666608,6504482320,572591102,6504480502,-1818,,
7583917613,6504733326,572842108,6504731508,-1818,,
7584167795,6504983507,573092289,6504981690,-1817,,
7584418895,6505234607,573343389,6505232790,-1817,,
7584669110,6505484822,573593604,6505483005,-1817,,
7584687512,6505503223,573612004,6505501405,-1818,6505501340,
7584938121,6505753833,573862615,6505751999,-1834,,
7585188582,6506004294,574113076,6506002444,-1850,,
7585438864,6506254577,574363359,6506252711,-1866,,
7585689178,6506504890,574613672,6506503009,-1881,,
7585940009,6506755721,574864503,6506753840,-1881,,
7586190747,6507006459,575115241,6507004579,-1880,,
7586441654,6507257367,575366149,6507255486,-1881,,
7586692197,6507507910,575616691,6507506028,-1882,,
7586710384,6507526095,575634876,6507524213,-1882,6507524257,
7586961393,6507777105,575885887,6507775236,-1869,,
7587212339,6508028051,576136833,6508026193,-1858,,
7587463113,6508278825,576387607,6508276978,-1847,,
7587713953,6508529666,576638448,6508527830,-1836,,
7587964443,6508780155,576888937,6508778320,-1835,,
7588214972,6509030684,577139466,6509028849,-1835,,
7588465609,6509281321,577390103,6509279486,-1835,,
7588715937,6509531649,577640430,6509529813,-1836,,
7588734110,6509549821,577658603,6509547985,-1836,6509547997,
7588984484,6509800196,577908978,6509798364,-1832,,
7589234656,6510050368,578159150,6510048539,-1829,,
7589484910,6510300623,578409404,6510298798,-1825,,
7589735496,6510551208,578659989,6510549386,-1822,,
7589986425,6510802138,578910920,6510800316,-1822,,
7590236608,6511052321,579161103,6511050499,-1822,,
7590487225,6511302937,579411718,6511301115,-1822,,
7590737401,6511553114,579661896,6511551292,-1822,,
7590755688,6511571400,579680181,6511569577,-1823,6511569547,
7591006154,6511821866,579930648,6511820037,-1829,,
7591256339,6512072051,580180833,6512070214,-1837,,
7591506998,6512322711,580431492,6512320867,-1844,,
7591757801,6512573513,580682295,6512571662,-1851,,
7592008111,6512823823,580932605,6512821972,-1851,,
7592258359,6513074071,581182853,6513072220,-1851,,
7592508804,6513324516,581433297,6513322665,-1851,,
7592759574,6513575286,581684068,6513573435,-1851,,
7592778554,6513594265,581703046,6513592414,-1851,6513591998,
7593028847,6513844559,581953341,6513842605,-1954,,
7593279044,6514094755,582203537,6514092698,-2057,,
7593529572,6514345284,582454066,6514343123,-2161,,
7593780372,6514596085,582704866,6514593819,-2266,,
7594031412,6514847124,582955906,6514844860,-2264,,
7594287560,6515103273,583212055,6515101008,-2265,,
7594538127,6515353839,583462621,6515351574,-2265,,
7594788216,6515603928,583712709,6515601663,-2265,,
7594806387,6515622099,583730880,6515619833,-2266,6515620214,
7595056638,6515872350,583981132,6515870181,-2169,,
7595307202,6516122914,584231696,6516120840,-2074,,
7595557783,6516373495,584482276,6516371517,-1978,,
7595808321,6516624033,584732815,6516622150,-1883,,
7596058788,6516874500,584983281,6516872617,-1883,,
7596309422,6517125134,585233916,6517123251,-1883,,
7596559672,6517375384,585484166,6517373501,-1883,,
7596810528,6517626240,585735022,6517624358,-1882,,
7596828699,6517644410,585753192,6517642527,-1883,6517642564,
7597079106,6517894818,586003600,6517892945,-1873,,
7597329735,6518145448,586254229,6518143585,-1863,,
7597580255,6518395967,586504749,6518394114,-1853,,
7597830536,6518646249,586755030,6518644405,-1844,,
7598081162,6518896874,587005656,6518895030,-1844,,
7598331891,6519147603,587256385,6519145759,-1844,,
7598582199,6519397911,587506693,6519396067,-1844,,
7598832907,6519648619,587757401,6519646775,-1844,,
7598851084,6519666795,587775576,6519664951,-1844,6519664922,
7599101383,6519917095,588025877,6519915244,-1851,,
7599351783,6520167495,588276277,6520165638,-1857,,
7599602434,6520418146,588526928,6520416282,-1864,,
7599853187,6520668899,588777681,6520667028,-1871,,
7600103420,6520919132,589027914,6520917262,-1870,,
7600353907,6521169623,589278405,6521167753,-1870,,
7600604378,6521420089,589528871,6521418219,-1870,,
7600855030,6521670743,589779524,6521668872,-1871,,
7600873228,6521688939,589797720,6521687067,-1872,6521687094,
7601123423,6521939136,590047917,6521937271,-1865,,
7601374240,6522189952,590298734,6522188095,-1857,,
7601624729,6522440441,590549222,6522438591,-1850,,
7601875653,6522691365,590800147,6522689522,-1843,,
7602125847,6522941559,591050341,6522939717,-1842,,
7602376556,6523192275,591301062,6523190438,-1837,,
7602626890,6523442602,591551384,6523440760,-1842,,
7602877401,6523693113,591801895,6523691271,-1842,,
7602895462,6523711173,591819954,6523709330,-1843,6523709287,
7603146041,6523961753,592070535,6523959899,-1854,,
7603396792,6524212504,592321285,6524210640,-1864,,
7603647404,6524463117,592571899,6524461243,-1874,,
7603898211,6524713923,592822705,6524712039,-1884,,
7604148812,6524964524,593073306,6524962639,-1885,,
7604399851,6525215563,593324345,6525213678,-1885,,
7604650139,6525465851,593574633,6525463966,-1885,,
7604900814,6525716526,593825308,6525714641,-1885,,
7604918963,6525734674,593843456,6525732789,-1885,6525732787,
7605169541,6525985252,594094034,6525983367,-1885,,
7605420249,6526235961,594344743,6526234076,-1885,,
7605670894,6526486606,594595388,6526484720,-1886,,
7605921553,6526737265,594846047,6526735380,-1885,,
7606172436,6526988148,595096930,6526986262,-1886,,
7606422826,6527238539,595347320,6527236653,-1886,,
7606673321,6527489034,595597815,6527487148,-1886,,
7606923432,6527739144,595847926,6527737258,-1886,,
7606941659,6527757371,595866152,6527755485,-1886,6527755475,
7607192571,6528008283,596117064,6528006395,-1888,,
7607442714,6528258427,596367208,6528256537,-1890,,
7607693333,6528509045,596617827,6528507153,-1892,,
7607944226,6528759939,596868721,6528758045,-1894,,
7608194463,6529010176,597118958,6529008282,-1894,,
7608445303,6529261015,597369797,6529259121,-1894,,
7608695941,6529511653,597620435,6529509759,-1894,,
7608946900,6529762612,597871394,6529760718,-1894,,
7608965070,6529780781,597889563,6529778887,-1894,6529778898,
7609215879,6530031592,598140373,6530029700,-1892,,
7609466917,6530282629,598391411,6530280741,-1888,,
7609717116,6530532828,598641610,6530530942,-1886,,
7609967998,6530783710,598892492,6530781828,-1882,,
7610218945,6531034658,599143439,6531032776,-1882,,
7610469307,6531285019,599393801,6531283137,-1882,,
7610719458,6531535170,599643952,6531533288,-1882,,
7610969645,6531785357,599894139,6531783475,-1882,,
7610987907,6531803618,599912399,6531801735,-1883,6531801676,
7611238203,6532053915,600162697,6532052019,-1896,,
7611488485,6532304197,600412979,6532302285,-1912,,
7611738982,6532554695,600663476,6532552769,-1926,,
7611989511,6532805223,600914005,6532803283,-1940,,
