Current Real Time,Real Time Elapsed (sec),Local Server Time,Hardware Clock Time,Software Clock Time,Error,Remote Est Time,
14525365505,0.00015,15929971160,11766058,11766058,-15918205102,,
14525600289,0.23494,15930205955,12000830,12000830,-15918205125,15930205851,
14525625782,0.26043,15930231449,12026322,93186881,-15837044568,,
14525676829,0.31148,15930282500,12077366,255746881,-15674535619,,
14525726974,0.36162,15930332658,12127520,415466181,-15514866477,,
14525777541,0.41219,15930383216,12178072,576459338,-15353923878,,
14525828111,0.46276,15930433788,12228640,737497079,-15192936709,,
14525878243,0.51289,15930483922,12278769,897139948,-15033343974,,
14525930110,0.56476,15930535791,12330633,1062308169,-14868227622,,
14525980845,0.61549,15930586529,12381366,1223874562,-14706711967,,
14526031421,0.66607,15930637108,12431939,1384934596,-14545702512,,
14526081532,0.71618,15930687220,12482047,1544507403,-14386179817,,
14526131671,0.76632,15930737363,12532183,1704175749,-14226561614,,
14526182767,0.81742,15930788460,12583277,1866888611,-14063899849,,
14526233798,0.86845,15930839494,12634305,2029397657,-13901441837,,
14526284833,0.91948,15930890531,12685336,2191913072,-13738977459,,
14526335869,0.97052,15930941574,12736376,2354453965,-13576487609,,
14526386931,1.02158,15930992635,12787431,2517045811,-13413946824,,
14526437476,1.07212,15931043182,12837973,2678003937,-13253039245,,
14526488513,1.12316,15931094220,12889006,2840525721,-13090568499,,
14526539080,1.17373,15931144790,12939571,3001557094,-12929587696,,
14526590128,1.22478,15931195840,12990616,3164117094,-12767078746,,
14526641175,1.27582,15931246889,13041660,3326673909,-12604572980,,
14526692237,1.32689,15931297954,13092719,3489281679,-12442016275,,
14526743290,1.37794,15931349009,13143770,3651857602,-12279491407,,
14526793827,1.42847,15931399550,13194305,3812793435,-12118606115,,
14526844060,1.47871,15931449785,13244535,3972761138,-11958688647,,
14526894632,1.52928,15931500359,13295105,4133805248,-11797695111,,
14526944990,1.57964,15931550732,13345471,4294206062,-11637344670,,
14526995299,1.62995,15931601030,13395765,4454374397,-11477226633,,
14527045812,1.68046,15931651545,13446276,4615230614,-11316420931,,
14527096048,1.73070,15931701785,13496509,4775207870,-11156493915,,
14527146460,1.78111,15931752199,13546919,4935742438,-10996009761,,
14527196542,1.83119,15931802283,13596998,5095229260,-10836573023,,
14527246913,1.88156,15931852657,13647366,5255633258,-10676219399,,
14527297545,1.93219,15931903290,13697995,5416868447,-10515034843,,
14527348592,1.98324,15931954340,13749040,5579425263,-10352529077,,
14527399226,2.03387,15932004977,13799671,5740670006,-10191334971,,
14527450275,2.08492,15932056028,13850717,5903233191,-10028822837,,
14527501323,2.13597,15932107078,13901762,6065793191,-9866313887,,
14527552372,2.18702,15932158130,13952808,6228356376,-9703801754,,
14527603422,2.23807,15932209182,14003856,6390925930,-9541283252,,
14527654471,2.28912,15932260234,14054902,6553489114,-9378771120,,
14527705519,2.34017,15932311284,14105948,6716049115,-9216262169,,
14527756068,2.39072,15932361834,14156494,6877023163,-9055338671,,
14527807075,2.44172,15932412845,14207499,7039455778,-8892957067,,
14527857666,2.49231,15932463438,14258087,7200557212,-8731906226,,
14527908686,2.54333,15932514460,14309104,7363028042,-8569486418,,
14527959296,2.59394,15932565073,14359711,7524196354,-8408368719,,
14528010404,2.64505,15932616183,14410816,7686947433,-8245668750,,
14528060962,2.69561,15932666743,14461372,7847946959,-8084719784,,
14528111585,2.74623,15932717369,14511993,8009156671,-7923560698,,
14528162214,2.79686,15932768012,14562630,8170420522,-7762347490,,
14528213119,2.84777,15932818907,14613520,8332483719,-7600335188,,
14528263689,2.89834,15932869480,14664087,8493524645,-7439344835,,
14528314631,2.94928,15932920424,14715028,8655750258,-7277170166,,
14528365074,2.99972,15932970870,14765467,8816383550,-7116587320,,
14528415686,3.05033,15933021483,14816076,8977555047,-6955466436,,
14528465860,3.10051,15933071660,14866248,9137334855,-6795736805,,
14528516483,3.15113,15933122286,14916868,9298541383,-6634580903,,
14528567484,3.20213,15933173288,14967866,9460948520,-6472224768,,
14528618158,3.25281,15933223965,15018538,9622320649,-6310903316,,
14528668712,3.30336,15933274521,15069089,9783307436,-6149967085,,
14528718776,3.35342,15933324587,15119160,9942765596,-5990558991,,
14528769518,3.40417,15933375332,15169889,10104319250,-5829056082,,
14528820417,3.45506,15933426234,15220786,10266407923,-5667018311,,
14528871319,3.50597,15933477138,15271685,10428502965,-5504974173,,
14528922364,3.55701,15933528186,15322727,10591056596,-5342471590,,
14528973359,3.60801,15933579183,15373720,10753447810,-5180131373,,
14529023462,3.65811,15933629287,15423820,10913001509,-5020627778,,
14529074495,3.70914,15933680324,15474850,11075513740,-4858166584,,
14529125047,3.75969,15933730877,15525399,11236522820,-4697208057,,
14529176119,3.81077,15933781952,15576469,11399133774,-4534648178,,
14529227181,3.86183,15933833017,15627528,11561735174,-4372097843,,
14529278187,3.91283,15933884025,15678531,11724164604,-4209719421,,
14529328751,3.96340,15933934591,15729092,11885180053,-4048754538,,
14529379277,4.01393,15933985120,15779617,12046084040,-3887901080,,
14529429878,4.06453,15934035723,15830215,12207220506,-3726815217,,
14529480902,4.11555,15934086749,15881247,12369739105,-3564347644,,
14529531763,4.16641,15934137613,15932094,12531668547,-3402469066,,
14529582321,4.21697,15934188173,15982649,12692668073,-3241520100,,
14529632844,4.26749,15934238699,16033170,12853591167,-3080647532,,
14529683431,4.31808,15934289288,16083754,13014651201,-2919638087,,
14529734515,4.36916,15934340374,16134835,13177329033,-2757011341,,
14529785295,4.41994,15934391157,16185613,13339067396,-2595323761,,
14529836353,4.47100,15934442217,16236667,13501627396,-2432814821,,
14529886956,4.52160,15934492833,16287280,13662811631,-2271681202,,
14529937870,4.57252,15934543738,16338179,13824906674,-2109637064,,
14529988891,4.62354,15934594762,16389197,13987377504,-1947217258,,
14530039488,4.67414,15934645361,16439791,14148539446,-1786105915,,
14530090550,4.72520,15934696426,16490853,14311115370,-1623581056,,
14530140926,4.77557,15934746804,16541225,14471532106,-1463214698,,
14530191464,4.82611,15934797357,16591771,14632506155,-1302291202,,
14530242570,4.87722,15934848453,16642864,14795215833,-1139632620,,
14530293160,4.92781,15934899044,16693450,14956352299,-978546745,,
14530343779,4.97843,15934949666,16744066,15117507872,-817441794,,
14530394805,5.02945,15935000706,16795101,15280036026,-654964680,,
14530445413,5.08006,15935051305,16845706,15441194784,-493856521,,
14530496021,5.13067,15935101915,16896300,15602318511,-332783404,,
14530546157,5.18081,15935152054,16946433,15761977303,-173174751,,
14530596692,5.23134,15935202591,16996967,15922906767,-12295824,,
14530647297,5.28195,15935253199,17047568,15935252591,-608,,
14530697800,5.33245,15935303703,17098068,15935303090,-613,,
14530748428,5.38308,15935354334,17148693,15935353716,-618,,
14530798590,5.43324,15935404498,17198853,15935403875,-623,,
14530849160,5.48381,15935455071,17249420,15935454442,-629,,
14530900248,5.53490,15935506162,17300505,15935505527,-635,,
14530951340,5.58599,15935557255,17351595,15935556617,-638,,
14531001935,5.63658,15935607852,17402187,15935607209,-643,,
14531052955,5.68760,15935658875,17453204,15935658226,-649,,
14531103799,5.73845,15935709721,17504045,15935709067,-654,,
14531154838,5.78949,15935760763,17555082,15935760104,-659,,
14531204942,5.83959,15935810882,17605196,15935810219,-663,,
14531255440,5.89009,15935861370,17655689,15935860712,-658,,
14531306486,5.94113,15935912418,17706734,15935911757,-661,,
14531357119,5.99177,15935963054,17757352,15935962375,-679,,
14531407712,6.04236,15936013649,17807942,15936012965,-684,,
14531458749,6.09340,15936064687,17858975,15936063998,-689,,
14531509810,6.14446,15936115752,17910035,15936115057,-695,,
14531560805,6.19545,15936166749,17961027,15936166049,-700,,
14531611396,6.24604,15936217343,18011616,15936216638,-705,,
14531662436,6.29708,15936268385,18062654,15936267676,-709,,
14531713020,6.34767,15936318971,18113234,15936318257,-714,,
14531764068,6.39872,15936370022,18164280,15936369302,-720,,
14531815122,6.44977,15936421078,18215330,15936420352,-726,,
14531865732,6.50038,15936471690,18265938,15936470961,-729,,
14531916770,6.55142,15936522731,18316973,15936521996,-735,,
14531967380,6.60203,15936573342,18367591,15936572613,-729,,
14532017489,6.65214,15936623454,18417687,15936622710,-744,,
14532068084,6.70273,15936674052,18468279,15936673302,-750,,
14532118690,6.75334,15936724659,18518882,15936723904,-755,,
14532169235,6.80388,15936775208,18569425,15936774447,-761,,
14532220283,6.85493,15936826258,18620470,15936825493,-765,,
14532271330,6.90598,15936877306,18671514,15936876536,-770,,
14532322379,6.95703,15936928359,18722560,15936927583,-776,,
14532372942,7.00759,15936978923,18773121,15936978143,-780,,
14532423976,7.05862,15937029960,18824153,15937029175,-785,,
14532474981,7.10963,15937080968,18875154,15937080177,-791,,
14532525533,7.16018,15937131522,18925704,15937130726,-796,,
14532575583,7.21023,15937181574,18975752,15937180774,-800,,
14532625647,7.26030,15937231651,19025823,15937230845,-806,,
14532676545,7.31119,15937282541,19076707,15937281730,-811,,
14532727048,7.36170,15937333046,19127208,15937332230,-816,,
14532777606,7.41225,15937383607,19177763,15937382786,-821,,
14532828194,7.46284,15937434197,19228348,15937433371,-826,,
14532878332,7.51298,15937484337,19278485,15937483507,-830,,
14532928451,7.56310,15937534458,19328600,15937533623,-835,,
14532979064,7.61371,15937585073,19379210,15937584232,-841,,
14533030157,7.66481,15937636169,19430300,15937635322,-847,,
14533080839,7.71549,15937686855,19480981,15937686003,-852,,
14533131722,7.76637,15937737750,19531871,15937736894,-856,,
14533181837,7.81649,15937787858,19581973,15937786996,-862,,
14533232530,7.86718,15937838552,19632663,15937837686,-866,,
14533283578,7.91823,15937889602,19683709,15937888731,-871,,
14533334629,7.96928,15937940656,19734756,15937939778,-878,,
14533385184,8.01983,15937991213,19785309,15937990331,-882,,
14533436226,8.07087,15938042257,19836349,15938041371,-886,,
14533487275,8.12192,15938093309,19887395,15938092417,-892,,
14533538325,8.17297,15938144360,19938441,15938143463,-897,,
14533589373,8.22402,15938195412,19989488,15938194510,-902,,
14533640400,8.27505,15938246441,20040511,15938245544,-897,,
14533691479,8.32613,15938297521,20091597,15938296620,-901,,
14533742550,8.37720,15938348596,20142655,15938347677,-919,,
14533793176,8.42782,15938399224,20193279,15938398302,-922,,
14533843303,8.47795,15938449353,20243403,15938448425,-928,,
14533893933,8.52858,15938499986,20294031,15938499053,-933,,
14533944081,8.57873,15938550136,20344176,15938549199,-937,,
14533995145,8.62979,15938601202,20395237,15938600259,-943,,
14534045754,8.68040,15938651813,20445843,15938650865,-948,,
14534096783,8.73143,15938702845,20496869,15938701891,-954,,
14534147564,8.78221,15938753629,20547648,15938752670,-959,,
14534197812,8.83246,15938803879,20597893,15938802916,-963,,
14534248861,8.88351,15938854929,20648939,15938853961,-968,,
14534299888,8.93454,15938905960,20699963,15938904985,-975,,
14534350127,8.98478,15938956201,20750200,15938955223,-978,,
14534400968,9.03562,15939007044,20801038,15939006061,-983,,
14534451119,9.08577,15939057208,20851197,15939056219,-989,,
14534502225,9.13687,15939108306,20902291,15939107313,-993,,
14534553650,9.18830,15939159733,20953712,15939158735,-998,,
14534604353,9.23900,15939210482,21004456,15939209479,-1003,,
14534655195,9.28984,15939261282,21055251,15939260273,-1009,,
14534706215,9.34086,15939312305,21106269,15939311292,-1013,,
14534757303,9.39195,15939363396,21157355,15939362377,-1019,,
14534807884,9.44253,15939413979,21207932,15939412955,-1024,,
14534858954,9.49360,15939465052,21259001,15939464023,-1029,,
14534909981,9.54463,15939516092,21310036,15939515058,-1034,,
14534960532,9.59518,15939566634,21360572,15939565605,-1029,,
14535011580,9.64623,15939617684,21411628,15939616650,-1034,,
14535062475,9.69712,15939668581,21462510,15939667532,-1049,,
14535113034,9.74768,15939719142,21513066,15939718098,-1044,,
14535163483,9.79813,15939769605,21563522,15939768545,-1060,,
14535213997,9.84864,15939820111,21614024,15939819046,-1065,,
14535265046,9.89969,15939871161,21665070,15939870092,-1069,,
14535316093,9.95074,15939922212,21716114,15939921136,-1076,,
14535366630,10.00128,15939972751,21766649,15939971681,-1070,,
14535417679,10.05233,15940023803,21817707,15940022730,-1073,,
14535468752,10.10340,15940074877,21868765,15940073788,-1089,,
14535519801,10.15445,15940125929,21919811,15940124834,-1095,,
14535570809,10.20546,15940176939,21970816,15940175838,-1101,,
14535621357,10.25601,15940227490,22021362,15940226384,-1106,,
14535680548,10.31520,15940286683,22080550,15940285572,-1111,,
14535731329,10.36598,15940337467,22131329,15940336351,-1116,,
14535781810,10.41646,15940387951,22181807,15940386829,-1122,,
14535832148,10.46680,15940438290,22232142,15940437164,-1126,,
14535882723,10.51737,15940488867,22282714,15940487736,-1131,,
14535933275,10.56792,15940539423,22333263,15940538286,-1137,,
14535984106,10.61875,15940590255,22384091,15940589113,-1142,,
14536034703,10.66935,15940640854,22434685,15940639708,-1146,,
14536085329,10.71998,15940691484,22485309,15940690332,-1152,,
14536136336,10.77098,15940742493,22536313,15940741336,-1157,,
14536189382,10.82403,15940795540,22589355,15940794378,-1162,,
14536240216,10.87486,15940846377,22640188,15940845210,-1167,,
14536291163,10.92581,15940897327,22691132,15940896155,-1172,,
14536342243,10.97689,15940948409,22742209,15940947231,-1178,,
14536392799,11.02745,15940998967,22792763,15940997785,-1182,,
14536443367,11.07802,15941049537,22843328,15941048350,-1187,,
14536494011,11.12866,15941100185,22893969,15941098992,-1193,,
14536544753,11.17940,15941150929,22944708,15941149731,-1198,,
14536594899,11.22955,15941201076,22994852,15941199874,-1202,,
14536645456,11.28010,15941251636,23045406,15941250428,-1208,,
14536696238,11.33089,15941302421,23096185,15941301207,-1214,,
14536747257,11.38190,15941353441,23147202,15941352224,-1217,,
14536802997,11.43764,15941409185,23202939,15941407962,-1223,,
14536853102,11.48775,15941459291,23253041,15941458063,-1228,,
14536903379,11.53803,15941509571,23303315,15941508338,-1233,,
14536954059,11.58871,15941560253,23353992,15941559014,-1239,,
14537004592,11.63924,15941610789,23404523,15941609546,-1243,,
14537055148,11.68980,15941661347,23455076,15941660098,-1249,,
14537105464,11.74011,15941711665,23505389,15941710412,-1253,,
14537155802,11.79045,15941762005,23555725,15941760747,-1258,,
14537207973,11.84262,15941814179,23607893,15941812915,-1264,,
14537258672,11.89332,15941864881,23658590,15941863612,-1269,,
14537308943,11.94359,15941915154,23708858,15941913880,-1274,,
14537359547,11.99419,15941965761,23759460,15941964482,-1279,,
14537409884,12.04453,15942016100,23809794,15942014816,-1284,,
14537460171,12.09482,15942066389,23860077,15942065100,-1289,,
14537510508,12.14516,15942116728,23910412,15942115434,-1294,,
14537560825,12.19547,15942167048,23960726,15942165749,-1299,,
14537611147,12.24579,15942217372,24011045,15942216067,-1305,,
14537661460,12.29611,15942267687,24061356,15942266378,-1309,,
14537712164,12.34681,15942318393,24112057,15942317079,-1314,,
14537762823,12.39747,15942369056,24162713,15942367736,-1320,,
14537813606,12.44825,15942419841,24213494,15942418517,-1324,,
14537864207,12.49886,15942470443,24264092,15942469114,-1329,,
14537914746,12.54939,15942520985,24314628,15942519650,-1335,,
14537965316,12.59996,15942571558,24365196,15942570218,-1340,,
14538016350,12.65100,15942622594,24416228,15942621250,-1344,,
14538066677,12.70133,15942672924,24466552,15942671574,-1350,,
14538117466,12.75211,15942723715,24517337,15942722360,-1355,,
14538168217,12.80287,15942774468,24568086,15942773109,-1359,,
14538218727,12.85337,15942824981,24618593,15942823616,-1365,,
14538269300,12.90395,15942875555,24669163,15942874185,-1370,,
14538319590,12.95424,15942925849,24719451,15942924473,-1376,,
14538370235,13.00488,15942976496,24770093,15942975116,-1380,,
14538420582,13.05523,15943026844,24820437,15943025459,-1385,,
14538471396,13.10604,15943077661,24871248,15943076270,-1391,,
14538521624,13.15627,15943127891,24921474,15943126496,-1395,,
14538571963,13.20661,15943178233,24971810,15943176833,-1400,,
14538622410,13.25706,15943228683,25022255,15943227277,-1406,,
14538672535,13.30718,15943278810,25072377,15943277400,-1410,,
14538722809,13.35746,15943329085,25122648,15943327670,-1415,,
14538773504,13.40815,15943379783,25173340,15943378362,-1421,,
14538823877,13.45852,15943430158,25223710,15943428732,-1426,,
14538874596,13.50924,15943480879,25274427,15943479449,-1430,,
14538925053,13.55970,15943531339,25324881,15943529904,-1435,,
14538975724,13.61037,15943582012,25375548,15943580571,-1441,,
14539026102,13.66075,15943632392,25425925,15943630948,-1444,,
14539076177,13.71082,15943682470,25475996,15943681019,-1451,,
14539126560,13.76121,15943732855,25526377,15943731399,-1456,,
14539177284,13.81193,15943783582,25577099,15943782121,-1461,,
14539227588,13.86224,15943833888,25627400,15943832422,-1466,,
14539278321,13.91297,15943884623,25678130,15943883152,-1471,,
14539329043,13.96369,15943935348,25728850,15943933872,-1476,,
14539380077,14.01473,15943986385,25779881,15943984903,-1482,,
14539430521,14.06517,15944036831,25830322,15944035345,-1486,,
14539480742,14.11539,15944087055,25880540,15944085563,-1492,,
14539531417,14.16606,15944137731,25931213,15944136235,-1496,,
14539582104,14.21675,15944188420,25981897,15944186919,-1501,,
14539632439,14.26709,15944238758,26032229,15944237252,-1506,,
14539682522,14.31717,15944288843,26082310,15944287333,-1510,,
14539733099,14.36775,15944339423,26132884,15944337907,-1516,,
14539783378,14.41803,15944389705,26183160,15944388183,-1522,,
14539833976,14.46862,15944440304,26233755,15944438777,-1527,,
14539884471,14.51912,15944490802,26284248,15944489271,-1531,,
14539935348,14.57000,15944541682,26335122,15944540144,-1538,,
14539986071,14.62072,15944592407,26385842,15944590865,-1542,,
14540036636,14.67128,15944642973,26436405,15944641427,-1546,,
14540086967,14.72161,15944693308,26486734,15944691756,-1552,,
14540137542,14.77219,15944743884,26537305,15944742327,-1557,,
14540187787,14.82244,15944794131,26587547,15944792569,-1562,,
14540238738,14.87339,15944845085,26638496,15944843518,-1567,,
14540289057,14.92370,15944895407,26688812,15944893835,-1572,,
14540339365,14.97401,15944945716,26739117,15944944139,-1577,,
14540389613,15.02426,15944995967,26789363,15944994385,-1582,,
14540439893,15.07454,15945046250,26839641,15945044663,-1587,,
14540490526,15.12517,15945096884,26890270,15945095292,-1592,,
14540540630,15.17528,15945146991,26940372,15945145394,-1597,,
14540590927,15.22557,15945197290,26990666,15945195688,-1602,,
14540641299,15.27595,15945247665,27041036,15945246058,-1607,,
14540691638,15.32629,15945298006,27091371,15945296394,-1612,,
14540741894,15.37654,15945348264,27141625,15945346648,-1616,,
14540792111,15.42676,15945398484,27191839,15945396862,-1622,,
14540842537,15.47719,15945448913,27242262,15945447285,-1628,,
14540893126,15.52777,15945499504,27292850,15945497872,-1632,,
14540943711,15.57836,15945550092,27343432,15945548454,-1638,,
14540994735,15.62938,15945601117,27394452,15945599474,-1643,,
14541045577,15.68023,15945651961,27445292,15945650314,-1647,,
14541096184,15.73083,15945702571,27495896,15945700918,-1653,,
14541147062,15.78171,15945753451,27546771,15945751793,-1658,,
14541197705,15.83235,15945804096,27597411,15945802433,-1663,,
14541248102,15.88275,15945854496,27647806,15945852828,-1668,,
14541298696,15.93334,15945905092,27698397,15945903419,-1673,,
14541349425,15.98407,15945955823,27749123,15945954145,-1678,,
14541399725,16.03437,15946006127,27799433,15946004456,-1671,,
14541450209,16.08486,15946056612,27849902,15946054924,-1688,,
14541500816,16.13546,15946107221,27900506,15946105528,-1693,,
14541550960,16.18561,15946157369,27950659,15946155682,-1687,,
14541601251,16.23590,15946207662,28000936,15946205959,-1703,,
14541652002,16.28665,15946258415,28051685,15946256707,-1708,,
14541702608,16.33726,15946309023,28102287,15946307309,-1714,,
14541752799,16.38745,15946359216,28152476,15946357498,-1718,,
14541803122,16.43777,15946409543,28202796,15946407818,-1725,,
14541853297,16.48794,15946459720,28252969,15946457991,-1729,,
14541903842,16.53849,15946510267,28303511,15946508533,-1734,,
14541954059,16.58871,15946560486,28353725,15946558747,-1739,,
14542004443,16.63909,15946610872,28404106,15946609128,-1744,,
14542055161,16.68981,15946661593,28454822,15946659845,-1748,,
14542105898,16.74055,15946712333,28505556,15946710579,-1754,,
14542156373,16.79102,15946762809,28556028,15946761050,-1759,,
14542206930,16.84158,15946813368,28606582,15946811604,-1764,,
14542257168,16.89182,15946863610,28656819,15946861841,-1769,,
14542307909,16.94256,15946914353,28707556,15946912579,-1774,,
14542358057,16.99271,15946964514,28757713,15946962735,-1779,,
14542408337,17.04299,15947014786,28807979,15947013002,-1784,,
14542458800,17.09345,15947065251,28858439,15947063462,-1789,,
14542509095,17.14374,15947115548,28908731,15947113753,-1795,,
14542559809,17.19446,15947166276,28959455,15947164478,-1798,,
14542610295,17.24494,15947216764,29009938,15947214961,-1803,,
14542660759,17.29541,15947267220,29060388,15947265411,-1809,,
14542711086,17.34573,15947317549,29110711,15947315733,-1816,,
14542761599,17.39625,15947368064,29161222,15947366245,-1819,,
14542812021,17.44667,15947418488,29211642,15947416664,-1824,,
14542862230,17.49688,15947468699,29261847,15947466869,-1830,,
14542912638,17.54729,15947519110,29312253,15947517276,-1834,,
14542962938,17.59759,15947569412,29362551,15947567573,-1839,,
14543013288,17.64794,15947619765,29412897,15947617920,-1845,,
14543063911,17.69856,15947670390,29463519,15947668541,-1849,,
14543114609,17.74926,15947721089,29514213,15947719235,-1854,,
14543165347,17.79999,15947771831,29564948,15947769971,-1860,,
14543215695,17.85034,15947822180,29615293,15947820315,-1865,,
14543266275,17.90092,15947872764,29665872,15947870894,-1870,,
14543316574,17.95122,15947923064,29716167,15947921189,-1875,,
14543366844,18.00149,15947973337,29766434,15947971457,-1880,,
14543416982,18.05163,15948023477,29816570,15948021593,-1884,,
14543467534,18.10218,15948074031,29867119,15948072141,-1890,,
14543517856,18.15250,15948124356,29917438,15948122461,-1895,,
14543568147,18.20279,15948174650,29967727,15948172750,-1900,,
14543618281,18.25293,15948224786,30017859,15948222881,-1905,,
14543668905,18.30355,15948275412,30068480,15948273502,-1910,,
14543719523,18.35417,15948326032,30119095,15948324117,-1915,,
14543770328,18.40498,15948376840,30169897,15948374920,-1920,,
14543820523,18.45517,15948427037,30220090,15948425112,-1925,,
14543870689,18.50534,15948477205,30270252,15948475274,-1931,,
14543920788,18.55544,15948527306,30320349,15948525371,-1935,,
14543971242,18.60589,15948577762,30370800,15948575822,-1940,,
14544021545,18.65619,15948628069,30421100,15948626123,-1946,,
14544072214,18.70686,15948678740,30471767,15948676789,-1951,,
14544122363,18.75701,15948728891,30521913,15948726936,-1955,,
14544172809,18.80746,15948779339,30572356,15948777378,-1961,,
14544223070,18.85772,15948829603,30622615,15948827638,-1965,,
14544273364,18.90801,15948879899,30672907,15948877929,-1970,,
14544323594,18.95824,15948930132,30723134,15948928156,-1976,,
14544373778,19.00843,15948980318,30773316,15948978338,-1980,,
14544424222,19.05887,15949030764,30823757,15949028779,-1985,,
14544474989,19.10964,15949081534,30874521,15949079543,-1991,,
14544525420,19.16007,15949131967,30924948,15949129971,-1996,,
14544576163,19.21081,15949182712,30975689,15949180712,-2000,,
14544626589,19.26124,15949233140,31026112,15949231134,-2006,,
14544677138,19.31179,15949283692,31076669,15949281692,-2000,,
14544727409,19.36206,15949333965,31126928,15949331950,-2015,,
14544778125,19.41277,15949384683,31177640,15949382662,-2021,,
14544828545,19.46319,15949435106,31228058,15949433080,-2026,,
14544879150,19.51380,15949485713,31278660,15949483682,-2031,,
14544929649,19.56430,15949536215,31329157,15949534179,-2036,,
14544980270,19.61492,15949586838,31379774,15949584797,-2041,,
14545030841,19.66549,15949637411,31430342,15949635364,-2047,,
14545081621,19.71627,15949688193,31481120,15949686142,-2051,,
14545132224,19.76687,15949738799,31531721,15949736743,-2056,,
14545182610,19.81726,15949789187,31582102,15949787125,-2062,,
14545233349,19.86800,15949839928,31632840,15949837862,-2066,,
14545284150,19.91880,15949890732,31683638,15949888661,-2071,,
14545334787,19.96944,15949941372,31734272,15949939295,-2077,,
14545385172,20.01982,15949991759,31784654,15949989677,-2082,,
14545435299,20.06995,15950041888,31834779,15950039802,-2086,,
14545485754,20.12040,15950092346,31885231,15950090254,-2092,,
14545536012,20.17066,15950142606,31935487,15950140509,-2097,,
14545586142,20.22079,15950192737,31985614,15950190636,-2101,,
14545636899,20.27155,15950243498,32036368,15950241391,-2107,,
14545687187,20.32184,15950293788,32086653,15950291676,-2112,,
14545737934,20.37258,15950344536,32137398,15950342420,-2116,,
14545788910,20.42356,15950395526,32188382,15950393405,-2121,,
14545839959,20.47461,15950446567,32239418,15950444440,-2127,,
14545890542,20.52519,15950497153,32289998,15950495020,-2133,,
14545941117,20.57577,15950547730,32340571,15950545593,-2137,,
14545991253,20.62590,15950597867,32390703,15950595726,-2141,,
14546041610,20.67626,15950648227,32441057,15950646079,-2148,,
14546092674,20.72732,15950699293,32492119,15950697142,-2151,,
14546143712,20.77836,15950750333,32543154,15950748176,-2157,,
14546194299,20.82895,15950800924,32593739,15950798761,-2163,,
14546244851,20.87950,15950851488,32644298,15950849321,-2167,,
14546295911,20.93056,15950902540,32695346,15950900368,-2172,,
14546346535,20.98118,15950953167,32745967,15950950989,-2178,,
14546397583,21.03223,15951004217,32797012,15951002034,-2183,,
14546448605,21.08325,15951055242,32848031,15951053053,-2189,,
14546499143,21.13379,15951105781,32898565,15951103588,-2193,,
14546549697,21.18435,15951156338,32949117,15951154140,-2198,,
14546600721,21.23537,15951207364,33000138,15951205161,-2203,,
14546651166,21.28581,15951257812,33050582,15951255605,-2207,,
14546702256,21.33690,15951308904,33101669,15951306691,-2213,,
14546753304,21.38795,15951359954,33152713,15951357736,-2218,,
14546804310,21.43896,15951410963,33203718,15951408740,-2223,,
14546854855,21.48950,15951461509,33254259,15951459281,-2228,,
14546905423,21.54007,15951512080,33304824,15951509846,-2234,,
14546955957,21.59061,15951562616,33355355,15951560377,-2239,,
14547007014,21.64166,15951613676,33406410,15951611433,-2243,,
14547057871,21.69252,15951664536,33457265,15951662287,-2249,,
14547108484,21.74313,15951715150,33507874,15951712896,-2254,,
14547159028,21.79368,15951765698,33558416,15951763439,-2259,,
14547209142,21.84379,15951815814,33608527,15951813550,-2264,,
14547260129,21.89478,15951866803,33659511,15951864534,-2269,,
14547310725,21.94537,15951917413,33710116,15951915138,-2275,,
14547361800,21.99645,15951968478,33761177,15951966200,-2278,,
14547412809,22.04746,15952019490,33812183,15952017206,-2284,,
14547463850,22.09850,15952070533,33863221,15952068244,-2289,,
14547514315,22.14896,15952121000,33913684,15952118706,-2294,,
14547564863,22.19951,15952171551,33964230,15952169252,-2299,,
14547615392,22.25004,15952222083,34014755,15952219778,-2305,,
14547665834,22.30048,15952272527,34065194,15952270216,-2311,,
14547716890,22.35154,15952323585,34116249,15952321272,-2313,,
14547767958,22.40261,15952374656,34167313,15952372336,-2320,,
14547818037,22.45268,15952424737,34217389,15952422412,-2325,,
14547869069,22.50372,15952475771,34268419,15952473441,-2330,,
14547919889,22.55454,15952526605,34319248,15952524271,-2334,,
14547970448,22.60510,15952577155,34369793,15952574815,-2340,,
14548021018,22.65567,15952627728,34420360,15952625382,-2346,,
14548071949,22.70660,15952678661,34471288,15952676311,-2350,,
14548122532,22.75718,15952729246,34521868,15952726891,-2355,,
14548173594,22.80824,15952780311,34572928,15952777950,-2361,,
14548224191,22.85884,15952830909,34623522,15952828544,-2365,,
14548275073,22.90972,15952881794,34674401,15952879424,-2370,,
14548325650,22.96030,15952932375,34724977,15952929999,-2376,,
14548376139,23.01079,15952982865,34775462,15952980484,-2381,,
14548426379,23.06103,15953033119,34825712,15953030735,-2384,,
14548476984,23.11163,15953083714,34876301,15953081324,-2390,,
14548527524,23.16217,15953134257,34926838,15953131861,-2396,,
14548577571,23.21222,15953184306,34976883,15953181906,-2400,,
14548628143,23.26279,15953234893,35027464,15953232487,-2406,,
14548678733,23.31338,15953285473,35078039,15953283062,-2411,,
14548729728,23.36438,15953336470,35129031,15953334054,-2416,,
14548780290,23.41494,15953387035,35179592,15953384614,-2421,,
14548830861,23.46551,15953437607,35230159,15953435182,-2425,,
14548881406,23.51605,15953488156,35280701,15953485724,-2432,,
14548931858,23.56651,15953538609,35331151,15953536173,-2436,,
14548982417,23.61707,15953589171,35381707,15953586729,-2442,,
14549032560,23.66721,15953639317,35431847,15953636870,-2447,,
14549082881,23.71753,15953689640,35482167,15953687189,-2451,,
14549133452,23.76810,15953740225,35532747,15953737769,-2456,,
14549183987,23.81864,15953790751,35583266,15953788289,-2462,,
14549234749,23.86940,15953841515,35634026,15953839048,-2467,,
14549284891,23.91954,15953891658,35684165,15953889187,-2471,,
14549335898,23.97055,15953942669,35735170,15953940192,-2477,,
14549386551,24.02120,15953993324,35785819,15953990842,-2482,,
14549437099,24.07175,15954043874,35836366,15954041388,-2486,,
14549488197,24.12285,15954094975,35887461,15954092484,-2491,,
14549539130,24.17378,15954145910,35938390,15954143413,-2497,,
14549590186,24.22483,15954196968,35989443,15954194465,-2503,,
14549640773,24.27542,15954247557,36040028,15954245050,-2507,,
14549691422,24.32607,15954298209,36090675,15954295697,-2512,,
14549741963,24.37661,15954348752,36141212,15954346234,-2518,,
14549792029,24.42668,15954398821,36191277,15954396299,-2522,,
14549843008,24.47766,15954449801,36242252,15954447274,-2527,,
14549893971,24.52862,15954500767,36293212,15954498234,-2533,,
14549944099,24.57875,15954550898,36343338,15954548360,-2538,,
14549994703,24.62935,15954601503,36393939,15954598962,-2541,,
14550045283,24.67993,15954652097,36444527,15954649549,-2548,,
14550095856,24.73050,15954702662,36495086,15954700109,-2553,,
14550146389,24.78104,15954753197,36545618,15954750640,-2557,,
14550197414,24.83206,15954804225,36596639,15954801662,-2563,,
14550248030,24.88268,15954854843,36647253,15954852275,-2568,,
14550298169,24.93282,15954904985,36697389,15954902412,-2573,,
14550348753,24.98340,15954955570,36747970,15954952992,-2578,,
14550399142,25.03379,15955005962,36798356,15955003378,-2584,,
14550449742,25.08439,15955056564,36848953,15955053975,-2589,,
14550499863,25.13451,15955106687,36899072,15955104094,-2593,,
14550550439,25.18509,15955157265,36949645,15955154667,-2598,,
14550600539,25.23519,15955207369,36999742,15955204765,-2604,,
14550650982,25.28563,15955257814,37050183,15955255206,-2608,,
14550701548,25.33620,15955308382,37100746,15955305769,-2613,,
14550752141,25.38679,15955358978,37151336,15955356359,-2619,,
14550802685,25.43733,15955409524,37201878,15955406901,-2623,,
14550853234,25.48788,15955460075,37252424,15955457447,-2628,,
14550903293,25.53794,15955510137,37302480,15955507503,-2634,,
14550953937,25.58858,15955560783,37353122,15955558145,-2638,,
14551004971,25.63962,15955611819,37404154,15955609176,-2643,,
14551055676,25.69032,15955662527,37454857,15955659879,-2648,,
14551106229,25.74088,15955713082,37505406,15955710428,-2654,,
14551157293,25.79194,15955764147,37556467,15955761490,-2657,,
14551208340,25.84299,15955815198,37607512,15955812534,-2664,,
14551259406,25.89405,15955866265,37658574,15955863597,-2668,,
14551310408,25.94506,15955917271,37709574,15955914596,-2675,,
14551361358,25.99601,15955968223,37760521,15955965544,-2679,,
14551412392,26.04704,15956019259,37811552,15956016575,-2684,,
14551462456,26.09710,15956069325,37861613,15956066635,-2690,,
14551512995,26.14764,15956119867,37912150,15956117173,-2694,,
14551563538,26.19819,15956170412,37962690,15956167713,-2699,,
14551614434,26.24908,15956221310,38013583,15956218605,-2705,,
14551665049,26.29970,15956271927,38064195,15956269217,-2710,,
14551715809,26.35046,15956322690,38114953,15956319976,-2714,,
14551766856,26.40150,15956373740,38165998,15956371020,-2720,,
14551817380,26.45203,15956424265,38216518,15956421540,-2725,,
14551868450,26.50310,15956475339,38267586,15956472609,-2730,,
14551919499,26.55415,15956526390,38318632,15956523654,-2736,,
14551970550,26.60520,15956577442,38369680,15956574702,-2740,,
14552021598,26.65625,15956628493,38420725,15956625747,-2746,,
14552072152,26.70680,15956679050,38471277,15956676299,-2751,,
14552122673,26.75732,15956729573,38521795,15956726818,-2755,,
14552173719,26.80837,15956780622,38572839,15956777861,-2761,,
14552224781,26.85943,15956831685,38623898,15956828921,-2764,,
14552275363,26.91001,15956882270,38674478,15956879500,-2770,,
14552325958,26.96061,15956932868,38725069,15956930092,-2776,,
14552376914,27.01156,15956983825,38776022,15956981045,-2780,,
14552427481,27.06213,15957034396,38826587,15957031610,-2786,,
14552477614,27.11226,15957084531,38876717,15957081739,-2792,,
14552527759,27.16241,15957134677,38926859,15957131881,-2796,,
14552578284,27.21293,15957185206,38977382,15957182405,-2801,,
14552628785,27.26343,15957235708,39027880,15957232902,-2806,,
14552679416,27.31406,15957286341,39078508,15957283530,-2811,,
14552730140,27.36479,15957337068,39129229,15957334251,-2817,,
14552781181,27.41583,15957388111,39180268,15957385290,-2821,,
14552831752,27.46640,15957438684,39230836,15957435858,-2826,,
14552882729,27.51738,15957489665,39281810,15957486832,-2833,,
14552933263,27.56791,15957540200,39332342,15957537364,-2836,,
14552984297,27.61895,15957591237,39383374,15957588396,-2841,,
14553034867,27.66952,15957641810,39433940,15957638963,-2847,,
14553085441,27.72009,15957692386,39484511,15957689534,-2852,,
14553135496,27.77014,15957742443,39534565,15957739587,-2856,,
14553186097,27.82074,15957793047,39585162,15957790185,-2862,,
14553237128,27.87178,15957844080,39636191,15957841213,-2867,,
14553287751,27.92240,15957894706,39686811,15957891834,-2872,,
14553338301,27.97295,15957945258,39737358,15957942381,-2877,,
14553388440,28.02309,15957995409,39787504,15957992527,-2882,,
14553439039,28.07369,15958046001,39838101,15958043124,-2877,,
14553489641,28.12429,15958096604,39888690,15958093713,-2891,,
14553540227,28.17488,15958147192,39939273,15958144295,-2897,,
14553591220,28.22587,15958198189,39990264,15958195287,-2902,,
14553641835,28.27648,15958248816,40040887,15958245909,-2907,,
14553692423,28.32707,15958299396,40091461,15958296483,-2913,,
14553743468,28.37812,15958350444,40142504,15958347526,-2918,,
14553794516,28.42916,15958401493,40193549,15958398571,-2922,,
14553845530,28.48018,15958452510,40244560,15958449583,-2927,,
14553896105,28.53075,15958503088,40295132,15958500155,-2933,,
14553946692,28.58134,15958553677,40345717,15958550750,-2927,,
14553996847,28.63150,15958603835,40395869,15958600892,-2943,,
14554047405,28.68205,15958654395,40446424,15958651446,-2949,,
14554097558,28.73221,15958704550,40496574,15958701596,-2954,,
14554147754,28.78240,15958754749,40546769,15958751791,-2958,,
14554198186,28.83283,15958805183,40597197,15958802220,-2963,,
14554249274,28.88392,15958856273,40648282,15958853305,-2968,,
14554299889,28.93454,15958906890,40698894,15958903916,-2974,,
14554350468,28.98512,15958957484,40749484,15958954506,-2978,,
14554400596,29.03524,15959007602,40799596,15959004619,-2983,,
14554451689,29.08634,15959058698,40850686,15959055709,-2989,,
14554502296,29.13694,15959109306,40901291,15959106313,-2993,,
14554552931,29.18758,15959159944,40951923,15959156946,-2998,,
14554603980,29.23863,15959210996,41002969,15959207992,-3004,,
14554654162,29.28881,15959261180,41053149,15959258172,-3008,,
14554705211,29.33986,15959312230,41104195,15959309217,-3013,,
14554756207,29.39085,15959363230,41155188,15959360211,-3019,,
14554807216,29.44186,15959414240,41206194,15959411216,-3024,,
14554858167,29.49282,15959465195,41257143,15959462166,-3029,,
14554909208,29.54386,15959516238,41308181,15959513204,-3034,,
14554959796,29.59444,15959566828,41358776,15959563799,-3029,,
14555010870,29.64552,15959617904,41409837,15959614871,-3033,,
14555061459,29.69611,15959668496,41460424,15959665446,-3050,,
14555112081,29.74673,15959719119,41511043,15959716066,-3053,,
14555162656,29.79730,15959769698,41561615,15959766638,-3060,,
14555212812,29.84746,15959819855,41611769,15959816791,-3064,,
14555263452,29.89810,15959870498,41662406,15959867429,-3069,,
14555314001,29.94865,15959921050,41712952,15959917974,-3076,,
14555364952,29.99960,15959972012,41763911,15959968933,-3079,,
14555415145,30.04979,15960022198,41814091,15960019113,-3085,,
14555466116,30.10076,15960073172,41865059,15960070081,-3091,,
14555516763,30.15141,15960123821,41915703,15960120726,-3095,,
14555567418,30.20207,15960174478,41966356,15960171378,-3100,,
14555618431,30.25308,15960225494,42017367,15960222389,-3105,,
14555669481,30.30413,15960276546,42068413,15960273435,-3111,,
14555720272,30.35492,15960327340,42119203,15960324225,-3115,,
14555771004,30.40565,15960378074,42169931,15960374953,-3121,,
14555822052,30.45670,15960429124,42220976,15960425999,-3125,,
14555872341,30.50699,15960479415,42271262,15960476284,-3131,,
14555923395,30.55804,15960530472,42322314,15960527336,-3136,,
14555973975,30.60862,15960581054,42372891,15960577913,-3141,,
14556024094,30.65874,15960631186,42423017,15960628040,-3146,,
14556074671,30.70932,15960681755,42473582,15960678615,-3140,,
14556125359,30.76001,15960732445,42524268,15960729290,-3155,,
14556176205,30.81085,15960783294,42575111,15960780133,-3161,,
14556226771,30.86142,15960833872,42625684,15960830706,-3166,,
14556277413,30.91206,15960884507,42676313,15960881336,-3171,,
14556327994,30.96264,15960935090,42726892,15960931914,-3176,,
14556378119,31.01277,15960985227,42777023,15960982046,-3181,,
14556428767,31.06341,15961035868,42827660,15961032682,-3186,,
14556479795,31.11444,15961086897,42878684,15961083707,-3190,,
14556530798,31.16545,15961137903,42929684,15961134707,-3196,,
14556581277,31.21592,15961188384,42980171,15961185193,-3191,,
14556631885,31.26653,15961238995,43030767,15961235789,-3206,,
14556682933,31.31758,15961290045,43081811,15961286833,-3212,,
14556733981,31.36863,15961341096,43132856,15961337879,-3217,,
14556785029,31.41968,15961392146,43183902,15961388925,-3221,,
14556836079,31.47073,15961443198,43234949,15961439971,-3227,,
14556886597,31.52125,15961493718,43285464,15961490486,-3232,,
14556937176,31.57182,15961544299,43336040,15961541062,-3237,,
14556988220,31.62287,15961595346,43387082,15961592104,-3242,,
14557039273,31.67392,15961646402,43438132,15961643155,-3247,,
14557090324,31.72497,15961697455,43489180,15961694203,-3252,,
14557140462,31.77511,15961747595,43539316,15961744338,-3257,,
14557191482,31.82613,15961798618,43590334,15961795356,-3262,,
14557242074,31.87672,15961849212,43640923,15961845945,-3267,,
14557292643,31.92729,15961899793,43691498,15961896520,-3273,,
14557343202,31.97785,15961950356,43742057,15961947079,-3277,,
14557393757,32.02840,15962000902,43792597,15961997620,-3282,,
14557444279,32.07893,15962051427,43843117,15962048139,-3288,,
14557495316,32.12996,15962102465,43894151,15962099173,-3292,,
14557545408,32.18006,15962152571,43944251,15962149273,-3298,,
14557595554,32.23020,15962202708,43994383,15962199405,-3303,,
14557646021,32.28067,15962253178,44044847,15962249870,-3308,,
14557696354,32.33100,15962303514,44095178,15962300200,-3314,,
14557746962,32.38161,15962354124,44145783,15962350806,-3318,,
14557797543,32.43219,15962404706,44196361,15962401383,-3323,,
14557848592,32.48324,15962455759,44247408,15962452430,-3329,,
14557898762,32.53341,15962505931,44297576,15962502598,-3333,,
14557949783,32.58443,15962556954,44348594,15962553616,-3338,,
14557999887,32.63453,15962607061,44398695,15962603718,-3343,,
14558050412,32.68506,15962657587,44449217,15962654240,-3347,,
14558101448,32.73610,15962708625,44500250,15962705272,-3353,,
14558152439,32.78709,15962759620,44551239,15962756261,-3359,,
14558203001,32.83765,15962810193,44601808,15962806830,-3363,,
14558253594,32.88824,15962860778,44652388,15962857410,-3368,,
14558304164,32.93881,15962911352,44702956,15962907978,-3374,,
14558354423,32.98907,15962961612,44753212,15962958235,-3377,,
14558404944,33.03959,15963012135,44803730,15963008753,-3382,,
14558455514,33.09016,15963062709,44854297,15963059319,-3390,,
14558506122,33.14077,15963113318,44904902,15963109925,-3393,,
14558557169,33.19182,15963164368,44955947,15963160969,-3399,,
14558608197,33.24285,15963215398,45006972,15963211994,-3404,,
14558659258,33.29391,15963266462,45058031,15963263053,-3409,,
14558709808,33.34446,15963317015,45108578,15963313601,-3414,,
14558760866,33.39551,15963368075,45159634,15963364656,-3419,,
14558811891,33.44654,15963419102,45210655,15963415678,-3424,,
14558862464,33.49711,15963469678,45261235,15963466258,-3420,,
14558912997,33.54765,15963520213,45311756,15963516779,-3434,,
14558964064,33.59871,15963571282,45362820,15963567843,-3439,,
14559015099,33.64975,15963622320,45413853,15963618875,-3445,,
14559066149,33.70080,15963673371,45464899,15963669921,-3450,,
14559117198,33.75185,15963724423,45515946,15963720968,-3455,,
14559168246,33.80289,15963775474,45566991,15963772014,-3460,,
14559218795,33.85344,15963826035,45617548,15963822570,-3465,,
14559269627,33.90427,15963876859,45668367,15963873389,-3470,,
14559320167,33.95482,15963927402,45718904,15963923927,-3475,,
14559370713,34.00536,15963977949,45769447,15963974470,-3479,,
14559421283,34.05593,15964028523,45820014,15964025037,-3486,,
14559472322,34.10697,15964079564,45871052,15964076074,-3490,,
14559522874,34.15752,15964130117,45921600,15964126622,-3495,,
14559573271,34.20792,15964180517,45971994,15964177016,-3501,,
14559623377,34.25803,15964230626,46022098,15964227121,-3505,,
14559673468,34.30812,15964280718,46072186,15964277208,-3510,,
14559724067,34.35871,15964331321,46122782,15964327805,-3516,,
14559774159,34.40881,15964381425,46172883,15964377906,-3519,,
14559824696,34.45934,15964431954,46223406,15964428429,-3525,,
14559875260,34.50991,15964482520,46273967,15964478989,-3531,,
14559926206,34.56085,15964533469,46324911,15964529933,-3536,,
14559976805,34.61145,15964584082,46375518,15964580541,-3541,,
14560027329,34.66198,15964634596,46426028,15964631050,-3546,,
14560077476,34.71212,15964684756,46476183,15964681206,-3550,,
14560128056,34.76270,15964735328,46526750,15964731772,-3556,,
14560179075,34.81372,15964786350,46577767,15964782789,-3561,,
14560229648,34.86430,15964836924,46628336,15964833358,-3566,,
14560280198,34.91485,15964887478,46678885,15964883907,-3571,,
14560330768,34.96542,15964938050,46729451,15964934474,-3576,,
14560380839,35.01549,15964988123,46779519,15964984541,-3582,,
14560431902,35.06655,15965039189,46830580,15965035602,-3587,,
14560482527,35.11718,15965089816,46881202,15965086225,-3591,,
14560533236,35.16788,15965140538,46931920,15965136942,-3596,,
14560583850,35.21850,15965191144,46982520,15965187542,-3602,,
14560634890,35.26954,15965242186,47033557,15965238580,-3606,,
14560685438,35.32009,15965292736,47084102,15965289124,-3612,,
14560736496,35.37114,15965343797,47135157,15965340180,-3617,,
14560787522,35.42217,15965394825,47186180,15965391203,-3622,,
14560837641,35.47229,15965444947,47236298,15965441321,-3626,,
14560888687,35.52334,15965495994,47287340,15965492362,-3632,,
14560938741,35.57339,15965546051,47337391,15965542414,-3637,,
14560988857,35.62351,15965596170,47387505,15965592527,-3643,,
14561039464,35.67411,15965646779,47438110,15965643132,-3647,,
14561090104,35.72475,15965697421,47488747,15965693769,-3652,,
14561140677,35.77533,15965747997,47539317,15965744339,-3658,,
14561191225,35.82587,15965798546,47589862,15965794884,-3662,,
14561242282,35.87693,15965849605,47640916,15965845938,-3667,,
14561293318,35.92797,15965900644,47691949,15965896972,-3672,,
14561343854,35.97850,15965951183,47742484,15965947506,-3677,,
14561394407,36.02905,15966001738,47793033,15965998064,-3674,,
14561445455,36.08010,15966052788,47844078,15966049100,-3688,,
14561495993,36.13064,15966103328,47894614,15966099637,-3691,,
14561546067,36.18071,15966153405,47944685,15966149707,-3698,,
14561597098,36.23175,15966204439,47995714,15966200736,-3703,,
14561647661,36.28231,15966255004,48046274,15966251296,-3708,,
14561698216,36.33286,15966305562,48096826,15966301849,-3713,,
14561748758,36.38341,15966356106,48147366,15966352388,-3718,,
14561799305,36.43395,15966406654,48197909,15966402931,-3723,,
14561849839,36.48449,15966457192,48248442,15966453464,-3728,,
14561899877,36.53453,15966507232,48298476,15966503499,-3733,,
14561949938,36.58459,15966557294,48348534,15966553556,-3738,,
14562000471,36.63512,15966607831,48399065,15966604088,-3743,,
14562050532,36.68518,15966657894,48449124,15966654146,-3748,,
14562100580,36.73523,15966707943,48499168,15966704190,-3753,,
14562150637,36.78529,15966758004,48549222,15966754245,-3759,,
14562201186,36.83583,15966808556,48599770,15966804793,-3763,,
14562251725,36.88637,15966859101,48650311,15966855333,-3768,,
14562302277,36.93693,15966909651,48700854,15966905877,-3774,,
14562352342,36.98699,15966959718,48750917,15966955940,-3778,,
14562402876,37.03752,15967010253,48801448,15967006470,-3783,,
14562453907,37.08855,15967061287,48852476,15967057498,-3789,,
14562503967,37.13862,15967111350,48902535,15967107557,-3793,,
14562554513,37.18916,15967161898,48953077,15967158100,-3798,,
14562604552,37.23920,15967211940,49003113,15967208136,-3804,,
14562654600,37.28925,15967261989,49053159,15967258182,-3807,,
14562704661,37.33931,15967312053,49103217,15967308240,-3813,,
14562755199,37.38985,15967362594,49153752,15967358775,-3819,,
14562805245,37.43989,15967412643,49203796,15967408819,-3824,,
14562855793,37.49044,15967463192,49254342,15967459364,-3828,,
14562906405,37.54105,15967513807,49304951,15967509973,-3834,,
14562959228,37.59388,15967566631,49357770,15967562792,-3839,,
14563009954,37.64460,15967617361,49408494,15967613517,-3844,,
14563063442,37.69809,15967670851,49461980,15967667003,-3848,,
14563114513,37.74916,15967721924,49513048,15967718071,-3853,,
14563164584,37.79923,15967771997,49563115,15967768137,-3860,,
14563214642,37.84929,15967822058,49613171,15967818194,-3864,,
14563265200,37.89985,15967872618,49663726,15967868749,-3869,,
14563315748,37.95040,15967923169,49714271,15967919293,-3876,,
14563365804,38.00045,15967973227,49764324,15967969346,-3881,,
14563420326,38.05497,15968027752,49818845,15968023867,-3885,,
14563470386,38.10503,15968077813,49868901,15968073923,-3890,,
14563524459,38.15911,15968131890,49922972,15968127994,-3896,,
14563574988,38.20964,15968182420,49973497,15968178519,-3901,,
14563625026,38.25967,15968232461,50023534,15968228556,-3905,,
14563676091,38.31074,15968283529,50074596,15968279619,-3910,,
14563726149,38.36080,15968333589,50124650,15968329673,-3916,,
14563776675,38.41132,15968384117,50175174,15968380196,-3921,,
14563827204,38.46185,15968434649,50225700,15968430723,-3926,,
14563878050,38.51270,15968485497,50276543,15968481566,-3931,,
14563928507,38.56316,15968535956,50326998,15968532020,-3936,,
14563979060,38.61371,15968586512,50377549,15968582571,-3941,,
14564029674,38.66432,15968637128,50428159,15968633182,-3946,,
14564080208,38.71486,15968687664,50478690,15968683713,-3951,,
14564130834,38.76548,15968738292,50529314,15968734336,-3956,,
14564181866,38.81651,15968789326,50580343,15968785365,-3961,,
14564231980,38.86663,15968839442,50630454,15968835476,-3966,,
14564282589,38.91724,15968890054,50681060,15968886082,-3972,,
14564333123,38.96777,15968940590,50731592,15968936614,-3976,,
14564383700,39.01835,15968991182,50782179,15968987201,-3981,,
14564434722,39.06937,15969042194,50833185,15969038207,-3987,,
14564485377,39.12002,15969092853,50883839,15969088862,-3991,,
14564535951,39.17060,15969143429,50934409,15969139432,-3997,,
14564586984,39.22163,15969194464,50985439,15969190462,-4002,,
14564637067,39.27172,15969244560,51035531,15969240553,-4007,,
14564688097,39.32274,15969295582,51086547,15969291570,-4012,,
14564738698,39.37335,15969346185,51137146,15969342168,-4017,,
14564789701,39.42435,15969397190,51188145,15969393167,-4023,,
14564840753,39.47540,15969448245,51239196,15969444218,-4027,,
14564891806,39.52645,15969499300,51290245,15969495268,-4032,,
14564942345,39.57699,15969549840,51340781,15969545803,-4037,,
14564993395,39.62804,15969600894,51391828,15969596851,-4043,,
14565043944,39.67859,15969651444,51442375,15969647397,-4047,,
14565094967,39.72962,15969702471,51493395,15969698418,-4053,,
14565145576,39.78022,15969753082,51544002,15969749024,-4058,,
14565196090,39.83074,15969803598,51594513,15969799535,-4063,,
14565246922,39.88157,15969854432,51645342,15969850364,-4068,,
14565297512,39.93216,15969905025,51695930,15969900952,-4073,,
14565347915,39.98256,15969955429,51746329,15969951352,-4077,,
14565398473,40.03312,15970005991,51796895,15970001918,-4073,,
14565449007,40.08366,15970056527,51847416,15970052439,-4088,,
14565499575,40.13422,15970107097,51897981,15970103004,-4093,,
14565550124,40.18477,15970157649,51948529,15970153551,-4098,,
14565600788,40.23544,15970208315,51999190,15970204212,-4103,,
14565651819,40.28647,15970259348,52050217,15970255240,-4108,,
14565702896,40.33754,15970310428,52101291,15970306314,-4114,,
14565753514,40.38816,15970361048,52151908,15970356930,-4118,,
14565804527,40.43917,15970412064,52202917,15970407940,-4124,,
14565855180,40.48983,15970462719,52253568,15970458590,-4129,,
14565905872,40.54052,15970513412,52304257,15970509279,-4133,,
14565956778,40.59143,15970564322,52355160,15970560183,-4139,,
14566007352,40.64200,15970614898,52405732,15970610754,-4144,,
14566057887,40.69253,15970665435,52456264,15970661286,-4149,,
14566108413,40.74306,15970715975,52506798,15970711821,-4154,,
14566159425,40.79407,15970766978,52557797,15970762819,-4159,,
14566210494,40.84514,15970818049,52608862,15970813885,-4164,,
14566261542,40.89619,15970869100,52659908,15970864931,-4169,,
14566312592,40.94724,15970920152,52710955,15970915978,-4174,,
14566363212,40.99786,15970970775,52761572,15970966595,-4180,,
14566414292,41.04894,15971021856,52812649,15971017671,-4185,,
14566464792,41.09944,15971072359,52863147,15971068170,-4189,,
14566514852,41.14950,15971122421,52913204,15971118226,-4195,,
14566565409,41.20006,15971172980,52963758,15971168780,-4200,,
14566616443,41.25109,15971224017,53014790,15971219813,-4204,,
14566667034,41.30168,15971274611,53065379,15971270401,-4210,,
14566717617,41.35227,15971325196,53115958,15971320980,-4216,,
14566768633,41.40328,15971376213,53166971,15971371994,-4219,,
14566819180,41.45383,15971426764,53217517,15971422539,-4225,,
14566870236,41.50488,15971477822,53268569,15971473592,-4230,,
14566921266,41.55591,15971528853,53319596,15971524618,-4235,,
14566972320,41.60697,15971579911,53370648,15971575671,-4240,,
14567022895,41.65754,15971630488,53421220,15971626243,-4245,,
14567073497,41.70815,15971681093,53471819,15971676841,-4252,,
14567124024,41.75867,15971731622,53522343,15971727366,-4256,,
14567174127,41.80877,15971781727,53572445,15971777467,-4260,,
14567224322,41.85897,15971831925,53622637,15971827659,-4266,,
14567274865,41.90951,15971882470,53673176,15971878199,-4271,,
14567325695,41.96034,15971933302,53724004,15971929027,-4275,,
14567375812,42.01046,15971983421,53774118,15971979140,-4281,,
14567431065,42.06571,15972038676,53829368,15972034390,-4286,,
14567481961,42.11661,15972089576,53880261,15972085284,-4292,,
14567532681,42.16733,15972140298,53930979,15972136002,-4296,,
14567583070,42.21772,15972190689,53981365,15972186387,-4302,,
14567633630,42.26828,15972241251,54031922,15972236945,-4306,,
14567684165,42.31881,15972291789,54082454,15972287477,-4312,,
14567735221,42.36987,15972342847,54133508,15972338530,-4317,,
14567786028,42.42068,15972393657,54184312,15972389335,-4322,,
14567836848,42.47150,15972444479,54235129,15972440152,-4327,,
14567887891,42.52254,15972495524,54286170,15972491193,-4331,,
14567938823,42.57347,15972546458,54337099,15972542121,-4337,,
14567989401,42.62405,15972597038,54387673,15972592696,-4342,,
14568039956,42.67460,15972647597,54438226,15972643249,-4348,,
14568091000,42.72565,15972698642,54489268,15972694290,-4352,,
14568142028,42.77668,15972749673,54540293,15972745316,-4357,,
14568193081,42.82773,15972800729,54591343,15972796366,-4363,,
14568243243,42.87789,15972850892,54641503,15972846525,-4367,,
14568294102,42.92875,15972901754,54692359,15972897382,-4372,,
14568344409,42.97906,15972952064,54742664,15972947686,-4378,,
14568394939,43.02959,15973002595,54793190,15972998213,-4382,,
14568445994,43.08064,15973053653,54844244,15973049266,-4387,,
14568497671,43.13232,15973105332,54895917,15973100939,-4393,,
14568548595,43.18324,15973156259,54946839,15973151861,-4398,,
14568599123,43.23377,15973206790,54997364,15973202386,-4404,,
14568649970,43.28462,15973257638,55048208,15973253230,-4408,,
14568700300,43.33495,15973307971,55098535,15973303558,-4413,,
14568752371,43.38702,15973360045,55150604,15973355627,-4418,,
14568804199,43.43885,15973411875,55202429,15973407452,-4423,,
14568854367,43.48902,15973462045,55252594,15973457616,-4429,,
14568904414,43.53906,15973512095,55302639,15973507661,-4434,,
14568954461,43.58911,15973562145,55352684,15973557706,-4439,,
14569004509,43.63916,15973612193,55402728,15973607750,-4443,,
14569054554,43.68920,15973662241,55452770,15973657792,-4449,,
14569105344,43.73999,15973713034,55503558,15973708580,-4454,,
14569155875,43.79052,15973763567,55554087,15973759109,-4458,,
14569205921,43.84057,15973813616,55604129,15973809151,-4465,,
14569255967,43.89061,15973863663,55654172,15973859194,-4469,,
14569306028,43.94068,15973913726,55704231,15973909253,-4473,,
14569356565,43.99121,15973964267,55754766,15973959788,-4479,,
14569406636,44.04128,15974014340,55804834,15974009856,-4484,,
14569457661,44.09231,15974065367,55855857,15974060879,-4488,,
14569507741,44.14239,15974115450,55905933,15974110956,-4494,,
14569557851,44.19250,15974165562,55956041,15974161063,-4499,,
14569608906,44.24355,15974216619,56007092,15974212115,-4504,,
14569659691,44.29434,15974267407,56057876,15974262898,-4509,,
14569710505,44.34515,15974318222,56108686,15974313708,-4514,,
14569761108,44.39576,15974368829,56159286,15974364308,-4521,,
14569811957,44.44660,15974419680,56210133,15974415155,-4525,,
14569862691,44.49734,15974470416,56260865,15974465887,-4529,,
14569913333,44.54798,15974521061,56311503,15974516525,-4536,,
14569963925,44.59857,15974571655,56362092,15974567115,-4540,,
14570014898,44.64955,15974622629,56413073,15974618095,-4534,,
14570065454,44.70010,15974673189,56463616,15974668639,-4550,,
14570115929,44.75058,15974723665,56514088,15974719110,-4555,,
14570166918,44.80157,15974774656,56565075,15974770097,-4559,,
14570217463,44.85211,15974825205,56615618,15974820640,-4565,,
14570268268,44.90292,15974876012,56666419,15974871441,-4571,,
14570318521,44.95317,15974926267,56716669,15974921692,-4575,,
14570369086,45.00373,15974976834,56767232,15974972254,-4580,,
14570420134,45.05478,15975027885,56818277,15975023299,-4586,,
14570471143,45.10579,15975078897,56869283,15975074306,-4591,,
14570521320,45.15597,15975129075,56919458,15975124480,-4595,,
14570571927,45.20658,15975179685,56970074,15975175096,-4589,,
14570622540,45.25719,15975230300,57020672,15975225694,-4606,,
14570673160,45.30781,15975280923,57071290,15975276313,-4610,,
14570723340,45.35799,15975331105,57121468,15975326490,-4615,,
14570773878,45.40853,15975381646,57172002,15975377025,-4621,,
14570824472,45.45912,15975432242,57222606,15975427629,-4613,,
14570875045,45.50969,15975482817,57273165,15975478187,-4630,,
14570925388,45.56004,15975533163,57323505,15975528528,-4635,,
14570976155,45.61080,15975583932,57374269,15975579291,-4641,,
14571026252,45.66090,15975634030,57424363,15975629385,-4645,,
14571077294,45.71194,15975685075,57475402,15975680425,-4650,,
14571128342,45.76299,15975736126,57526447,15975731470,-4656,,
14571179047,45.81370,15975786833,57577149,15975782172,-4661,,
14571229927,45.86458,15975837716,57628027,15975833050,-4666,,
14571280987,45.91564,15975888778,57679095,15975884118,-4660,,
14571331555,45.96620,15975939349,57729649,15975934672,-4677,,
14571382440,46.01709,15975990236,57780532,15975985555,-4681,,
14571433061,46.06771,15976040859,57831150,15976036172,-4687,,
14571483611,46.11826,15976091411,57881697,15976086719,-4692,,
14571534406,46.16905,15976142209,57932499,15976137521,-4688,,
14571585473,46.22012,15976193278,57983554,15976188577,-4701,,
14571636492,46.27114,15976244300,58034570,15976239593,-4707,,
14571687571,46.32222,15976295381,58085646,15976290669,-4712,,
14571738623,46.37327,15976346436,58136696,15976341719,-4717,,
14571789657,46.42430,15976397472,58187737,15976392760,-4712,,
14571840741,46.47539,15976448558,58238808,15976443830,-4728,,
14571891796,46.52644,15976499615,58289860,15976494882,-4733,,
14571942888,46.57754,15976550710,58340950,15976545972,-4738,,
14571993950,46.62860,15976601774,58392009,15976597032,-4742,,
14572045009,46.67966,15976652846,58443076,15976648098,-4748,,
14572095627,46.73027,15976703456,58493680,15976698703,-4753,,
14572146190,46.78084,15976754021,58544241,15976749263,-4758,,
14572197268,46.83192,15976805101,58595316,15976800338,-4763,,
14572248318,46.88297,15976856154,58646363,15976851386,-4768,,
14572299325,46.93397,15976907164,58697369,15976902391,-4773,,
14572349933,46.98458,15976957773,58747972,15976952995,-4778,,
14572400981,47.03563,15977008824,58799018,15977004040,-4784,,
14572451524,47.08617,15977059370,58849558,15977054581,-4789,,
14572502578,47.13723,15977110426,58900610,15977105633,-4793,,
14572553195,47.18784,15977161044,58951224,15977156246,-4798,,
14572604000,47.23865,15977211853,59002026,15977207049,-4804,,
14572655040,47.28969,15977262894,59053063,15977258085,-4809,,
14572706095,47.34074,15977313951,59104127,15977309149,-4802,,
14572756661,47.39131,15977364520,59154679,15977359702,-4818,,
14572807550,47.44220,15977415411,59205565,15977410587,-4824,,
14572857821,47.49247,15977465686,59255846,15977460868,-4818,,
14572908848,47.54350,15977516714,59306869,15977511892,-4822,,
14572959440,47.59409,15977567309,59357447,15977562469,-4840,,
14573010347,47.64500,15977618219,59408351,15977613374,-4845,,
14573060916,47.69556,15977668800,59458929,15977663951,-4849,,
14573111573,47.74622,15977719449,59509572,15977714595,-4854,,
14573162495,47.79714,15977770374,59560492,15977765514,-4860,,
14573212684,47.84733,15977820564,59610677,15977815700,-4864,,
14573263305,47.89795,15977871188,59661296,15977866319,-4869,,
14573314391,47.94904,15977922276,59712379,15977917401,-4875,,
14573365476,48.00012,15977973376,59763474,15977968497,-4879,,
14573415939,48.05059,15978023828,59813922,15978018944,-4884,,
14573466551,48.10120,15978074444,59864532,15978069554,-4890,,
14573517107,48.15176,15978125002,59915085,15978120107,-4895,,
14573567751,48.20240,15978175649,59965726,15978170749,-4900,,
14573617881,48.25253,15978225780,60015863,15978220886,-4894,,
14573668284,48.30293,15978276197,60066264,15978271287,-4910,,
14573719364,48.35401,15978327268,60117331,15978322354,-4914,,
14573769909,48.40456,15978377826,60167884,15978372906,-4920,,
14573820881,48.45553,15978428790,60218842,15978423865,-4925,,
14573871010,48.50566,15978478922,60268968,15978473990,-4932,,
14573921194,48.55584,15978529108,60319150,15978524172,-4936,,
14573972225,48.60687,15978580141,60370178,15978575201,-4940,,
14574022792,48.65744,15978630711,60420742,15978625764,-4947,,
14574073383,48.70803,15978681303,60471331,15978676353,-4950,,
14574123532,48.75818,15978731454,60521477,15978726499,-4955,,
14574174580,48.80923,15978782505,60572522,15978777544,-4961,,
14574225128,48.85978,15978833056,60623068,15978828090,-4966,,
14574275711,48.91036,15978883640,60673648,15978878670,-4970,,
14574325856,48.96050,15978933788,60723790,15978928812,-4976,,
14574376317,49.01096,15978984252,60774249,15978979272,-4980,,
14574426642,49.06129,15979034579,60824572,15979029594,-4985,,
14574477204,49.11185,15979085144,60875130,15979080153,-4991,,
14574527816,49.16246,15979135758,60925740,15979130762,-4996,,
14574578815,49.21346,15979186759,60976736,15979181758,-5001,,
14574629875,49.26452,15979237822,61027794,15979232816,-5006,,
14574680929,49.31558,15979288878,61078844,15979283867,-5011,,
14574731474,49.36612,15979339425,61129386,15979334409,-5016,,
14574782056,49.41670,15979390010,61179966,15979384989,-5021,,
14574833081,49.46773,15979441036,61230988,15979436011,-5025,,
14574884125,49.51877,15979492084,61282030,15979487052,-5032,,
14574934731,49.56938,15979542692,61332633,15979537656,-5036,,
14574985741,49.62039,15979593704,61383640,15979588663,-5041,,
14575036289,49.67094,15979644254,61434184,15979639207,-5047,,
14575086864,49.72151,15979694832,61484758,15979689780,-5052,,
14575137921,49.77257,15979745892,61535812,15979740835,-5057,,
14575188968,49.82362,15979796940,61586856,15979791878,-5062,,
14575239520,49.87417,15979847496,61637407,15979842429,-5067,,
14575290594,49.92524,15979898572,61688476,15979893499,-5073,,
14575341117,49.97577,15979949098,61738999,15979944021,-5077,,
14575391641,50.02629,15979999623,61789518,15979994541,-5082,,
14575442271,50.07692,15980050255,61840145,15980045167,-5088,,
14575492853,50.12750,15980100840,61890726,15980095748,-5092,,
14575543901,50.17855,15980151890,61941771,15980146793,-5097,,
14575594927,50.22957,15980202930,61992805,15980197827,-5103,,
14575645975,50.28062,15980253969,62043839,15980248861,-5108,,
14575696976,50.33162,15980304973,62094837,15980299860,-5113,,
14575747572,50.38222,15980355570,62145430,15980350453,-5117,,
14575798058,50.43271,15980406059,62195913,15980400936,-5123,,
14575848679,50.48333,15980456683,62246533,15980451555,-5128,,
14575899707,50.53435,15980507712,62297567,15980502590,-5122,,
14575949923,50.58457,15980557941,62347780,15980552803,-5138,,
14576000538,50.63519,15980608560,62398395,15980603417,-5143,,
14576051563,50.68621,15980659576,62449405,15980654427,-5149,,
14576101761,50.73641,15980709775,62499600,15980704622,-5153,,
14576152785,50.78743,15980760803,62550621,15980755644,-5159,,
14576203363,50.83801,15980811383,62601198,15980806220,-5163,,
14576254408,50.88906,15980862430,62652239,15980857262,-5168,,
14576305461,50.94011,15980913486,62703289,15980908311,-5175,,
14576356061,50.99071,15980964088,62753886,15980958908,-5180,,
14576406598,51.04125,15981014628,62804421,15981009444,-5184,,
14576456693,51.09134,15981064725,62854513,15981059536,-5189,,
14576506767,51.14142,15981114801,62904585,15981109608,-5193,,
14576557815,51.19246,15981165852,62955630,15981160653,-5199,,
14576608385,51.24303,15981216424,63006198,15981211220,-5204,,
14576659011,51.29366,15981267051,63056820,15981261843,-5208,,
14576709785,51.34443,15981317829,63107593,15981312615,-5214,,
14576760116,51.39476,15981368161,63157920,15981362943,-5218,,
14576811163,51.44581,15981419211,63208965,15981413987,-5224,,
14576861751,51.49640,15981469802,63259550,15981464572,-5230,,
14576912811,51.54746,15981520864,63310607,15981515630,-5234,,
14576963438,51.59809,15981571493,63361231,15981566253,-5240,,
14577014463,51.64911,15981622521,63412253,15981617275,-5246,,
14577065480,51.70013,15981673540,63463268,15981668291,-5249,,
14577116105,51.75075,15981724168,63513890,15981718913,-5255,,
14577166848,51.80150,15981774912,63564630,15981769652,-5260,,
14577217897,51.85254,15981825963,63615676,15981820698,-5265,,
14577268948,51.90360,15981877018,63666725,15981871747,-5271,,
14577319834,51.95448,15981927906,63717608,15981922631,-5275,,
14577370580,52.00523,15981978654,63768352,15981973374,-5280,,
14577421631,52.05628,15982029707,63819399,15982024422,-5285,,
14577472193,52.10684,15982080272,63869960,15982074982,-5290,,
14577523223,52.15787,15982131303,63920986,15982126008,-5295,,
14577573370,52.20802,15982181454,63971130,15982176153,-5301,,
14577623984,52.25863,15982232070,64021743,15982226765,-5305,,
14577674568,52.30922,15982282657,64072323,15982277346,-5311,,
14577725120,52.35977,15982333211,64122872,15982327895,-5316,,
14577775619,52.41027,15982383711,64173369,15982378391,-5320,,
14577826667,52.46131,15982434763,64224414,15982429436,-5327,,
14577876980,52.51163,15982485078,64274724,15982479747,-5331,,
14577928034,52.56268,15982536134,64325775,15982530797,-5337,,
14577979064,52.61371,15982587167,64376803,15982581826,-5341,,
14578029608,52.66426,15982637713,64427345,15982632367,-5346,,
14578080206,52.71485,15982688312,64477939,15982682961,-5351,,
14578131135,52.76578,15982739245,64528867,15982733889,-5356,,
14578182221,52.81687,15982790333,64579950,15982784972,-5361,,
14578232739,52.86739,15982840853,64630465,15982835487,-5366,,
14578283367,52.91801,15982891484,64681090,15982886112,-5372,,
14578333520,52.96817,15982941639,64731240,15982936263,-5376,,
14578384115,53.01876,15982992236,64781832,15982986854,-5382,,
14578435151,53.06980,15983043275,64832865,15983037888,-5387,,
14578485755,53.12040,15983093881,64883468,15983088490,-5391,,
14578536337,53.17099,15983144466,64934047,15983139069,-5397,,
14578587379,53.22203,15983195510,64985086,15983190109,-5401,,
14578638435,53.27308,15983246567,65036138,15983241161,-5406,,
14578688965,53.32361,15983297101,65086667,15983291689,-5412,,
14578739486,53.37413,15983347624,65137184,15983342207,-5417,,
14578790094,53.42474,15983398233,65187789,15983392811,-5422,,
14578841141,53.47579,15983449283,65238834,15983443856,-5427,,
14578892224,53.52687,15983500370,65289916,15983494941,-5429,,
14578943242,53.57789,15983551389,65340929,15983545951,-5438,,
14578993759,53.62841,15983601908,65391443,15983596465,-5443,,
14579044790,53.67944,15983652941,65442472,15983647495,-5446,,
14579094842,53.72949,15983702997,65492521,15983697544,-5453,,
14579145388,53.78004,15983753544,65543064,15983748086,-5458,,
14579196028,53.83068,15983804186,65593702,15983798724,-5462,,
14579246545,53.88119,15983854706,65644216,15983849238,-5468,,
14579297102,53.93175,15983905266,65694770,15983899793,-5473,,
14579348150,53.98280,15983956327,65745826,15983950849,-5478,,
14579398749,54.03340,15984006917,65796412,15984001434,-5483,,
14579449768,54.08442,15984057939,65847429,15984052451,-5488,,
14579500845,54.13549,15984109017,65898502,15984103525,-5492,,
14579551365,54.18601,15984159541,65949020,15984154042,-5499,,
14579602408,54.23706,15984210586,66000061,15984205083,-5503,,
14579653351,54.28800,15984261532,66051001,15984256023,-5509,,
14579703441,54.33809,15984311624,66101088,15984306110,-5514,,
14579753513,54.38816,15984361698,66151158,15984356180,-5518,,
14579804550,54.43920,15984412737,66202191,15984407213,-5524,,
14579855098,54.48975,15984463288,66252736,15984457758,-5530,,
14579905691,54.54034,15984513883,66303327,15984508349,-5534,,
14579956231,54.59088,15984564426,66353864,15984558887,-5539,,
14580007289,54.64194,15984615485,66404919,15984609941,-5544,,
14580058311,54.69296,15984666510,66455938,15984660961,-5549,,
14580108895,54.74354,15984717097,66506520,15984711543,-5554,,
14580159421,54.79407,15984767624,66557043,15984762066,-5558,,
14580210392,54.84504,15984818597,66608011,15984813033,-5564,,
14580260963,54.89561,15984869172,66658580,15984863603,-5569,,
14580311904,54.94655,15984920115,66709519,15984914541,-5574,,
14580362516,54.99716,15984970730,66760127,15984965150,-5580,,
14580413071,55.04772,15985021287,66810691,15985015713,-5574,,
14580463629,55.09828,15985071847,66861236,15985066258,-5589,,
14580514665,55.14931,15985122886,66912268,15985117291,-5595,,
14580565248,55.19990,15985173471,66962848,15985167871,-5600,,
14580616302,55.25095,15985224526,67013900,15985218922,-5604,,
14580666896,55.30154,15985275124,67064491,15985269514,-5610,,
14580717923,55.35257,15985326152,67115515,15985320537,-5615,,
14580768006,55.40265,15985376238,67165595,15985370618,-5620,,
14580818137,55.45278,15985426372,67215724,15985420747,-5625,,
14580868684,55.50333,15985476921,67266268,15985471291,-5630,,
14580919704,55.55435,15985527953,67317296,15985522319,-5634,,
14580970283,55.60493,15985578524,67367862,15985572884,-5640,,
14581021257,55.65590,15985629500,67418833,15985623855,-5645,,
14581071332,55.70598,15985679577,67468905,15985673927,-5650,,
14581122401,55.75705,15985730650,67519972,15985724994,-5656,,
14581173415,55.80806,15985781666,67570983,15985776006,-5660,,
14581224451,55.85910,15985832704,67622016,15985827039,-5665,,
14581275487,55.91013,15985883743,67673050,15985878072,-5671,,
14581326214,55.96086,15985934472,67723774,15985928797,-5675,,
14581376782,56.01143,15985985053,67774350,15985979373,-5680,,
14581427459,56.06211,15986035721,67825013,15986030035,-5686,,
14581477963,56.11261,15986086228,67875515,15986080537,-5691,,
14581529003,56.16365,15986137271,67926552,15986131575,-5696,,
14581579546,56.21419,15986187815,67977092,15986182114,-5701,,
14581630591,56.26524,15986238862,68028134,15986233156,-5706,,
14581681692,56.31634,15986289967,68079233,15986284256,-5711,,
14581732275,56.36692,15986340551,68129813,15986334836,-5715,,
14581783290,56.41794,15986391569,68180825,15986385848,-5721,,
14581833831,56.46848,15986442112,68231363,15986436385,-5727,,
14581884872,56.51952,15986493155,68282402,15986487424,-5731,,
14581935970,56.57062,15986544257,68333497,15986538519,-5738,,
14581986493,56.62114,15986594783,68384018,15986589041,-5742,,
14582037032,56.67168,15986645323,68434555,15986639577,-5746,,
14582088086,56.72273,15986696379,68485605,15986690627,-5752,,
14582139165,56.77381,15986747461,68536681,15986741704,-5757,,
14582190185,56.82483,15986798483,68587699,15986792721,-5762,,
14582241258,56.87591,15986849559,68638769,15986843792,-5767,,
14582292275,56.92692,15986900578,68689783,15986894806,-5772,,
14582343326,56.97797,15986951632,68740832,15986945854,-5778,,
14582394402,57.02905,15987002710,68791905,15986996927,-5783,,
14582444922,57.07957,15987053231,68842422,15987047444,-5787,,
14582495510,57.13016,15987103823,68893008,15987098030,-5793,,
14582546112,57.18076,15987154427,68943607,15987148629,-5798,,
14582597161,57.23181,15987205478,68994653,15987199676,-5802,,
14582648210,57.28286,15987256530,69045699,15987250722,-5808,,
14582699270,57.33392,15987307592,69096756,15987301778,-5814,,
14582750319,57.38497,15987358643,69147801,15987352824,-5819,,
14582801312,57.43596,15987409638,69198793,15987403815,-5823,,
14582851890,57.48654,15987460219,69249369,15987454391,-5828,,
14582902969,57.53762,15987511300,69300444,15987505466,-5834,,
14582954028,57.58868,15987562361,69351500,15987556522,-5839,,
14583005076,57.63972,15987613412,69402547,15987607569,-5843,,
14583055608,57.69026,15987663957,69453086,15987658109,-5848,,
14583106141,57.74079,15987714482,69503606,15987708628,-5854,,
14583157178,57.79183,15987765520,69554640,15987759662,-5858,,
14583207776,57.84242,15987816121,69605235,15987810257,-5864,,
14583259297,57.89395,15987867645,69656754,15987861776,-5869,,
14583309896,57.94454,15987918257,69707360,15987912382,-5875,,
14583360563,57.99521,15987968915,69758014,15987963036,-5879,,
14583411163,58.04581,15988019518,69808612,15988013634,-5884,,
14583462190,58.09684,15988070547,69859635,15988064657,-5890,,
14583512803,58.14745,15988121162,69910256,15988115278,-5884,,
14583563855,58.19850,15988172217,69961295,15988166317,-5900,,
14583614432,58.24908,15988222797,70011870,15988216892,-5905,,
14583664983,58.29963,15988273349,70062417,15988267440,-5909,,
14583715525,58.35017,15988323904,70112967,15988317990,-5914,,
14583766066,58.40071,15988374438,70163496,15988368518,-5920,,
14583817056,58.45170,15988425430,70214482,15988419505,-5925,,
14583867600,58.50225,15988475975,70265024,15988470047,-5928,,
14583918156,58.55280,15988526547,70315590,15988520612,-5935,,
14583968695,58.60334,15988577076,70366114,15988571136,-5940,,
14584019768,58.65442,15988628152,70417184,15988622207,-5945,,
14584070304,58.70495,15988678690,70467717,15988672740,-5950,,
14584121315,58.75596,15988729702,70518725,15988723747,-5955,,
14584171868,58.80652,15988780259,70569275,15988774298,-5961,,
14584222427,58.85708,15988830820,70619833,15988824855,-5965,,
14584272967,58.90761,15988881362,70670370,15988875392,-5970,,
14584323553,58.95820,15988931951,70720952,15988925975,-5976,,
14584374164,59.00881,15988982564,70771561,15988976584,-5980,,
14584424331,59.05898,15989032733,70821726,15989026748,-5985,,
14584474952,59.10960,15989083357,70872344,15989077366,-5991,,
14584525477,59.16013,15989133884,70922866,15989127888,-5996,,
14584576114,59.21076,15989184523,70973501,15989178523,-6000,,
14584626642,59.26129,15989235065,71024037,15989229059,-6006,,
14584677269,59.31192,15989285683,71074649,15989279672,-6011,,
14584727874,59.36252,15989336291,71125252,15989330275,-6016,,
14584778721,59.41337,15989387140,71176096,15989381119,-6021,,
14584829346,59.46399,15989437767,71226719,15989431741,-6026,,
14584879863,59.51451,15989488287,71277232,15989482255,-6032,,
14584930402,59.56505,15989538828,71327770,15989532792,-6036,,
14584980854,59.61550,15989589281,71378218,15989583240,-6041,,
14585031408,59.66606,15989639839,71428769,15989633792,-6047,,
14585081972,59.71662,15989690405,71479332,15989684354,-6051,,
14585132584,59.76723,15989741019,71529940,15989734963,-6056,,
14585183172,59.81782,15989791610,71580525,15989785547,-6063,,
14585233320,59.86797,15989841770,71630682,15989835704,-6066,,
14585283924,59.91857,15989892378,71681285,15989886307,-6071,,
14585334751,59.96940,15989943206,71732107,15989937130,-6076,,
14585385822,60.02047,15989994268,71783164,15989988186,-6082,,
14585436413,60.07106,15990044862,71833753,15990038776,-6086,,
14585486971,60.12162,15990095422,71884308,15990089330,-6092,,
14585538020,60.17267,15990146473,71935354,15990140376,-6097,,
14585589078,60.22373,15990197535,71986411,15990191433,-6102,,
14585849575,60.48422,15990458044,72246893,15990451915,-6129,15990457863,
14585874924,60.50957,15990483404,72272250,15990477302,-6102,,
14585925972,60.56062,15990534454,72323296,15990528408,-6046,,
14585976549,60.61120,15990585024,72373860,15990579033,-5991,,
14586027120,60.66177,15990635596,72424438,15990629671,-5925,,
14586078172,60.71282,15990686651,72475478,15990680771,-5880,,
14586129240,60.76389,15990737722,72526543,15990731898,-5824,,
14586179853,60.81450,15990788336,72577153,15990782567,-5769,,
14586230067,60.86471,15990838553,72627365,15990832839,-5714,,
14586280616,60.91526,15990889105,72677912,15990883447,-5658,,
14586331625,60.96627,15990940117,72728918,15990934519,-5598,,
14586382192,61.01684,15990990684,72779481,15990985136,-5548,,
14586432764,61.06741,15991041271,72830061,15991035777,-5494,,
14586483375,61.11802,15991091883,72880670,15991086445,-5438,,
14586534377,61.16902,15991142878,72931659,15991137495,-5383,,
14586585472,61.22012,15991193975,72982750,15991188647,-5328,,
14586636522,61.27117,15991245027,73033798,15991239755,-5272,,
14586687122,61.32177,15991295630,73084396,15991290413,-5217,,
14586738155,61.37280,15991346665,73135426,15991341504,-5161,,
14586788750,61.42340,15991397261,73186017,15991392156,-5105,,
14586839789,61.47444,15991448304,73237054,15991443254,-5050,,
14586890805,61.52545,15991499321,73288078,15991494338,-4983,,
14586941160,61.57581,15991549679,73338419,15991544740,-4939,,
14586991744,61.62639,15991600265,73389000,15991595381,-4884,,
14587042804,61.67745,15991651328,73440059,15991646500,-4828,,
14587093369,61.72802,15991701894,73490620,15991697121,-4773,,
14587144414,61.77906,15991752943,73541662,15991748225,-4718,,
14587194964,61.82961,15991803495,73592211,15991798833,-4662,,
14587245479,61.88013,15991854024,73642733,15991849416,-4608,,
14587296518,61.93117,15991905053,73693758,15991900501,-4552,,
14587347554,61.98220,15991956092,73744791,15991951594,-4498,,
14587398116,62.03276,15992006657,73795352,15992002215,-4442,,
14587449144,62.08379,15992057687,73846377,15992053301,-4386,,
14587499227,62.13388,15992107772,73896457,15992103441,-4331,,
14587549833,62.18448,15992158381,73947060,15992154105,-4276,,
14587600566,62.23521,15992209116,73997791,15992204895,-4221,,
14587651638,62.28629,15992260201,74048871,15992256037,-4164,,
14587702257,62.33691,15992310812,74099475,15992306700,-4112,,
14587753257,62.38791,15992361813,74150473,15992357760,-4053,,
14587803845,62.43849,15992412405,74201058,15992408405,-4000,,
14587854770,62.48942,15992463332,74251980,15992459388,-3944,,
14587905350,62.54000,15992513914,74302558,15992510026,-3888,,
14587956197,62.59085,15992564763,74353402,15992560930,-3833,,
14588006720,62.64137,15992615289,74403923,15992611511,-3778,,
14588056830,62.69148,15992665411,74454039,15992661687,-3724,,
14588107491,62.74214,15992716065,74504688,15992712396,-3669,,
14588158058,62.79271,15992766633,74555252,15992763020,-3613,,
14588209093,62.84374,15992817680,74606294,15992814122,-3558,,
14588259198,62.89385,15992867779,74656388,15992864276,-3503,,
14588309755,62.94440,15992918337,74706941,15992914889,-3448,,
14588360303,62.99495,15992968888,74757486,15992965495,-3393,,
14588410837,63.04548,15993019435,74808029,15993016098,-3337,,
14588461357,63.09600,15993069947,74858536,15993066665,-3282,,
14588511991,63.14664,15993120582,74909166,15993117355,-3227,,
14588562727,63.19738,15993171321,74959899,15993168159,-3162,,
14588613583,63.24823,15993222180,75010754,15993219064,-3116,,
14588664117,63.29877,15993272717,75061284,15993269655,-3062,,
14588714674,63.34932,15993323276,75111849,15993320279,-2997,,
14588765720,63.40037,15993374324,75162882,15993371374,-2950,,
14588816770,63.45142,15993425377,75213929,15993422482,-2895,,
14588867790,63.50244,15993476399,75264946,15993473559,-2840,,
14588918834,63.55348,15993527445,75315987,15993524661,-2784,,
14588969391,63.60404,15993578005,75366542,15993575276,-2729,,
14589019859,63.65451,15993628475,75417007,15993625801,-2674,,
14589070402,63.70505,15993679020,75467548,15993676401,-2619,,
14589120967,63.75561,15993729587,75518110,15993727024,-2563,,
14589171012,63.80566,15993779634,75568152,15993777125,-2509,,
14589221244,63.85589,15993829868,75618381,15993827414,-2454,,
14589272249,63.90690,15993880877,75669384,15993878478,-2399,,
14589322371,63.95702,15993931000,75719503,15993928656,-2344,,
14589373430,64.00808,15993982073,75770569,15993979784,-2289,,
14589424275,64.05892,15994032919,75821411,15994030686,-2233,,
14589474848,64.10950,15994083484,75871972,15994081307,-2177,,
14589525481,64.16013,15994134121,75922602,15994131998,-2123,,
14589576064,64.21071,15994184706,75973182,15994182638,-2068,,
14589626675,64.26132,15994235319,76023792,15994233307,-2012,,
14589677272,64.31192,15994285929,76074395,15994283972,-1957,,
14589727746,64.36239,15994336394,76124856,15994334492,-1902,,
14589778282,64.41293,15994386932,76175389,15994385086,-1846,,
14589829309,64.46396,15994437962,76226414,15994436170,-1792,,
14589879676,64.51432,15994488332,76276779,15994486595,-1737,,
14589930224,64.56487,15994538882,76327324,15994537201,-1681,,
14589981248,64.61590,15994589909,76378345,15994588283,-1626,,
14590031800,64.66645,15994640462,76428894,15994638892,-1570,,
14590082358,64.71701,15994691022,76479449,15994689507,-1515,,
14590132919,64.76757,15994741586,76530017,15994740136,-1450,,
14590183957,64.81861,15994792627,76581043,15994791222,-1405,,
14590235005,64.86965,15994843677,76632088,15994842327,-1350,,
14590286084,64.92073,15994894758,76683164,15994893464,-1294,,
14590337088,64.97174,15994945765,76734167,15994944528,-1237,,
14590388139,65.02279,15994996819,76785215,15994995636,-1183,,
14590439210,65.07386,15995047892,76836283,15995046765,-1127,,
14590489747,65.12440,15995098442,76886827,15995097370,-1072,,
14590540381,65.17503,15995149068,76937459,15995148062,-1006,,
14590590718,65.22537,15995199406,76987782,15995198444,-962,,
14590641211,65.27586,15995249902,77038273,15995248996,-906,,
14590691358,65.32601,15995300052,77088417,15995299200,-852,,
14590741538,65.37619,15995350233,77138594,15995349437,-796,,
14590792324,65.42697,15995401021,77189388,15995400291,-730,,
14590842896,65.47754,15995451597,77239956,15995450920,-677,,
14590893968,65.52862,15995502670,77291016,15995501987,-683,,
14590944988,65.57964,15995553694,77342043,15995553015,-679,,
14590995604,65.63025,15995604312,77392646,15995603618,-694,,
14591046532,65.68118,15995655241,77443572,15995654543,-698,,
14591097161,65.73181,15995705874,77494198,15995705170,-704,,
14591147710,65.78236,15995756425,77544744,15995755716,-709,,
14591198731,65.83338,15995807448,77595762,15995806733,-715,,
14591249351,65.88400,15995858071,77646380,15995857352,-719,,
14591299497,65.93415,15995908219,77696523,15995907495,-724,,
14591350582,65.98523,15995959317,77747617,15995958588,-729,,
14591401229,66.03588,15996009955,77798250,15996009222,-733,,
14591451807,66.08646,15996060536,77848826,15996059797,-739,,
14591502365,66.13701,15996111096,77899380,15996110351,-745,,
14591552952,66.18760,15996161686,77949965,15996160936,-750,,
14591603962,66.23861,15996212698,78000972,15996211943,-755,,
14591654589,66.28924,15996263328,78051597,15996262568,-760,,
14591705130,66.33978,15996313871,78102134,15996313117,-754,,
14591756198,66.39085,15996364940,78153200,15996364171,-769,,
14591806732,66.44138,15996415488,78203742,15996414713,-775,,
14591857752,66.49240,15996466500,78254749,15996465721,-779,,
14591907887,66.54254,15996516636,78304880,15996515851,-785,,
14591958487,66.59314,15996567240,78355479,15996566450,-790,,
14592008582,66.64323,15996617336,78405569,15996616541,-795,,
14592059589,66.69424,15996668346,78456574,15996667545,-801,,
14592109753,66.74440,15996718512,78506736,15996717707,-805,,
14592160799,66.79545,15996769561,78557779,15996768751,-810,,
14592211331,66.84598,15996820104,78608318,15996819290,-814,,
14592262399,66.89705,15996871165,78659373,15996870344,-821,,
14592313009,66.94766,15996921777,78709981,15996920952,-825,,
14592363615,66.99826,15996972387,78760585,15996971556,-831,,
14592414660,67.04931,15997023434,78811626,15997022598,-836,,
14592465295,67.09994,15997074071,78862259,15997073231,-840,,
14592516206,67.15085,15997124985,78913167,15997124150,-835,,
14592566810,67.20146,15997175590,78963768,15997174739,-851,,
14592617007,67.25165,15997225790,79013964,15997224935,-855,,
14592667621,67.30227,15997276407,79064574,15997275546,-861,,
14592718645,67.35329,15997327432,79115606,15997326578,-854,,
14592769341,67.40399,15997378131,79166289,15997377260,-871,,
14592819897,67.45454,15997428691,79216844,15997427815,-876,,
14592870505,67.50515,15997479300,79267447,15997478419,-881,,
14592921097,67.55575,15997529893,79318036,15997529007,-886,,
14592972145,67.60679,15997580945,79369083,15997580054,-891,,
14593022852,67.65750,15997631653,79419786,15997630757,-896,,
14593073039,67.70769,15997681844,79469970,15997680942,-902,,
14593123946,67.75859,15997732752,79520874,15997731845,-907,,
14593174965,67.80961,15997783774,79571892,15997782863,-911,,
14593225564,67.86021,15997834376,79622488,15997833460,-916,,
14593276576,67.91122,15997885389,79673496,15997884478,-911,,
14593327645,67.96229,15997936461,79724563,15997935535,-926,,
14593378718,68.01337,15997987537,79775634,15997986605,-932,,
14593428887,68.06354,15998037708,79825800,15998036771,-937,,
14593479503,68.11415,15998088326,79876412,15998087384,-942,,
14593529690,68.16434,15998138516,79926597,15998137569,-947,,
14593580019,68.21467,15998188847,79976934,15998187906,-941,,
14593630640,68.26529,15998239470,80027541,15998238513,-957,,
14593681271,68.31592,15998290115,80078182,15998289153,-962,,
14593731861,68.36651,15998340696,80128758,15998339729,-967,,
14593782447,68.41710,15998391284,80179340,15998390312,-972,,
14593833462,68.46811,15998442301,80230352,15998441323,-978,,
14593883980,68.51863,15998492822,80280868,15998491840,-982,,
14593934581,68.56923,15998543425,80331466,15998542437,-988,,
14593985194,68.61984,15998594040,80382087,15998593059,-981,,
14594036201,68.67085,15998645049,80433081,15998644052,-997,,
14594087287,68.72194,15998696139,80484164,15998695135,-1004,,
14594138317,68.77296,15998747171,80535191,15998746162,-1009,,
14594189367,68.82402,15998798222,80586248,15998797220,-1002,,
14594239942,68.87459,15998848801,80636822,15998847793,-1008,,
14594291010,68.92566,15998899870,80687876,15998898847,-1023,,
14594342059,68.97671,15998950923,80738922,15998949893,-1030,,
14594392629,69.02728,15999001494,80789490,15999000461,-1033,,
14594443106,69.07775,15999051974,80839965,15999050936,-1038,,
14594493702,69.12835,15999102572,80890557,15999101529,-1043,,
14594544298,69.17895,15999153170,80941150,15999152121,-1049,,
14594594597,69.22925,15999203472,80991448,15999202419,-1053,,
14594645621,69.28027,15999254499,81042468,15999253440,-1059,,
14594696277,69.33092,15999305157,81093121,15999304093,-1064,,
14594746900,69.38155,15999355782,81143742,15999354713,-1069,,
14594797508,69.43216,15999406393,81194348,15999405319,-1074,,
14594848036,69.48268,15999456923,81244872,15999455844,-1079,,
14594898595,69.53324,15999507484,81295428,15999506400,-1084,,
14594949206,69.58385,15999558098,81346038,15999557009,-1089,,
14594999364,69.63401,15999608258,81396192,15999607164,-1094,,
14595050414,69.68506,15999659310,81447239,15999658211,-1099,,
14595101016,69.73566,15999709915,81497840,15999708811,-1104,,
14595152125,69.78677,15999761026,81548945,15999759917,-1109,,
14595203125,69.83777,15999812029,81599943,15999810914,-1115,,
14595253707,69.88836,15999862613,81650521,15999861493,-1120,,
14595303892,69.93854,15999912800,81700704,15999911676,-1124,,
14595354891,69.98954,15999963801,81751700,15999962671,-1130,,
14595405528,70.04018,16000014441,81802335,16000013306,-1135,,
14595456121,70.09077,16000065048,81852937,16000063909,-1139,,
14595507172,70.14182,16000116090,81903973,16000114945,-1145,,
14595557262,70.19191,16000166182,81954060,16000165031,-1151,,
14595607423,70.24207,16000216345,82004219,16000215191,-1154,,
14595658012,70.29266,16000266947,82054816,16000265787,-1160,,
14595708128,70.34278,16000317055,82104919,16000315890,-1165,,
14595758658,70.39331,16000367586,82155445,16000366416,-1170,,
14595809745,70.44439,16000418676,82206530,16000417501,-1175,,
14595859946,70.49459,16000468880,82256729,16000467700,-1180,,
14595910562,70.54521,16000519498,82307342,16000518313,-1185,,
14595961191,70.59584,16000570130,82357968,16000568939,-1191,,
14596011534,70.64618,16000620474,82408308,16000619279,-1195,,
14596062319,70.69697,16000671263,82459090,16000670062,-1201,,
14596112408,70.74706,16000721364,82509188,16000720160,-1204,,
14596163023,70.79767,16000771971,82559789,16000770761,-1210,,
14596213731,70.84838,16000822682,82610495,16000821466,-1216,,
14596264296,70.89894,16000873249,82661056,16000872028,-1221,,
14596315321,70.94997,16000924276,82712079,16000923051,-1225,,
14596365873,71.00052,16000974831,82762628,16000973600,-1231,,
14596416434,71.05108,16001025394,82813186,16001024158,-1236,,
14596467513,71.10216,16001076474,82864263,16001075234,-1240,,
14596518364,71.15301,16001127329,82915111,16001126083,-1246,,
14596569424,71.20407,16001178391,82966169,16001177140,-1251,,
14596619981,71.25463,16001228950,83016722,16001227694,-1256,,
14596670618,71.30527,16001279602,83067369,16001278341,-1261,,
14596721691,71.35634,16001330665,83118427,16001329399,-1266,,
14596772770,71.40742,16001381747,83169504,16001380475,-1272,,
14596823369,71.45802,16001432348,83220100,16001431071,-1277,,
14596873907,71.50856,16001482899,83270647,16001481619,-1280,,
14596924646,71.55929,16001533630,83321372,16001532343,-1287,,
14596975273,71.60992,16001584259,83371996,16001582967,-1292,,
14597025918,71.66057,16001634906,83422638,16001633610,-1296,,
14597076516,71.71116,16001685507,83473233,16001684204,-1303,,
14597127135,71.76178,16001736128,83523850,16001734821,-1307,,
14597177638,71.81229,16001786633,83574350,16001785322,-1311,,
14597228538,71.86319,16001837536,83625247,16001836219,-1317,,
14597279103,71.91375,16001888103,83675810,16001886781,-1322,,
14597329557,71.96421,16001938558,83726260,16001937231,-1327,,
14597380121,72.01477,16001989126,83776822,16001987793,-1333,,
14597430652,72.06530,16002039659,83827350,16002038322,-1337,,
14597480713,72.11536,16002089723,83877408,16002088380,-1343,,
14597531809,72.16646,16002140821,83928502,16002139474,-1347,,
14597582843,72.21749,16002191857,83979533,16002190505,-1352,,
14597633441,72.26809,16002242457,84030128,16002241099,-1358,,
14597684247,72.31889,16002293266,84080931,16002291902,-1364,,
14597734816,72.36946,16002343836,84131498,16002342469,-1367,,
14597784895,72.41954,16002393919,84181575,16002392546,-1373,,
14597835472,72.47012,16002444498,84232149,16002443120,-1378,,
14597886520,72.52117,16002495548,84283194,16002494166,-1382,,
14597937569,72.57222,16002546599,84334240,16002545211,-1388,,
14597987988,72.62264,16002597020,84384656,16002595627,-1393,,
14598038424,72.67307,16002647458,84435089,16002646060,-1398,,
14598089314,72.72396,16002698351,84485977,16002696948,-1403,,
14598140360,72.77501,16002749400,84537020,16002747992,-1408,,
14598190412,72.82506,16002799455,84587070,16002798041,-1414,,
14598240981,72.87563,16002850026,84637636,16002848608,-1418,,
14598291571,72.92622,16002900617,84688223,16002899194,-1423,,
14598342162,72.97681,16002951212,84738812,16002949783,-1429,,
14598392684,73.02733,16003001736,84789331,16003000303,-1433,,
14598443255,73.07790,16003052308,84839899,16003050871,-1437,,
14598493789,73.12844,16003102845,84890430,16003101401,-1444,,
14598544411,73.17906,16003153470,84941050,16003152021,-1449,,
14598594972,73.22962,16003204033,84991609,16003202581,-1452,,
14598646020,73.28067,16003255084,85042654,16003253625,-1459,,
14598696259,73.33091,16003305324,85092889,16003303860,-1464,,
14598746392,73.38104,16003355460,85143021,16003353993,-1467,,
14598797364,73.43201,16003406434,85193989,16003404961,-1473,,
14598847543,73.48219,16003456615,85244165,16003455136,-1479,,
14598898084,73.53273,16003507159,85294704,16003505675,-1484,,
14598949103,73.58375,16003558181,85345720,16003556692,-1489,,
14599000160,73.63481,16003609240,85396775,16003607746,-1494,,
14599051221,73.68587,16003660303,85447832,16003658803,-1500,,
14599101753,73.73640,16003710838,85498362,16003709334,-1504,,
14599152307,73.78696,16003761394,85548914,16003759885,-1509,,
14599203359,73.83801,16003812449,85599963,16003810934,-1515,,
14599253951,73.88860,16003863043,85650551,16003861523,-1520,,
14599305004,73.93965,16003914098,85701602,16003912574,-1524,,
14599355591,73.99024,16003964687,85752186,16003963157,-1530,,
14599406224,74.04087,16004015323,85802816,16004013788,-1535,,
14599456768,74.09142,16004065869,85853359,16004064330,-1539,,
14599507363,74.14201,16004116466,85903949,16004114921,-1545,,
14599558426,74.19307,16004167532,85955010,16004165982,-1550,,
14599608939,74.24359,16004218047,86005521,16004216492,-1555,,
14599659579,74.29423,16004268691,86056160,16004267131,-1560,,
14599710620,74.34527,16004319734,86107197,16004318169,-1565,,
14599761143,74.39579,16004370271,86157729,16004368700,-1571,,
14599811962,74.44661,16004421080,86208534,16004419505,-1575,,
14599862965,74.49761,16004472085,86259533,16004470504,-1581,,
14599913550,74.54820,16004522673,86310116,16004521087,-1586,,
14599964425,74.59907,16004573549,86360987,16004571958,-1591,,
14600015497,74.65014,16004624623,86412057,16004623029,-1594,,
14600066522,74.70117,16004675664,86463092,16004674064,-1600,,
14600117091,74.75174,16004726223,86513645,16004724617,-1606,,
14600168101,74.80275,16004777235,86564654,16004775625,-1610,,
14600219163,74.85381,16004828299,86615712,16004826683,-1616,,
14600270239,74.90489,16004879378,86666785,16004877757,-1621,,
14600320780,74.95543,16004929922,86717323,16004928295,-1627,,
14600370995,75.00564,16004980138,86767536,16004978507,-1631,,
14600421512,75.05616,16005030658,86818051,16005029022,-1636,,
14600472081,75.10673,16005081230,86868616,16005079588,-1642,,
14600522697,75.15735,16005131848,86919230,16005130202,-1646,,
14600573169,75.20782,16005182322,86969700,16005180671,-1651,,
14600624189,75.25884,16005233345,87020717,16005231688,-1657,,
14600675263,75.30991,16005284421,87071787,16005282759,-1662,,
14600726261,75.36091,16005335420,87122783,16005333754,-1666,,
14600777226,75.41187,16005386389,87173746,16005384717,-1672,,
14600827831,75.46248,16005436996,87224347,16005435319,-1677,,
14600878907,75.51355,16005488075,87275422,16005486393,-1682,,
14600929513,75.56416,16005538683,87326036,16005537008,-1675,,
14600980089,75.61474,16005589261,87376597,16005587569,-1692,,
14601030291,75.66494,16005639465,87426796,16005637767,-1698,,
14601080659,75.71531,16005689836,87477162,16005688134,-1702,,
14601131228,75.76588,16005740407,87527728,16005738700,-1707,,
14601181881,75.81653,16005791063,87578378,16005789350,-1713,,
14601232870,75.86752,16005842053,87629365,16005840336,-1717,,
14601283438,75.91809,16005892624,87679931,16005890902,-1722,,
14601334121,75.96877,16005943309,87730610,16005941582,-1727,,
14601384873,76.01952,16005994064,87781359,16005992331,-1733,,
14601435942,76.07059,16006045135,87832426,16006043398,-1737,,
14601486516,76.12116,16006095712,87882998,16006093969,-1743,,
14601537550,76.17220,16006146747,87934028,16006145000,-1747,,
14601588148,76.22280,16006197348,87984624,16006195596,-1752,,
14601639174,76.27382,16006248377,88035647,16006246619,-1758,,
14601689499,76.32415,16006298703,88085969,16006296940,-1763,,
14601740291,76.37494,16006349499,88136758,16006347730,-1769,,
14601790873,76.42552,16006400083,88187339,16006398310,-1773,,
14601841409,76.47606,16006450621,88237871,16006448843,-1778,,
14601891484,76.52613,16006500699,88287943,16006498915,-1784,,
14601942515,76.57716,16006551732,88338973,16006549944,-1788,,
14601993573,76.62822,16006602792,88390028,16006600999,-1793,,
14602044601,76.67925,16006653823,88441053,16006652024,-1799,,
14602094924,76.72957,16006704148,88491373,16006702345,-1803,,
14602145484,76.78013,16006754710,88541931,16006752902,-1808,,
14602196066,76.83071,16006805294,88592509,16006803481,-1813,,
14602246205,76.88085,16006855436,88642645,16006853616,-1820,,
14602297222,76.93187,16006906455,88693660,16006904632,-1823,,
14602348298,76.98295,16006957534,88744733,16006955705,-1829,,
14602399300,77.03395,16007008537,88795732,16007006703,-1834,,
14602450395,77.08504,16007059636,88846825,16007057796,-1840,,
14602500996,77.13564,16007110239,88897424,16007108395,-1844,,
14602552012,77.18666,16007161257,88948436,16007159408,-1849,,
14602602603,77.23725,16007211851,88999025,16007209996,-1855,,
14602653648,77.28830,16007262897,89050067,16007261038,-1859,,
14602704694,77.33934,16007313946,89101111,16007312082,-1864,,
14602755233,77.38988,16007364487,89151646,16007362618,-1869,,
14602805781,77.44043,16007415038,89202191,16007413163,-1875,,
14602856338,77.49099,16007465596,89252746,16007463717,-1879,,
14602906871,77.54152,16007516132,89303276,16007514247,-1885,,
14602957402,77.59205,16007566666,89353805,16007564776,-1890,,
14603007499,77.64215,16007616766,89403900,16007614871,-1895,,
14603058509,77.69316,16007667777,89454906,16007665877,-1900,,
14603109140,77.74379,16007718411,89505534,16007716506,-1905,,
14603159278,77.79393,16007768551,89555670,16007766641,-1910,,
14603210002,77.84465,16007819278,89606391,16007817363,-1915,,
14603260551,77.89520,16007869841,89656949,16007867921,-1920,,
14603311183,77.94583,16007920464,89707567,16007918538,-1926,,
14603361758,77.99641,16007971041,89758140,16007969111,-1930,,
14603412562,78.04721,16008021847,89808941,16008019912,-1935,,
14603463155,78.09780,16008072443,89859530,16008070502,-1941,,
14603514191,78.14884,16008123481,89910564,16008121536,-1945,,
14603564271,78.19892,16008173562,89960641,16008171612,-1950,,
14603615225,78.24987,16008224519,90011592,16008222563,-1956,,
14603665857,78.30051,16008275153,90062221,16008273192,-1961,,
14603716409,78.35106,16008325708,90112771,16008323743,-1965,,
14603767434,78.40208,16008376736,90163794,16008374765,-1971,,
14603818527,78.45318,16008427831,90214883,16008425855,-1976,,
14603869119,78.50377,16008478426,90265473,16008476445,-1981,,
14603919693,78.55434,16008529002,90316044,16008527016,-1986,,
14603970789,78.60544,16008580099,90367137,16008578109,-1990,,
14604021276,78.65592,16008630590,90417621,16008628593,-1997,,
14604072304,78.70695,16008681619,90468647,16008679619,-2000,,
14604123355,78.75800,16008732673,90519695,16008730667,-2006,,
14604174419,78.80907,16008783740,90570756,16008781728,-2012,,
14604224983,78.85963,16008834305,90621318,16008832289,-2016,,
14604275153,78.90980,16008884478,90671486,16008882457,-2021,,
14604325452,78.96010,16008934780,90721782,16008932753,-2027,,
14604376322,79.01097,16008985652,90772648,16008983620,-2032,,
14604426897,79.06154,16009036230,90823222,16009034193,-2037,,
14604477936,79.11258,16009087271,90874258,16009085230,-2041,,
14604528868,79.16352,16009138205,90925186,16009136158,-2047,,
14604579864,79.21451,16009189204,90976191,16009187163,-2041,,
14604630886,79.26553,16009240227,91027199,16009238170,-2057,,
14604681082,79.31573,16009290426,91077392,16009288364,-2062,,
14604731209,79.36586,16009340555,91127516,16009338487,-2068,,
14604781741,79.41639,16009391090,91178046,16009389018,-2072,,
14604832779,79.46743,16009442130,91229081,16009440052,-2078,,
14604883837,79.51848,16009493190,91280136,16009491108,-2082,,
14604934416,79.56906,16009543772,91330714,16009541685,-2087,,
14604985476,79.62012,16009594834,91381770,16009592742,-2092,,
14605036048,79.67070,16009645408,91432339,16009643310,-2098,,
14605087029,79.72168,16009696392,91483318,16009694290,-2102,,
14605138063,79.77271,16009747429,91534350,16009745321,-2108,,
14605188791,79.82344,16009798158,91585074,16009796045,-2113,,
14605239347,79.87399,16009848716,91635627,16009846598,-2118,,
14605289913,79.92456,16009899286,91686191,16009897163,-2123,,
14605340495,79.97514,16009949870,91736770,16009947741,-2129,,
14605390711,80.02536,16010000088,91786984,16009997955,-2133,,
14605441258,80.07591,16010050638,91837527,16010048499,-2139,,
14605492276,80.12692,16010101658,91888544,16010099515,-2143,,
14605542395,80.17704,16010151779,91938660,16010149631,-2148,,
14605593518,80.22817,16010202905,91989780,16010200751,-2154,,
14605644080,80.27873,16010253469,92040340,16010251311,-2158,,
14605694438,80.32909,16010303829,92090694,16010301666,-2163,,
14605745463,80.38011,16010354857,92141716,16010352688,-2169,,
14605796059,80.43071,16010405455,92192310,16010403281,-2174,,
14605846629,80.48128,16010456027,92242877,16010453849,-2178,,
14605897663,80.53231,16010507064,92293908,16010504880,-2184,,
14605948695,80.58334,16010558098,92344938,16010555909,-2189,,
14605999478,80.63413,16010608884,92395718,16010606689,-2195,,
14606050475,80.68512,16010659883,92446713,16010657684,-2199,,
14606101533,80.73618,16010710942,92497767,16010708739,-2203,,
14606152081,80.78673,16010761494,92548312,16010759284,-2210,,
14606203127,80.83777,16010812542,92599356,16010810328,-2214,,
14606253658,80.88831,16010863074,92649884,16010860855,-2219,,
14606304702,80.93935,16010914121,92700925,16010911896,-2225,,
14606355246,80.98989,16010964668,92751467,16010962439,-2229,,
14606405812,81.04046,16011015237,92802031,16011013002,-2235,,
14606456357,81.09100,16011065784,92852573,16011063544,-2240,,
14606506910,81.14156,16011116339,92903123,16011114094,-2245,,
14606557503,81.19215,16011166935,92953713,16011164685,-2250,,
14606608525,81.24317,16011217959,93004733,16011215704,-2255,,
14606659555,81.29420,16011268991,93055759,16011266731,-2260,,
14606709983,81.34463,16011319422,93106185,16011317157,-2265,,
14606760567,81.39521,16011370008,93156766,16011367738,-2270,,
14606811520,81.44617,16011420962,93207716,16011418688,-2274,,
14606862094,81.49674,16011471539,93258287,16011469258,-2281,,
14606912626,81.54727,16011522074,93308818,16011519789,-2285,,
14606963177,81.59783,16011572627,93359365,16011570337,-2290,,
14607013751,81.64840,16011623204,93409937,16011620908,-2296,,
14607064537,81.69918,16011673992,93460720,16011671692,-2300,,
14607115571,81.75022,16011725029,93511751,16011722723,-2306,,
14607166635,81.80128,16011776095,93562812,16011773784,-2311,,
14607217302,81.85195,16011826764,93613476,16011824448,-2316,,
14607267838,81.90249,16011877302,93664010,16011874981,-2321,,
14607318357,81.95301,16011927824,93714527,16011925498,-2326,,
14607368496,82.00314,16011977964,93764662,16011975633,-2331,,
14607419009,82.05366,16012028480,93815173,16012026144,-2336,,
14607470088,82.10474,16012079561,93866249,16012077220,-2341,,
14607520805,82.15545,16012130281,93916963,16012127935,-2346,,
14607570953,82.20560,16012180432,93967108,16012178080,-2352,,
14607621504,82.25615,16012230985,94017657,16012228629,-2356,,
14607672196,82.30684,16012281689,94068357,16012279328,-2361,,
14607722654,82.35730,16012332140,94118812,16012329784,-2356,,
14607773592,82.40824,16012383080,94169737,16012380709,-2371,,
14607824596,82.45924,16012434086,94220739,16012431710,-2376,,
14607874822,82.50947,16012484315,94270961,16012481932,-2383,,
14607925849,82.56050,16012535343,94321996,16012532967,-2376,,
14607976260,82.61091,16012585758,94372394,16012583365,-2393,,
14608027252,82.66190,16012636752,94423384,16012634355,-2397,,
14608077807,82.71246,16012687308,94473935,16012684906,-2402,,
14608128403,82.76305,16012737908,94524529,16012735501,-2407,,
14608179418,82.81407,16012788924,94575541,16012786512,-2412,,
14608230496,82.86514,16012840005,94626616,16012837587,-2418,,
14608281109,82.91576,16012890621,94677227,16012888198,-2423,,
14608331691,82.96634,16012941205,94727807,16012938778,-2427,,
14608382627,83.01727,16012992143,94778740,16012989711,-2432,,
14608433231,83.06788,16013042749,94829339,16013040311,-2438,,
14608484215,83.11886,16013093736,94880322,16013091294,-2442,,
14608534905,83.16955,16013144429,94931009,16013141981,-2448,,
14608585026,83.21967,16013194551,94981127,16013192098,-2453,,
14608635684,83.27033,16013245211,95031783,16013242754,-2457,,
14608686240,83.32089,16013295771,95082336,16013293308,-2463,,
14608737553,83.37220,16013347088,95133648,16013344620,-2468,,
14608788343,83.42299,16013397878,95184433,16013395405,-2473,,
14608838824,83.47347,16013448362,95234912,16013445884,-2478,,
14608888937,83.52358,16013498477,95285023,16013495994,-2483,,
14608939915,83.57456,16013549458,95335998,16013546970,-2488,,
14608990952,83.62560,16013600509,95387045,16013598016,-2493,,
14609042027,83.67668,16013651573,95438104,16013649075,-2498,,
14609093064,83.72771,16013702624,95489150,16013700121,-2503,,
14609144137,83.77878,16013753688,95540208,16013751180,-2508,,
14609194699,83.82935,16013804253,95590769,16013801740,-2513,,
14609245249,83.87990,16013854805,95641315,16013852286,-2519,,
14609295759,83.93041,16013905317,95691822,16013902793,-2524,,
14609346334,83.98098,16013955895,95742395,16013953367,-2528,,
14609396846,84.03149,16014006410,95792905,16014003876,-2534,,
14609447729,84.08238,16014057295,95843785,16014054756,-2539,,
14609497971,84.13262,16014107539,95894024,16014104995,-2544,,
14609548545,84.18319,16014158116,95944606,16014155578,-2538,,
14609599570,84.23422,16014209142,95995617,16014206588,-2554,,
14609650573,84.28522,16014260147,96046616,16014257588,-2559,,
14609700987,84.33563,16014310574,96097039,16014308010,-2564,,
14609751839,84.38649,16014361419,96147878,16014358850,-2569,,
14609802076,84.43672,16014411658,96198122,16014409094,-2564,,
14609852651,84.48730,16014462236,96248685,16014459656,-2580,,
14609903239,84.53789,16014512826,96299271,16014510242,-2584,,
14609953757,84.58840,16014563347,96349785,16014560757,-2590,,
14610004837,84.63948,16014614429,96400862,16014611834,-2595,,
14610055722,84.69037,16014665316,96451746,16014662717,-2599,,
14610106403,84.74105,16014716000,96502423,16014713395,-2605,,
14610156541,84.79119,16014766139,96552558,16014763530,-2609,,
14610207557,84.84221,16014817157,96603571,16014814542,-2615,,
14610258098,84.89275,16014867701,96654110,16014865081,-2620,,
14610308653,84.94330,16014918259,96704663,16014915634,-2625,,
14610359264,84.99391,16014968872,96755270,16014966241,-2631,,
14610409851,85.04450,16015019461,96805855,16015016826,-2635,,
14610460401,85.09505,16015070014,96856403,16015067374,-2640,,
14610511478,85.14613,16015121093,96907476,16015118448,-2645,,
14610562511,85.19716,16015172129,96958507,16015169478,-2651,,
14610613076,85.24772,16015222696,97009069,16015220041,-2655,,
14610663632,85.29828,16015273255,97059623,16015270594,-2661,,
14610714189,85.34884,16015323814,97110176,16015321148,-2666,,
14610764739,85.39939,16015374366,97160724,16015371696,-2670,,
14610815261,85.44991,16015424890,97211243,16015422214,-2676,,
14610865334,85.49998,16015474966,97261313,16015472284,-2682,,
14610916281,85.55093,16015525914,97312258,16015523229,-2685,,
14610966853,85.60150,16015576490,97362828,16015573799,-2691,,
14611017834,85.65248,16015627473,97413806,16015624777,-2696,,
14611068869,85.70352,16015678510,97464838,16015675809,-2701,,
14611119429,85.75408,16015729073,97515395,16015726366,-2707,,
14611170306,85.80495,16015779952,97566270,16015777242,-2710,,
14611221366,85.85601,16015831014,97617327,16015828298,-2716,,
14611271926,85.90657,16015881577,97667883,16015878854,-2723,,
14611322022,85.95667,16015931675,97717978,16015928949,-2726,,
14611372605,86.00725,16015982260,97768558,16015979529,-2731,,
14611423264,86.05791,16016032921,97819213,16016030185,-2736,,
14611473861,86.10851,16016083520,97869808,16016080779,-2741,,
14611524425,86.15907,16016134088,97920369,16016131341,-2747,,
14611575472,86.21012,16016185137,97971413,16016182385,-2752,,
14611626522,86.26117,16016236188,98022461,16016233432,-2756,,
14611677557,86.31221,16016287227,98073493,16016284464,-2763,,
14611727643,86.36229,16016337316,98123577,16016334549,-2767,,
14611777967,86.41262,16016387640,98173896,16016384868,-2772,,
14611828994,86.46364,16016438671,98224922,16016435894,-2777,,
14611879068,86.51372,16016488758,98275005,16016485976,-2782,,
14611929630,86.56428,16016539311,98325552,16016536524,-2787,,
14611979708,86.61436,16016589392,98375629,16016586600,-2792,,
14612030264,86.66491,16016639950,98426181,16016637153,-2797,,
14612081290,86.71594,16016690978,98477204,16016688176,-2802,,
14612131346,86.76599,16016741037,98527259,16016738230,-2807,,
14612181884,86.81653,16016791577,98577794,16016788765,-2812,,
14612232480,86.86713,16016842175,98628387,16016839358,-2817,,
14612283029,86.91768,16016892726,98678932,16016889904,-2822,,
14612334045,86.96869,16016943745,98729947,16016940918,-2827,,
14612384589,87.01924,16016994292,98780487,16016991459,-2833,,
14612435126,87.06977,16017044830,98831021,16017041992,-2838,,
14612485700,87.12035,16017095417,98881604,16017092576,-2841,,
14612536239,87.17089,16017145949,98932129,16017143101,-2848,,
14612587298,87.22195,16017197010,98983185,16017194157,-2853,,
14612637348,87.27200,16017247062,99033233,16017244204,-2858,,
14612687924,87.32257,16017297641,99083807,16017294778,-2863,,
14612738472,87.37312,16017348191,99134352,16017345323,-2868,,
14612789508,87.42416,16017399229,99185384,16017396356,-2873,,
14612840068,87.47472,16017449791,99235942,16017446913,-2878,,
14612890672,87.52532,16017500493,99286642,16017497614,-2879,,
14612941164,87.57581,16017550892,99337032,16017548004,-2888,,
14612991699,87.62635,16017601429,99387564,16017598536,-2893,,
14613042249,87.67690,16017651982,99438112,16017649084,-2898,,
14613092811,87.72746,16017702545,99488671,16017699642,-2903,,
14613143389,87.77804,16017753126,99539246,16017750217,-2909,,
14613193949,87.82860,16017803689,99589804,16017800776,-2913,,
14613244551,87.87920,16017854294,99640403,16017851375,-2919,,
14613295598,87.93025,16017905342,99691447,16017902418,-2924,,
14613346633,87.98128,16017956379,99742479,16017953450,-2929,,
14613397229,88.03188,16018006978,99793073,16018004044,-2934,,
14613447755,88.08240,16018057506,99843596,16018054577,-2929,,
14613498825,88.13347,16018108579,99894663,16018105635,-2944,,
14613549841,88.18449,16018159597,99945677,16018156648,-2949,,
14613600891,88.23554,16018210649,99996724,16018207696,-2953,,
14613651538,88.28619,16018261298,100047368,16018258340,-2958,,
14613702585,88.33723,16018312349,100098412,16018309383,-2966,,
14613753634,88.38828,16018363400,100149459,16018360430,-2970,,
14613804150,88.43880,16018413918,100199972,16018410943,-2975,,
14613854695,88.48934,16018464465,100250514,16018461485,-2980,,
14613904778,88.53943,16018514551,100300595,16018511567,-2984,,
14613955782,88.59043,16018565557,100351596,16018562567,-2990,,
14614006382,88.64103,16018616160,100402194,16018613165,-2995,,
14614056861,88.69151,16018666640,100452669,16018663640,-3000,,
14614107437,88.74209,16018717220,100503244,16018714215,-3005,,
14614157986,88.79263,16018767771,100553789,16018764761,-3010,,
14614209033,88.84368,16018818820,100604833,16018815805,-3015,,
14614259593,88.89424,16018869383,100655391,16018866363,-3020,,
14614310632,88.94528,16018920424,100706428,16018917399,-3025,,
14614360674,88.99532,16018970467,100756466,16018967437,-3030,,
14614410777,89.04542,16019020573,100806567,16019017538,-3035,,
14614461364,89.09601,16019071163,100857152,16019068123,-3040,,
14614512437,89.14709,16019122238,100908222,16019119193,-3045,,
14614563007,89.19765,16019172811,100958788,16019169760,-3051,,
14614613613,89.24826,16019223418,101009392,16019220364,-3054,,
14614663838,89.29849,16019273647,101059614,16019270586,-3061,,
14614714369,89.34902,16019324179,101110142,16019321113,-3066,,
14614764600,89.39925,16019374412,101160371,16019371342,-3070,,
14614815474,89.45012,16019425290,101211243,16019422214,-3076,,
14614866032,89.50068,16019475850,101261798,16019472769,-3081,,
14614917124,89.55177,16019526943,101312886,16019523857,-3086,,
14614967253,89.60190,16019577076,101363013,16019573985,-3091,,
14615017938,89.65259,16019627762,101413695,16019624666,-3096,,
14615068486,89.70313,16019678313,101464241,16019675212,-3101,,
14615119100,89.75375,16019728930,101514852,16019725824,-3106,,
14615169634,89.80428,16019779466,101565384,16019776355,-3111,,
14615220219,89.85487,16019830053,101615965,16019826937,-3116,,
14615270891,89.90554,16019880727,101666635,16019877606,-3121,,
14615321440,89.95609,16019931278,101717181,16019928152,-3126,,
14615372501,90.00715,16019982341,101768239,16019979210,-3131,,
14615423557,90.05821,16020033401,101819292,16020030264,-3137,,
14615474631,90.10928,16020084476,101870364,16020081335,-3141,,
14615525183,90.15983,16020135031,101920913,16020131885,-3146,,
14615576141,90.21079,16020185991,101971868,16020182839,-3152,,
14615627187,90.26184,16020237040,102022911,16020233883,-3157,,
14615678234,90.31288,16020288090,102073956,16020284928,-3162,,
14615729286,90.36393,16020339143,102125005,16020335976,-3167,,
14615780320,90.41497,16020390180,102176037,16020387008,-3172,,
14615831158,90.46581,16020441021,102226873,16020437844,-3177,,
14615882206,90.51685,16020492071,102277918,16020488889,-3182,,
14615933220,90.56787,16020543087,102328928,16020539899,-3188,,
14615983768,90.61842,16020593638,102379473,16020590445,-3193,,
14616034351,90.66900,16020644222,102430054,16020641025,-3197,,
14616085377,90.72003,16020695252,102481077,16020692060,-3192,,
14616136402,90.77105,16020746279,102532099,16020743071,-3208,,
14616187498,90.82215,16020797377,102583193,16020794165,-3212,,
14616238531,90.87318,16020848413,102634223,16020845195,-3218,,
14616289557,90.92421,16020899440,102685246,16020896217,-3223,,
14616340160,90.97481,16020950046,102735846,16020946818,-3228,,
14616391189,91.02584,16021001078,102786883,16020997855,-3223,,
14616442226,91.07687,16021052117,102837907,16021048879,-3238,,
14616492813,91.12746,16021102707,102888491,16021099463,-3244,,
14616543861,91.17851,16021153757,102939537,16021150508,-3249,,
14616594861,91.22951,16021204759,102990535,16021201506,-3253,,
14616645272,91.27992,16021255173,103040942,16021251914,-3259,,
14616696285,91.33093,16021306188,103091953,16021302924,-3264,,
14616746914,91.38156,16021356819,103142580,16021353551,-3268,,
14616797338,91.43199,16021407246,103193000,16021403972,-3274,,
14616847853,91.48250,16021457762,103243512,16021454483,-3279,,
14616898391,91.53304,16021508303,103294047,16021505019,-3284,,
14616948713,91.58336,16021558628,103344367,16021555339,-3289,,
14616999261,91.63391,16021609178,103394912,16021605884,-3294,,
14617049832,91.68448,16021659750,103445480,16021656451,-3299,,
14617099986,91.73463,16021709918,103495643,16021706614,-3304,,
14617151057,91.78570,16021760981,103546700,16021757672,-3309,,
14617201614,91.83626,16021811541,103597255,16021808226,-3315,,
14617252144,91.88679,16021862072,103647782,16021858754,-3318,,
14617302383,91.93703,16021912313,103698018,16021908989,-3324,,
14617352897,91.98754,16021962831,103748530,16021959501,-3330,,
14617403433,92.03808,16022013369,103799062,16022010034,-3335,,
14617454488,92.08914,16022064426,103850116,16022061087,-3339,,
14617505036,92.13968,16022114977,103900660,16022111632,-3345,,
14617555577,92.19022,16022165520,103951198,16022162170,-3350,,
14617606126,92.24077,16022216071,104001745,16022212717,-3354,,
14617656689,92.29134,16022266637,104052306,16022263277,-3360,,
14617707733,92.34238,16022317682,104103346,16022314317,-3365,,
14617758780,92.39343,16022368731,104154390,16022365361,-3370,,
14617810378,92.44503,16022420332,104205985,16022416957,-3375,,
14617861380,92.49603,16022471337,104256986,16022467969,-3368,,
14617911921,92.54657,16022521881,104307524,16022518495,-3386,,
14617962531,92.59718,16022572494,104358132,16022569104,-3390,,
14618013106,92.64775,16022623069,104408714,16022619686,-3383,,
14618063688,92.69834,16022673654,104459282,16022670253,-3401,,
14618113767,92.74841,16022723736,104509359,16022720330,-3406,,
14618164343,92.79899,16022774323,104559942,16022770913,-3410,,
14618214954,92.84960,16022824928,104610541,16022821512,-3416,,
14618265543,92.90019,16022875519,104661126,16022872098,-3421,,
14618316141,92.95079,16022926119,104711722,16022922694,-3425,,
14618366723,93.00137,16022976704,104762301,16022973273,-3431,,
14618417270,93.05192,16023027252,104812845,16023023816,-3436,,
14618467796,93.10244,16023077781,104863369,16023074341,-3440,,
14618518868,93.15352,16023128856,104914439,16023125410,-3446,,
14618569372,93.20402,16023179362,104964939,16023175911,-3451,,
14618620401,93.25505,16023230394,105015966,16023226937,-3457,,
14618671435,93.30608,16023281429,105066997,16023277968,-3461,,
14618722077,93.35672,16023332073,105117636,16023328607,-3466,,
14618773129,93.40778,16023383129,105168685,16023379657,-3472,,
14618824169,93.45882,16023434171,105219722,16023430698,-3473,,
14618875221,93.50987,16023485225,105270772,16023481744,-3481,,
14618925763,93.56041,16023535770,105321312,16023532283,-3487,,
14618976804,93.61145,16023586813,105372350,16023583321,-3492,,
14619027367,93.66201,16023637378,105422910,16023633882,-3496,,
14619077939,93.71259,16023687953,105473480,16023684451,-3502,,
14619128509,93.76316,16023738524,105524045,16023735017,-3507,,
14619179095,93.81374,16023789113,105574630,16023785601,-3512,,
14619229685,93.86433,16023839705,105625217,16023836188,-3517,,
14619280269,93.91492,16023890291,105675798,16023886769,-3522,,
14619330712,93.96536,16023940737,105726238,16023937210,-3527,,
14619381286,94.01593,16023991325,105776822,16023987793,-3532,,
14619431907,94.06655,16024041937,105827429,16024038400,-3537,,
14619482161,94.11681,16024092194,105877679,16024088651,-3543,,
14619533198,94.16785,16024143233,105928714,16024139686,-3547,,
14619583758,94.21841,16024193795,105979272,16024190243,-3552,,
14619634308,94.26896,16024244348,106029819,16024240790,-3558,,
14619685341,94.31999,16024295383,106080848,16024291820,-3563,,
14619735878,94.37053,16024345921,106131382,16024342354,-3567,,
14619786460,94.42111,16024396507,106181963,16024392934,-3573,,
14619837515,94.47216,16024447564,106233014,16024443986,-3578,,
14619888508,94.52316,16024498558,106284005,16024494976,-3582,,
14619939604,94.57425,16024549658,106335098,16024546070,-3588,,
14619990638,94.62529,16024600693,106386129,16024597101,-3592,,
14620041691,94.67634,16024651750,106437180,16024648151,-3599,,
14620092744,94.72739,16024702804,106488230,16024699201,-3603,,
14620143282,94.77793,16024753345,106538765,16024749737,-3608,,
14620193830,94.82848,16024803896,106589310,16024800282,-3614,,
14620244883,94.87953,16024854950,106640360,16024851332,-3618,,
14620295427,94.93008,16024905497,106690903,16024901874,-3623,,
14620346154,94.98080,16024956238,106741637,16024952609,-3629,,
14620397259,95.03191,16025007333,106792728,16025003699,-3634,,
14620447876,95.08252,16025057953,106843343,16025054315,-3638,,
14620498469,95.13312,16025108548,106893933,16025104904,-3644,,
14620549503,95.18415,16025159585,106944965,16025155936,-3649,,
14620600079,95.23473,16025210165,106995538,16025206510,-3655,,
14620650549,95.28520,16025260646,107046016,16025256988,-3658,,
14620701575,95.33622,16025311664,107097028,16025308000,-3664,,
14620752519,95.38717,16025362610,107147969,16025358940,-3670,,
14620803066,95.43771,16025413160,107198515,16025409486,-3674,,
14620854106,95.48875,16025464202,107249552,16025460523,-3679,,
14620905157,95.53981,16025515256,107300600,16025511571,-3685,,
14620956114,95.59076,16025566215,107351553,16025562525,-3690,,
14621006734,95.64138,16025616837,107402172,16025613143,-3694,,
14621057792,95.69244,16025667898,107453226,16025664198,-3700,,
14621108342,95.74299,16025718450,107503774,16025714745,-3705,,
14621159413,95.79406,16025769524,107554842,16025765814,-3710,,
14621210462,95.84511,16025820575,107605889,16025816860,-3715,,
14621261011,95.89566,16025871126,107656434,16025867406,-3720,,
14621311619,95.94627,16025921736,107707039,16025918010,-3726,,
14621362654,95.99730,16025972774,107758072,16025969043,-3731,,
14621416681,96.05133,16026026804,107812097,16026023068,-3736,,
14621467226,96.10187,16026077351,107862639,16026073610,-3741,,
14621517459,96.15211,16026127586,107912868,16026123840,-3746,,
14621568004,96.20265,16026178134,107963411,16026174382,-3752,,
14621619042,96.25369,16026229174,108014446,16026225418,-3756,,
14621669563,96.30421,16026279697,108064965,16026275936,-3761,,
14621720143,96.35479,16026330292,108115554,16026326526,-3766,,
14621771169,96.40582,16026381308,108166566,16026377537,-3771,,
14621822212,96.45686,16026432353,108217605,16026428577,-3776,,
14621872264,96.50691,16026482408,108267654,16026478626,-3782,,
14621922833,96.55748,16026532979,108318221,16026529193,-3786,,
14621973851,96.60850,16026583999,108369236,16026580208,-3791,,
14622024412,96.65906,16026634563,108419794,16026630765,-3798,,
14622075472,96.71012,16026685625,108470852,16026681823,-3802,,
14622126514,96.76116,16026736669,108521891,16026732862,-3807,,
14622177076,96.81172,16026787233,108572450,16026783421,-3812,,
14622227618,96.86227,16026837778,108622989,16026833961,-3817,,
14622278150,96.91280,16026888313,108673520,16026884491,-3822,,
14622329201,96.96385,16026939366,108724567,16026935539,-3827,,
14622380278,97.01493,16026990444,108775641,16026986612,-3832,,
14622430818,97.06547,16027040988,108826179,16027037150,-3838,,
14622481854,97.11650,16027092025,108877212,16027088184,-3841,,
14622532404,97.16705,16027142578,108927759,16027138731,-3847,,
14622582943,97.21759,16027193119,108978295,16027189266,-3853,,
14622633477,97.26812,16027243656,109028828,16027239799,-3857,,
14622684583,97.31923,16027294765,109079931,16027290902,-3863,,
14622736093,97.37074,16027346277,109131438,16027342409,-3868,,
14622788181,97.42283,16027398367,109183523,16027394494,-3873,,
14622839177,97.47383,16027449365,109234516,16027445487,-3878,,
14622889729,97.52438,16027499920,109285065,16027496037,-3883,,
14622939786,97.57443,16027549978,109335119,16027546091,-3887,,
14622990321,97.62497,16027600517,109385652,16027596624,-3893,,
14623040892,97.67554,16027651089,109436220,16027647191,-3898,,
14623092325,97.72697,16027702524,109487650,16027698621,-3903,,
14623144076,97.77872,16027754278,109539398,16027750369,-3909,,
14623195048,97.82970,16027805253,109590368,16027801340,-3913,,
14623246071,97.88072,16027856279,109641388,16027852360,-3919,,
14623296632,97.93128,16027906841,109691946,16027902918,-3923,,
14623347662,97.98231,16027957874,109742974,16027953945,-3929,,
14623398244,98.03289,16028008458,109793553,16028004524,-3934,,
14623448819,98.08347,16028059035,109844125,16028055096,-3939,,
14623499401,98.13405,16028109620,109894704,16028105676,-3944,,
14623550393,98.18504,16028160614,109945694,16028156665,-3949,,
14623600967,98.23561,16028211191,109996265,16028207237,-3954,,
14623652029,98.28668,16028262254,110047327,16028258299,-3955,,
14623703048,98.33770,16028313276,110098340,16028309311,-3965,,
14623753934,98.38858,16028364164,110149224,16028360195,-3969,,
14623804123,98.43877,16028414357,110199410,16028410382,-3975,,
14623855132,98.48978,16028465368,110250416,16028461387,-3981,,
14623906235,98.54088,16028516472,110301517,16028512489,-3983,,
14623957165,98.59181,16028567406,110352444,16028563416,-3990,,
14624007761,98.64241,16028618004,110403037,16028614009,-3995,,
14624058664,98.69331,16028668910,110453938,16028664910,-4000,,
14624109731,98.74438,16028719980,110505004,16028715975,-4005,,
14624160680,98.79533,16028770930,110555949,16028766920,-4010,,
14624211238,98.84589,16028821490,110606503,16028817475,-4015,,
14624262091,98.89674,16028872346,110657355,16028868337,-4009,,
14624313181,98.94783,16028923437,110708441,16028919412,-4025,,
14624363781,98.99843,16028974041,110759038,16028970010,-4031,,
14624414379,99.04903,16029024641,110809633,16029020605,-4036,,
14624464740,99.09939,16029075003,110859992,16029070973,-4030,,
14624515349,99.15000,16029125615,110910598,16029121569,-4046,,
14624566013,99.20066,16029176281,110961259,16029172230,-4051,,
14624617059,99.25171,16029227329,111012303,16029223274,-4055,,
14624667810,99.30246,16029278084,111063061,16029274033,-4051,,
14624718703,99.35335,16029328979,111113941,16029324913,-4066,,
14624769776,99.40442,16029380054,111165021,16029375993,-4061,,
14624820411,99.45506,16029430691,111215644,16029426615,-4076,,
14624871319,99.50597,16029481602,111266549,16029477520,-4082,,
14624921868,99.55652,16029532154,111317095,16029528067,-4087,,
14624972033,99.60668,16029582321,111367258,16029578229,-4092,,
14625022769,99.65742,16029633059,111417992,16029628963,-4096,,
14625073784,99.70843,16029684077,111469003,16029679975,-4102,,
14625124300,99.75895,16029734594,111519516,16029730487,-4107,,
14625175362,99.81001,16029785658,111570576,16029781547,-4111,,
14625226441,99.86109,16029836740,111621652,16029832623,-4117,,
14625276989,99.91164,16029887291,111672197,16029883169,-4122,,
14625328038,99.96269,16029938341,111723243,16029934214,-4127,,
14625379042,100.01369,16029989349,111774246,16029985217,-4132,,
14625429138,100.06379,16030039447,111824338,16030035310,-4137,,
14625479730,100.11438,16030090041,111874927,16030085899,-4142,,
14625530780,100.16543,16030141093,111925975,16030136946,-4147,,
14625581323,100.21597,16030191638,111976515,16030187486,-4152,,
14625632401,100.26705,16030242720,112027591,16030238562,-4158,,
14625682933,100.31758,16030293253,112078119,16030289090,-4163,,
14625733085,100.36773,16030343407,112128269,16030339241,-4166,,
14625783724,100.41837,16030394050,112178906,16030389877,-4173,,
14625834272,100.46892,16030444600,112229450,16030440422,-4178,,
14625885285,100.51993,16030495615,112280461,16030491433,-4182,,
14625935839,100.57049,16030546172,112331012,16030541984,-4188,,
14625985965,100.62061,16030596300,112381136,16030592107,-4193,,
14626037016,100.67166,16030647353,112432185,16030643156,-4197,,
14626087640,100.72229,16030697979,112482805,16030693776,-4203,,
14626138686,100.77333,16030749028,112533848,16030744820,-4208,,
14626189222,100.82387,16030799565,112584381,16030795352,-4213,,
14626239785,100.87443,16030850132,112634942,16030845914,-4218,,
14626290328,100.92498,16030900676,112685481,16030896453,-4223,,
14626340890,100.97554,16030951241,112736041,16030947013,-4228,,
14626391556,101.02620,16031001910,112786705,16030997677,-4233,,
14626442175,101.07682,16031052530,112837321,16031048297,-4233,,
14626492738,101.12739,16031103096,112887881,16031098852,-4244,,
14626543267,101.17791,16031153628,112938407,16031149378,-4250,,
14626593801,101.22845,16031204164,112988940,16031199911,-4253,,
14626644863,101.27951,16031255229,113039998,16031250970,-4259,,
14626695886,101.33053,16031306254,113091018,16031301990,-4264,,
14626746683,101.38133,16031357063,113141824,16031352796,-4267,,
14626797206,101.43185,16031407579,113192333,16031403304,-4275,,
14626847743,101.48239,16031458118,113242868,16031453839,-4279,,
14626898304,101.53295,16031508680,113293425,16031504396,-4284,,
14626948428,101.58308,16031558808,113343547,16031554519,-4289,,
14626999005,101.63365,16031609387,113394121,16031605093,-4294,,
14627049607,101.68425,16031659991,113444721,16031655692,-4299,,
14627099724,101.73437,16031710110,113494835,16031705806,-4304,,
14627150668,101.78532,16031761057,113545776,16031756748,-4309,,
14627201677,101.83633,16031812069,113596783,16031807754,-4315,,
14627252250,101.88690,16031862644,113647354,16031858325,-4319,,
14627302825,101.93747,16031913221,113697926,16031908898,-4323,,
14627353895,101.98854,16031964293,113748992,16031959963,-4330,,
14627404423,102.03907,16032014824,113799517,16032010489,-4335,,
14627454972,102.08962,16032065375,113850065,16032061036,-4339,,
14627505540,102.14019,16032115946,113900629,16032111601,-4345,,
14627556132,102.19078,16032166540,113951218,16032162190,-4350,,
14627607202,102.24185,16032217612,114002287,16032213258,-4354,,
14627658251,102.29290,16032268664,114053332,16032264304,-4360,,
14627709293,102.34394,16032319708,114104371,16032315343,-4365,,
14627760348,102.39500,16032370766,114155423,16032366395,-4371,,
14627811390,102.44604,16032421810,114206463,16032417435,-4375,,
14627862432,102.49708,16032472854,114257503,16032468474,-4380,,
14627912987,102.54763,16032523411,114308054,16032519026,-4385,,
14627964036,102.59868,16032574463,114359101,16032570072,-4391,,
14628015116,102.64976,16032625545,114410178,16032621150,-4395,,
14628066165,102.70081,16032676596,114461224,16032672195,-4401,,
14628116701,102.75135,16032727146,114511769,16032722740,-4406,,
14628167716,102.80236,16032778151,114562770,16032773741,-4410,,
14628218287,102.85294,16032828726,114613339,16032824311,-4415,,
14628268847,102.90350,16032879288,114663895,16032874867,-4421,,
14628319858,102.95451,16032930301,114714903,16032925875,-4426,,
14628370420,103.00507,16032980865,114765463,16032976434,-4431,,
14628421487,103.05613,16033031935,114816527,16033027499,-4436,,
14628472056,103.10670,16033082507,114867093,16033078065,-4442,,
14628523085,103.15773,16033133538,114918120,16033129092,-4446,,
14628573628,103.20828,16033184082,114968660,16033179631,-4451,,
14628624186,103.25883,16033234655,115019226,16033230198,-4457,,
14628675210,103.30986,16033285670,115070237,16033281208,-4462,,
14628726272,103.36092,16033336734,115121296,16033332268,-4466,,
14628777321,103.41197,16033387785,115172342,16033383314,-4471,,
14628828370,103.46302,16033438837,115223388,16033434360,-4477,,
14628878998,103.51365,16033489467,115274014,16033484986,-4481,,
14628929531,103.56418,16033540002,115324544,16033535516,-4486,,
14628979623,103.61427,16033590097,115374633,16033585605,-4492,,
14629030171,103.66482,16033640648,115425179,16033636150,-4498,,
14629080719,103.71537,16033691198,115475725,16033686696,-4502,,
14629131775,103.76642,16033742256,115526778,16033737749,-4507,,
14629182340,103.81699,16033792823,115577339,16033788311,-4512,,
14629233395,103.86804,16033843880,115628392,16033839364,-4516,,
14629283934,103.91858,16033894422,115678929,16033889900,-4522,,
14629334483,103.96913,16033944973,115729474,16033940445,-4528,,
14629385539,104.02019,16033996031,115780527,16033991498,-4533,,
14629436584,104.07123,16034047079,115831570,16034042542,-4537,,
14629486915,104.12156,16034097412,115881898,16034092869,-4543,,
14629537485,104.17213,16034147984,115932465,16034143436,-4548,,
14629588033,104.22268,16034198535,115983011,16034193983,-4552,,
14629639081,104.27373,16034249586,116034057,16034245028,-4558,,
14629690136,104.32478,16034300643,116085109,16034296080,-4563,,
14629741051,104.37570,16034351561,116136020,16034346992,-4569,,
14629791659,104.42631,16034402171,116186627,16034397598,-4573,,
14629841774,104.47642,16034452288,116236739,16034447710,-4578,,
14629892832,104.52748,16034503349,116287793,16034498765,-4584,,
14629943382,104.57803,16034553900,116338341,16034549312,-4588,,
14629994451,104.62910,16034604971,116389407,16034600378,-4593,,
14630045108,104.67976,16034655631,116440061,16034651032,-4599,,
14630095574,104.73022,16034706100,116490524,16034701496,-4604,,
14630146638,104.78129,16034757165,116541586,16034752558,-4607,,
14630197251,104.83190,16034807793,116592208,16034803179,-4614,,
14630248241,104.88289,16034858774,116643183,16034854155,-4619,,
14630299778,104.93443,16034910314,116694717,16034905689,-4625,,
14630350838,104.98549,16034961376,116745775,16034956747,-4629,,
14630401382,105.03603,16035011922,116796317,16035007288,-4634,,
14630451967,105.08661,16035062510,116846899,16035057870,-4640,,
14630503016,105.13766,16035113560,116897945,16035108916,-4644,,
14630553535,105.18818,16035164082,116948461,16035159433,-4649,,
14630604570,105.23922,16035215119,116999493,16035210464,-4655,,
14630655172,105.28982,16035265724,117050093,16035261064,-4660,,
14630706179,105.34083,16035316732,117101097,16035312068,-4664,,
14630756772,105.39142,16035367329,117151688,16035362659,-4670,,
14630807286,105.44193,16035417844,117202198,16035413169,-4675,,
14630857823,105.49247,16035468385,117252733,16035463705,-4680,,
14630908399,105.54305,16035518963,117303307,16035514278,-4685,,
14630958948,105.59360,16035569513,117353852,16035564823,-4690,,
14631009469,105.64412,16035620038,117404371,16035615343,-4695,,
14631060004,105.69465,16035670575,117454903,16035665875,-4700,,
14631110577,105.74523,16035721149,117505472,16035716444,-4705,,
14631160717,105.79537,16035771292,117555610,16035766581,-4711,,
14631211225,105.84587,16035821803,117606116,16035817087,-4716,,
14631262269,105.89692,16035872848,117657157,16035868129,-4719,,
14631312497,105.94715,16035923080,117707383,16035918354,-4726,,
14631362572,105.99722,16035973156,117757455,16035968426,-4730,,
14631412646,106.04729,16036023232,117807526,16036018498,-4734,,
14631463678,106.09833,16036074268,117858555,16036069527,-4741,,
14631513867,106.14852,16036124458,117908742,16036119713,-4745,,
14631564816,106.19946,16036175409,117959688,16036170659,-4750,,
14631616348,106.25100,16036226945,118011217,16036222189,-4756,,
14631674932,106.30958,16036285531,118069798,16036280770,-4761,,
14631732905,106.36755,16036343506,118127768,16036338739,-4767,,
14631783976,106.41862,16036394580,118178836,16036389807,-4773,,
14631834544,106.46919,16036445150,118229401,16036440372,-4778,,
14631885093,106.51974,16036495702,118279948,16036490920,-4782,,
14631935633,106.57028,16036546244,118330485,16036541457,-4787,,
14631985677,106.62032,16036596291,118380527,16036591498,-4793,,
14632035722,106.67037,16036646338,118430569,16036641541,-4797,,
14632085935,106.72058,16036696554,118480779,16036691750,-4804,,
14632136359,106.77101,16036746980,118531200,16036742171,-4809,,
14632186876,106.82152,16036797500,118581716,16036792688,-4812,,
14632237924,106.87257,16036848550,118632761,16036843733,-4817,,
14632288474,106.92312,16036899102,118683308,16036894279,-4823,,
14632339426,106.97407,16036950056,118734256,16036945228,-4828,,
14632390009,107.02466,16037000642,118784838,16036995809,-4833,,
14632440201,107.07485,16037050836,118835026,16037045998,-4838,,
14632491286,107.12593,16037101923,118886108,16037097080,-4843,,
14632542334,107.17698,16037152973,118937154,16037148125,-4848,,
14632592998,107.22765,16037203639,118987815,16037198786,-4853,,
14632643537,107.27818,16037254194,119038363,16037249335,-4859,,
14632694624,107.32927,16037305270,119089435,16037300406,-4864,,
14632745669,107.38032,16037356318,119140479,16037351450,-4868,,
14632796221,107.43087,16037406872,119191027,16037401998,-4874,,
14632846742,107.48139,16037457396,119241546,16037452517,-4879,,
14632897276,107.53192,16037507932,119292078,16037503049,-4883,,
14632948328,107.58298,16037558987,119343127,16037554098,-4889,,
14632999376,107.63402,16037610036,119394171,16037605143,-4893,,
14633049583,107.68423,16037660246,119444376,16037655347,-4899,,
14633100430,107.73508,16037711096,119495220,16037706192,-4904,,
14633150511,107.78516,16037761179,119545299,16037756270,-4909,,
14633201126,107.83577,16037811796,119595910,16037806881,-4915,,
14633252175,107.88682,16037862847,119646957,16037857928,-4919,,
14633303211,107.93786,16037913886,119697990,16037908962,-4924,,
14633353804,107.98845,16037964482,119748580,16037959551,-4931,,
14633404364,108.03901,16038015044,119799137,16038010109,-4935,,
14633455403,108.09005,16038066085,119850174,16038061146,-4939,,
14633506005,108.14065,16038116689,119900773,16038111744,-4945,,
14633556589,108.19124,16038167276,119951355,16038162326,-4950,,
14633606681,108.24133,16038217370,120001445,16038212416,-4954,,
14633657732,108.29238,16038268424,120052493,16038263464,-4960,,
14633708759,108.34341,16038319463,120103527,16038314499,-4964,,
14633759832,108.39448,16038370528,120154586,16038365558,-4970,,
14633810486,108.44513,16038421185,120205238,16038416209,-4976,,
14633860671,108.49532,16038471371,120255419,16038466391,-4980,,
14633911701,108.54635,16038522404,120306447,16038517418,-4986,,
14633962278,108.59693,16038572984,120357022,16038567994,-4990,,
14634013339,108.64799,16038624046,120408080,16038619051,-4995,,
14634064375,108.69902,16038675086,120459113,16038670085,-5001,,
14634115454,108.75010,16038726167,120510189,16038721161,-5006,,
14634166497,108.80115,16038777213,120561231,16038772203,-5010,,
14634217097,108.85174,16038827815,120611827,16038822799,-5016,,
14634267639,108.90229,16038878371,120662378,16038873350,-5021,,
14634318546,108.95319,16038929267,120713270,16038924241,-5026,,
14634368671,109.00332,16038979395,120763393,16038974364,-5031,,
14634419302,109.05395,16039030029,120814021,16039024993,-5036,,
14634469841,109.10449,16039080571,120864567,16039075539,-5032,,
14634520401,109.15505,16039131133,120915116,16039126087,-5046,,
14634570996,109.20564,16039181730,120965707,16039176679,-5051,,
14634621623,109.25627,16039232360,121016331,16039227303,-5057,,
14634672542,109.30719,16039283281,121067248,16039278220,-5061,,
14634723131,109.35778,16039333872,121117835,16039328806,-5066,,
14634773275,109.40792,16039384030,121167987,16039378958,-5072,,
14634824328,109.45898,16039435084,121219035,16039430007,-5077,,
14634875293,109.50994,16039486041,121269988,16039480960,-5081,,
14634926064,109.56071,16039536815,121320756,16039531727,-5088,,
14634976911,109.61156,16039587664,121371601,16039582573,-5091,,
14635027456,109.66210,16039638211,121422143,16039633114,-5097,,
14635077566,109.71221,16039688324,121472250,16039683222,-5102,,
14635128154,109.76280,16039738914,121522835,16039733807,-5107,,
14635179245,109.81389,16039790006,121573923,16039784894,-5112,,
14635229854,109.86450,16039840618,121624530,16039835502,-5116,,
14635279990,109.91464,16039890757,121674663,16039885645,-5112,,
14635330916,109.96556,16039941685,121725586,16039936557,-5128,,
14635381214,110.01586,16039991985,121775882,16039986863,-5122,,
14635431843,110.06649,16040042617,121826508,16040037479,-5138,,
14635482849,110.11750,16040093626,121877511,16040088482,-5144,,
14635532991,110.16764,16040143770,121927651,16040138623,-5147,,
14635583581,110.21823,16040194361,121978238,16040189209,-5152,,
14635634590,110.26924,16040245374,122029244,16040240216,-5158,,
14635685641,110.32029,16040296426,122080292,16040291263,-5163,,
14635736665,110.37131,16040347453,122131314,16040342286,-5167,,
14635786827,110.42148,16040397617,122181473,16040392444,-5173,,
14635837875,110.47252,16040448667,122232518,16040443489,-5178,,
14635888003,110.52265,16040498807,122282654,16040493626,-5181,,
14635940772,110.57542,16040551570,122335410,16040546382,-5188,,
14635991315,110.62596,16040602114,122385949,16040596921,-5193,,
14636041811,110.67646,16040652614,122436444,16040647415,-5199,,
14636092818,110.72747,16040703623,122487449,16040698420,-5203,,
14636143887,110.77854,16040754694,122538525,16040749496,-5198,,
14636194954,110.82960,16040805764,122589578,16040800550,-5214,,
14636245089,110.87974,16040855910,122639720,16040850691,-5219,,
14636296038,110.93069,16040906851,122690667,16040901638,-5213,,
14636346747,110.98140,16040957564,122741364,16040952335,-5229,,
14636396858,111.03151,16041007688,122791482,16041002454,-5234,,
14636447781,111.08243,16041058602,122842392,16041053363,-5239,,
14636498156,111.13280,16041108980,122892764,16041103735,-5245,,
14636549188,111.18384,16041160014,122943793,16041154764,-5250,,
14636599305,111.23395,16041210134,122993908,16041204879,-5255,,
14636649494,111.28414,16041260324,123044094,16041255065,-5259,,
14636700512,111.33516,16041311344,123095109,16041306080,-5264,,
14636751518,111.38617,16041362354,123146113,16041357085,-5269,,
14636802069,111.43672,16041412908,123196662,16041407634,-5274,,
14636853121,111.48777,16041463961,123247710,16041458681,-5280,,
14636903238,111.53789,16041514080,123297824,16041508795,-5285,,
14636953328,111.58798,16041564177,123347922,16041558895,-5282,,
14637004396,111.63904,16041615242,123398977,16041609949,-5293,,
14637055344,111.68999,16041666193,123449922,16041660893,-5300,,
14637105695,111.74034,16041716547,123500270,16041711242,-5305,,
14637156511,111.79116,16041767365,123551084,16041762056,-5309,,
14637207031,111.84168,16041817888,123601601,16041812573,-5315,,
14637257654,111.89230,16041868513,123652222,16041863193,-5320,,
14637308291,111.94294,16041919152,123702856,16041913828,-5324,,
14637359279,111.99393,16041970143,123753841,16041964813,-5330,,
14637409902,112.04455,16042020767,123804461,16042015433,-5334,,
14637461355,112.09600,16042072223,123855911,16042066882,-5341,,
14637511999,112.14665,16042122869,123906553,16042117525,-5344,,
14637562514,112.19716,16042173386,123957065,16042168036,-5350,,
14637612588,112.24724,16042223464,124007136,16042218108,-5356,,
14637663658,112.29831,16042274535,124058204,16042269175,-5360,,
14637714387,112.34904,16042325267,124108930,16042319902,-5365,,
14637764468,112.39912,16042375350,124159008,16042369980,-5370,,
14637815494,112.45014,16042426379,124210031,16042421003,-5376,,
14637865593,112.50024,16042476480,124260128,16042471100,-5380,,
14637916618,112.55127,16042527508,124311151,16042522123,-5385,,
14637966698,112.60135,16042577590,124361227,16042572199,-5391,,
14638017655,112.65230,16042628548,124412182,16042623153,-5395,,
14638068566,112.70321,16042679464,124463092,16042674063,-5401,,
14638119134,112.75378,16042730033,124513656,16042724628,-5405,,
14638169677,112.80433,16042780579,124564195,16042775167,-5412,,
14638220250,112.85490,16042831154,124614766,16042825738,-5416,,
14638270539,112.90519,16042881445,124665052,16042876024,-5421,,
14638320594,112.95524,16042931502,124715104,16042926076,-5426,,
14638370651,113.00530,16042981561,124765159,16042976130,-5431,,
14638421195,113.05584,16043032108,124815701,16043026672,-5436,,
14638471792,113.10644,16043082708,124866311,16043077282,-5426,,
14638522292,113.15694,16043133210,124916793,16043127764,-5446,,
14638572382,113.20703,16043183301,124966879,16043177851,-5450,,
14638622941,113.25759,16043233864,125017436,16043228407,-5457,,
14638673347,113.30800,16043284271,125067839,16043278810,-5461,,
14638724379,113.35903,16043335306,125118869,16043329840,-5466,,
14638775425,113.41007,16043386355,125169912,16043380883,-5472,,
14638825759,113.46041,16043436691,125220242,16043431214,-5477,,
14638881885,113.51653,16043492820,125276365,16043487337,-5483,,
14638932900,113.56755,16043543837,125327379,16043538350,-5487,,
14638983965,113.61861,16043594904,125378440,16043589411,-5493,,
14639035006,113.66965,16043645947,125429478,16043640450,-5497,,
14639086083,113.72073,16043697026,125480552,16043691523,-5503,,
14639136715,113.77136,16043747661,125531182,16043742153,-5508,,
14639187306,113.82195,16043798255,125581771,16043792742,-5513,,
14639237499,113.87215,16043848450,125631961,16043842932,-5518,,
14639288082,113.92273,16043899035,125682541,16043893512,-5523,,
14639338969,113.97362,16043949924,125733425,16043944396,-5528,,
14639389637,114.02429,16044000594,125784090,16043995061,-5533,,
14639442555,114.07720,16044053516,125837005,16044047977,-5539,,
14639493290,114.12794,16044104252,125887738,16044098709,-5543,,
14639543846,114.17849,16044154811,125938292,16044149263,-5548,,
14639594417,114.22907,16044205394,125988869,16044199841,-5553,,
14639645043,114.27969,16044256012,126039483,16044250454,-5558,,
14639695557,114.33021,16044306528,126089993,16044300965,-5563,,
14639745665,114.38031,16044356640,126140109,16044351081,-5559,,
14639796225,114.43087,16044407202,126190656,16044401628,-5574,,
14639847236,114.48188,16044458216,126241666,16044452637,-5579,,
14639897830,114.53248,16044508812,126292256,16044503238,-5574,,
14639948901,114.58355,16044559884,126343324,16044554295,-5589,,
14639999607,114.63425,16044610593,126394028,16044605000,-5593,,
14640050622,114.68527,16044661611,126445040,16044656012,-5599,,
14640101200,114.73585,16044712191,126495616,16044706587,-5604,,
14640151380,114.78603,16044762373,126545792,16044756763,-5610,,
14640201734,114.83638,16044812730,126596144,16044807116,-5614,,
14640252483,114.88713,16044863480,126646890,16044857861,-5619,,
14640303534,114.93818,16044914535,126697939,16044908910,-5625,,
14640354586,114.98923,16044965589,126748988,16044959960,-5629,,
14640405634,115.04028,16045016639,126800033,16045011005,-5634,,
14640456158,115.09081,16045067166,126850555,16045061526,-5640,,
14640507191,115.14184,16045118200,126901584,16045112555,-5645,,
14640557734,115.19238,16045168746,126952125,16045163096,-5650,,
14640608315,115.24296,16045219330,127002704,16045213676,-5654,,
14640658840,115.29349,16045269857,127053226,16045264197,-5660,,
14640709910,115.34456,16045320930,127104294,16045315265,-5665,,
14640760435,115.39508,16045371457,127154815,16045365787,-5670,,
14640811468,115.44612,16045422493,127205846,16045416817,-5676,,
14640861567,115.49622,16045472593,127255941,16045466912,-5681,,
14640912083,115.54673,16045523111,127306455,16045517426,-5685,,
14640962640,115.59729,16045573670,127357009,16045567980,-5690,,
14641013238,115.64789,16045624272,127407604,16045618576,-5696,,
14641063799,115.69845,16045674845,127458174,16045669146,-5699,,
14641114367,115.74901,16045725404,127508728,16045719699,-5705,,
14641164948,115.79960,16045775988,127559306,16045770277,-5711,,
14641215577,115.85022,16045826620,127609933,16045820915,-5705,,
14641266143,115.90079,16045877188,127660496,16045871467,-5721,,
14641316299,115.95095,16045927347,127710650,16045921621,-5726,,
14641367369,116.00202,16045978418,127761715,16045972687,-5731,,
14641418395,116.05304,16046029447,127812740,16046023711,-5736,,
14641468997,116.10365,16046080052,127863339,16046074310,-5742,,
14641519515,116.15416,16046130572,127913854,16046124826,-5746,,
14641570088,116.20474,16046181148,127964425,16046175397,-5751,,
14641621124,116.25577,16046232185,128015458,16046226429,-5756,,
14641671683,116.30633,16046282747,128066015,16046276986,-5761,,
14641722297,116.35694,16046333363,128116625,16046327596,-5767,,
14641772432,116.40708,16046383511,128166769,16046377740,-5771,,
14641823052,116.45770,16046434123,128217375,16046428347,-5776,,
14641873587,116.50823,16046484661,128267908,16046478879,-5782,,
14641924647,116.55930,16046535723,128318965,16046529936,-5787,,
14641975696,116.61034,16046586775,128370011,16046580983,-5792,,
14642026762,116.66141,16046637843,128421075,16046632046,-5797,,
14642077776,116.71242,16046688858,128472085,16046683056,-5802,,
14642127812,116.76246,16046738897,128522119,16046733090,-5807,,
14642178407,116.81306,16046789495,128572711,16046783683,-5812,,
14642228920,116.86357,16046840010,128623222,16046834193,-5817,,
14642278967,116.91361,16046890060,128673267,16046884238,-5822,,
14642330052,116.96470,16046941147,128724348,16046935319,-5828,,
14642380582,117.01523,16046991679,128774875,16046985847,-5832,,
14642431631,117.06628,16047042730,128825921,16047036892,-5838,,
14642482704,117.11735,16047093806,128876992,16047087964,-5842,,
14642533253,117.16790,16047144356,128927538,16047138510,-5846,,
14642584281,117.21893,16047195388,128978563,16047189545,-5843,,
14642635362,117.27001,16047246471,129029642,16047240613,-5858,,
14642686439,117.32109,16047297551,129080716,16047291687,-5864,,
14642736901,117.37155,16047348015,129131175,16047342146,-5869,,
14642787490,117.42214,16047398606,129181761,16047392733,-5873,,
14642838543,117.47319,16047449661,129232812,16047443784,-5877,,
14642889153,117.52380,16047500273,129283419,16047494390,-5883,,
14642940190,117.57484,16047551312,129334453,16047545424,-5888,,
14642991225,117.62587,16047602351,129385486,16047596458,-5893,,
14643041791,117.67644,16047652919,129436050,16047647021,-5898,,
14643092322,117.72697,16047703452,129486577,16047697549,-5903,,
14643142926,117.77757,16047754059,129537179,16047748150,-5909,,
14643193429,117.82808,16047804563,129587679,16047798651,-5912,,
14643243903,117.87855,16047855049,129638160,16047849132,-5917,,
14643294468,117.92912,16047905617,129688722,16047899694,-5923,,
14643345031,117.97968,16047956173,129739273,16047950245,-5928,,
14643396082,118.03073,16048007227,129790321,16048001293,-5934,,
14643447085,118.08173,16048058232,129841321,16048052293,-5939,,
14643497620,118.13227,16048108769,129891853,16048102825,-5944,,
14643548665,118.18331,16048159816,129942896,16048153867,-5949,,
14643598799,118.23345,16048209953,129993027,16048203999,-5954,,
14643649770,118.28442,16048260925,130043995,16048254966,-5959,,
14643700293,118.33494,16048311452,130094517,16048305488,-5964,,
14643750425,118.38507,16048361597,130144656,16048355628,-5969,,
14643801224,118.43587,16048412387,130195441,16048406412,-5975,,
14643851778,118.48643,16048462943,130245992,16048456964,-5979,,
14643902826,118.53747,16048513994,130297039,16048508011,-5983,,
14643953360,118.58801,16048564530,130347570,16048558542,-5988,,
14644003891,118.63854,16048615063,130398097,16048609068,-5995,,
14644054002,118.68865,16048665177,130448207,16048659178,-5999,,
14644104573,118.73922,16048715751,130498774,16048709746,-6005,,
14644154695,118.78934,16048765875,130548893,16048759865,-6010,,
14644205681,118.84033,16048816863,130599878,16048810849,-6014,,
14644255805,118.89045,16048866990,130649998,16048860970,-6020,,
14644306356,118.94100,16048917543,130700547,16048911518,-6025,,
14644356966,118.99161,16048968155,130751154,16048962125,-6030,,
14644408013,119.04266,16049019205,130802198,16049013170,-6035,,
14644459035,119.09368,16049070229,130853218,16049064189,-6040,,
14644509559,119.14421,16049120755,130903738,16049114710,-6045,,
14644560097,119.19474,16049171296,130954274,16049165246,-6050,,
14644610227,119.24487,16049221428,131004401,16049215373,-6055,,
14644660721,119.29537,16049271924,131054893,16049265865,-6059,,
14644711246,119.34589,16049322451,131105414,16049316386,-6065,,
14644762148,119.39680,16049373355,131156313,16049367285,-6070,,
14644812706,119.44735,16049423917,131206871,16049417842,-6075,,
14644863159,119.49781,16049474372,131257320,16049468291,-6081,,
14644913809,119.54846,16049525024,131307968,16049518940,-6084,,
14644964855,119.59950,16049576073,131359010,16049569982,-6091,,
14645015417,119.65006,16049626637,131409570,16049620541,-6096,,
14645066458,119.70111,16049677679,131460607,16049671578,-6101,,
14645116860,119.75151,16049728085,131511007,16049721979,-6106,,
14645167443,119.80209,16049778670,131561588,16049772559,-6111,,
14645218485,119.85313,16049829714,131612627,16049823598,-6116,,
14645269505,119.90415,16049880737,131663644,16049874616,-6121,,
14645319876,119.95452,16049931109,131714012,16049924983,-6126,,
14645369971,120.00462,16049981207,131764104,16049975076,-6131,,
14645421062,120.05571,16050032301,131815193,16050026165,-6136,,
14645472058,120.10671,16050083298,131866186,16050077157,-6141,,
14645522130,120.15678,16050133373,131916255,16050127227,-6146,,
14645573176,120.20782,16050184421,131967298,16050178269,-6152,,
14645623801,120.25845,16050235049,132017922,16050228893,-6156,,
14645674331,120.30898,16050285582,132068460,16050279431,-6151,,
14645724414,120.35906,16050335667,132118529,16050329500,-6167,,
14645774975,120.40962,16050386230,132169087,16050380059,-6171,,
14645825567,120.46022,16050436836,132219688,16050430659,-6177,,
14646085452,120.72010,16050696721,132479547,16050690518,-6203,16050696652,
14646110857,120.74550,16050722128,132504951,16050715952,-6176,,
14646161904,120.79655,16050773177,132555995,16050767060,-6117,,
14646212380,120.84703,16050823655,132606468,16050817594,-6061,,
14646263426,120.89807,16050874703,132657511,16050868699,-6004,,
14646314461,120.94911,16050925741,132708544,16050919795,-5946,,
14646365005,120.99965,16050976288,132759085,16050970399,-5889,,
14646415598,121.05025,16051026883,132809675,16051021051,-5832,,
14646466642,121.10129,16051077929,132860718,16051072156,-5773,,
14646517149,121.15180,16051128439,132911221,16051122722,-5717,,
14646567765,121.20241,16051179056,132961834,16051173396,-5660,,
14646618837,121.25348,16051230130,133012903,16051224527,-5603,,
14646669508,121.30416,16051280804,133063572,16051275259,-5545,,
14646720547,121.35519,16051331846,133114609,16051326358,-5488,,
14646770787,121.40543,16051382088,133164846,16051376657,-5431,,
14646821007,121.45565,16051432311,133215063,16051426937,-5374,,
14646871957,121.50660,16051483262,133266010,16051477945,-5317,,
14646922719,121.55737,16051534028,133316769,16051528767,-5261,,
14646973752,121.60840,16051585063,133367800,16051579860,-5203,,
14647023924,121.65857,16051635236,133417969,16051630091,-5145,,
14647074954,121.70960,16051686270,133468997,16051681181,-5089,,
14647125519,121.76017,16051736837,133519559,16051731805,-5032,,
14647176589,121.81124,16051787909,133570627,16051782936,-4973,,
14647227206,121.86185,16051838538,133621250,16051833621,-4917,,
14647278190,121.91284,16051889514,133672221,16051884655,-4859,,
14647328462,121.96311,16051939788,133722490,16051934985,-4803,,
14647378797,122.01345,16051990126,133772823,16051985380,-4746,,
14647429345,122.06399,16052040677,133823369,16052035988,-4689,,
14647479384,122.11403,16052090718,133873404,16052086084,-4634,,
14647529956,122.16460,16052141292,133923974,16052136717,-4575,,
14647580056,122.21470,16052191394,133974071,16052186875,-4519,,
14647630361,122.26501,16052241702,134024373,16052237240,-4462,,
14647680901,122.31555,16052292245,134074911,16052287840,-4405,,
14647731950,122.36660,16052343295,134125957,16052338948,-4347,,
14647782536,122.41718,16052393884,134176540,16052389592,-4292,,
14647833086,122.46773,16052444437,134227088,16052440203,-4234,,
14647883629,122.51828,16052494981,134277628,16052490806,-4175,,
14647934260,122.56891,16052545615,134328256,16052541495,-4120,,
14647985168,122.61982,16052596526,134379162,16052592463,-4063,,
14648035329,122.66998,16052646699,134429331,16052642695,-4004,,
14648086378,122.72103,16052697750,134480376,16052693802,-3948,,
14648137414,122.77206,16052748778,134531399,16052744887,-3891,,
14648187921,122.82257,16052799288,134581903,16052795454,-3834,,
14648238135,122.87278,16052849504,134632115,16052845727,-3777,,
14648288723,122.92337,16052900095,134682700,16052896375,-3720,,
14648339295,122.97394,16052950669,134733269,16052947006,-3663,,
14648389887,123.02454,16053001264,134783859,16052997658,-3606,,
14648440455,123.07510,16053051833,134834423,16053048284,-3549,,
14648491123,123.12577,16053102504,134885089,16053099012,-3492,,
14648542126,123.17677,16053153510,134936090,16053150076,-3434,,
14648593206,123.22785,16053204591,134987167,16053201214,-3377,,
14648644253,123.27890,16053255642,135038211,16053252321,-3321,,
14648694794,123.32944,16053306185,135088749,16053302922,-3263,,
14648745377,123.38003,16053356769,135139330,16053353564,-3205,,
14648796338,123.43099,16053407734,135190288,16053404585,-3149,,
14648846916,123.48156,16053458314,135240864,16053455223,-3091,,
14648897815,123.53246,16053509214,135291760,16053506182,-3032,,
14648948498,123.58315,16053559901,135342440,16053556924,-2977,,
14648999043,123.63369,16053610448,135392982,16053607528,-2920,,
14649049690,123.68434,16053661097,135443626,16053658234,-2863,,
14649099943,123.73459,16053711353,135493877,16053708547,-2806,,
14649150529,123.78518,16053761941,135544460,16053759192,-2749,,
14649201548,123.83620,16053812963,135595477,16053810272,-2691,,
14649252119,123.88677,16053863536,135646045,16053860902,-2634,,
14649302334,123.93698,16053913753,135696257,16053911175,-2578,,
14649353383,123.98803,16053964805,135747304,16053962284,-2521,,
14649404432,124.03908,16054015856,135798350,16054013393,-2463,,
14649455481,124.09013,16054066907,135849396,16054064501,-2406,,
14649506533,124.14118,16054117961,135900445,16054115613,-2348,,
14649557360,124.19201,16054168790,135951269,16054166499,-2291,,
14649607868,124.24252,16054219301,136001776,16054217068,-2233,,
14649658455,124.29310,16054269891,136052359,16054267714,-2177,,
14649709495,124.34414,16054320933,136103396,16054318814,-2119,,
14649760087,124.39473,16054371526,136153985,16054369464,-2062,,
14649811158,124.44581,16054422613,136205066,16054420608,-2005,,
14649861731,124.49638,16054473176,136255625,16054471229,-1947,,
14649912814,124.54746,16054524262,136306704,16054522372,-1890,,
14649962956,124.59760,16054574405,136356844,16054572572,-1833,,
14650013611,124.64826,16054625063,136407496,16054623287,-1776,,
14650064216,124.69886,16054675670,136458098,16054673950,-1720,,
14650114786,124.74943,16054726243,136508665,16054724580,-1663,,
14650165834,124.80048,16054777293,136559712,16054775689,-1604,,
14650216375,124.85102,16054827837,136610249,16054826289,-1548,,
14650266937,124.90158,16054878401,136660809,16054876921,-1480,,
14650318010,124.95266,16054929476,136711879,16054928044,-1432,,
14650369014,125.00366,16054980482,136762879,16054979106,-1376,,
14650419607,125.05425,16055031078,136813470,16055029759,-1319,,
14650470656,125.10530,16055082129,136864516,16055080867,-1262,,
14650521640,125.15629,16055133116,136915499,16055131913,-1203,,
14650572157,125.20681,16055183634,136966012,16055182488,-1146,,
14650623212,125.25786,16055234693,137017065,16055233603,-1090,,
14650673785,125.30843,16055285268,137067634,16055284235,-1033,,
14650724787,125.35944,16055336272,137118634,16055335297,-975,,
14650775001,125.40965,16055386489,137168845,16055385571,-918,,
14650825579,125.46023,16055437069,137219421,16055436208,-861,,
14650876128,125.51078,16055487619,137269967,16055486817,-802,,
14650926764,125.56141,16055538258,137320600,16055537511,-747,,
14650977217,125.61186,16055588713,137371050,16055588034,-679,,
14651028267,125.66291,16055639766,137422098,16055639134,-632,,
14651078636,125.71328,16055690137,137472464,16055689561,-576,,
14651129205,125.76385,16055740709,137523030,16055740137,-572,,
14651180263,125.81491,16055791770,137574085,16055791203,-567,,
14651231315,125.86596,16055842824,137625136,16055842242,-582,,
14651281910,125.91656,16055893421,137675727,16055892833,-588,,
14651332538,125.96719,16055944052,137726353,16055943459,-593,,
14651383220,126.01787,16055994735,137777032,16055994138,-597,,
14651434018,126.06867,16056045536,137827828,16056044934,-602,,
14651484219,126.11887,16056095739,137878025,16056095131,-608,,
14651534436,126.16908,16056145959,137928239,16056145346,-613,,
14651584966,126.21961,16056196490,137978767,16056195874,-616,,
14651635937,126.27058,16056247465,138029735,16056246842,-623,,
14651686911,126.32156,16056298441,138080707,16056297813,-628,,
14651737541,126.37219,16056349073,138131334,16056348441,-632,,
14651788440,126.42309,16056399974,138182230,16056399336,-638,,
14651839024,126.47367,16056450561,138232812,16056449918,-643,,
14651889589,126.52424,16056501140,138283384,16056500491,-649,,
14651940237,126.57488,16056551778,138334019,16056551125,-653,,
14651990849,126.62550,16056602392,138384638,16056601744,-648,,
14652041456,126.67610,16056653003,138435232,16056652339,-664,,
14652092074,126.72672,16056703634,138485859,16056702966,-668,,
14652142647,126.77729,16056754198,138536418,16056753525,-673,,
14652193698,126.82835,16056805252,138587466,16056804573,-679,,
14652244756,126.87940,16056856311,138638521,16056855628,-683,,
14652295828,126.93048,16056907385,138689591,16056906698,-687,,
14652346380,126.98103,16056957941,138740140,16056957247,-694,,
14652396905,127.03155,16057008467,138790674,16057007780,-687,,
14652447977,127.08262,16057059542,138841732,16057058839,-703,,
14652498978,127.13363,16057110545,138892730,16057109836,-709,,
14652549549,127.18420,16057161119,138943299,16057160405,-714,,
14652600140,127.23479,16057211713,138993886,16057210993,-720,,
14652651115,127.28576,16057262689,139044859,16057261965,-724,,
14652702187,127.33683,16057313764,139095928,16057313035,-729,,
14652752735,127.38738,16057364315,139146473,16057363579,-736,,
14652802864,127.43751,16057414445,139196600,16057413706,-739,,
14652853867,127.48852,16057465450,139247600,16057464706,-744,,
14652904452,127.53910,16057516038,139298182,16057515288,-750,,
14652955018,127.58967,16057566617,139348756,16057565862,-755,,
14653005746,127.64039,16057617336,139399471,16057616577,-759,,
14653055919,127.69057,16057667512,139449641,16057666747,-765,,
14653107992,127.74264,16057719588,139501711,16057718818,-770,,
14653158569,127.79322,16057770169,139552287,16057769394,-775,,
14653209107,127.84376,16057820708,139602821,16057819928,-780,,
14653260127,127.89477,16057871730,139653839,16057870945,-785,,
14653310179,127.94483,16057921785,139703887,16057920993,-792,,
14653360773,127.99542,16057972381,139754480,16057971587,-794,,
14653411865,128.04651,16058023475,139805569,16058022676,-799,,
14653462437,128.09708,16058074050,139856137,16058073244,-806,,
14653513444,128.14809,16058125058,139907142,16058124248,-810,,
14653564027,128.19868,16058175644,139957722,16058174829,-815,,
14653615070,128.24972,16058226690,140008762,16058225868,-822,,
14653665601,128.30025,16058277223,140059291,16058276397,-826,,
14653715707,128.35036,16058327330,140109394,16058326500,-830,,
14653766278,128.40093,16058377904,140159962,16058377068,-836,,
14653816886,128.45153,16058428526,140210578,16058427685,-841,,
14653867407,128.50206,16058479038,140261087,16058478193,-845,,
14653918448,128.55310,16058530082,140312124,16058529231,-851,,
14653968529,128.60318,16058580165,140362202,16058579309,-856,,
14654019168,128.65382,16058630807,140412839,16058629946,-861,,
14654069996,128.70464,16058681637,140463665,16058680771,-866,,
14654120560,128.75521,16058732203,140514225,16058731332,-871,,
14654171200,128.80585,16058782846,140564863,16058781969,-877,,
14654222091,128.85674,16058833739,140615752,16058832858,-881,,
14654273141,128.90779,16058884791,140666798,16058883904,-887,,
14654323768,128.95842,16058935421,140717422,16058934529,-892,,
14654374379,129.00903,16058986033,140768031,16058985138,-895,,
14654424979,129.05963,16059036636,140818628,16059035734,-902,,
14654475635,129.11028,16059087294,140869281,16059086387,-907,,
14654526233,129.16088,16059137895,140919876,16059136983,-912,,
14654577234,129.21188,16059188898,140970876,16059187982,-916,,
14654627815,129.26246,16059239482,141021453,16059238560,-922,,
14654678332,129.31298,16059290001,141071967,16059289074,-927,,
14654728894,129.36354,16059340565,141122527,16059339633,-932,,
14654779633,129.41428,16059391306,141173263,16059390369,-937,,
14654830181,129.46483,16059441856,141223808,16059440915,-941,,
14654880313,129.51496,16059491992,141273937,16059491044,-948,,
14654930902,129.56555,16059542583,141324525,16059541631,-952,,
14654981464,129.61611,16059593146,141375083,16059592190,-956,,
14655031643,129.66629,16059643328,141425259,16059642365,-963,,
14655082197,129.71685,16059693885,141475811,16059692918,-967,,
14655133221,129.76787,16059744911,141526832,16059743939,-972,,
14655184268,129.81892,16059795960,141577876,16059794982,-978,,
14655234796,129.86944,16059846491,141628411,16059845518,-973,,
14655284961,129.91961,16059896657,141678564,16059895670,-987,,
14655335425,129.97007,16059947125,141729025,16059946132,-993,,
14655386056,130.02070,16059997757,141779653,16059996759,-998,,
14655436653,130.07130,16060048357,141830260,16060047366,-991,,
14655487679,130.12233,16060099386,141881271,16060098378,-1008,,
14655538253,130.17290,16060149962,141931843,16060148949,-1013,,
14655588452,130.22310,16060200164,141982049,16060199156,-1008,,
14655639574,130.27422,16060251287,142033158,16060250265,-1022,,
14655690333,130.32498,16060302049,142083914,16060301021,-1028,,
14655741357,130.37600,16060353086,142134946,16060352052,-1034,,
14655791479,130.42613,16060403200,142185065,16060402172,-1028,,
14655842041,130.47669,16060453763,142235614,16060452721,-1042,,
14655892538,130.52719,16060504264,142286108,16060503215,-1049,,
14655943577,130.57823,16060555304,142337145,16060554251,-1053,,
14655994624,130.62927,16060606353,142388189,16060605295,-1058,,
14656045162,130.67981,16060656895,142438724,16060655831,-1064,,
14656095716,130.73036,16060707450,142489275,16060706381,-1069,,
14656145771,130.78042,16060757507,142539328,16060756434,-1073,,
14656195975,130.83062,16060807714,142589529,16060806635,-1079,,
14656246099,130.88075,16060857841,142639650,16060856757,-1084,,
14656296867,130.93151,16060908610,142690416,16060907522,-1088,,
14656347447,130.98209,16060959194,142740993,16060958100,-1094,,
14656397591,131.03224,16061009340,142791134,16061008241,-1099,,
14656448194,131.08284,16061059945,142841736,16061058842,-1103,,
14656499268,131.13392,16061111022,142892807,16061109913,-1109,,
14656549848,131.18450,16061161604,142943383,16061160490,-1114,,
14656600959,131.23561,16061212717,142994491,16061211597,-1120,,
14656651512,131.28616,16061263273,143045043,16061262150,-1123,,
14656702087,131.33674,16061313850,143095615,16061312721,-1129,,
14656752725,131.38737,16061364491,143146249,16061363355,-1136,,
14656803276,131.43792,16061415043,143196798,16061413904,-1139,,
14656853842,131.48849,16061465612,143247361,16061464468,-1144,,
14656904321,131.53897,16061516093,143297837,16061514943,-1150,,
14656955366,131.59001,16061567141,143348879,16061565986,-1155,,
14657006415,131.64106,16061618192,143399926,16061617033,-1159,,
14657057438,131.69209,16061669217,143450946,16061668052,-1165,,
14657108013,131.74266,16061719795,143501519,16061718625,-1170,,
14657158607,131.79325,16061770392,143552111,16061769217,-1175,,
14657209622,131.84427,16061821409,143603122,16061820229,-1180,,
14657260692,131.89534,16061872482,143654191,16061871297,-1185,,
14657311091,131.94574,16061922882,143704585,16061921691,-1191,,
14657362151,131.99680,16061973945,143755643,16061972749,-1196,,
14657412522,132.04717,16062024318,143806011,16062023118,-1200,,
14657462966,132.09761,16062074764,143856463,16062073570,-1194,,
14657513541,132.14819,16062125341,143907025,16062124132,-1209,,
14657564198,132.19885,16062176001,143957680,16062174786,-1215,,
14657615040,132.24969,16062226846,144008518,16062225625,-1221,,
14657666060,132.30071,16062277868,144059535,16062276642,-1226,,
14657716634,132.35128,16062328444,144110107,16062327214,-1230,,
14657767203,132.40185,16062379016,144160674,16062377780,-1236,,
14657817942,132.45259,16062429756,144211409,16062428516,-1240,,
14657868491,132.50314,16062480309,144261957,16062479063,-1246,,
14657919259,132.55391,16062531079,144312722,16062529828,-1251,,
14657969892,132.60454,16062581714,144363351,16062580458,-1256,,
14658020944,132.65559,16062632769,144414401,16062631507,-1262,,
14658071611,132.70626,16062683438,144465065,16062682172,-1266,,
14658122643,132.75729,16062734472,144516095,16062733201,-1271,,
14658172716,132.80736,16062784548,144566164,16062783271,-1277,,
14658223313,132.85796,16062835147,144616759,16062833865,-1282,,
14658274353,132.90900,16062886189,144667797,16062884903,-1286,,
14658324934,132.95958,16062936772,144718373,16062935480,-1292,,
14658375476,133.01012,16062987316,144768913,16062986019,-1297,,
14658426525,133.06117,16063038368,144819961,16063037067,-1301,,
14658476894,133.11154,16063088740,144870327,16063087433,-1307,,
14658527923,133.16257,16063139771,144921352,16063138459,-1312,,
14658578476,133.21312,16063190326,144971903,16063189009,-1317,,
14658629026,133.26367,16063240879,145022451,16063239557,-1322,,
14658679695,133.31434,16063291550,145073116,16063290222,-1328,,
14658733500,133.36815,16063345358,145126919,16063344025,-1333,,
14658787178,133.42183,16063399038,145180593,16063397699,-1339,,
14658838819,133.47347,16063450681,145232232,16063449339,-1342,,
14658904532,133.53918,16063516397,145297941,16063515047,-1350,,
14658959257,133.59391,16063571149,145352687,16063569793,-1356,,
14659010030,133.64468,16063621901,145403434,16063620540,-1361,,
14659061096,133.69574,16063672969,145454497,16063671604,-1365,,
14659112104,133.74675,16063723979,145505502,16063722609,-1370,,
14659164486,133.79913,16063776363,145557881,16063774988,-1375,,
14659214533,133.84918,16063826412,145607926,16063825032,-1380,,
14659264838,133.89949,16063876720,145658229,16063875335,-1385,,
14659315023,133.94967,16063926908,145708411,16063925517,-1391,,
14659365294,133.99994,16063977180,145758678,16063975784,-1396,,
14659415875,134.05052,16064027764,145809258,16064026364,-1400,,
14659466353,134.10100,16064078255,145859742,16064076848,-1407,,
14659517192,134.15184,16064129086,145910568,16064127675,-1411,,
14659567620,134.20227,16064179517,145960994,16064178101,-1416,,
14659618731,134.25338,16064230629,146012102,16064229208,-1421,,
14659676751,134.31140,16064288652,146070119,16064287225,-1427,,
14659727154,134.36180,16064339058,146120519,16064337625,-1433,,
14659777771,134.41242,16064389676,146171133,16064388239,-1437,,
14659828052,134.46270,16064439960,146221412,16064438518,-1442,,
14659879483,134.51413,16064491393,146272840,16064489946,-1447,,
14659930089,134.56474,16064542001,146323442,16064540549,-1452,,
14659980947,134.61560,16064592862,146374299,16064591405,-1457,,
14660031219,134.66587,16064643136,146424568,16064641675,-1461,,
14660081577,134.71623,16064693497,146474923,16064692030,-1467,,
14660132011,134.76666,16064743933,146525354,16064742460,-1473,,
14660182334,134.81698,16064794258,146575675,16064792781,-1477,,
14660232764,134.86741,16064844690,146626102,16064843208,-1482,,
14660283460,134.91811,16064895389,146676795,16064893901,-1488,,
14660333851,134.96850,16064945782,146727184,16064944290,-1492,,
14660384503,135.01915,16064996438,146777834,16064994940,-1498,,
14660434979,135.06963,16065046916,146828306,16065045413,-1503,,
14660485499,135.12015,16065097437,146878824,16065095930,-1507,,
14660535792,135.17044,16065147733,146929114,16065146221,-1512,,
14660586068,135.22072,16065198012,146979387,16065196494,-1518,,
14660636193,135.27084,16065248138,147029510,16065246617,-1521,,
14660686656,135.32130,16065298605,147079970,16065297077,-1528,,
14660737580,135.37223,16065349530,147130891,16065347997,-1533,,
14660787847,135.42249,16065399799,147181155,16065398261,-1538,,
14660838631,135.47328,16065450587,147231937,16065449044,-1543,,
14660889220,135.52387,16065501177,147282523,16065499629,-1548,,
14660939705,135.57435,16065551664,147333005,16065550112,-1552,,
14660990456,135.62510,16065602419,147383754,16065600861,-1558,,
14661040771,135.67542,16065652736,147434066,16065651173,-1563,,
14661091539,135.72619,16065703506,147484831,16065701937,-1569,,
14661142323,135.77697,16065754292,147535612,16065752719,-1573,,
14661193100,135.82775,16065805071,147586387,16065803493,-1578,,
14661243618,135.87827,16065855592,147636902,16065854009,-1583,,
14661293845,135.92849,16065905821,147687126,16065904232,-1589,,
14661344333,135.97898,16065956311,147737612,16065954719,-1592,,
14661395031,136.02968,16066007013,147788307,16066005414,-1599,,
14661445719,136.08037,16066057702,147838991,16066056098,-1604,,
14661496414,136.13106,16066108399,147889684,16066106790,-1609,,
14661546620,136.18127,16066158609,147939888,16066156995,-1614,,
14661597335,136.23198,16066209325,147990600,16066207706,-1619,,
14661648259,136.28291,16066260251,148041521,16066258628,-1623,,
14661698950,136.33360,16066310945,148092210,16066309316,-1629,,
14661749264,136.38391,16066361262,148142521,16066359628,-1634,,
14661799423,136.43407,16066411422,148192677,16066409783,-1639,,
14661850149,136.48480,16066462151,148243401,16066460507,-1644,,
14661900930,136.53558,16066512935,148294180,16066511287,-1648,,
14661951619,136.58627,16066563639,148344878,16066561985,-1654,,
14662002357,136.63700,16066614367,148395600,16066612707,-1660,,
14662053174,136.68782,16066665186,148446415,16066663522,-1664,,
14662103905,136.73855,16066715918,148497143,16066714250,-1668,,
14662154087,136.78874,16066766104,148547322,16066764429,-1675,,
14662204516,136.83916,16066816535,148597749,16066814855,-1680,,
14662254615,136.88926,16066866636,148647845,16066864952,-1684,,
14662304893,136.93954,16066916917,148698120,16066915226,-1691,,
14662355100,136.98975,16066967126,148748326,16066965432,-1694,,
14662405499,137.04015,16067017527,148798721,16067015827,-1700,,
14662455971,137.09062,16067068002,148849191,16067066297,-1705,,
14662506275,137.14092,16067118307,148899491,16067116597,-1710,,
14662556572,137.19122,16067168607,148949786,16067166892,-1715,,
14662607020,137.24167,16067219057,149000231,16067217338,-1719,,
14662657485,137.29213,16067269524,149050693,16067267800,-1724,,
14662707839,137.34249,16067319881,149101045,16067318151,-1730,,
14662758363,137.39301,16067370407,149151566,16067368672,-1735,,
14662808861,137.44351,16067420908,149202062,16067419168,-1740,,
14662859196,137.49384,16067471245,149252394,16067469501,-1744,,
14662909672,137.54432,16067521724,149302868,16067519974,-1750,,
14662959833,137.59448,16067571887,149353025,16067570132,-1755,,
14663010328,137.64498,16067622385,149403517,16067620624,-1761,,
14663060561,137.69521,16067672619,149453748,16067670854,-1765,,
14663110858,137.74551,16067722918,149504042,16067721148,-1770,,
14663161637,137.79629,16067773701,149554818,16067771925,-1776,,
14663211929,137.84658,16067823995,149605108,16067822215,-1780,,
14663262204,137.89685,16067874272,149655381,16067872487,-1785,,
14663312317,137.94697,16067924388,149705491,16067922597,-1791,,
14663362607,137.99725,16067974679,149755778,16067972884,-1795,,
14663412775,138.04742,16068024850,149805943,16068023050,-1800,,
14663463232,138.09788,16068075310,149856398,16068073505,-1805,,
14663513382,138.14803,16068125461,149906545,16068123651,-1810,,
14663563460,138.19811,16068175541,149956620,16068173726,-1815,,
14663613616,138.24826,16068225701,150006773,16068223880,-1821,,
14663664073,138.29872,16068276160,150057228,16068274335,-1825,,
14663714384,138.34903,16068326473,150107537,16068324643,-1830,,
14663764877,138.39953,16068376969,150158026,16068375133,-1836,,
14663815310,138.44996,16068427403,150208455,16068425562,-1841,,
14663865615,138.50026,16068477711,150258759,16068475866,-1845,,
14663916043,138.55069,16068528141,150309184,16068526290,-1851,,
14663966339,138.60099,16068578440,150359477,16068576584,-1856,,
14664016762,138.65141,16068628864,150409898,16068627005,-1859,,
14664067392,138.70204,16068679497,150460525,16068677631,-1866,,
14664118109,138.75276,16068730217,150511239,16068728346,-1871,,
14664168580,138.80323,16068780690,150561709,16068778815,-1875,,
14664219599,138.85425,16068831712,150612724,16068829831,-1881,,
14664269879,138.90453,16068881994,150663001,16068880108,-1886,,
14664320151,138.95480,16068932274,150713291,16068930399,-1875,,
14664370815,139.00546,16068982934,150763932,16068981038,-1896,,
14664421650,139.05630,16069033772,150814765,16069031871,-1901,,
14664472064,139.10671,16069084189,150865175,16069082282,-1907,,
14664522864,139.15751,16069134991,150915974,16069133080,-1911,,
14664573171,139.20782,16069185299,150966277,16069183383,-1916,,
14664623324,139.25797,16069235455,151016427,16069233533,-1922,,
14664673576,139.30822,16069285710,151066677,16069283784,-1926,,
14664724183,139.35883,16069336329,151117291,16069334398,-1931,,
14664774751,139.40940,16069386889,151167846,16069384952,-1937,,
14664825745,139.46039,16069437885,151218837,16069435944,-1941,,
14664876135,139.51078,16069488278,151269226,16069486332,-1946,,
14664926660,139.56131,16069538806,151319747,16069536854,-1952,,
14664976986,139.61163,16069589145,151370082,16069587188,-1957,,
14665027562,139.66221,16069639712,151420644,16069637751,-1961,,
14665077943,139.71259,16069690096,151471022,16069688128,-1968,,
14665128492,139.76314,16069740646,151521568,16069738674,-1972,,
14665178833,139.81348,16069790989,151571906,16069789012,-1977,,
14665229760,139.86441,16069841920,151622832,16069839938,-1982,,
14665280216,139.91486,16069892377,151673284,16069890390,-1987,,
14665331262,139.96591,16069943426,151724327,16069941433,-1993,,
14665381823,140.01647,16069993990,151774886,16069991993,-1997,,
14665431925,140.06657,16070044094,151824985,16070042091,-2003,,
14665482231,140.11688,16070094414,151875300,16070092406,-2008,,
14665532506,140.16715,16070144680,151925561,16070142667,-2013,,
14665582803,140.21745,16070194978,151975854,16070192960,-2018,,
14665632916,140.26756,16070245094,152025965,16070243071,-2023,,
14665683697,140.31834,16070295878,152076744,16070293851,-2027,,
14665734334,140.36898,16070346517,152127378,16070344484,-2033,,
14665784623,140.41927,16070396808,152177664,16070394770,-2038,,
14665834932,140.46958,16070447119,152227970,16070445077,-2042,,
14665885265,140.51991,16070497455,152278301,16070495408,-2047,,
14665935621,140.57027,16070547814,152328654,16070545761,-2053,,
14665985914,140.62056,16070598108,152378944,16070596051,-2057,,
14666036481,140.67113,16070648683,152429514,16070646621,-2062,,
14666086982,140.72163,16070699181,152480007,16070697114,-2067,,
14666137764,140.77241,16070749966,152530786,16070747893,-2073,,
14666188333,140.82298,16070800537,152581353,16070798459,-2078,,
14666238738,140.87339,16070850945,152631755,16070848862,-2083,,
14666289498,140.92415,16070901707,152682512,16070899619,-2088,,
14666339913,140.97456,16070952124,152732925,16070950031,-2093,,
14666390171,141.02482,16071002384,152783180,16071000286,-2098,,
14666441235,141.07588,16071053451,152834241,16071051348,-2103,,
14666491509,141.12616,16071103727,152884512,16071101618,-2109,,
14666542108,141.17676,16071154329,152935109,16071152216,-2113,,
14666592233,141.22688,16071204456,152985231,16071202338,-2118,,
14666642963,141.27761,16071255188,153035958,16071253064,-2124,,
14666693392,141.32804,16071305619,153086384,16071303491,-2128,,
14666743779,141.37843,16071356008,153136770,16071353876,-2132,,
14666794072,141.42872,16071406304,153187059,16071404165,-2139,,
14666844253,141.47890,16071456488,153237237,16071454344,-2144,,
14666894392,141.52904,16071506628,153287374,16071504480,-2148,,
14666944909,141.57956,16071557149,153337888,16071554995,-2154,,
14666995156,141.62980,16071607398,153388133,16071605239,-2159,,
14667045722,141.68037,16071657965,153438696,16071655802,-2163,,
14667095841,141.73049,16071708088,153488812,16071705919,-2169,,
14667146619,141.78127,16071758868,153539588,16071756694,-2174,,
14667197167,141.83182,16071809417,153590132,16071807238,-2179,,
14667248214,141.88286,16071860467,153641177,16071858283,-2184,,
14667298287,141.93293,16071910543,153691247,16071908354,-2189,,
14667348838,141.98349,16071961096,153741796,16071958902,-2194,,
14667399415,142.03406,16072011676,153792371,16072009477,-2199,,
14667449965,142.08461,16072062227,153842917,16072060023,-2204,,
14667500526,142.13517,16072112791,153893476,16072110582,-2209,,
14667551576,142.18622,16072163844,153944523,16072161630,-2214,,
14667602375,142.23702,16072214645,153995320,16072212426,-2219,,
14667652917,142.28757,16072265189,154045858,16072262964,-2225,,
14667703482,142.33813,16072315756,154096420,16072313526,-2230,,
14667754341,142.38899,16072366617,154147277,16072364383,-2234,,
14667805401,142.44005,16072417680,154198334,16072415440,-2240,,
14667856435,142.49108,16072468716,154249364,16072466471,-2245,,
14667907011,142.54166,16072519295,154299939,16072517046,-2249,,
14667958030,142.59268,16072570317,154350955,16072568062,-2255,,
14668009072,142.64372,16072621360,154401994,16072619100,-2260,,
14668060175,142.69482,16072672466,154453095,16072670201,-2265,,
14668111161,142.74581,16072723455,154504079,16072721185,-2270,,
14668162200,142.79685,16072774496,154555115,16072772221,-2275,,
14668212749,142.84740,16072825048,154605661,16072822767,-2281,,
14668263309,142.89796,16072875610,154656217,16072873324,-2286,,
14668314341,142.94899,16072926643,154707247,16072924354,-2289,,
14668364909,142.99956,16072977214,154757812,16072974919,-2295,,
14668415944,143.05059,16073028252,154808844,16073025951,-2301,,
14668466504,143.10115,16073078813,154859402,16073076508,-2305,,
14668517569,143.15222,16073129882,154910465,16073127572,-2310,,
14668568594,143.20324,16073180909,154961486,16073178592,-2317,,
14668619160,143.25381,16073231476,155012049,16073229155,-2321,,
14668670191,143.30484,16073282511,155063078,16073280185,-2326,,
14668721218,143.35587,16073333540,155114103,16073331209,-2331,,
14668772072,143.40672,16073384397,155164953,16073382059,-2338,,
14668822652,143.45730,16073434978,155215531,16073432637,-2341,,
14668872830,143.50748,16073485159,155265707,16073482813,-2346,,
14668923426,143.55807,16073535758,155316299,16073533406,-2352,,
14668973970,143.60862,16073586304,155366841,16073583947,-2357,,
14669024569,143.65922,16073636905,155417437,16073634544,-2361,,
14669074825,143.70947,16073687164,155467691,16073684797,-2367,,
14669125820,143.76047,16073738160,155518682,16073735788,-2372,,
14669176758,143.81141,16073789101,155569619,16073786725,-2376,,
14669227744,143.86239,16073840089,155620601,16073837707,-2382,,
14669278296,143.91294,16073890643,155671150,16073888256,-2387,,
14669328870,143.96352,16073941220,155721721,16073938828,-2392,,
14669380137,144.01478,16073992490,155772986,16073990092,-2398,,
14669430449,144.06510,16074042804,155823295,16074040402,-2402,,
14669480989,144.11564,16074093347,155873833,16074090939,-2408,,
14669531036,144.16568,16074143395,155923877,16074140983,-2412,,
14669581087,144.21573,16074193450,155973926,16074191032,-2418,,
14669633277,144.26792,16074245642,156026113,16074243219,-2423,,
14669683684,144.31833,16074296051,156076516,16074293623,-2428,,
14669740490,144.37514,16074352860,156133319,16074350426,-2434,,
14669791355,144.42600,16074403726,156184182,16074401288,-2438,,
14669842393,144.47704,16074454766,156235217,16074452324,-2442,,
14669893153,144.52780,16074505530,156285974,16074503080,-2450,,
14669943957,144.57861,16074556335,156336776,16074553882,-2453,,
14669995236,144.62988,16074607616,156388052,16074605158,-2458,,
14670046062,144.68071,16074658445,156438875,16074655981,-2464,,
14670097156,144.73180,16074709541,156489965,16074707072,-2469,,
14670148149,144.78280,16074760537,156540957,16074758063,-2474,,
14670198210,144.83286,16074810600,156591015,16074808121,-2479,,
14670249351,144.88400,16074861744,156642153,16074859260,-2484,,
14670300317,144.93497,16074912712,156693116,16074910222,-2490,,
14670350388,144.98504,16074962785,156743185,16074960291,-2494,,
14670401497,145.03615,16075013897,156794292,16075011398,-2499,,
14670452479,145.08713,16075064881,156845270,16075062376,-2505,,
14670503505,145.13815,16075115909,156896294,16075113401,-2508,,
14670554077,145.18873,16075166484,156946863,16075163970,-2514,,
14670605127,145.23978,16075217536,156997909,16075215016,-2520,,
14670656173,145.29082,16075268585,157048953,16075266060,-2525,,
14670707211,145.34186,16075319626,157099990,16075317096,-2530,,
14670758302,145.39295,16075370718,157151077,16075368183,-2535,,
14670809323,145.44397,16075421741,157202095,16075419201,-2540,,
14670860298,145.49495,16075472720,157253069,16075470175,-2545,,
14670911318,145.54597,16075523742,157304086,16075521192,-2550,,
14670962330,145.59698,16075574756,157355095,16075572201,-2555,,
14671013371,145.64802,16075625799,157406132,16075623238,-2561,,
14671063911,145.69856,16075676341,157456670,16075673776,-2565,,
14671113973,145.74862,16075726405,157506729,16075723835,-2570,,
14671164525,145.79917,16075776960,157557278,16075774384,-2576,,
14671215108,145.84976,16075827546,157607859,16075824966,-2580,,
14671266105,145.90075,16075878546,157658854,16075875960,-2586,,
14671317164,145.95181,16075929607,157709909,16075927016,-2591,,
14671367723,146.00237,16075980168,157760465,16075977572,-2596,,
14671418328,146.05298,16076030776,157811069,16076028175,-2601,,
14671469211,146.10386,16076081661,157861949,16076079055,-2606,,
14671519748,146.15440,16076132200,157912482,16076129589,-2611,,
14671569887,146.20453,16076182341,157962619,16076179725,-2616,,
14671620935,146.25558,16076233392,158013665,16076230771,-2621,,
14671671516,146.30616,16076283975,158064243,16076281349,-2626,,
14671721643,146.35629,16076334105,158114366,16076331473,-2632,,
14671772278,146.40693,16076384742,158164999,16076382105,-2637,,
14671823291,146.45794,16076435757,158216010,16076433116,-2641,,
14671873817,146.50847,16076486285,158266532,16076483638,-2647,,
14671923888,146.55854,16076536358,158316601,16076533707,-2651,,
14671974456,146.60910,16076586928,158367166,16076584272,-2656,,
14672025044,146.65969,16076637519,158417751,16076634857,-2662,,
14672076057,146.71070,16076688535,158468761,16076685868,-2667,,
14672126199,146.76085,16076738679,158518901,16076736007,-2672,,
14672176808,146.81146,16076789291,158569507,16076786614,-2677,,
14672227885,146.86253,16076840370,158620582,16076837688,-2682,,
14672278399,146.91305,16076890886,158671093,16076888199,-2687,,
14672329023,146.96367,16076941513,158721714,16076938821,-2692,,
14672379541,147.01419,16076992033,158772230,16076989336,-2697,,
14672430141,147.06479,16077042636,158822828,16077039934,-2702,,
14672481085,147.11573,16077093582,158873768,16077090875,-2707,,
14672531681,147.16633,16077144190,158924371,16077141477,-2713,,
14672582307,147.21696,16077194809,158974984,16077192091,-2718,,
14672633357,147.26800,16077245860,159026032,16077243139,-2721,,
14672683981,147.31863,16077296487,159076653,16077293760,-2727,,
14672735028,147.36968,16077347537,159127698,16077344805,-2732,,
14672785594,147.42024,16077398105,159178271,16077395378,-2727,,
14672836667,147.47132,16077449181,159229332,16077446438,-2743,,
14672887689,147.52234,16077500205,159280351,16077497457,-2748,,
14672938286,147.57293,16077550803,159330944,16077548050,-2753,,
14672989352,147.62400,16077601873,159382008,16077599115,-2758,,
14673040402,147.67505,16077652925,159433055,16077650162,-2763,,
14673091402,147.72605,16077703926,159484052,16077701158,-2768,,
14673142453,147.77710,16077754981,159535100,16077752207,-2774,,
14673193002,147.82765,16077805532,159585647,16077802753,-2779,,
14673244049,147.87870,16077856581,159636691,16077853798,-2783,,
14673294597,147.92925,16077907131,159687236,16077904342,-2789,,
14673345131,147.97978,16077957668,159737786,16077954893,-2775,,
14673395202,148.02985,16078007741,159787836,16078004942,-2799,,
14673446255,148.08090,16078058797,159838886,16078055993,-2804,,
14673497290,148.13194,16078109835,159889919,16078107025,-2810,,
14673547874,148.18252,16078160421,159940501,16078157608,-2813,,
14673598630,148.23328,16078211179,159991253,16078208359,-2820,,
14673649678,148.28433,16078262229,160042299,16078259405,-2824,,
14673700736,148.33538,16078313290,160093355,16078310461,-2829,,
14673751323,148.38597,16078363879,160143938,16078361045,-2834,,
14673801871,148.43652,16078414428,160194483,16078411589,-2839,,
14673852420,148.48707,16078464981,160245029,16078462136,-2845,,
14673902968,148.53762,16078515531,160295575,16078512682,-2849,,
14673954024,148.58867,16078566590,160346628,16078563735,-2855,,
14674004586,148.63923,16078617154,160397188,16078614294,-2860,,
14674055631,148.69028,16078668200,160448230,16078665336,-2864,,
14674106679,148.74133,16078719252,160499276,16078716382,-2870,,
14674157734,148.79238,16078770309,160550327,16078767434,-2875,,
14674208776,148.84342,16078821352,160601366,16078818473,-2879,,
14674259309,148.89396,16078871889,160651897,16078869004,-2885,,
14674309371,148.94402,16078921952,160701956,16078919062,-2890,,
14674359931,148.99458,16078972514,160752513,16078969619,-2895,,
14674412232,149.04688,16079024818,160804811,16079021917,-2901,,
14674466997,149.10164,16079079586,160859574,16079076681,-2905,,
14674518488,149.15314,16079131079,160911062,16079128168,-2911,,
14674569055,149.20370,16079181649,160961627,16079178733,-2916,,
14674619903,149.25455,16079232499,161012471,16079229578,-2921,,
14674670649,149.30530,16079283248,161063215,16079280322,-2926,,
14674722509,149.35716,16079335109,161115072,16079332178,-2931,,
14674773103,149.40775,16079385706,161165663,16079382769,-2937,,
14674824257,149.45890,16079436862,161216814,16079433920,-2942,,
14674874617,149.50926,16079487225,161267172,16079484279,-2946,,
14674925299,149.55995,16079537909,161317851,16079534957,-2952,,
14674975623,149.61027,16079588235,161368172,16079585278,-2957,,
14675025940,149.66059,16079638555,161418488,16079635594,-2961,,
14675077104,149.71175,16079689722,161469648,16079686755,-2967,,
14675127517,149.76217,16079740136,161520058,16079737164,-2972,,
14675178035,149.81268,16079790656,161570574,16079787680,-2976,,
14675228309,149.86296,16079840934,161620845,16079837952,-2982,,
14675280172,149.91482,16079892798,161672705,16079889811,-2987,,
14675330647,149.96529,16079943277,161723178,16079940285,-2992,,
14675380936,150.01558,16079993568,161773464,16079990571,-2997,,
14675431268,150.06592,16080043902,161823794,16080040900,-3002,,
14675481598,150.11625,16080094235,161874120,16080091227,-3008,,
14675531795,150.16644,16080144433,161924315,16080141421,-3012,,
14675582257,150.21690,16080194897,161974773,16080191880,-3017,,
14675632614,150.26726,16080245258,162025129,16080242235,-3023,,
14675683171,150.31782,16080295816,162075682,16080292788,-3028,,
14675733391,150.36804,16080346039,162125900,16080343007,-3032,,
14675784026,150.41867,16080396676,162176531,16080393638,-3038,,
14675834518,150.46917,16080447171,162227021,16080444127,-3044,,
14675884730,150.51938,16080497385,162277231,16080494338,-3047,,
14675935032,150.56968,16080547690,162327531,16080544637,-3053,,
14675985461,150.62011,16080598121,162377957,16080595063,-3058,,
14676035711,150.67036,16080648373,162428204,16080645311,-3062,,
14676086173,150.72082,16080698837,162478663,16080695769,-3068,,
14676136892,150.77154,16080749558,162529379,16080746485,-3073,,
14676187579,150.82223,16080800248,162580065,16080797171,-3077,,
14676238662,150.87331,16080851334,162631145,16080848251,-3083,,
14676289725,150.92437,16080902399,162682205,16080899311,-3088,,
14676339790,150.97444,16080952475,162732276,16080949383,-3092,,
14676390804,151.02545,16081003482,162783278,16081000384,-3098,,
14676441312,151.07596,16081053992,162833783,16081050889,-3103,,
14676491859,151.12651,16081104543,162884327,16081101434,-3109,,
14676542467,151.17711,16081155153,162934933,16081152040,-3113,,
14676593454,151.22810,16081206142,162985917,16081203024,-3118,,
14676643984,151.27863,16081256675,163036444,16081253551,-3124,,
14676695066,151.32971,16081307759,163087523,16081304630,-3129,,
14676745519,151.38017,16081358214,163137975,16081355081,-3133,,
14676795771,151.43042,16081408468,163188223,16081405329,-3139,,
14676846797,151.48145,16081459497,163239246,16081456352,-3145,,
14676897841,151.53249,16081510543,163290288,16081507395,-3148,,
14676947934,151.58258,16081560639,163340378,16081557485,-3154,,
14676998458,151.63311,16081611165,163390899,16081608006,-3159,,
14677049040,151.68369,16081661749,163441478,16081658585,-3164,,
14677099380,151.73403,16081712092,163491817,16081708923,-3169,,
14677149934,151.78458,16081762647,163542367,16081759474,-3173,,
14677200528,151.83518,16081813244,163592959,16081810065,-3179,,
14677251496,151.88614,16081864215,163643925,16081861031,-3184,,
14677302078,151.93673,16081914798,163694502,16081911609,-3189,,
14677352696,151.98734,16081965420,163745119,16081962225,-3195,,
14677403721,152.03837,16082016447,163796140,16082013247,-3200,,
14677454797,152.08945,16082067525,163847215,16082064321,-3204,,
14677505900,152.14055,16082118642,163898326,16082115433,-3209,,
14677556517,152.19117,16082169250,163948929,16082166035,-3215,,
14677607069,152.24172,16082219804,163999479,16082216586,-3218,,
14677657632,152.29228,16082270370,164050038,16082267145,-3225,,
14677708227,152.34287,16082320967,164100631,16082317737,-3230,,
14677758832,152.39348,16082371574,164151232,16082368339,-3235,,
14677809352,152.44400,16082422097,164201750,16082418857,-3240,,
14677859409,152.49406,16082472156,164251804,16082468911,-3245,,
14677910468,152.54512,16082523217,164302861,16082519967,-3250,,
14677961566,152.59621,16082574318,164353956,16082571062,-3256,,
14678012131,152.64678,16082624884,164404518,16082621624,-3260,,
14678062258,152.69691,16082675015,164454642,16082671749,-3266,,
14678112881,152.74753,16082725640,164505262,16082722369,-3271,,
14678163485,152.79813,16082776246,164555864,16082772971,-3275,,
14678214088,152.84874,16082826851,164606464,16082823570,-3281,,
14678264701,152.89935,16082877467,164657075,16082874181,-3286,,
14678315486,152.95013,16082928254,164707857,16082924963,-3291,,
14678365637,153.00028,16082978418,164758016,16082975123,-3295,,
14678416186,153.05083,16083028958,164808551,16083025657,-3301,,
14678466730,153.10138,16083079505,164859094,16083076200,-3305,,
14678516935,153.15158,16083129713,164909295,16083126402,-3311,,
14678567526,153.20217,16083180306,164959884,16083176990,-3316,,
14678618117,153.25277,16083230898,165010471,16083227577,-3321,,
14678668546,153.30319,16083281331,165060899,16083278005,-3326,,
14678719095,153.35374,16083331881,165111443,16083328550,-3331,,
14678769643,153.40429,16083382431,165161989,16083379095,-3336,,
14678820022,153.45467,16083432814,165212367,16083429473,-3341,,
14678870441,153.50509,16083483235,165262782,16083479889,-3346,,
14678921482,153.55613,16083534279,165313820,16083530938,-3341,,
14678972578,153.60723,16083585376,165364914,16083582020,-3356,,
14679022780,153.65743,16083635581,165415113,16083632220,-3361,,
14679073331,153.70798,16083686135,165465662,16083682768,-3367,,
14679124399,153.75905,16083737205,165516738,16083733845,-3360,,
14679175030,153.80968,16083787838,165567355,16083784472,-3366,,
14679225614,153.86026,16083838425,165617936,16083835043,-3382,,
14679276262,153.91091,16083889075,165668582,16083885688,-3387,,
14679326607,153.96125,16083939422,165718925,16083936031,-3391,,
14679377304,154.01195,16083990122,165769619,16083986725,-3397,,
14679428352,154.06300,16084041172,165820664,16084037770,-3402,,
14679479400,154.11405,16084092222,165871708,16084088815,-3407,,
14679530499,154.16515,16084143323,165922805,16084139912,-3411,,
14679581086,154.21573,16084193912,165973389,16084190495,-3417,,
14679631472,154.26612,16084244313,166023784,16084240891,-3422,,
14679682097,154.31674,16084294929,166074396,16084291502,-3427,,
14679732640,154.36729,16084345474,166124935,16084342053,-3421,,
14679783712,154.41836,16084396549,166176004,16084393110,-3439,,
14679834745,154.46939,16084447584,166227035,16084444141,-3443,,
14679885298,154.51995,16084498138,166277585,16084494691,-3447,,
14679935846,154.57049,16084548690,166328130,16084545237,-3453,,
14679986470,154.62112,16084599315,166378751,16084595857,-3458,,
14680037547,154.67219,16084650395,166429826,16084646933,-3462,,
14680088576,154.72322,16084701427,166480852,16084697959,-3468,,
14680139185,154.77383,16084752038,166531458,16084748565,-3473,,
14680189298,154.82395,16084802152,166581568,16084798675,-3477,,
14680239859,154.87451,16084852727,166632137,16084849244,-3483,,
14680290311,154.92496,16084903171,166682576,16084899683,-3488,,
14680340896,154.97554,16084953759,166733159,16084950266,-3493,,
14680391964,155.02661,16085004829,166784224,16085001331,-3498,,
14680443035,155.07768,16085055901,166835292,16085052398,-3503,,
14680493465,155.12811,16085106335,166885720,16085102826,-3509,,
14680544086,155.17873,16085156958,166936337,16085153444,-3514,,
14680595188,155.22984,16085208062,166987437,16085204544,-3518,,
14680645723,155.28037,16085258600,167037969,16085255076,-3524,,
14680696776,155.33142,16085309654,167089018,16085306125,-3529,,
14680747842,155.38249,16085360723,167140084,16085357190,-3533,,
14680798387,155.43303,16085411271,167190625,16085407732,-3539,,
14680849407,155.48406,16085462292,167241642,16085458749,-3543,,
14680899967,155.53462,16085512856,167292200,16085509316,-3540,,
14680951041,155.58569,16085563932,167343272,16085560378,-3554,,
14681002079,155.63673,16085614972,167394307,16085611413,-3559,,
14681052666,155.68731,16085665561,167444890,16085661996,-3565,,
14681103237,155.73789,16085716134,167495470,16085712577,-3557,,
14681154346,155.78899,16085767246,167546566,16085763672,-3574,,
14681204511,155.83916,16085817413,167596727,16085813833,-3580,,
14681255559,155.89021,16085868463,167647771,16085864878,-3585,,
14681306154,155.94080,16085919061,167698365,16085915472,-3589,,
14681356760,155.99141,16085969670,167748968,16085966075,-3595,,
14681407757,156.04241,16086020669,167799962,16086017069,-3600,,
14681458381,156.09303,16086071295,167850584,16086067691,-3604,,
14681509445,156.14409,16086122362,167901645,16086118752,-3610,,
14681560459,156.19511,16086173378,167952656,16086169763,-3615,,
14681611019,156.24567,16086223941,168003214,16086220321,-3620,,
14681662090,156.29674,16086275014,168054283,16086271389,-3625,,
14681712614,156.34726,16086325540,168104803,16086321910,-3630,,
14681763624,156.39827,16086376553,168155810,16086372916,-3637,,
14681813745,156.44839,16086426676,168205929,16086423035,-3641,,
14681864255,156.49890,16086477188,168256436,16086473543,-3645,,
14681914784,156.54943,16086527720,168306963,16086524069,-3651,,
14681965321,156.59997,16086578258,168357496,16086574602,-3656,,
14682015865,156.65051,16086628805,168408038,16086625145,-3660,,
14682066496,156.70114,16086679439,168458667,16086675773,-3666,,
14682117331,156.75198,16086730275,168509498,16086726604,-3671,,
14682167678,156.80233,16086780624,168559843,16086776949,-3675,,
14682218034,156.85268,16086830984,168610196,16086827302,-3682,,
14682268740,156.90339,16086881692,168660900,16086878006,-3686,,
14682319790,156.95444,16086932745,168711946,16086929053,-3692,,
14682370840,157.00549,16086983797,168762994,16086980101,-3696,,
14682421889,157.05654,16087034847,168814040,16087031146,-3701,,
14682472445,157.10709,16087085407,168864593,16087081700,-3707,,
14682523513,157.15816,16087136477,168915660,16087132766,-3711,,
14682574546,157.20919,16087187511,168966689,16087183795,-3716,,
14682625075,157.25972,16087238044,169017215,16087234322,-3722,,
14682675621,157.31027,16087288592,169067758,16087284865,-3727,,
14682726671,157.36132,16087339644,169118807,16087335913,-3731,,
14682776858,157.41151,16087389834,169168990,16087386097,-3737,,
14682827887,157.46254,16087440865,169220016,16087437123,-3742,,
14682878475,157.51312,16087491455,169270602,16087487709,-3746,,
14682929553,157.56420,16087542536,169321678,16087538784,-3752,,
14682980602,157.61525,16087593587,169372724,16087589830,-3757,,
14683031129,157.66578,16087644117,169423247,16087640354,-3763,,
14683082210,157.71686,16087695200,169474326,16087691433,-3767,,
14683133258,157.76791,16087746250,169525372,16087742478,-3772,,
14683183367,157.81802,16087796361,169575477,16087792584,-3777,,
14683234153,157.86880,16087847150,169626262,16087843368,-3782,,
14683284744,157.91939,16087897743,169676849,16087893956,-3787,,
14683335345,157.96999,16087948346,169727447,16087944554,-3792,,
14683386360,158.02101,16087999364,169778459,16087995566,-3798,,
14683436909,158.07156,16088049915,169829007,16088046114,-3801,,
14683487460,158.12211,16088100468,169879554,16088096660,-3808,,
14683538003,158.17265,16088151013,169930094,16088147200,-3813,,
14683588551,158.22320,16088201565,169980640,16088197747,-3818,,
14683639085,158.27373,16088252100,170031171,16088248277,-3823,,
14683689683,158.32433,16088302701,170081767,16088298873,-3828,,
14683740732,158.37538,16088353753,170132813,16088349919,-3834,,
14683791753,158.42640,16088404775,170183831,16088400937,-3838,,
14683841892,158.47654,16088454917,170233967,16088451073,-3844,,
14683892404,158.52705,16088505431,170284476,16088501582,-3849,,
14683942458,158.57711,16088555487,170334528,16088551635,-3852,,
14683993536,158.62818,16088606568,170385604,16088602710,-3858,,
14684043723,158.67837,16088656758,170435788,16088652894,-3864,,
14684094766,158.72941,16088707803,170486828,16088703934,-3869,,
14684145246,158.77989,16088758284,170537305,16088754421,-3863,,
14684195509,158.83016,16088808551,170587565,16088804672,-3879,,
14684246575,158.88122,16088859619,170638628,16088855735,-3884,,
14684297183,158.93183,16088910229,170689235,16088906353,-3876,,
14684347325,158.98197,16088960374,170739374,16088956480,-3894,,
14684397936,159.03258,16089010986,170789981,16089007087,-3899,,
14684448547,159.08319,16089061600,170840590,16089057696,-3904,,
14684499570,159.13422,16089112626,170891610,16089108728,-3898,,
14684550644,159.18529,16089163702,170942681,16089159788,-3914,,
14684601692,159.23634,16089214753,170993726,16089210833,-3920,,
14684652741,159.28739,16089265804,171044773,16089261880,-3924,,
14684703790,159.33844,16089316855,171095819,16089312926,-3929,,
14684754785,159.38943,16089367853,171146811,16089363918,-3935,,
14684805339,159.43999,16089418408,171197362,16089414468,-3940,,
14684855840,159.49049,16089468912,171247862,16089464968,-3944,,
14684906895,159.54154,16089519970,171298914,16089516020,-3950,,
14684957463,159.59211,16089570540,171349479,16089566585,-3955,,
14685007752,159.64240,16089620832,171399765,16089616872,-3960,,
14685058309,159.69296,16089671391,171450331,16089667438,-3953,,
14685109367,159.74401,16089722450,171501374,16089718481,-3969,,
14685159526,159.79417,16089772613,171551531,16089768638,-3975,,
14685209954,159.84460,16089823043,171601956,16089819063,-3980,,
14685260056,159.89470,16089873146,171652055,16089869162,-3984,,
14685310670,159.94532,16089923763,171702666,16089919772,-3991,,
14685361167,159.99581,16089974263,171753162,16089970268,-3995,,
14685412219,160.04687,16090025317,171804211,16090021317,-4000,,
14685462736,160.09738,16090075836,171854724,16090071830,-4006,,
14685513294,160.14794,16090126396,171905280,16090122386,-4010,,
14685564328,160.19898,16090177432,171956311,16090173417,-4015,,
14685615400,160.25005,16090228508,172007381,16090224487,-4021,,
14685666017,160.30067,16090279127,172057994,16090275111,-4016,,
14685716284,160.35093,16090329396,172108259,16090325366,-4030,,
14685766854,160.40150,16090379969,172158827,16090375933,-4036,,
14685817926,160.45257,16090431043,172209895,16090427002,-4041,,
14685868362,160.50301,16090481482,172260329,16090477435,-4047,,
14685918890,160.55354,16090532011,172310854,16090527960,-4051,,
14685968938,160.60359,16090582061,172360899,16090578005,-4056,,
14686019500,160.65415,16090632626,172411458,16090628564,-4062,,
14686070535,160.70518,16090683664,172462491,16090679598,-4066,,
14686120730,160.75538,16090733861,172512683,16090729790,-4071,,
14686171144,160.80579,16090784278,172563094,16090780201,-4077,,
14686221244,160.85589,16090834379,172613192,16090830298,-4081,,
14686271820,160.90647,16090884957,172663765,16090880871,-4086,,
14686322892,160.95754,16090936044,172714846,16090931953,-4091,,
14686374011,161.00866,16090987153,172765951,16090983057,-4096,,
14686424406,161.05905,16091037551,172816344,16091033450,-4101,,
14686475456,161.11010,16091088604,172867390,16091084497,-4107,,
14686526505,161.16115,16091139655,172918436,16091135542,-4113,,
14686577553,161.21220,16091190706,172969482,16091186589,-4117,,
14686628560,161.26321,16091241714,173020485,16091237591,-4123,,
14686679146,161.31379,16091292303,173071069,16091288176,-4127,,
14686730196,161.36484,16091343356,173122116,16091339223,-4133,,
14686781213,161.41586,16091394387,173173143,16091390250,-4137,,
14686832269,161.46692,16091445432,173224184,16091441291,-4141,,
14686883304,161.51795,16091496471,173275216,16091492323,-4148,,
14686933856,161.56850,16091547025,173325766,16091542873,-4152,,
14686984916,161.61956,16091598087,173376824,16091593930,-4157,,
14687035493,161.67014,16091648666,173427397,16091644503,-4163,,
14687086051,161.72070,16091699227,173477953,16091695059,-4168,,
14687136169,161.77082,16091749346,173528068,16091745174,-4172,,
14687187233,161.82188,16091800414,173579130,16091796236,-4178,,
14687237484,161.87213,16091850667,173629377,16091846484,-4183,,
14687288043,161.92269,16091901229,173679934,16091897041,-4188,,
14687338705,161.97335,16091951893,173730605,16091947711,-4182,,
14687389305,162.02395,16092002495,173781190,16091998296,-4199,,
14687440330,162.07498,16092053523,173832213,16092049319,-4204,,
14687491378,162.12603,16092104573,173883258,16092100364,-4209,,
14687542406,162.17705,16092155603,173934283,16092151390,-4213,,
14687592954,162.22760,16092206154,173984828,16092201935,-4219,,
14687643539,162.27819,16092256740,174035411,16092252517,-4223,,
14687694131,162.32878,16092307335,174086000,16092303106,-4229,,
14687745183,162.37983,16092358389,174137049,16092354155,-4234,,
14687795777,162.43043,16092408986,174187641,16092404747,-4239,,
14687846308,162.48096,16092459519,174238169,16092455275,-4244,,
14687896881,162.53153,16092510094,174288739,16092505845,-4249,,
14687946931,162.58158,16092560146,174338786,16092555892,-4254,,
14687997480,162.63213,16092610699,174389333,16092606440,-4259,,
14688048036,162.68268,16092661257,174439886,16092656993,-4264,,
14688098623,162.73327,16092711845,174490470,16092707576,-4269,,
14688149204,162.78385,16092762430,174541050,16092758156,-4274,,
14688199818,162.83447,16092813045,174591660,16092808766,-4279,,
14688250871,162.88552,16092864101,174642710,16092859817,-4284,,
14688301918,162.93657,16092915151,174693755,16092910861,-4290,,
14688352934,162.98758,16092966169,174744768,16092961875,-4294,,
14688403961,163.03861,16093017198,174795792,16093012899,-4299,,
14688454508,163.08916,16093067748,174846336,16093063443,-4305,,
14688505480,163.14013,16093118722,174897316,16093114423,-4299,,
14688556560,163.19121,16093169805,174948383,16093165490,-4315,,
14688607196,163.24184,16093220442,174999016,16093216122,-4320,,
14688657672,163.29232,16093270921,175049489,16093266595,-4326,,
14688708720,163.34337,16093321972,175100535,16093317642,-4330,,
14688759731,163.39438,16093372985,175151543,16093368649,-4336,,
14688809850,163.44450,16093423106,175201659,16093418766,-4340,,
14688860470,163.49512,16093473729,175252277,16093469384,-4345,,
14688911499,163.54615,16093524760,175303314,16093520420,-4340,,
14688962567,163.59722,16093575830,175354368,16093571475,-4355,,
14689013616,163.64826,16093626882,175405415,16093622521,-4361,,
14689064183,163.69883,16093677451,175455979,16093673085,-4366,,
14689115251,163.74990,16093728521,175507044,16093724150,-4371,,
14689165780,163.80043,16093779053,175557582,16093774688,-4365,,
14689216848,163.85150,16093830123,175608635,16093825742,-4381,,
14689267350,163.90200,16093880628,175659135,16093876241,-4387,,
14689317415,163.95206,16093930695,175709197,16093926303,-4392,,
14689367958,164.00261,16093981240,175759737,16093976843,-4397,,
14689418544,164.05319,16094031829,175810321,16094027428,-4401,,
14689469547,164.10420,16094082834,175861321,16094078427,-4407,,
14689520108,164.15476,16094133397,175911880,16094128986,-4411,,
14689570886,164.20553,16094184178,175962654,16094179761,-4417,,
14689621879,164.25653,16094235172,176013645,16094230751,-4421,,
14689672076,164.30672,16094285372,176063839,16094280946,-4426,,
14689722749,164.35740,16094336048,176114509,16094331615,-4433,,
14689772838,164.40749,16094386138,176164596,16094381702,-4436,,
14689823364,164.45801,16094436666,176215119,16094432225,-4441,,
14689873516,164.50816,16094486821,176265268,16094482374,-4447,,
14689924524,164.55917,16094537831,176316274,16094533380,-4451,,
14689975063,164.60971,16094588373,176366810,16094583917,-4456,,
14690025611,164.66026,16094638923,176417355,16094634461,-4462,,
14690076210,164.71086,16094689536,176467962,16094685069,-4467,,
14690127248,164.76190,16094740576,176518998,16094736104,-4472,,
14690178326,164.81297,16094791646,176570062,16094787168,-4478,,
14690229361,164.86401,16094842683,176621095,16094838201,-4482,,
14690279925,164.91457,16094893250,176671666,16094888773,-4477,,
14690330028,164.96468,16094943355,176721756,16094938863,-4492,,
14690381058,165.01571,16094994386,176772783,16094989889,-4497,,
14690431233,165.06588,16095044565,176822955,16095040062,-4503,,
14690481693,165.11634,16095095027,176873413,16095090520,-4507,,
14690532215,165.16686,16095145551,176923932,16095141038,-4513,,
14690582780,165.21743,16095196118,176974494,16095191600,-4518,,
14690633837,165.26848,16095247178,177025549,16095242655,-4523,,
14690684868,165.31952,16095298212,177076577,16095293683,-4529,,
14690735516,165.37016,16095348862,177127222,16095344329,-4533,,
14690786072,165.42072,16095399420,177177775,16095394882,-4538,,
14690837130,165.47178,16095450481,177228832,16095445938,-4543,,
14690888207,165.52285,16095501560,177279906,16095497012,-4548,,
14690939304,165.57395,16095552658,177330999,16095548105,-4553,,
14690989871,165.62452,16095603228,177381564,16095598670,-4558,,
14691040482,165.67513,16095653841,177432172,16095649278,-4563,,
14691091074,165.72572,16095704436,177482773,16095699880,-4556,,
14691141671,165.77632,16095755036,177533355,16095750462,-4574,,
14691192746,165.82739,16095806113,177584428,16095801535,-4578,,
14691243358,165.87801,16095856726,177635037,16095852143,-4583,,
14691293940,165.92859,16095907312,177685617,16095902723,-4589,,
14691344548,165.97920,16095957922,177736222,16095953328,-4594,,
14691395108,166.02976,16096008485,177786779,16096003886,-4599,,
14691445154,166.07980,16096058532,177836822,16096053928,-4604,,
14691495718,166.13037,16096109109,177887395,16096104502,-4607,,
14691546753,166.18140,16096160137,177938416,16096155523,-4614,,
14691597353,166.23200,16096210738,177989013,16096206119,-4619,,
14691648421,166.28307,16096261809,178040078,16096257184,-4625,,
14691699426,166.33407,16096312816,178091081,16096308187,-4629,,
14691750021,166.38467,16096363414,178141674,16096358780,-4634,,
14691800812,166.43546,16096414207,178192462,16096409568,-4639,,
14691850975,166.48562,16096464372,178242622,16096459728,-4644,,
14691901529,166.53618,16096514928,178293173,16096510279,-4649,,
14691952104,166.58675,16096565506,178343745,16096560852,-4654,,
14692003153,166.63780,16096616558,178394791,16096611898,-4660,,
14692053702,166.68835,16096667108,178445338,16096662444,-4664,,
14692104736,166.73938,16096718146,178496370,16096713476,-4670,,
14692154831,166.78948,16096768243,178546461,16096763568,-4675,,
14692205835,166.84048,16096819249,178597464,16096814570,-4679,,
14692256399,166.89105,16096869816,178648025,16096865131,-4685,,
14692306990,166.94164,16096920419,178698623,16096915729,-4690,,
14692357609,166.99226,16096971040,178749238,16096966345,-4695,,
14692408118,167.04277,16097021542,178799735,16097016842,-4700,,
14692459141,167.09379,16097072567,178850756,16097067862,-4705,,
14692509704,167.14435,16097123132,178901315,16097118422,-4710,,
14692560252,167.19490,16097173683,178951861,16097168968,-4715,,
14692610798,167.24545,16097224231,179002404,16097219511,-4720,,
14692661345,167.29599,16097274780,179052949,16097270055,-4725,,
14692711945,167.34659,16097325394,179103557,16097320663,-4731,,
14692762981,167.39763,16097376420,179154579,16097371685,-4735,,
14692813328,167.44798,16097426769,179204923,16097422029,-4740,,
14692863635,167.49828,16097477080,179255228,16097472334,-4746,,
14692914687,167.54934,16097528134,179306277,16097523384,-4750,,
14692965248,167.59990,16097578697,179356835,16097573942,-4755,,
14693015780,167.65043,16097629232,179407364,16097624471,-4761,,
14693066762,167.70141,16097680215,179458343,16097675450,-4765,,
14693116865,167.75151,16097730322,179508445,16097725551,-4771,,
14693167417,167.80206,16097780877,179558995,16097776101,-4776,,
14693217507,167.85216,16097830967,179609080,16097826186,-4781,,
14693268072,167.90272,16097881536,179659644,16097876750,-4786,,
14693319108,167.95376,16097932574,179710676,16097927783,-4791,,
14693369654,168.00430,16097983121,179761219,16097978325,-4796,,
14693419743,168.05439,16098033213,179811306,16098028412,-4801,,
14693470787,168.10543,16098084259,179862347,16098079453,-4806,,
14693521367,168.15601,16098134842,179912924,16098130031,-4811,,
14693571974,168.20662,16098185452,179963529,16098180635,-4817,,
14693622547,168.25719,16098236027,180014099,16098231205,-4822,,
14693673182,168.30783,16098286674,180064741,16098281848,-4826,,
14693723835,168.35848,16098337320,180115382,16098332488,-4832,,
14693774405,168.40905,16098387891,180165949,16098383055,-4836,,
14693825005,168.45965,16098438495,180216547,16098433653,-4842,,
14693875631,168.51028,16098489122,180267169,16098484275,-4847,,
14693926680,168.56133,16098540173,180318214,16098535321,-4852,,
14693977196,168.61184,16098590693,180368730,16098585836,-4857,,
14694028233,168.66288,16098641732,180419763,16098636870,-4862,,
14694078995,168.71364,16098692495,180470522,16098687628,-4867,,
14694129629,168.76428,16098743133,180521155,16098738261,-4872,,
14694180678,168.81533,16098794184,180572201,16098789307,-4877,,
14694231254,168.86590,16098844762,180622783,16098839890,-4872,,
14694281883,168.91653,16098895394,180673400,16098890506,-4888,,
14694332501,168.96715,16098946013,180724015,16098941121,-4892,,
14694382645,169.01729,16098996159,180774156,16098991262,-4897,,
14694432791,169.06744,16099046309,180824299,16099041406,-4903,,
14694483453,169.11810,16099096972,180874959,16099092065,-4907,,
14694534030,169.16868,16099147552,180925534,16099142640,-4912,,
14694584121,169.21877,16099197645,180975621,16099192727,-4918,,
14694635158,169.26981,16099248685,181026657,16099243763,-4922,,
14694685771,169.32042,16099299301,181077277,16099294384,-4917,,
14694736651,169.37130,16099350183,181128143,16099345250,-4933,,
14694786907,169.42156,16099400441,181178396,16099395503,-4938,,
14694837984,169.47263,16099451521,181229471,16099446578,-4943,,
14694888513,169.52316,16099502052,181279998,16099497104,-4948,,
14694939177,169.57382,16099552717,181330658,16099547764,-4953,,
14694990177,169.62482,16099603732,181381668,16099598774,-4958,,
14695040797,169.67544,16099654342,181432272,16099649379,-4963,,
14695091377,169.72602,16099704924,181482850,16099699956,-4968,,
14695141813,169.77646,16099755368,181533288,16099750394,-4974,,
14695192879,169.82753,16099806432,181584348,16099801454,-4978,,
14695243496,169.87814,16099857050,181634961,16099852067,-4983,,
14695294317,169.92897,16099907875,181685779,16099902886,-4989,,
14695344967,169.97961,16099958526,181736427,16099953534,-4992,,
14695395543,170.03019,16100009105,181787000,16100004106,-4999,,
14695446608,170.08126,16100060172,181838061,16100055168,-5004,,
14695497668,170.13232,16100111235,181889119,16100106225,-5010,,
14695548276,170.18292,16100161846,181939726,16100156832,-5014,,
14695598854,170.23350,16100212426,181990300,16100207407,-5019,,
14695649483,170.28413,16100263057,182040926,16100258033,-5024,,
14695700042,170.33469,16100313619,182091484,16100308590,-5029,,
14695750657,170.38530,16100364236,182142096,16100359202,-5034,,
14695801280,170.43593,16100414861,182192715,16100409821,-5040,,
14695852329,170.48698,16100465913,182243761,16100460868,-5045,,
14695903316,170.53796,16100516901,182294746,16100511852,-5049,,
14695954318,170.58897,16100567906,182345745,16100562851,-5055,,
14696004887,170.63953,16100618478,182396311,16100613418,-5060,,
14696055416,170.69006,16100669009,182446839,16100663945,-5064,,
14696106443,170.74109,16100720039,182497862,16100714969,-5070,,
14696157502,170.79215,16100771099,182548918,16100766024,-5075,,
14696208102,170.84275,16100821702,182599515,16100816622,-5080,,
14696259136,170.89378,16100872739,182650547,16100867654,-5085,,
14696310187,170.94484,16100923792,182701596,16100918702,-5090,,
14696360763,170.99541,16100974370,182752169,16100969275,-5095,,
14696411377,171.04602,16101024987,182802781,16101019887,-5100,,
14696462871,171.09752,16101076483,182854272,16101071378,-5105,,
14696513485,171.14813,16101127100,182904883,16101121989,-5111,,
14696564527,171.19917,16101178143,182955921,16101173027,-5116,,
14696615068,171.24972,16101228687,183006461,16101223567,-5120,,
14696666130,171.30078,16101279752,183057520,16101274626,-5126,,
14696716663,171.35131,16101330287,183108050,16101325156,-5131,,
14696767727,171.40238,16101381352,183159110,16101376216,-5136,,
14696818286,171.45293,16101431925,183209678,16101426784,-5141,,
14696869324,171.50397,16101482954,183260702,16101477808,-5146,,
14696919517,171.55417,16101533150,183310892,16101527999,-5151,,
14696970105,171.60475,16101583751,183361489,16101578595,-5156,,
14697020724,171.65537,16101634361,183412094,16101629201,-5160,,
14697071269,171.70592,16101684908,183462636,16101679742,-5166,,
14697122309,171.75696,16101735952,183513674,16101730780,-5172,,
14697172875,171.80752,16101786520,183564238,16101781344,-5176,,
14697223488,171.85814,16101837135,183614847,16101831954,-5181,,
14697274081,171.90873,16101887731,183665437,16101882554,-5177,,
14697324387,171.95904,16101938039,183715741,16101932848,-5191,,
14697375464,172.01011,16101989129,183766826,16101983932,-5197,,
14697426073,172.06072,16102039729,183817421,16102034527,-5202,,
14697477143,172.11179,16102090801,183868489,16102085595,-5206,,
14697527697,172.16234,16102141359,183919040,16102136147,-5212,,
14697578332,172.21298,16102191996,183969672,16102186778,-5218,,
14697629382,172.26403,16102243047,184020719,16102237825,-5222,,
14697679636,172.31428,16102293305,184070971,16102288077,-5228,,
14697729997,172.36464,16102343678,184121339,16102338445,-5233,,
14697780619,172.41527,16102394292,184171948,16102389054,-5238,,
14697831209,172.46586,16102444884,184222536,16102439642,-5242,,
14697882213,172.51686,16102495890,184273537,16102490643,-5247,,
14697932841,172.56749,16102546522,184324162,16102541269,-5253,,
14697983395,172.61804,16102597078,184374714,16102591820,-5258,,
14698033943,172.66859,16102647628,184425259,16102642365,-5263,,
14698084992,172.71964,16102698679,184476305,16102693411,-5268,,
14698135552,172.77020,16102749242,184526862,16102743969,-5273,,
14698186105,172.82075,16102799796,184577413,16102794519,-5277,,
14698236721,172.87137,16102850415,184628026,16102845132,-5283,,
14698287328,172.92198,16102901024,184678630,16102895736,-5288,,
14698337420,172.97207,16102951118,184728719,16102945825,-5293,,
14698388080,173.02273,16103001782,184779377,16102996483,-5299,,
14698438239,173.07289,16103051943,184829533,16103046640,-5303,,
14698488375,173.12302,16103102081,184879666,16103096772,-5309,,
14698538516,173.17316,16103152225,184929805,16103146912,-5313,,
14698588638,173.22329,16103202349,184979924,16103197030,-5319,,
14698639235,173.27388,16103252948,185030518,16103247625,-5323,,
14698689799,173.32445,16103303515,185081080,16103298187,-5328,,
14698740873,173.37552,16103354591,185132151,16103349257,-5334,,
14698791457,173.42611,16103405176,185182732,16103399838,-5338,,
14698841902,173.47655,16103455625,185233174,16103450281,-5344,,
14698892951,173.52760,16103506675,185284221,16103501327,-5348,,
14698944001,173.57865,16103557728,185335268,16103552374,-5354,,
14698995051,173.62970,16103608781,185386315,16103603422,-5359,,
14699046063,173.68071,16103659795,185437326,16103654432,-5363,,
14699096602,173.73125,16103710336,185487861,16103704967,-5369,,
14699146663,173.78131,16103760400,185537919,16103755026,-5374,,
14699197206,173.83185,16103810944,185588459,16103805565,-5379,,
14699247791,173.88244,16103861533,185639042,16103856148,-5385,,
14699298840,173.93349,16103912584,185690088,16103907195,-5389,,
14699349866,173.98451,16103963612,185741111,16103958218,-5394,,
14699400937,174.03558,16104014686,185792181,16104009287,-5399,,
14699451986,174.08663,16104065737,185843226,16104060332,-5405,,
14699502589,174.13724,16104116343,185893826,16104110933,-5410,,
14699553152,174.18780,16104166918,185944397,16104161503,-5415,,
14699603430,174.23808,16104217188,185994663,16104211769,-5419,,
14699654488,174.28914,16104268249,186045718,16104262824,-5425,,
14699704555,174.33920,16104318327,186095791,16104312897,-5430,,
14699755104,174.38975,16104368868,186146328,16104363434,-5434,,
14699806175,174.44082,16104419943,186197397,16104414503,-5440,,
14699857223,174.49187,16104470993,186248441,16104465548,-5445,,
14699908230,174.54288,16104522002,186299446,16104516552,-5450,,
14699958793,174.59344,16104572568,186350007,16104567113,-5455,,
14700009821,174.64447,16104623598,186401032,16104618138,-5460,,
14700060871,174.69552,16104674650,186452079,16104669185,-5465,,
14700111417,174.74606,16104725199,186502622,16104719729,-5470,,
14700161510,174.79616,16104775294,186552713,16104769819,-5475,,
14700212559,174.84721,16104826346,186603759,16104820865,-5481,,
14700263577,174.89822,16104877366,186654774,16104871880,-5486,,
14700314661,174.94931,16104928452,186705856,16104922962,-5490,,
14700375977,175.01063,16104989771,186767168,16104984274,-5497,,
14700427015,175.06166,16105040812,186818203,16105035310,-5502,,
14700478395,175.11304,16105092194,186869581,16105086687,-5507,,
14700529042,175.16369,16105142843,186920224,16105137331,-5512,,
14700580686,175.21533,16105194496,186971872,16105188978,-5518,,
14700631145,175.26579,16105244950,187022322,16105239428,-5522,,
14700681703,175.31635,16105295511,187072877,16105289983,-5528,,
14700732231,175.36688,16105346041,187123402,16105340508,-5533,,
14700782279,175.41693,16105396092,187173448,16105390555,-5537,,
14700832852,175.46750,16105446666,187224018,16105441124,-5542,,
14700883889,175.51854,16105497706,187275052,16105492158,-5548,,
14700934983,175.56963,16105548802,187326144,16105543250,-5552,,
14700985983,175.62063,16105599805,187377141,16105594248,-5557,,
14701036545,175.67119,16105650370,187427701,16105644807,-5563,,
14701087594,175.72224,16105701421,187478746,16105695853,-5568,,
14701138142,175.77279,16105751972,187529292,16105746399,-5573,,
14701192693,175.82734,16105806525,187583840,16105800947,-5578,,
14701243240,175.87789,16105857074,187634384,16105851490,-5584,,
14701293808,175.92846,16105907645,187684949,16105902056,-5589,,
14701344349,175.97900,16105958188,187735489,16105952595,-5593,,
14701395679,176.03033,16106009523,187786818,16106003924,-5599,,
14701445924,176.08057,16106059768,187837058,16106054164,-5604,,
14701495983,176.13063,16106109829,187887115,16106104221,-5608,,
14701546591,176.18124,16106160440,187937719,16106154826,-5614,,
14701597081,176.23173,16106210932,187988206,16106205312,-5620,,
14701648142,176.28279,16106261995,188039264,16106256371,-5624,,
14701699198,176.33385,16106313054,188090318,16106307425,-5629,,
14701749727,176.38438,16106363585,188140845,16106357951,-5634,,
14701800778,176.43543,16106414638,188191892,16106408999,-5639,,
14701851811,176.48646,16106465674,188242923,16106460029,-5645,,
14701902300,176.53695,16106516164,188293409,16106510515,-5649,,
14701952864,176.58751,16106566741,188343981,16106561087,-5654,,
14702003312,176.63796,16106617181,188394415,16106611521,-5660,,
14702053819,176.68847,16106667691,188444920,16106662027,-5664,,
14702103868,176.73852,16106717741,188494966,16106712072,-5669,,
14702154406,176.78905,16106768282,188545501,16106762607,-5675,,
14702204971,176.83962,16106818850,188596065,16106813171,-5679,,
14702256003,176.89065,16106869884,188647093,16106864199,-5685,,
14702306545,176.94119,16106920429,188697633,16106914739,-5690,,
14702357589,176.99224,16106971474,188748673,16106965780,-5694,,
14702408160,177.04281,16107022049,188799243,16107016349,-5700,,
14702459161,177.09381,16107073051,188850240,16107067347,-5704,,
14702509727,177.14437,16107123620,188900803,16107117910,-5710,,
14702559820,177.19447,16107173716,188950894,16107168001,-5715,,
14702610091,177.24474,16107223988,189001172,16107218278,-5710,,
14702660690,177.29534,16107274590,189051761,16107268868,-5722,,
14702711442,177.34609,16107325345,189102507,16107319614,-5731,,
14702761992,177.39664,16107375896,189153055,16107370161,-5735,,
14702812336,177.44698,16107426243,189203397,16107420503,-5740,,
14702862400,177.49705,16107476310,189253457,16107470563,-5747,,
14702912979,177.54763,16107526891,189304035,16107521141,-5750,,
14702964017,177.59867,16107577931,189355070,16107572176,-5755,,
14703014652,177.64930,16107628568,189405701,16107622808,-5760,,
14703064781,177.69943,16107678700,189455828,16107672935,-5765,,
14703115584,177.75023,16107729516,189506639,16107723745,-5771,,
14703166185,177.80083,16107780108,189557226,16107774333,-5775,,
14703217153,177.85180,16107831089,189608201,16107825308,-5781,,
14703267766,177.90241,16107881694,189658802,16107875908,-5786,,
14703318710,177.95336,16107932641,189709744,16107926850,-5791,,
14703369103,178.00375,16107983036,189760133,16107977240,-5796,,
14703419779,178.05443,16108033715,189810807,16108027914,-5801,,
14703470575,178.10522,16108084512,189861600,16108078706,-5806,,
14703520758,178.15541,16108134698,189911780,16108128887,-5811,,
14703571036,178.20568,16108184979,189962055,16108179162,-5817,,
14703621598,178.25625,16108235543,190012615,16108229722,-5821,,
14703672639,178.30729,16108286586,190063653,16108280760,-5826,,
14703723094,178.35774,16108337054,190114115,16108331222,-5832,,
14703773610,178.40826,16108387562,190164620,16108381726,-5836,,
14703824565,178.45921,16108438519,190215572,16108432678,-5841,,
14703875206,178.50985,16108489162,190266209,16108483315,-5847,,
14703925380,178.56003,16108539338,190316381,16108533487,-5851,,
14703976396,178.61104,16108590357,190367394,16108584500,-5857,,
14704026954,178.66160,16108640918,190417949,16108635056,-5862,,
14704077005,178.71165,16108690971,190467997,16108685104,-5867,,
14704127553,178.76220,16108741522,190518543,16108735650,-5872,,
14704178155,178.81280,16108792125,190569142,16108786248,-5877,,
14704228785,178.86343,16108842758,190619769,16108836876,-5882,,
14704279501,178.91415,16108893476,190670483,16108887589,-5887,,
14704329552,178.96420,16108943530,190720531,16108937638,-5892,,
14704380136,179.01478,16108994116,190771112,16108988219,-5897,,
14704431197,179.06584,16109045180,190822171,16109039277,-5903,,
14704481816,179.11646,16109095801,190872787,16109089894,-5907,,
14704532860,179.16751,16109146847,190923829,16109140936,-5911,,
14704583924,179.21857,16109197914,190974889,16109191996,-5918,,
14704634971,179.26962,16109248963,191025934,16109243040,-5923,,
14704685861,179.32051,16109299856,191076821,16109293928,-5928,,
14704736792,179.37144,16109350789,191127749,16109344856,-5933,,
14704787865,179.42251,16109401864,191178819,16109395925,-5939,,
14704838914,179.47356,16109452916,191229866,16109446973,-5943,,
14704889977,179.52462,16109503981,191280927,16109498033,-5948,,
14704941029,179.57568,16109555035,191331976,16109549082,-5953,,
14704992072,179.62672,16109606081,191383015,16109600122,-5959,,
14705043101,179.67775,16109657112,191434053,16109651160,-5952,,
14705094178,179.72883,16109708192,191485117,16109702223,-5969,,
14705144820,179.77947,16109758835,191535755,16109752861,-5974,,
14705195388,179.83004,16109809417,191586332,16109803439,-5978,,
14705246411,179.88106,16109860432,191637341,16109854448,-5984,,
14705296815,179.93146,16109910838,191687754,16109904860,-5978,,
14705347385,179.98203,16109961410,191738309,16109955415,-5995,,
14705398026,180.03267,16110012053,191788948,16110006055,-5998,,
14705449079,180.08373,16110063108,191840008,16110057114,-5994,,
14705499563,180.13421,16110113595,191890480,16110107586,-6009,,
14705550115,180.18476,16110164160,191941039,16110158146,-6014,,
14705601183,180.23583,16110215220,191992095,16110209201,-6019,,
14705651689,180.28634,16110265728,192042598,16110259704,-6024,,
14705702239,180.33689,16110316280,192093144,16110310250,-6030,,
14705753300,180.38795,16110367344,192144204,16110361310,-6034,,
14705804347,180.43900,16110418394,192195248,16110412354,-6040,,
14705855377,180.49003,16110469427,192246275,16110463382,-6045,,
14705906428,180.54108,16110520478,192297323,16110514429,-6049,,
14705957028,180.59168,16110571082,192347920,16110565027,-6055,,
14706007770,180.64242,16110621826,192398659,16110615766,-6060,,
14706058310,180.69296,16110672367,192449195,16110666302,-6065,,
14706108867,180.74352,16110722928,192499752,16110716858,-6070,,
14706343615,180.97826,16110957686,192734486,16110951592,-6094,16110957450,
14706368759,181.00341,16110982832,192759630,16110976764,-6068,,
14706419311,181.05396,16111033386,192810178,16111027373,-6013,,
14706469924,181.10457,16111084002,192860788,16111078042,-5960,,
14706520043,181.15469,16111134123,192910905,16111128217,-5906,,
14706570629,181.20528,16111184711,192961488,16111178860,-5851,,
14706621678,181.25633,16111235763,193012535,16111229966,-5797,,
14706672245,181.30689,16111286332,193063099,16111280590,-5742,,
14706722814,181.35746,16111336903,193113665,16111331215,-5688,,
14706773732,181.40838,16111387824,193164580,16111382190,-5634,,
14706824756,181.45940,16111438850,193215602,16111433271,-5579,,
14706875356,181.51000,16111489452,193266209,16111483938,-5514,,
14706926341,181.56099,16111540439,193317181,16111534969,-5470,,
14706976911,181.61156,16111591012,193367749,16111585596,-5416,,
14707027963,181.66261,16111642066,193418808,16111636716,-5350,,
14707078509,181.71316,16111692615,193469342,16111687308,-5307,,
14707129068,181.76372,16111743176,193519898,16111737923,-5253,,
14707179625,181.81427,16111793736,193570451,16111788537,-5199,,
14707230198,181.86485,16111844311,193621022,16111839167,-5144,,
14707281250,181.91590,16111895365,193672072,16111890276,-5089,,
14707332302,181.96695,16111946420,193723120,16111941384,-5036,,
14707383350,182.01800,16111997469,193774166,16111992489,-4980,,
14707434384,182.06903,16112048517,193825209,16112043592,-4925,,
14707484905,182.11955,16112099030,193875715,16112094158,-4872,,
14707535500,182.17015,16112149627,193926308,16112144810,-4817,,
14707586019,182.22067,16112200147,193976824,16112195385,-4762,,
14707637085,182.27173,16112251217,194027888,16112246510,-4707,,
14707688120,182.32277,16112302254,194078919,16112297600,-4654,,
14707739168,182.37382,16112353305,194129965,16112348705,-4600,,
14707789703,182.42435,16112403841,194180497,16112399297,-4544,,
14707840758,182.47541,16112454899,194231550,16112450409,-4490,,
14707891798,182.52645,16112505942,194282586,16112501506,-4436,,
14707942384,182.57703,16112556530,194333171,16112552149,-4381,,
14707993394,182.62804,16112607541,194384177,16112603215,-4326,,
14708043864,182.67851,16112658015,194434644,16112653742,-4273,,
14708093933,182.72858,16112708086,194484711,16112703868,-4218,,
14708144483,182.77913,16112758638,194535259,16112754474,-4164,,
14708195067,182.82971,16112809224,194585839,16112805114,-4110,,
14708245617,182.88027,16112859777,194636387,16112855721,-4056,,
14708296433,182.93108,16112910595,194687200,16112906594,-4001,,
14708346574,182.98122,16112960739,194737338,16112956791,-3948,,
14708397105,183.03175,16113011271,194787866,16113007378,-3893,,
14708447517,183.08217,16113061687,194838278,16113057848,-3839,,
14708498209,183.13286,16113112380,194888965,16113108595,-3785,,
14708549260,183.18391,16113163434,194940014,16113159704,-3730,,
14708599942,183.23459,16113214118,194990692,16113210441,-3677,,
14708650490,183.28514,16113264669,195041238,16113261046,-3623,,
14708700859,183.33551,16113315039,195091604,16113311471,-3568,,
14708751404,183.38605,16113365588,195142146,16113362074,-3514,,
14708802060,183.43671,16113416246,195192800,16113412787,-3459,,
14708852524,183.48717,16113466712,195243262,16113463307,-3405,,
14708903317,183.53797,16113517508,195294052,16113514157,-3351,,
14708953559,183.58821,16113567753,195344292,16113564457,-3296,,
14709004127,183.63878,16113618322,195394856,16113615080,-3242,,
14709054719,183.68937,16113668917,195445446,16113665728,-3189,,
14709105198,183.73985,16113719398,195495921,16113716263,-3135,,
14709155368,183.79002,16113769570,195546090,16113766490,-3080,,
14709205517,183.84017,16113819722,195596236,16113816695,-3027,,
14709256508,183.89116,16113870715,195647224,16113867744,-2971,,
14709307032,183.94168,16113921240,195697745,16113918323,-2917,,
14709357707,183.99236,16113971920,195748419,16113969056,-2864,,
14709407791,184.04244,16114022006,195798500,16114019196,-2810,,
14709458837,184.09348,16114073053,195849542,16114070298,-2755,,
14709509890,184.14454,16114124109,195900593,16114121408,-2701,,
14709560005,184.19465,16114174225,195950704,16114171578,-2647,,
14709610597,184.24525,16114224820,196001293,16114222228,-2592,,
14709661410,184.29606,16114275636,196052105,16114273098,-2538,,
14709711991,184.34664,16114326219,196102682,16114323735,-2484,,
14709762566,184.39721,16114376797,196153255,16114374367,-2430,,
14709813197,184.44785,16114427440,196203893,16114425065,-2375,,
14709864171,184.49882,16114478406,196254855,16114476086,-2320,,
14709914232,184.54888,16114528470,196304913,16114526202,-2268,,
14709964798,184.59945,16114579038,196355475,16114576825,-2213,,
14710014900,184.64955,16114629153,196405586,16114626994,-2159,,
14710065442,184.70009,16114679687,196456115,16114677582,-2105,,
14710116002,184.75065,16114730249,196506672,16114728198,-2051,,
14710166547,184.80120,16114780797,196557215,16114778800,-1997,,
14710217092,184.85174,16114831344,196607757,16114829402,-1942,,
14710267643,184.90229,16114881897,196658304,16114880009,-1888,,
14710318221,184.95287,16114932477,196708880,16114930644,-1833,,
14710368783,185.00343,16114983042,196759440,16114981262,-1780,,
14710419491,185.05414,16115033752,196810145,16115032026,-1726,,
14710469650,185.10430,16115083913,196860301,16115082241,-1672,,
14710519758,185.15441,16115134034,196910417,16115132416,-1618,,
14710571362,185.20601,16115185630,196962008,16115184067,-1563,,
14710621816,185.25646,16115236087,197012459,16115234578,-1509,,
14710672341,185.30699,16115286625,197062993,16115285171,-1454,,
14710722860,185.35751,16115337134,197113497,16115335735,-1399,,
14710773476,185.40812,16115387754,197164110,16115386407,-1347,,
14710823915,185.45856,16115438195,197214547,16115436902,-1293,,
14710874367,185.50902,16115488649,197264997,16115487412,-1237,,
14710925012,185.55966,16115539297,197315639,16115538113,-1184,,
14710975619,185.61027,16115589906,197366243,16115588776,-1130,,
14711025764,185.66041,16115640052,197416385,16115638977,-1075,,
14711076020,185.71067,16115690312,197466638,16115689290,-1022,,
14711126951,185.76160,16115741245,197517566,16115740278,-967,,
14711177314,185.81196,16115791610,197567927,16115790698,-912,,
14711227887,185.86254,16115842186,197618498,16115841328,-858,,
14711278627,185.91327,16115892927,197669234,16115892122,-805,,
14711328776,185.96342,16115943079,197719380,16115942328,-751,,
14711378999,186.01365,16115993305,197769602,16115992567,-738,,
14711429456,186.06410,16116043764,197820055,16116043021,-743,,
14711479717,186.11436,16116094028,197870314,16116093280,-748,,
14711529834,186.16448,16116144146,197920428,16116143393,-753,,
14711580140,186.21479,16116194454,197970731,16116193696,-758,,
14711630505,186.26515,16116244821,198021093,16116244058,-763,,
14711681102,186.31575,16116295422,198071689,16116294654,-768,,
14711731270,186.36592,16116345591,198121864,16116344829,-762,,
14711781861,186.41651,16116396186,198172441,16116395407,-779,,
14711832127,186.46678,16116446454,198222705,16116445671,-783,,
14711882833,186.51748,16116497162,198273408,16116496374,-788,,
14711933357,186.56800,16116547689,198323929,16116546894,-795,,
14711983439,186.61809,16116597772,198374008,16116596973,-799,,
14712033531,186.66818,16116647867,198424098,16116647064,-803,,
14712083934,186.71858,16116698272,198474498,16116697463,-809,,
14712134005,186.76865,16116748346,198524566,16116747531,-815,,
14712184898,186.81955,16116799241,198575457,16116798422,-819,,
14712235558,186.87021,16116849903,198626114,16116849079,-824,,
14712285599,186.92025,16116899947,198676153,16116899118,-829,,
14712336478,186.97113,16116950839,198727041,16116950006,-833,,
14712387025,187.02167,16117001378,198777573,16117000539,-839,,
14712437637,187.07228,16117051992,198828182,16117051148,-844,,
14712488015,187.12266,16117102372,198878558,16117101523,-849,,
14712538451,187.17310,16117152811,198928992,16117151957,-854,,
14712588995,187.22364,16117203357,198979533,16117202498,-859,,
14712639746,187.27439,16117254120,199030290,16117253256,-864,,
14712690475,187.32512,16117304842,199081007,16117303972,-870,,
14712740914,187.37556,16117355283,199131444,16117354409,-874,,
14712791092,187.42574,16117405463,199181618,16117404584,-879,,
14712841185,187.47583,16117455558,199231709,16117454675,-883,,
14712891801,187.52645,16117506177,199282322,16117505288,-889,,
14712942833,187.57748,16117557211,199333351,16117556317,-894,,
14712993370,187.62802,16117607751,199383886,16117606851,-900,,
14713043445,187.67809,16117657828,199433958,16117656924,-904,,
14713093622,187.72827,16117708008,199484132,16117707098,-910,,
14713144198,187.77885,16117758586,199534705,16117757670,-916,,
14713194426,187.82907,16117808816,199584931,16117807896,-920,,
14713245139,187.87979,16117859543,199635652,16117858618,-925,,
14713295413,187.93006,16117909808,199685912,16117908878,-930,,
14713345791,187.98044,16117960188,199736289,16117959254,-934,,
14713396796,188.03144,16118011195,199787290,16118010255,-940,,
14713447345,188.08199,16118061747,199837847,16118060813,-934,,
14713497468,188.13212,16118111873,199887957,16118110922,-951,,
14713549359,188.18401,16118163767,199939847,16118162812,-955,,
14713600186,188.23483,16118214595,199990670,16118213635,-960,,
14713650311,188.28496,16118264722,200040792,16118263757,-965,,
14713700963,188.33561,16118315378,200091442,16118314408,-970,,
14713751130,188.38578,16118365546,200141605,16118364571,-975,,
14713801424,188.43607,16118415842,200191897,16118414862,-980,,
14713851973,188.48662,16118466404,200242453,16118465419,-985,,
14713902576,188.53722,16118516998,200293043,16118516018,-980,,
14713952993,188.58764,16118567418,200343457,16118566422,-996,,
14714003870,188.63852,16118618308,200394341,16118617307,-1001,,
14714054463,188.68911,16118668893,200444923,16118667888,-1005,,
14714105023,188.73967,16118719456,200495479,16118718445,-1011,,
14714155551,188.79020,16118769986,200546005,16118768970,-1016,,
14714205640,188.84029,16118820077,200596091,16118819057,-1020,,
14714256036,188.89068,16118870475,200646484,16118869449,-1026,,
14714306143,188.94079,16118920584,200696588,16118919553,-1031,,
14714356224,188.99087,16118970668,200746666,16118969632,-1036,,
14714406691,189.04134,16119021137,200797131,16119020096,-1041,,
14714457276,189.09192,16119071724,200847713,16119070678,-1046,,
14714507858,189.14251,16119122309,200898292,16119121257,-1052,,
14714558448,189.19310,16119172902,200948881,16119171846,-1056,,
14714609058,189.24371,16119223513,200999487,16119222452,-1061,,
14714659667,189.29432,16119274125,201050093,16119273059,-1066,,
14714710749,189.34540,16119325210,201101173,16119324139,-1071,,
14714761611,189.39626,16119376074,201152032,16119374998,-1076,,
14714811721,189.44637,16119426185,201202139,16119425105,-1080,,
14714862617,189.49726,16119477086,201253033,16119475999,-1087,,
14714913031,189.54768,16119527501,201303444,16119526410,-1091,,
14714963351,189.59800,16119577822,201353761,16119576726,-1096,,
14715014305,189.64895,16119628779,201404712,16119627677,-1102,,
14715064435,189.69908,16119678911,201454840,16119677805,-1106,,
14715114859,189.74951,16119729338,201505262,16119728227,-1111,,
14715165742,189.80039,16119780224,201556141,16119779107,-1117,,
14715216314,189.85096,16119830798,201606711,16119829676,-1122,,
14715266673,189.90132,16119881171,201657079,16119880044,-1127,,
14715316801,189.95145,16119931299,201707202,16119930168,-1131,,
14715366922,190.00157,16119981422,201757320,16119980285,-1137,,
14715417500,190.05215,16120032004,201807897,16120030862,-1142,,
14715468044,190.10269,16120082539,201858427,16120081392,-1147,,
14715518611,190.15326,16120133108,201908991,16120131956,-1152,,
14715568776,190.20342,16120183277,201959154,16120182120,-1157,,
14715619429,190.25408,16120233931,202009804,16120232769,-1162,,
14715669726,190.30437,16120284230,202060098,16120283063,-1167,,
14715719877,190.35452,16120334395,202110258,16120333223,-1172,,
14715770275,190.40492,16120384784,202160642,16120383607,-1177,,
14715820672,190.45532,16120435195,202211048,16120434014,-1181,,
14715871292,190.50594,16120485807,202261654,16120484619,-1188,,
14715921436,190.55608,16120535953,202311806,16120534771,-1182,,
14715971863,190.60651,16120586382,202362220,16120585185,-1197,,
14716021937,190.65659,16120636459,202412291,16120635256,-1203,,
14716072532,190.70718,16120687057,202462885,16120685850,-1207,,
14716123574,190.75822,16120738100,202513923,16120736888,-1212,,
14716174142,190.80879,16120788670,202564487,16120787452,-1218,,
14716224519,190.85917,16120839049,202614862,16120837827,-1222,,
14716274949,190.90960,16120889481,202665289,16120888254,-1227,,
14716325459,190.96011,16120939995,202715796,16120938762,-1233,,
14716376274,191.01092,16120990811,202766608,16120989573,-1238,,
14716427095,191.06174,16121041636,202817428,16121040393,-1243,,
14716477699,191.11235,16121092242,202868029,16121090994,-1248,,
14716527920,191.16257,16121142465,202918246,16121141211,-1254,,
14716578888,191.21354,16121193436,202969212,16121192178,-1258,,
14716629484,191.26413,16121244034,203019805,16121242771,-1263,,
14716680050,191.31470,16121294601,203070368,16121293333,-1268,,
14716730908,191.36556,16121345463,203121224,16121344189,-1274,,
14716781418,191.41607,16121395975,203171731,16121394697,-1278,,
14716831568,191.46622,16121446127,203221878,16121444844,-1283,,
14716882761,191.51741,16121497322,203273068,16121496034,-1288,,
14716933366,191.56801,16121547929,203323671,16121546636,-1293,,
14716984311,191.61896,16121598877,203374613,16121597579,-1298,,
14717034961,191.66961,16121649530,203425261,16121648226,-1304,,
14717085791,191.72044,16121700362,203476088,16121699054,-1308,,
14717136522,191.77117,16121751096,203526816,16121749782,-1314,,
14717187365,191.82201,16121801940,203577655,16121800621,-1319,,
14717238401,191.87305,16121852979,203628689,16121851655,-1324,,
14717288955,191.92360,16121903536,203679242,16121902207,-1329,,
14717339051,191.97370,16121953633,203729334,16121952299,-1334,,
14717389559,192.02421,16122004143,203779839,16122002804,-1339,,
14717439712,192.07436,16122054300,203829990,16122052956,-1344,,
14717490180,192.12483,16122104769,203880455,16122103420,-1349,,
14717540559,192.17521,16122155151,203930831,16122153797,-1354,,
14717590941,192.22559,16122205536,203981211,16122204176,-1360,,
14717652500,192.28715,16122267096,204042766,16122265731,-1365,,
14717710058,192.34471,16122324657,204100321,16122323286,-1371,,
14717761428,192.39608,16122376031,204151689,16122374654,-1377,,
14717812385,192.44703,16122426990,204202644,16122425609,-1381,,
14717862901,192.49755,16122477508,204253156,16122476122,-1386,,
14717912950,192.54760,16122527559,204303202,16122526167,-1392,,
14717962990,192.59764,16122577601,204353240,16122576205,-1396,,
14718013556,192.64820,16122628169,204403809,16122626778,-1391,,
14718064090,192.69874,16122678707,204454335,16122677300,-1407,,
14718114642,192.74929,16122729260,204504883,16122727848,-1412,,
14718165310,192.79996,16122779930,204555549,16122778514,-1416,,
14718216746,192.85139,16122831369,204606982,16122829947,-1422,,
14718267786,192.90243,16122882412,204658019,16122880985,-1427,,
14718319039,192.95369,16122933671,204709273,16122932239,-1432,,
14718369903,193.00455,16122984533,204760131,16122983096,-1437,,
14718420953,193.05560,16123035586,204811179,16123034144,-1442,,
14718471996,193.10664,16123086631,204862218,16123085183,-1448,,
14718522523,193.15717,16123137161,204912744,16123135709,-1452,,
14718573121,193.20777,16123187760,204963338,16123186303,-1457,,
14718623761,193.25841,16123238404,205013975,16123236940,-1464,,
14718674267,193.30892,16123288912,205064478,16123287444,-1468,,
14718724753,193.35940,16123339400,205114962,16123337928,-1472,,
14718775774,193.41042,16123390423,205165980,16123388945,-1478,,
14718826006,193.46065,16123440658,205216210,16123439175,-1483,,
14718876815,193.51146,16123491468,205267016,16123489982,-1486,,
14718927463,193.56211,16123542120,205317661,16123540627,-1493,,
14718978190,193.61284,16123592849,205368385,16123591351,-1498,,
14719028447,193.66309,16123643107,205418640,16123641605,-1502,,
14719078727,193.71338,16123693391,205468918,16123691883,-1508,,
14719129052,193.76370,16123743718,205519239,16123742205,-1513,,
14719179129,193.81378,16123793796,205569313,16123792278,-1518,,
14719229737,193.86438,16123844408,205619919,16123842884,-1524,,
14719280252,193.91490,16123894924,205670431,16123893396,-1528,,
14719330342,193.96499,16123945017,205720518,16123943484,-1533,,
14719384440,194.01909,16123999118,205774613,16123997579,-1539,,
14719435072,194.06972,16124049751,205825243,16124048208,-1543,,
14719485157,194.11981,16124099839,205875325,16124098290,-1549,,
14719535839,194.17049,16124150524,205926004,16124148970,-1554,,
14719586377,194.22102,16124201073,205976550,16124199516,-1557,,
14719636807,194.27146,16124251497,206026968,16124249933,-1564,,
14719687961,194.32261,16124302653,206078119,16124301084,-1569,,
14719739002,194.37365,16124353696,206129157,16124352122,-1574,,
14719789360,194.42401,16124404056,206179512,16124402477,-1579,,
14719839506,194.47415,16124454204,206229655,16124452620,-1584,,
14719889828,194.52448,16124504529,206279974,16124502939,-1590,,
14719940107,194.57476,16124554811,206330251,16124553217,-1594,,
14719990503,194.62515,16124605208,206380644,16124603609,-1599,,
14720041530,194.67618,16124656239,206431668,16124654634,-1605,,
14720092104,194.72675,16124706815,206482240,16124705205,-1610,,
14720142532,194.77718,16124757245,206532665,16124755631,-1614,,
14720193085,194.82773,16124807800,206583215,16124806181,-1619,,
14720243253,194.87790,16124857970,206633380,16124856346,-1624,,
14720293828,194.92848,16124908547,206683953,16124906918,-1629,,
14720343927,194.97858,16124958650,206734049,16124957015,-1635,,
14720394968,195.02962,16125009693,206785088,16125008053,-1640,,
14720445221,195.07987,16125059948,206835338,16125058304,-1644,,
14720495293,195.12994,16125110023,206885408,16125108373,-1650,,
14720545459,195.18011,16125160190,206935570,16125158536,-1654,,
14720595939,195.23059,16125210672,206986048,16125209013,-1659,,
14720646930,195.28158,16125261667,207037037,16125260002,-1665,,
14720697496,195.33214,16125312235,207087599,16125310565,-1670,,
14720748102,195.38275,16125362855,207138216,16125361181,-1674,,
14720798343,195.43299,16125413087,207188441,16125411407,-1680,,
14720848591,195.48324,16125463337,207238686,16125461652,-1685,,
14720899023,195.53367,16125513771,207289115,16125512081,-1690,,
14720949298,195.58395,16125564049,207339389,16125562354,-1695,,
14721000013,195.63466,16125614765,207390100,16125613065,-1700,,
14721050278,195.68493,16125665033,207440362,16125663328,-1705,,
14721100926,195.73557,16125715684,207491008,16125713974,-1710,,
14721151130,195.78578,16125765890,207541210,16125764175,-1715,,
14721201733,195.83638,16125816496,207591810,16125814775,-1721,,
14721251900,195.88655,16125866665,207641974,16125864940,-1725,,
14721302188,195.93684,16125916955,207692259,16125915225,-1730,,
14721352314,195.98696,16125967084,207742383,16125965348,-1736,,
14721402520,196.03717,16126017292,207792586,16126015551,-1741,,
14721452799,196.08745,16126067573,207842863,16126065828,-1745,,
14721503340,196.13799,16126118117,207893401,16126116366,-1751,,
14721553779,196.18843,16126168557,207943836,16126166801,-1756,,
14721604367,196.23901,16126219148,207994423,16126217388,-1760,,
14721655059,196.28971,16126269842,208045110,16126268076,-1766,,
14721705379,196.34003,16126320165,208095428,16126318394,-1771,,
14721755566,196.39021,16126370354,208145613,16126368579,-1775,,
14721806102,196.44075,16126420893,208196146,16126419112,-1781,,
14721856704,196.49135,16126471497,208246745,16126469711,-1786,,
14721906880,196.54153,16126521674,208296919,16126519884,-1790,,
14721957453,196.59210,16126572251,208347489,16126570455,-1796,,
14722007931,196.64258,16126622731,208397965,16126620930,-1801,,
14722058885,196.69353,16126673687,208448916,16126671881,-1806,,
14722109918,196.74457,16126724723,208499946,16126722912,-1811,,
14722160481,196.79513,16126775287,208550506,16126773471,-1816,,
14722211105,196.84575,16126825914,208601128,16126824093,-1821,,
14722261389,196.89604,16126876201,208651420,16126874386,-1815,,
14722311813,196.94646,16126926627,208701831,16126924796,-1831,,
14722362722,196.99737,16126977539,208752736,16126975702,-1837,,
14722412854,197.04750,16127027673,208802865,16127025830,-1843,,
14722463070,197.09772,16127077890,208853079,16127076044,-1846,,
14722513565,197.14821,16127128389,208903571,16127126537,-1852,,
14722563663,197.19831,16127178488,208953666,16127176631,-1857,,
14722614361,197.24901,16127229189,209004362,16127227328,-1861,,
14722664982,197.29963,16127279813,209054980,16127277946,-1867,,
14722715370,197.35002,16127330202,209105365,16127328330,-1872,,
14722766292,197.40094,16127381127,209156286,16127379251,-1876,,
14722816825,197.45147,16127431674,209206827,16127429793,-1881,,
14722867306,197.50195,16127482145,209257293,16127480258,-1887,,
14722918144,197.55279,16127532986,209308128,16127531094,-1892,,
14722968596,197.60324,16127583441,209358578,16127581544,-1897,,
14723018700,197.65335,16127633547,209408680,16127631645,-1902,,
14723069241,197.70389,16127684090,209459217,16127682183,-1907,,
14723119364,197.75401,16127734216,209509338,16127732303,-1913,,
14723169700,197.80435,16127784554,209559672,16127782637,-1917,,
14723219872,197.85452,16127834738,209609851,16127832816,-1922,,
14723270329,197.90498,16127885188,209660296,16127883261,-1927,,
14723320508,197.95516,16127935369,209710472,16127933437,-1932,,
14723370791,198.00544,16127985665,209760763,16127983729,-1936,,
14723421684,198.05633,16128036549,209811641,16128034606,-1943,,
14723472516,198.10716,16128087384,209862471,16128085437,-1947,,
14723523164,198.15781,16128138034,209913117,16128136082,-1952,,
14723573709,198.20836,16128188581,209963658,16128186623,-1958,,
14723624133,198.25878,16128239008,210014080,16128237046,-1962,,
14723675094,198.30974,16128289972,210065038,16128288004,-1968,,
14723725612,198.36026,16128340492,210115554,16128338520,-1972,,
14723775814,198.41046,16128390696,210165753,16128388719,-1977,,
14723826045,198.46069,16128440930,210215981,16128438947,-1983,,
14723877156,198.51180,16128492043,210267089,16128490055,-1988,,
14723927627,198.56227,16128542516,210317558,16128540523,-1993,,
14723977709,198.61236,16128592600,210367637,16128590602,-1998,,
14724028140,198.66279,16128643045,210418077,16128641042,-2003,,
14724078880,198.71353,16128693776,210468803,16128691768,-2008,,
14724129921,198.76457,16128744820,210519842,16128742807,-2013,,
14724180973,198.81562,16128795874,210570897,16128793862,-2012,,
14724231930,198.86658,16128846832,210621844,16128844809,-2023,,
14724282322,198.91697,16128897227,210672233,16128895198,-2029,,
14724332543,198.96719,16128947451,210722452,16128945418,-2033,,
14724383218,199.01787,16128998128,210773125,16128996090,-2038,,
14724433896,199.06854,16129048809,210823799,16129046765,-2044,,
14724484618,199.11927,16129099533,210874520,16129097485,-2048,,
14724535108,199.16976,16129150026,210925006,16129147972,-2054,,
14724585674,199.22032,16129200594,210975569,16129198535,-2059,,
14724636726,199.27137,16129251648,211026618,16129249584,-2064,,
14724686842,199.32149,16129301766,211076732,16129299697,-2069,,
14724737883,199.37253,16129352810,211127771,16129350736,-2074,,
14724788060,199.42271,16129402988,211177944,16129400909,-2079,,
14724838927,199.47358,16129453858,211228809,16129451774,-2084,,
14724889562,199.52421,16129504496,211279442,16129502407,-2089,,
14724939861,199.57451,16129554797,211329737,16129552703,-2094,,
14724990559,199.62521,16129605498,211380433,16129603399,-2099,,
14725040868,199.67552,16129655809,211430749,16129653714,-2095,,
14725091466,199.72611,16129706409,211481334,16129704300,-2109,,
14725141840,199.77649,16129756785,211531705,16129754670,-2115,,
14725192268,199.82692,16129807217,211582132,16129805098,-2119,,
14725243313,199.87796,16129858264,211633174,16129856140,-2124,,
14725293473,199.92812,16129908426,211683330,16129906296,-2130,,
14725343747,199.97840,16129958702,211733603,16129956568,-2134,,
14725394061,200.02871,16130009018,211783914,16130006879,-2139,,
14725444512,200.07916,16130059472,211834361,16130057327,-2145,,
14725495107,200.12975,16130110069,211884954,16130107920,-2149,,
14725545982,200.18063,16130160946,211935826,16130158792,-2154,,
14725596576,200.23122,16130211543,211986417,16130209383,-2160,,
14725646930,200.28158,16130261898,212036768,16130259734,-2164,,
14725697341,200.33199,16130312313,212087178,16130310144,-2169,,
14725747803,200.38245,16130362776,212137636,16130360601,-2175,,
14725798353,200.43300,16130413329,212188184,16130411149,-2180,,
14725848956,200.48360,16130463935,212238784,16130461750,-2185,,
14725899107,200.53376,16130514088,212288933,16130511898,-2190,,
14725949616,200.58426,16130564598,212339437,16130562403,-2195,,
14726000563,200.63521,16130615549,212390384,16130613349,-2200,,
14726050706,200.68535,16130665693,212440523,16130663488,-2205,,
14726101479,200.73613,16130716469,212491293,16130714258,-2211,,
14726152538,200.78719,16130767531,212542349,16130765315,-2216,,
14726203117,200.83776,16130818112,212592927,16130815892,-2220,,
14726253619,200.88827,16130868616,212643426,16130866391,-2225,,
14726303777,200.93842,16130918777,212693581,16130916546,-2231,,
14726354751,200.98940,16130969752,212744551,16130967517,-2235,,
14726405161,201.03981,16131020165,212794959,16131017925,-2240,,
14726455463,201.09011,16131070470,212845259,16131068224,-2246,,
14726505560,201.14021,16131120569,212895353,16131118318,-2251,,
14726556305,201.19095,16131171317,212946096,16131169061,-2256,,
14726606857,201.24150,16131221871,212996644,16131219610,-2261,,
14726656957,201.29161,16131271973,213046742,16131269707,-2266,,
14726707928,201.34258,16131322947,213097710,16131320676,-2271,,
14726758485,201.39313,16131373506,213148265,16131371230,-2276,,
14726808923,201.44357,16131423955,213198709,16131421674,-2281,,
14726859673,201.49432,16131474698,213249447,16131472412,-2286,,
14726910475,201.54512,16131525502,213300246,16131523211,-2291,,
14726961149,201.59580,16131576178,213350917,16131573882,-2296,,
14727011301,201.64595,16131626334,213401066,16131624032,-2302,,
14727061614,201.69626,16131676648,213451377,16131674343,-2305,,
14727112191,201.74684,16131727228,213501951,16131724917,-2311,,
14727162809,201.79746,16131777848,213552566,16131775531,-2317,,
14727213713,201.84836,16131828754,213603468,16131826433,-2321,,
14727264173,201.89882,16131879217,213653926,16131876891,-2326,,
14727314954,201.94960,16131930000,213704703,16131927669,-2331,,
14727365051,201.99970,16131980112,213754811,16131977776,-2336,,
14727415669,202.05032,16132030720,213805413,16132028379,-2341,,
14727466241,202.10089,16132081295,213855983,16132078949,-2346,,
14727516354,202.15100,16132131410,213906092,16132129058,-2352,,
14727566650,202.20130,16132181709,213956387,16132179352,-2357,,
14727617159,202.25181,16132232220,214006892,16132229858,-2362,,
14727667667,202.30231,16132282730,214057397,16132280362,-2368,,
14727718280,202.35293,16132333346,214108008,16132330974,-2372,,
14727768400,202.40305,16132383481,214158138,16132381104,-2377,,
14727819167,202.45381,16132434236,214208889,16132431854,-2382,,
14727869322,202.50397,16132484395,214259043,16132482008,-2387,,
14727919780,202.55443,16132534855,214309498,16132532464,-2391,,
14727970357,202.60501,16132585434,214360072,16132583037,-2397,,
14728021007,202.65565,16132636087,214410719,16132633684,-2403,,
14728071122,202.70577,16132686204,214460831,16132683796,-2408,,
14728121666,202.75631,16132736749,214511372,16132734337,-2412,,
14728172744,202.80739,16132787831,214562447,16132785413,-2418,,
14728223311,202.85796,16132838399,214613012,16132835978,-2421,,
14728273423,202.90807,16132888514,214663121,16132886087,-2427,,
14728323647,202.95829,16132938741,214713343,16132936308,-2433,,
14728373726,203.00837,16132988822,214763419,16132986385,-2437,,
14728424485,203.05913,16133039583,214814176,16133037141,-2442,,
14728475087,203.10974,16133090188,214864775,16133087740,-2448,,
14728525710,203.16036,16133140813,214915395,16133138360,-2453,,
14728576337,203.21098,16133191442,214966020,16133188985,-2457,,
14728627174,203.26182,16133242281,215016853,16133239818,-2463,,
14728677727,203.31238,16133292836,215067403,16133290368,-2468,,
14728728300,203.36295,16133343413,215117975,16133340940,-2473,,
14728778504,203.41315,16133393619,215168175,16133391141,-2478,,
14728829091,203.46374,16133444207,215218759,16133441724,-2483,,
14728880028,203.51468,16133495147,215269693,16133492659,-2488,,
14728930138,203.56479,16133545260,215319801,16133542767,-2493,,
14728980629,203.61528,16133595752,215370289,16133593255,-2497,,
14729030820,203.66547,16133645947,215420478,16133643443,-2504,,
14729080925,203.71557,16133696059,215470586,16133693551,-2508,,
14729131339,203.76599,16133746470,215520991,16133743957,-2513,,
14729181916,203.81656,16133797049,215571565,16133794530,-2519,,
14729232361,203.86701,16133847497,215622008,16133844974,-2523,,
14729283196,203.91784,16133898333,215672840,16133895805,-2528,,
14729333431,203.96808,16133948572,215723072,16133946038,-2534,,
14729383797,204.01845,16133998940,215773436,16133996402,-2538,,
14729434914,204.06956,16134050058,215824550,16134047515,-2543,,
14729485592,204.12024,16134100740,215875226,16134098191,-2549,,
14729536094,204.17074,16134151244,215925725,16134148690,-2554,,
14729586668,204.22132,16134201820,215976297,16134199262,-2558,,
14729637304,204.27195,16134252458,216026929,16134249894,-2564,,
14729687906,204.32255,16134303063,216077528,16134300493,-2570,,
14729738053,204.37270,16134353211,216127673,16134350638,-2573,,
14729788776,204.42342,16134403938,216178393,16134401359,-2579,,
14729839326,204.47397,16134454490,216228941,16134451907,-2583,,
14729889809,204.52446,16134504975,216279420,16134502386,-2589,,
14729940123,204.57477,16134555291,216329732,16134552697,-2594,,
14729990307,204.62495,16134605478,216379913,16134602879,-2599,,
14730040492,204.67514,16134655678,216430108,16134653074,-2604,,
14730090912,204.72556,16134706087,216480513,16134703478,-2609,,
14730141461,204.77611,16134756639,216531060,16134754025,-2614,,
14730192014,204.82666,16134807194,216581609,16134804575,-2619,,
14730242632,204.87728,16134857814,216632225,16134855190,-2624,,
14730292723,204.92737,16134907907,216682313,16134905279,-2628,,
14730343256,204.97790,16134958444,216732844,16134955809,-2635,,
14730393440,205.02809,16135008630,216783025,16135005990,-2640,,
14730443555,205.07820,16135058761,216833152,16135056117,-2644,,
14730494244,205.12889,16135109439,216883823,16135106789,-2650,,
14730545202,205.17985,16135160398,216934778,16135157743,-2655,,
14730595373,205.23002,16135210572,216984948,16135207913,-2659,,
14730646141,205.28079,16135261343,217035712,16135258678,-2665,,
14730696916,205.33156,16135312120,217086484,16135309450,-2670,,
14730747930,205.38258,16135363136,217137496,16135360461,-2675,,
14730798249,205.43290,16135413457,217187812,16135410777,-2680,,
14730848490,205.48314,16135463701,217238050,16135461016,-2685,,
14730898629,205.53328,16135513842,217288186,16135511152,-2690,,
14730949320,205.58397,16135564536,217338875,16135561841,-2695,,
14730999606,205.63425,16135614824,217389158,16135612124,-2700,,
14731049790,205.68444,16135665010,217439339,16135662304,-2706,,
14731100393,205.73504,16135715615,217489951,16135712916,-2699,,
14731150876,205.78552,16135766111,217540430,16135763396,-2715,,
14731201333,205.83598,16135816560,217590874,16135813839,-2721,,
14731251495,205.88614,16135866725,217641035,16135864000,-2725,,
14731302019,205.93667,16135917251,217691555,16135914521,-2730,,
14731352065,205.98671,16135967300,217741599,16135964564,-2736,,
14731402565,206.03721,16136017802,217792096,16136015061,-2741,,
14731453190,206.08784,16136068429,217842718,16136065684,-2745,,
14731503553,206.13820,16136118795,217893078,16136116044,-2751,,
14731554032,206.18868,16136169276,217943554,16136166520,-2756,,
14731604392,206.23904,16136219638,217993913,16136216878,-2760,,
14731654893,206.28954,16136270142,218044410,16136267376,-2766,,
14731705000,206.33965,16136320251,218094514,16136317480,-2771,,
14731755879,206.39053,16136371131,218145391,16136368356,-2775,,
14731806519,206.44117,16136421775,218196028,16136418994,-2781,,
14731857195,206.49184,16136472453,218246701,16136469667,-2786,,
14731907839,206.54249,16136523098,218297342,16136520307,-2791,,
14731958783,206.59343,16136574046,218348285,16136571250,-2796,,
14732008947,206.64360,16136624211,218398445,16136621410,-2801,,
14732059812,206.69446,16136675078,218449307,16136672272,-2806,,
14732110838,206.74549,16136726108,218500331,16136723297,-2811,,
14732161386,206.79603,16136776658,218550876,16136773842,-2816,,
14732211913,206.84656,16136827187,218601400,16136824366,-2821,,
14732262481,206.89713,16136877757,218651975,16136874940,-2817,,
14732312741,206.94739,16136928019,218702223,16136925188,-2831,,
14732362868,206.99752,16136978160,218752358,16136975323,-2837,,
14732413153,207.04780,16137028437,218802630,16137025595,-2842,,
14732463332,207.09798,16137078618,218852806,16137075772,-2846,,
14732513952,207.14860,16137129241,218903423,16137126389,-2852,,
14732564131,207.19878,16137179422,218953600,16137176565,-2857,,
14732614711,207.24936,16137230004,219004177,16137227143,-2861,,
14732665726,207.30037,16137281021,219055189,16137278154,-2867,,
14732715955,207.35060,16137331252,219105415,16137328380,-2872,,
14732766506,207.40115,16137381805,219155964,16137378929,-2876,,
14732817452,207.45210,16137432755,219206908,16137429873,-2882,,
14732867901,207.50255,16137483205,219257352,16137480318,-2887,,
14732918377,207.55302,16137533693,219307836,16137530801,-2892,,
14732968544,207.60319,16137583853,219357991,16137580956,-2897,,
14733018752,207.65340,16137634064,219408196,16137631161,-2903,,
14733068988,207.70364,16137684301,219458429,16137681394,-2907,,
14733119617,207.75427,16137734934,219509056,16137732022,-2912,,
14733170439,207.80509,16137785757,219559875,16137782841,-2916,,
14733221125,207.85577,16137836446,219610558,16137833524,-2922,,
14733271566,207.90621,16137886889,219660997,16137883962,-2927,,
14733322350,207.95700,16137937676,219711778,16137934744,-2932,,
14733372508,208.00716,16137987836,219761933,16137984899,-2937,,
14733422623,208.05727,16138037954,219812046,16138035011,-2943,,
14733473039,208.10769,16138088372,219862460,16138085425,-2947,,
14733523368,208.15802,16138138703,219912785,16138135750,-2953,,
14733573862,208.20851,16138189200,219963277,16138186242,-2958,,
14733623987,208.25863,16138239327,220013400,16138236365,-2962,,
14733674473,208.30912,16138289815,220063882,16138286847,-2968,,
14733724963,208.35961,16138340308,220114369,16138337335,-2973,,
14733775314,208.40996,16138390660,220164718,16138387683,-2977,,
14733826162,208.46081,16138441512,220215563,16138438529,-2983,,
14733876326,208.51097,16138491678,220265724,16138488690,-2988,,
14733926749,208.56140,16138542102,220316144,16138539110,-2992,,
14733977239,208.61189,16138592595,220366632,16138589597,-2998,,
14734027444,208.66209,16138642803,220416835,16138639800,-3003,,
14734077884,208.71253,16138693245,220467271,16138690236,-3009,,
14734128429,208.76308,16138743793,220517815,16138740780,-3013,,
14734179657,208.81430,16138795022,220569039,16138792004,-3018,,
14734230107,208.86476,16138845475,220619486,16138842452,-3023,,
14734280680,208.91533,16138896051,220670057,16138893023,-3028,,
14734331292,208.96594,16138946665,220720668,16138943633,-3032,,
14734381914,209.01656,16138997289,220771286,16138994251,-3038,,
14734432949,209.06760,16139048327,220822317,16139045282,-3045,,
14734483575,209.11822,16139098954,220872941,16139095907,-3047,,
14734534185,209.16883,16139149567,220923548,16139146514,-3053,,
14734584771,209.21942,16139200156,220974131,16139197097,-3059,,
14734635820,209.27047,16139251207,221025178,16139248144,-3063,,
14734686380,209.32103,16139301770,221075735,16139298701,-3069,,
14734737337,209.37198,16139352728,221126689,16139349655,-3073,,
14734788397,209.42305,16139403790,221177746,16139400711,-3079,,
14734839421,209.47407,16139454818,221228769,16139451734,-3084,,
14734890022,209.52467,16139505421,221279366,16139502332,-3089,,
14734940653,209.57530,16139556054,221329994,16139552960,-3094,,
14734991672,209.62632,16139607076,221381011,16139603976,-3100,,
14735042010,209.67666,16139657416,221431346,16139654311,-3105,,
14735092568,209.72722,16139707976,221481902,16139704867,-3109,,
14735143584,209.77823,16139758994,221532914,16139755879,-3115,,
14735194666,209.82931,16139810079,221583994,16139806959,-3120,,
14735245662,209.88031,16139861078,221634988,16139857953,-3125,,
14735296681,209.93133,16139912099,221686004,16139908969,-3130,,
14735347166,209.98181,16139962586,221736485,16139959451,-3135,,
14735397798,210.03245,16140013221,221787126,16140010091,-3130,,
14735448419,210.08307,16140063844,221837733,16140060698,-3146,,
14735498930,210.13358,16140114356,221888241,16140111206,-3150,,
14735549034,210.18368,16140164464,221938343,16140161308,-3156,,
14735599596,210.23424,16140215027,221988902,16140211867,-3160,,
14735649754,210.28440,16140265188,222039069,16140262034,-3154,,
14735700363,210.33501,16140315800,222089664,16140312630,-3170,,
14735751374,210.38602,16140366812,222140672,16140363637,-3175,,
14735802422,210.43707,16140417863,222191717,16140414693,-3170,,
14735853404,210.48805,16140468848,222242696,16140465662,-3186,,
14735904046,210.53869,16140519492,222293336,16140516302,-3190,,
14735954603,210.58925,16140570052,222343890,16140566856,-3196,,
14736005671,210.64032,16140621122,222394956,16140617921,-3201,,
14736056277,210.69092,16140671730,222445559,16140668524,-3206,,
14736106814,210.74146,16140722270,222496094,16140719059,-3211,,
14736156864,210.79151,16140772322,222546140,16140769106,-3216,,
14736207409,210.84206,16140822869,222596683,16140819648,-3221,,
14736257482,210.89213,16140872944,222646753,16140869718,-3226,,
14736307627,210.94227,16140923092,222696895,16140919861,-3231,,
14736358100,210.99275,16140973566,222747365,16140970330,-3236,,
14736409210,211.04386,16141024680,222798474,16141021439,-3241,,
14736459771,211.09442,16141075243,222849031,16141072007,-3236,,
14736510373,211.14502,16141125847,222899630,16141122596,-3251,,
14736560528,211.19518,16141176005,222949784,16141172749,-3256,,
14736611621,211.24627,16141227100,223000874,16141223839,-3261,,
14736662276,211.29692,16141277757,223051525,16141274491,-3266,,
14736713168,211.34782,16141328651,223102414,16141325379,-3272,,
14736764216,211.39886,16141379701,223153460,16141376426,-3275,,
14736814290,211.44894,16141429778,223203530,16141426496,-3282,,
14736864876,211.49952,16141480367,223254114,16141477080,-3287,,
14736915462,211.55011,16141530955,223304698,16141527675,-3280,,
14736966110,211.60076,16141581606,223355344,16141578309,-3297,,
14737016674,211.65132,16141632172,223405904,16141628869,-3303,,
14737066793,211.70144,16141682293,223456020,16141678985,-3308,,
14737117352,211.75200,16141732866,223506589,16141729554,-3312,,
14737167992,211.80264,16141783497,223557214,16141780180,-3317,,
14737218558,211.85321,16141834065,223607777,16141830743,-3322,,
14737268759,211.90341,16141884268,223657976,16141880941,-3327,,
14737319280,211.95393,16141934792,223708494,16141931460,-3332,,
14737369837,212.00448,16141985351,223759048,16141982014,-3337,,
14737420416,212.05506,16142035943,223809635,16142032601,-3342,,
14737471452,212.10610,16142086981,223860669,16142083634,-3347,,
14737522070,212.15672,16142137600,223911283,16142134249,-3351,,
14737572625,212.20727,16142188148,223961825,16142184790,-3358,,
14737623713,212.25836,16142239240,224012912,16142235878,-3362,,
14737674318,212.30897,16142289847,224063514,16142286479,-3368,,
14737724700,212.35935,16142340231,224113892,16142336858,-3373,,
14737775762,212.41041,16142391295,224164952,16142387918,-3377,,
14737826098,212.46075,16142441634,224215285,16142438251,-3383,,
14737876250,212.51090,16142491788,224265434,16142488400,-3388,,
14737927302,212.56195,16142542842,224316483,16142539449,-3393,,
14737978281,212.61293,16142593824,224367460,16142590426,-3398,,
14738029376,212.66402,16142644921,224418552,16142641518,-3403,,
14738080426,212.71507,16142695973,224469600,16142692565,-3408,,
14738131439,212.76609,16142746988,224520610,16142743576,-3412,,
14738181974,212.81662,16142797526,224571143,16142794108,-3418,,
14738232022,212.86667,16142847576,224621187,16142844153,-3423,,
14738282407,212.91706,16142897964,224671569,16142894535,-3429,,
14738332535,212.96718,16142948093,224721695,16142944661,-3432,,
14738382725,213.01737,16142998286,224771893,16142994858,-3428,,
14738433662,213.06831,16143049225,224822816,16143045781,-3444,,
14738484274,213.11892,16143099840,224873426,16143096392,-3448,,
14738534839,213.16949,16143150407,224923987,16143146953,-3454,,
14738585470,213.22012,16143201041,224974616,16143197582,-3459,,
14738635998,213.27065,16143251581,225025152,16143248118,-3463,,
14738686416,213.32106,16143301991,225075557,16143298523,-3468,,
14738737020,213.37167,16143352597,225126158,16143349123,-3474,,
14738787591,213.42224,16143403171,225176727,16143399692,-3479,,
14738838212,213.47286,16143453794,225227345,16143450310,-3484,,
14738889238,213.52389,16143504822,225278368,16143501333,-3489,,
14738939842,213.57449,16143555428,225328968,16143551934,-3494,,
14738990930,213.62558,16143606520,225380055,16143603020,-3500,,
14739041938,213.67659,16143657530,225431060,16143654026,-3504,,
14739092083,213.72673,16143707676,225481202,16143704167,-3509,,
14739143138,213.77779,16143758734,225532264,16143755230,-3504,,
14739194160,213.82881,16143809758,225583274,16143806240,-3518,,
14739245253,213.87990,16143860855,225634364,16143857330,-3525,,
14739296272,213.93092,16143911875,225685380,16143908345,-3530,,
14739346899,213.98155,16143962504,225736004,16143958969,-3535,,
14739397964,214.03261,16144013573,225787068,16144010033,-3540,,
14739448544,214.08319,16144064155,225837645,16144060610,-3545,,
14739499145,214.13379,16144114757,225888242,16144111207,-3550,,
14739549733,214.18438,16144165348,225938828,16144161793,-3555,,
14739600298,214.23495,16144215927,225989401,16144212366,-3561,,
14739650858,214.28551,16144266478,226039947,16144262913,-3565,,
14739701875,214.33652,16144317497,226090961,16144313926,-3571,,
14739752938,214.38759,16144368575,226142035,16144365001,-3574,,
14739803981,214.43863,16144419608,226193062,16144416027,-3581,,
14739855057,214.48970,16144470687,226244135,16144467100,-3587,,
14739906122,214.54077,16144521754,226295199,16144518164,-3590,,
14739957156,214.59180,16144572791,226346230,16144569195,-3596,,
14740007796,214.64244,16144623432,226396866,16144619832,-3600,,
14740058336,214.69298,16144673975,226447403,16144670369,-3606,,
14740109343,214.74399,16144724985,226498408,16144721374,-3611,,
14740160395,214.79504,16144776039,226549457,16144772423,-3616,,
14740210448,214.84510,16144826094,226599507,16144822473,-3621,,
14740261504,214.89615,16144877153,226650562,16144873527,-3626,,
14740311638,214.94629,16144927289,226700693,16144923658,-3631,,
14740361789,214.99644,16144977441,226750840,16144973805,-3636,,
14740412373,215.04702,16145028029,226801421,16145024387,-3642,,
14740463004,215.09765,16145078661,226852060,16145075025,-3636,,
14740513554,215.14820,16145129215,226902598,16145125563,-3652,,
14740564400,215.19905,16145180063,226953441,16145176406,-3657,,
14740614834,215.24948,16145230499,227003873,16145226838,-3661,,
14740665453,215.30010,16145281121,227054488,16145277454,-3667,,
14740715929,215.35058,16145331599,227104962,16145327927,-3672,,
14740766045,215.40069,16145381717,227155076,16145378041,-3676,,
14740816854,215.45150,16145432529,227205882,16145428847,-3682,,
14740867964,215.50261,16145483640,227256988,16145479954,-3686,,
14740918962,215.55361,16145534641,227307983,16145530949,-3692,,
14740969986,215.60463,16145585667,227359005,16145581970,-3697,,
14741020418,215.65507,16145636102,227409435,16145632400,-3702,,
14741071008,215.70566,16145686693,227460021,16145682987,-3706,,
14741122532,215.75718,16145738221,227511542,16145734508,-3713,,
14741173568,215.80822,16145789258,227562576,16145785542,-3716,,
14741224603,215.85925,16145840296,227613607,16145836573,-3723,,
14741275586,215.91023,16145891281,227664588,16145887553,-3728,,
14741326164,215.96081,16145941862,227715164,16145938130,-3732,,
14741377212,216.01186,16145992913,227766209,16145989175,-3738,,
14741427802,216.06245,16146043504,227816795,16146039761,-3743,,
14741478423,216.11307,16146094127,227867414,16146090380,-3747,,
14741529472,216.16412,16146145181,227918463,16146141428,-3753,,
14741579828,216.21448,16146195538,227968814,16146191780,-3758,,
14741630391,216.26504,16146246103,228019375,16146242340,-3763,,
14741681373,216.31602,16146297088,228070354,16146293320,-3768,,
14741732448,216.36710,16146348164,228121426,16146344392,-3772,,
14741783457,216.41810,16146399177,228172432,16146395398,-3779,,
14741834010,216.46866,16146449732,228222982,16146445948,-3784,,
14741884560,216.51921,16146500293,228273540,16146496506,-3787,,
14741935146,216.56979,16146550872,228324113,16146547078,-3794,,
14741986199,216.62085,16146601928,228375163,16146598129,-3799,,
14742036388,216.67104,16146652118,228425350,16146648315,-3803,,
14742086842,216.72149,16146702576,228475801,16146698767,-3809,,
14742137394,216.77204,16146753129,228526350,16146749315,-3814,,
14742187469,216.82212,16146803207,228576424,16146799389,-3818,,
14742238200,216.87285,16146853941,228627151,16146850117,-3824,,
14742289033,216.92368,16146904776,228677981,16146900947,-3829,,
14742339082,216.97373,16146954826,228728027,16146950993,-3833,,
14742389653,217.02430,16147005401,228778597,16147001562,-3839,,
14742440292,217.07494,16147056042,228829232,16147052197,-3845,,
14742491023,217.12567,16147106775,228879961,16147102926,-3849,,
14742541584,217.17623,16147157338,228930519,16147153484,-3854,,
14742592681,217.22733,16147208438,228981613,16147204579,-3859,,
14742643692,217.27834,16147259452,229032622,16147255587,-3865,,
14742694731,217.32938,16147310493,229083657,16147306623,-3870,,
14742744791,217.37944,16147360554,229133715,16147356680,-3874,,
14742794841,217.42949,16147410608,229183763,16147406728,-3880,,
14742845376,217.48002,16147461144,229234294,16147457259,-3885,,
14742896426,217.53107,16147512197,229285342,16147508308,-3889,,
14742946499,217.58115,16147562284,229335423,16147558389,-3895,,
14742997610,217.63226,16147613385,229386520,16147609486,-3899,,
14743048507,217.68315,16147664285,229437414,16147660380,-3905,,
14743099065,217.73371,16147714846,229487970,16147710936,-3910,,
14743149602,217.78425,16147765385,229538504,16147761470,-3915,,
14743200629,217.83528,16147816413,229589528,16147812493,-3920,,
14743250686,217.88533,16147866473,229639582,16147862548,-3925,,
14743301783,217.93643,16147917572,229690677,16147913642,-3930,,
14743352837,217.98748,16147968629,229741728,16147964693,-3936,,
14743403382,218.03803,16148019177,229792270,16148015236,-3941,,
14743454416,218.08906,16148070213,229843303,16148066268,-3945,,
14743505028,218.13968,16148120827,229893911,16148116876,-3951,,
14743555620,218.19027,16148171422,229944500,16148167466,-3956,,
14743606340,218.24099,16148222144,229995219,16148218184,-3960,,
14743657406,218.29205,16148273213,230046282,16148269248,-3965,,
14743708455,218.34310,16148324264,230097328,16148320293,-3971,,
14743758987,218.39363,16148374798,230147857,16148370822,-3976,,
14743810019,218.44467,16148425833,230198887,16148421853,-3980,,
14743860611,218.49526,16148476427,230249475,16148472441,-3986,,
14743911154,218.54580,16148526973,230300015,16148522981,-3992,,
14743961670,218.59632,16148577491,230350530,16148573495,-3996,,
14744012251,218.64690,16148628074,230401108,16148624073,-4001,,
14744063282,218.69793,16148679119,230452147,16148675112,-4007,,
14744114334,218.74898,16148730162,230503184,16148726149,-4013,,
14744165559,218.80021,16148781388,230554407,16148777373,-4015,,
14744222280,218.85693,16148838112,230611125,16148834090,-4022,,
14744276443,218.91109,16148892279,230665286,16148888251,-4028,,
14744326494,218.96114,16148942332,230715334,16148938299,-4033,,
14744376557,219.01120,16148992397,230765394,16148988359,-4038,,
14744427327,219.06197,16149043170,230816162,16149039127,-4043,,
14744477640,219.11229,16149093485,230866471,16149089437,-4048,,
14744528692,219.16334,16149144539,230917520,16149140486,-4053,,
14744579313,219.21396,16149195163,230968139,16149191105,-4058,,
14744629581,219.26423,16149245433,231018404,16149241370,-4063,,
14744681152,219.31580,16149297007,231069973,16149292938,-4069,,
14744731246,219.36589,16149347103,231120063,16149343029,-4074,,
14744781522,219.41617,16149397380,231170337,16149393302,-4078,,
14744832210,219.46686,16149448070,231221022,16149443988,-4082,,
14744882866,219.51751,16149498730,231271676,16149494641,-4089,,
14744933189,219.56784,16149549054,231321996,16149544961,-4093,,
14744983333,219.61798,16149599201,231372137,16149595103,-4098,,
14745033859,219.66851,16149649730,231422660,16149645626,-4104,,
14745085266,219.71991,16149701138,231474064,16149697029,-4109,,
14745139163,219.77381,16149755039,231527959,16149750924,-4115,,
14745189342,219.82399,16149805220,231578135,16149801101,-4119,,
14745239612,219.87426,16149855491,231628402,16149851367,-4124,,
14745290421,219.92507,16149906303,231679208,16149902174,-4129,,
14745342823,219.97747,16149958707,231731608,16149954574,-4133,,
14745394664,220.02931,16150010551,231783446,16150006412,-4139,,
14745445500,220.08015,16150061389,231834279,16150057245,-4144,,
14745495903,220.13055,16150111795,231884681,16150107646,-4149,,
14745546344,220.18099,16150162239,231935119,16150158084,-4155,,
14745596663,220.23131,16150212559,231985434,16150208399,-4160,,
14745647073,220.28172,16150262971,232035841,16150258807,-4164,,
14745697476,220.33212,16150313377,232086242,16150309207,-4170,,
14745747895,220.38254,16150363798,232136658,16150359623,-4175,,
14745798273,220.43292,16150414179,232187033,16150409998,-4181,,
14745848476,220.48312,16150464385,232237234,16150460199,-4186,,
14745898914,220.53356,16150514824,232287669,16150510634,-4190,,
14745949406,220.58405,16150565318,232338158,16150561123,-4195,,
14745999738,220.63439,16150615654,232388488,16150611454,-4200,,
14746050045,220.68469,16150665963,232438793,16150661758,-4205,,
14746100515,220.73516,16150716435,232489260,16150712225,-4210,,
14746151017,220.78566,16150766940,232539758,16150762724,-4216,,
14746201301,220.83595,16150817227,232590042,16150813007,-4220,,
14746252529,220.88718,16150868456,232641265,16150864231,-4225,,
14746302864,220.93751,16150918793,232691597,16150914562,-4231,,
14746353525,220.98817,16150969457,232742256,16150965222,-4235,,
14746403830,221.03848,16151019764,232792558,16151015524,-4240,,
14746454025,221.08867,16151069962,232842750,16151065715,-4247,,
14746504535,221.13918,16151120474,232893258,16151116224,-4250,,
14746554877,221.18953,16151170818,232943597,16151166563,-4255,,
14746605579,221.24023,16151221522,232994296,16151217261,-4261,,
14746656143,221.29079,16151272088,233044857,16151267823,-4265,,
14746706667,221.34132,16151322615,233095379,16151318345,-4270,,
14746756985,221.39163,16151372936,233145695,16151368660,-4276,,
14746807458,221.44211,16151423411,233196164,16151419130,-4281,,
14746858311,221.49296,16151474266,233247015,16151469980,-4286,,
14746908619,221.54327,16151524577,233297320,16151520286,-4291,,
14746959312,221.59396,16151575272,233348010,16151570976,-4296,,
14747009450,221.64410,16151625413,233398147,16151621112,-4301,,
14747059555,221.69420,16151675520,233448248,16151671213,-4307,,
14747110508,221.74516,16151726474,233499198,16151722164,-4310,,
14747161120,221.79577,16151777090,233549808,16151772773,-4317,,
14747211719,221.84637,16151827690,233600404,16151823369,-4321,,
14747262318,221.89697,16151878291,233651000,16151873965,-4326,,
14747313138,221.94779,16151929114,233701817,16151924782,-4332,,
14747363600,221.99825,16151979578,233752277,16151975242,-4336,,
14747414086,222.04873,16152030066,233802760,16152025726,-4340,,
14747464615,222.09926,16152080598,233853286,16152076252,-4346,,
14747515258,222.14991,16152131244,233903926,16152126892,-4352,,
14747565406,222.20005,16152181393,233954072,16152177037,-4356,,
14747615523,222.25017,16152231513,234004186,16152227151,-4362,,
14747665775,222.30042,16152281768,234054435,16152277401,-4367,,
14747716314,222.35096,16152332309,234104972,16152327938,-4371,,
14747766617,222.40126,16152382615,234155272,16152378238,-4377,,
14747816856,222.45150,16152432855,234205507,16152428473,-4382,,
14747867715,222.50236,16152483718,234256365,16152479331,-4387,,
14747918213,222.55286,16152534217,234306860,16152529826,-4391,,
14747969090,222.60374,16152585097,234357734,16152580700,-4397,,
14748019578,222.65423,16152635587,234408219,16152631184,-4403,,
14748070601,222.70525,16152686612,234459240,16152682205,-4407,,
14748120766,222.75541,16152736780,234509403,16152732369,-4411,,
14748171090,222.80574,16152787107,234559723,16152782688,-4419,,
14748221775,222.85642,16152837793,234610406,16152833371,-4422,,
14748272309,222.90696,16152888330,234660938,16152883903,-4427,,
14748322816,222.95746,16152938840,234711442,16152934407,-4433,,
14748373021,223.00767,16152989047,234761645,16152984610,-4437,,
14748423116,223.05776,16153039144,234811736,16153034702,-4442,,
14748473240,223.10789,16153089271,234861857,16153084823,-4448,,
14748523788,223.15844,16153139821,234912404,16153135369,-4452,,
14748574877,223.20953,16153190911,234963489,16153186454,-4457,,
14748625338,223.25999,16153241376,235013948,16153236913,-4463,,
14748675942,223.31059,16153291982,235064549,16153287514,-4468,,
14748726986,223.36163,16153343028,235115591,16153338556,-4472,,
14748777551,223.41220,16153393596,235166153,16153389118,-4478,,
14748828450,223.46310,16153444496,235217047,16153440013,-4483,,
14748878937,223.51359,16153494987,235267534,16153490499,-4488,,
14748929725,223.56437,16153545777,235318319,16153541284,-4493,,
14748980442,223.61509,16153596496,235369032,16153591998,-4498,,
14749030550,223.66520,16153646617,235419147,16153642113,-4504,,
14749081087,223.71573,16153697146,235469672,16153692638,-4508,,
14749131358,223.76601,16153747419,235519940,16153742906,-4513,,
14749182035,223.81668,16153798099,235570614,16153793579,-4520,,
14749233033,223.86768,16153849099,235621611,16153844576,-4523,,
14749283628,223.91828,16153899696,235672203,16153895168,-4528,,
14749333801,223.96845,16153949872,235722373,16153945338,-4534,,
14749384346,224.01899,16154000419,235772915,16153995880,-4539,,
14749434976,224.06962,16154051050,235823542,16154046507,-4543,,
14749486064,224.12071,16154102142,235874627,16154097593,-4549,,
14749537036,224.17168,16154153116,235925596,16154148562,-4554,,
14749588033,224.22268,16154204115,235976592,16154199557,-4558,,
14749639072,224.27372,16154255157,236027627,16154250593,-4564,,
14749689600,224.32425,16154305687,236078152,16154301118,-4569,,
14749739692,224.37434,16154355781,236128241,16154351206,-4575,,
14749790728,224.42538,16154406820,236179275,16154402240,-4580,,
14749840856,224.47550,16154456950,236229401,16154452366,-4584,,
14749891447,224.52609,16154507543,236279988,16154502953,-4590,,
14749942012,224.57666,16154558111,236330552,16154553517,-4594,,
14749992565,224.62721,16154608666,236381102,16154604067,-4599,,
14750043123,224.67777,16154659227,236431657,16154654623,-4604,,
14750093852,224.72850,16154709958,236482383,16154705348,-4610,,
14750144038,224.77869,16154760146,236532567,16154755532,-4614,,
14750194621,224.82927,16154810733,236583147,16154806113,-4620,,
14750245118,224.87977,16154861232,236633641,16154856606,-4626,,
14750295661,224.93031,16154911776,236684182,16154907147,-4629,,
14750346610,224.98126,16154962728,236735128,16154958093,-4635,,
14750397499,225.03215,16155013619,236786014,16155008979,-4640,,
14750447562,225.08221,16155063684,236836075,16155059040,-4644,,
14750498169,225.13282,16155114294,236886678,16155109644,-4650,,
14750548699,225.18335,16155164837,236937217,16155160182,-4655,,
14750599783,225.23443,16155215913,236988286,16155211251,-4662,,
14750650718,225.28537,16155266850,237039220,16155262185,-4665,,
14750701546,225.33619,16155317690,237090055,16155313021,-4669,,
14750752603,225.38725,16155368751,237141109,16155364075,-4676,,
14750803628,225.43828,16155419766,237192121,16155415087,-4679,,
14750853694,225.48834,16155469835,237242185,16155465150,-4685,,
14750904308,225.53896,16155520452,237292795,16155515761,-4691,,
14750955354,225.59000,16155571499,237343838,16155566803,-4696,,
14751005942,225.64059,16155622090,237394425,16155617390,-4700,,
14751056987,225.69163,16155673138,237445466,16155668432,-4706,,
14751108041,225.74269,16155724194,237496517,16155719483,-4711,,
14751158136,225.79278,16155774292,237546611,16155769576,-4716,,
14751208201,225.84285,16155824358,237596672,16155819637,-4721,,
14751258344,225.89299,16155874504,237646813,16155869778,-4726,,
14751309074,225.94372,16155925236,237697540,16155920505,-4731,,
14751360126,225.99477,16155976291,237748589,16155971555,-4736,,
14751410660,226.04531,16156026826,237799120,16156022085,-4741,,
14751461095,226.09574,16156077265,237849553,16156072518,-4747,,
14751511568,226.14622,16156127739,237900023,16156122989,-4750,,
14751561860,226.19651,16156178034,237950313,16156173278,-4756,,
14751612430,226.24708,16156228606,238000879,16156223844,-4762,,
14751663008,226.29766,16156279187,238051455,16156274421,-4766,,
14751713547,226.34820,16156329728,238101992,16156324957,-4771,,
14751764094,226.39874,16156380277,238152535,16156375500,-4777,,
14751815145,226.44979,16156431331,238203583,16156426549,-4782,,
14751865652,226.50030,16156481840,238254088,16156477054,-4786,,
14751916211,226.55086,16156532401,238304644,16156527609,-4792,,
14751966287,226.60093,16156582480,238354718,16156577683,-4797,,
14752017340,226.65199,16156633535,238405769,16156628734,-4801,,
14752068419,226.70307,16156684616,238456844,16156679810,-4806,,
14752119431,226.75408,16156735631,238507854,16156730819,-4812,,
14752170436,226.80508,16156786639,238558856,16156781821,-4818,,
14752221475,226.85612,16156837679,238609891,16156832857,-4822,,
14752280666,226.91531,16156896873,238669080,16156892046,-4827,,
14752331609,226.96626,16156947819,238720020,16156942986,-4833,,
14752382147,227.01680,16156998359,238770555,16156993521,-4838,,
14752433192,227.06784,16157049407,238821597,16157044563,-4844,,
14752484249,227.11890,16157100465,238872652,16157095617,-4848,,
14752534779,227.16943,16157150998,238923179,16157146144,-4854,,
14752584841,227.21949,16157201062,238973238,16157196203,-4859,,
14752635918,227.27057,16157252141,239024312,16157247278,-4863,,
14752695743,227.33039,16157311970,239084134,16157307100,-4870,,
14752746483,227.38113,16157362712,239134872,16157357838,-4874,,
14752796543,227.43119,16157412775,239184930,16157407895,-4880,,
14752847592,227.48224,16157463826,239235975,16157458941,-4885,,
14752898245,227.53289,16157514481,239286625,16157509591,-4890,,
14752948655,227.58330,16157564894,239337033,16157559999,-4895,,
14753004817,227.63947,16157621058,239393192,16157616158,-4900,,
14753055788,227.69044,16157672032,239444160,16157667126,-4906,,
14753106827,227.74148,16157723073,239495196,16157718162,-4911,,
14753157867,227.79252,16157774115,239546235,16157769200,-4915,,
14753207916,227.84256,16157824167,239596280,16157819245,-4922,,
14753273340,227.90799,16157889594,239661701,16157884666,-4928,,
14753326457,227.96111,16157942712,239714815,16157937780,-4932,,
14753386039,228.02069,16158002298,239774393,16157997359,-4939,,
14753445596,228.08024,16158061858,239833947,16158056912,-4946,,
14753500204,228.13485,16158116468,239888552,16158111517,-4951,,
14753551814,228.18646,16158168081,239940161,16158163126,-4955,,
14753604043,228.23869,16158220312,239992386,16158215351,-4961,,
14753655665,228.29031,16158271937,240044005,16158266971,-4966,,
14753710915,228.34556,16158327189,240099252,16158322218,-4971,,
14753761769,228.39642,16158378046,240150104,16158373069,-4977,,
14753812804,228.44745,16158429082,240201136,16158424101,-4981,,
14753863356,228.49800,16158479636,240251685,16158474650,-4986,,
14753917434,228.55208,16158533717,240305760,16158528725,-4992,,
14753967716,228.60236,16158584002,240356039,16158579005,-4997,,
14754029563,228.66421,16158645851,240417883,16158640848,-5003,,
14754080366,228.71501,16158696656,240468683,16158691648,-5008,,
14754130925,228.76557,16158747224,240519245,16158742211,-5013,,
14754181133,228.81578,16158797429,240569446,16158792411,-5018,,
14754231414,228.86606,16158847712,240619723,16158842689,-5023,,
14754284924,228.91957,16158901225,240673230,16158896196,-5029,,
14754358705,228.99335,16158975009,240747007,16158969972,-5037,,
14754409104,229.04375,16159025411,240797404,16159020369,-5042,,
14754460924,229.09557,16159077232,240849221,16159072186,-5046,,
14754524880,229.15953,16159141192,240913173,16159136139,-5053,,
14754575553,229.21020,16159191866,240963844,16159186809,-5057,,
14754630851,229.26550,16159247167,241019139,16159242104,-5063,,
14754681700,229.31635,16159298018,241069985,16159292950,-5068,,
14754736079,229.37073,16159352400,241124361,16159347326,-5074,,
14754786681,229.42133,16159403005,241174960,16159397926,-5079,,
14754838857,229.47350,16159455183,241227134,16159450099,-5084,,
14754889399,229.52405,16159505728,241277674,16159500639,-5089,,
14754939605,229.57425,16159555935,241327876,16159550841,-5094,,
14754990392,229.62504,16159606725,241378661,16159601626,-5099,,
14755042912,229.67756,16159659247,241431178,16159654143,-5104,,
14755093328,229.72798,16159709665,241481591,16159704556,-5109,,
14755145604,229.78025,16159761945,241533865,16159756830,-5115,,
14755196048,229.83070,16159812391,241584306,16159807272,-5119,,
14755249818,229.88447,16159866163,241638073,16159861038,-5125,,
14755300123,229.93477,16159916470,241688375,16159911341,-5129,,
14755350469,229.98512,16159966819,241738718,16159961684,-5135,,
14755400948,230.03560,16160017300,241789194,16160012160,-5140,,
14755452003,230.08665,16160068358,241840247,16160063213,-5145,,
14755529087,230.16374,16160145445,241917327,16160140292,-5153,,
14755579426,230.21407,16160195786,241967663,16160190629,-5157,,
14755629821,230.26447,16160246183,242018054,16160241020,-5163,,
14755680474,230.31512,16160296839,242068706,16160291671,-5168,,
14755730773,230.36542,16160347141,242119003,16160341969,-5172,,
14755781040,230.41569,16160397410,242169267,16160392232,-5178,,
14755832326,230.46697,16160448698,242220550,16160443515,-5183,,
14755882630,230.51728,16160499005,242270852,16160493817,-5188,,
14755932804,230.56745,16160549181,242321022,16160543987,-5194,,
14755983207,230.61785,16160599586,242371422,16160594387,-5199,,
14756033532,230.66818,16160649914,242421745,16160644711,-5203,,
14756084043,230.71869,16160700428,242472253,16160695218,-5210,,
14756134675,230.76932,16160751061,242522882,16160745847,-5214,,
14756184962,230.81961,16160801351,242573167,16160796133,-5218,,
14756235636,230.87028,16160852028,242623838,16160846804,-5224,,
14756285944,230.92059,16160902337,242674143,16160897108,-5229,,
14756336564,230.97121,16160952960,242724761,16160947727,-5233,,
14756386843,231.02149,16161003241,242775037,16160998002,-5239,,
14756437522,231.07217,16161053923,242825713,16161048679,-5244,,
14756508876,231.14352,16161125279,242897063,16161120028,-5251,,
14756558898,231.19355,16161175304,242947083,16161170048,-5256,,
14756610064,231.24471,16161226473,242998246,16161221212,-5261,,
14756665571,231.30022,16161281983,243053750,16161276716,-5267,,
14756717712,231.35236,16161334126,243105888,16161328854,-5272,,
14756774867,231.40951,16161391283,243163040,16161386005,-5278,,
14756825999,231.46065,16161442417,243214169,16161437134,-5283,,
14756876334,231.51098,16161492754,243264502,16161487467,-5287,,
14756926833,231.56148,16161543257,243314998,16161537964,-5293,,
14756977453,231.61210,16161593878,243365615,16161588580,-5298,,
14757027813,231.66246,16161644240,243415972,16161638938,-5302,,
14757078098,231.71275,16161694529,243466256,16161689221,-5308,,
14757128518,231.76317,16161744950,243516671,16161739637,-5313,,
14757179227,231.81387,16161795662,243567379,16161790344,-5318,,
14757229559,231.86421,16161845997,243617708,16161840674,-5323,,
14757279847,231.91449,16161896287,243667993,16161890959,-5328,,
14757330469,231.96512,16161946911,243718611,16161941577,-5334,,
14757380893,232.01554,16161997337,243769034,16161991999,-5338,,
14757431267,232.06591,16162047713,243819405,16162042370,-5343,,
14757481856,232.11650,16162098306,243869991,16162092957,-5349,,
14757532138,232.16679,16162148589,243920271,16162143236,-5353,,
14757582422,232.21707,16162198875,243970552,16162193517,-5358,,
14757633081,232.26773,16162249538,244021209,16162244174,-5364,,
14757683412,232.31806,16162299870,244071536,16162294501,-5369,,
14757733981,232.36863,16162350442,244122104,16162345069,-5373,,
14757784686,232.41933,16162401150,244172805,16162395771,-5379,,
14757836422,232.47107,16162452887,244224538,16162447504,-5383,,
14757886827,232.52148,16162503294,244274941,16162497907,-5387,,
14757937385,232.57203,16162553855,244325496,16162548462,-5393,,
14757988521,232.62317,16162604993,244376629,16162599594,-5399,,
14758039118,232.67377,16162655592,244427223,16162650188,-5404,,
14758089449,232.72410,16162705926,244477552,16162700518,-5408,,
14758140622,232.77527,16162757101,244528722,16162751687,-5414,,
14758191044,232.82569,16162807526,244579141,16162802106,-5420,,
14758242032,232.87668,16162858516,244630126,16162853092,-5424,,
14758292321,232.92697,16162908808,244680413,16162903379,-5429,,
14758342938,232.97759,16162959427,244731027,16162953992,-5435,,
14758393228,233.02788,16163009719,244781314,16163004280,-5439,,
14758444413,233.07906,16163060906,244832497,16163055462,-5444,,
14758494813,233.12946,16163111309,244882894,16163105859,-5450,,
14758545681,233.18033,16163162180,244933759,16163156725,-5455,,
14758596488,233.23114,16163212988,244984564,16163207529,-5459,,
14758647320,233.28197,16163263823,245035393,16163258358,-5465,,
14758698097,233.33274,16163314602,245086167,16163309132,-5470,,
14758748808,233.38346,16163365315,245136875,16163359840,-5475,,
14758799481,233.43413,16163415992,245187546,16163410512,-5480,,
14758851865,233.48651,16163468378,245239927,16163462893,-5485,,
14758902512,233.53716,16163519028,245290572,16163513537,-5491,,
14758953366,233.58801,16163569884,245341424,16163564389,-5495,,
14759004057,233.63870,16163620576,245392111,16163615077,-5499,,
14759055082,233.68973,16163671604,245443133,16163666098,-5506,,
14759105732,233.74038,16163722257,245493781,16163716746,-5511,,
14759155945,233.79059,16163772471,245543991,16163766956,-5515,,
14759206766,233.84141,16163823296,245594810,16163817775,-5521,,
14759257024,233.89167,16163873556,245645064,16163868030,-5526,,
14759307351,233.94200,16163923885,245695390,16163918355,-5530,,
14759358223,233.99287,16163974760,245746259,16163969224,-5536,,
14759408983,234.04363,16164025522,245797015,16164019981,-5541,,
14759459349,234.09400,16164075890,245847378,16164070343,-5547,,
14759510057,234.14470,16164126601,245898085,16164121050,-5551,,
14759560494,234.19514,16164177039,245948517,16164171483,-5556,,
14759610691,234.24534,16164227240,245998713,16164221678,-5562,,
14759660823,234.29547,16164277374,246048842,16164271808,-5566,,
14759711344,234.34599,16164327897,246099360,16164322326,-5571,,
14759761514,234.39616,16164378069,246149527,16164372492,-5577,,
14759812186,234.44683,16164428743,246200197,16164423162,-5581,,
14759862725,234.49737,16164479285,246250734,16164473699,-5586,,
14759913324,234.54797,16164529886,246301329,16164524294,-5592,,
14759971511,234.60616,16164588076,246359514,16164582479,-5597,,
14760022516,234.65716,16164639083,246410515,16164633480,-5603,,
14760073558,234.70821,16164690128,246461556,16164684521,-5607,,
14760125042,234.75969,16164741614,246513036,16164736002,-5612,,
14760175170,234.80982,16164791745,246563162,16164786127,-5618,,
14760225989,234.86064,16164842565,246613977,16164836942,-5623,,
14760277025,234.91167,16164893605,246665011,16164887977,-5628,,
14760327786,234.96243,16164944368,246715769,16164938734,-5634,,
14760378053,235.01270,16164994636,246766033,16164988998,-5638,,
14760428410,235.06306,16165044996,246816388,16165039353,-5643,,
14760479090,235.11374,16165095678,246867065,16165090030,-5648,,
14760529617,235.16427,16165146208,246917590,16165140555,-5653,,
14760580202,235.21485,16165196796,246968171,16165191137,-5659,,
14760630371,235.26502,16165246966,247018338,16165241304,-5662,,
14760681212,235.31586,16165297810,247069176,16165292142,-5668,,
14760731804,235.36645,16165348405,247119766,16165342731,-5674,,
14760782122,235.41677,16165398725,247170082,16165393047,-5678,,
14760832396,235.46704,16165449001,247220353,16165443318,-5683,,
14760882672,235.51732,16165499280,247270626,16165493591,-5689,,
14760933039,235.56769,16165549649,247320991,16165543956,-5693,,
14760983279,235.61793,16165599891,247371228,16165594193,-5698,,
14761033840,235.66849,16165650455,247421785,16165644751,-5704,,
14761084456,235.71910,16165701073,247472399,16165695365,-5708,,
14761135128,235.76978,16165751746,247523068,16165746034,-5712,,
14761185222,235.81987,16165801844,247573160,16165796125,-5719,,
14761236195,235.87084,16165852819,247624129,16165847095,-5724,,
14761286900,235.92155,16165903526,247674833,16165897798,-5728,,
14761337459,235.97211,16165954088,247725388,16165948354,-5734,,
14761387607,236.02226,16166004238,247775534,16165998499,-5739,,
14761438616,236.07326,16166055250,247826541,16166049506,-5744,,
14761489161,236.12381,16166105797,247877083,16166100048,-5749,,
14761539353,236.17400,16166155991,247927272,16166150237,-5754,,
14761589644,236.22429,16166206285,247977559,16166200525,-5760,,
14761639974,236.27462,16166256629,248027899,16166250865,-5764,,
14761690735,236.32538,16166307380,248078646,16166301611,-5769,,
14761741288,236.37594,16166357935,248129195,16166352160,-5775,,
14761792337,236.42699,16166408987,248180243,16166403208,-5779,,
14761842907,236.47755,16166459559,248230809,16166453775,-5784,,
14761893342,236.52799,16166509997,248281242,16166504207,-5790,,
14761943509,236.57816,16166560166,248331406,16166554372,-5794,,
14761994053,236.62870,16166610711,248381947,16166604912,-5799,,
14762044641,236.67929,16166661303,248432532,16166655498,-5805,,
14762095008,236.72966,16166711671,248482896,16166705861,-5810,,
14762145411,236.78006,16166762076,248533297,16166756262,-5814,,
14762196257,236.83091,16166812926,248584141,16166807106,-5820,,
14762247129,236.88178,16166863800,248635009,16166857975,-5825,,
14762297805,236.93245,16166914478,248685683,16166908648,-5830,,
14762347965,236.98261,16166964641,248735840,16166958806,-5835,,
14762398432,237.03308,16167015110,248786305,16167009270,-5840,,
14762449028,237.08368,16167065709,248836898,16167059864,-5845,,
14762499619,237.13427,16167116302,248887487,16167110452,-5850,,
14762550352,237.18500,16167167038,248938218,16167161183,-5855,,
14762601304,237.23595,16167217993,248989167,16167212133,-5860,,
14762652015,237.28666,16167268705,249039875,16167262840,-5865,,
14762702515,237.33716,16167319207,249090372,16167313337,-5870,,
14762752699,237.38735,16167369394,249140552,16167363518,-5876,,
14762802974,237.43762,16167419671,249190825,16167413791,-5880,,
14762853976,237.48862,16167470674,249241824,16167464789,-5885,,
14762904130,237.53878,16167520832,249291976,16167514941,-5891,,
14762954583,237.58923,16167571287,249342425,16167565391,-5896,,
14763005601,237.64025,16167622307,249393442,16167616407,-5900,,
14763055782,237.69043,16167672491,249443620,16167666586,-5905,,
14763106471,237.74112,16167723181,249494305,16167717270,-5911,,
14763156627,237.79128,16167773339,249544459,16167767425,-5914,,
14763207228,237.84188,16167823944,249595058,16167818023,-5921,,
14763257373,237.89202,16167874090,249645199,16167868164,-5926,,
14763307659,237.94231,16167924379,249695483,16167918449,-5930,,
14763358144,237.99279,16167974866,249745965,16167968931,-5935,,
14763409032,238.04368,16168025757,249796850,16168019816,-5941,,
14763459203,238.09385,16168075930,249847018,16168069984,-5946,,
14763509626,238.14427,16168126356,249897439,16168120405,-5951,,
14763560135,238.19478,16168176867,249947946,16168170911,-5956,,
14763610457,238.24510,16168227191,249998264,16168221229,-5962,,
14763660658,238.29531,16168277395,250048463,16168271429,-5966,,
14763710830,238.34548,16168327569,250098632,16168321597,-5972,,
14763761530,238.39618,16168378272,250149330,16168372295,-5977,,
14763811698,238.44635,16168428442,250199495,16168422461,-5981,,
14763862086,238.49673,16168478832,250249881,16168472846,-5986,,
14763912504,238.54715,16168529253,250300295,16168523261,-5992,,
14763962717,238.59736,16168579468,250350506,16168573472,-5996,,
14764013130,238.64778,16168629883,250400916,16168623882,-6001,,
14764063525,238.69817,16168680281,250451308,16168674274,-6007,,
14764114573,238.74922,16168731330,250502353,16168725318,-6012,,
14764165603,238.80025,16168782363,250553382,16168776347,-6016,,
14764215662,238.85031,16168832425,250603438,16168826403,-6022,,
14764266720,238.90137,16168883484,250654492,16168877457,-6027,,
14764317275,238.95192,16168934041,250705045,16168928010,-6031,,
14764367816,239.00246,16168984585,250755582,16168978548,-6037,,
14764418842,239.05349,16169035613,250806606,16169029572,-6041,,
14764469236,239.10388,16169086009,250856997,16169079962,-6047,,
14764519274,239.15392,16169136051,250907033,16169129999,-6052,,
14764569847,239.20450,16169186626,250957603,16169180569,-6057,,
14764620895,239.25554,16169237677,251008648,16169231613,-6064,,
14764671954,239.30660,16169288738,251059705,16169282671,-6067,,
14764722481,239.35713,16169339267,251110229,16169333194,-6073,,
14764772814,239.40746,16169389603,251160560,16169383525,-6078,,
14764823599,239.45825,16169440389,251211341,16169434306,-6083,,
14764874632,239.50928,16169491425,251262373,16169485338,-6087,,
14764924796,239.55944,16169541592,251312534,16169535499,-6093,,
14764975370,239.61002,16169592168,251363104,16169586070,-6098,,
14765025596,239.66024,16169642396,251413329,16169636294,-6102,,
14765076635,239.71128,16169693438,251464364,16169687330,-6108,,
14765127145,239.76179,16169743950,251514872,16169737837,-6113,,
14765177733,239.81238,16169794540,251565457,16169788422,-6118,,
14765228270,239.86292,16169845080,251615991,16169838957,-6123,,
14765279276,239.91392,16169896088,251666995,16169889961,-6127,,
14765330307,239.96496,16169947122,251718022,16169940988,-6134,,
14765380878,240.01553,16169997695,251768592,16169991557,-6138,,
14765431424,240.06607,16170048242,251819134,16170042099,-6143,,
14765481974,240.11662,16170098796,251869681,16170092647,-6149,,
14765533112,240.16776,16170149936,251920818,16170143783,-6153,,
14765584059,240.21871,16170200885,251971761,16170194727,-6158,,
14765634614,240.26926,16170251442,252022313,16170245278,-6164,,
14765685164,240.31981,16170301995,252072860,16170295826,-6169,,
14765736005,240.37065,16170352838,252123699,16170346665,-6173,,
14765787052,240.42170,16170403888,252174743,16170397709,-6179,,
14765837813,240.47246,16170454651,252225501,16170448467,-6184,,
14765888408,240.52306,16170505248,252276094,16170499060,-6188,,
14765938475,240.57312,16170555318,252326158,16170549124,-6194,,
14765989346,240.62399,16170606191,252377026,16170599992,-6199,,
14766039954,240.67460,16170656802,252427632,16170650597,-6205,,
14766090528,240.72518,16170707378,252478204,16170701169,-6209,,
14766141378,240.77603,16170758230,252529051,16170752016,-6214,,
14766192453,240.82710,16170809308,252580122,16170803088,-6220,,
14766243459,240.87811,16170860315,252631125,16170854091,-6224,,
14766294514,240.92916,16170911372,252682178,16170905144,-6228,,
14766345569,240.98022,16170962430,252733230,16170956196,-6234,,
14766580447,241.21509,16171197320,252968095,16171191060,-6260,16171196929,
14766605711,241.24036,16171222585,252993358,16171216353,-6232,,
14766656749,241.29140,16171273624,253044393,16171267447,-6177,,
14766707444,241.34209,16171324322,253095086,16171318200,-6122,,
14766758510,241.39316,16171375390,253146149,16171369322,-6068,,
14766809053,241.44370,16171425936,253196689,16171419923,-6013,,
14766860091,241.49474,16171476977,253247726,16171471018,-5959,,
14766911137,241.54578,16171528025,253298769,16171522121,-5904,,
14766961702,241.59635,16171578591,253349330,16171572742,-5849,,
14767012230,241.64688,16171629123,253399855,16171623327,-5796,,
14767062338,241.69699,16171679232,253449961,16171673491,-5741,,
14767113328,241.74798,16171730224,253500948,16171724539,-5685,,
14767164365,241.79901,16171781264,253551982,16171775632,-5632,,
14767214423,241.84907,16171831324,253602038,16171825747,-5577,,
14767264985,241.89963,16171881888,253652597,16171876365,-5523,,
14767316040,241.95069,16171932947,253703649,16171927478,-5469,,
14767367093,242.00174,16171984001,253754699,16171978587,-5414,,
14767418161,242.05281,16172035073,253805765,16172029713,-5360,,
14767468672,242.10332,16172085586,253856274,16172080281,-5305,,
14767519206,242.15385,16172136122,253906804,16172130871,-5251,,
14767569766,242.20441,16172186684,253957362,16172181489,-5195,,
14767620322,242.25497,16172237243,254007916,16172232101,-5142,,
14767670874,242.30552,16172287797,254058464,16172282709,-5088,,
14767721426,242.35607,16172338352,254109013,16172333318,-5034,,
14767772008,242.40666,16172388935,254159593,16172383957,-4978,,
14767822519,242.45717,16172439448,254210101,16172434524,-4924,,
14767873577,242.50823,16172490510,254261157,16172485639,-4871,,
14767924594,242.55924,16172541529,254312171,16172536713,-4816,,
14767975168,242.60982,16172592106,254362742,16172587345,-4761,,
14768025710,242.66036,16172642650,254413281,16172637943,-4707,,
14768075900,242.71055,16172692842,254463468,16172688189,-4653,,
14768126468,242.76112,16172743413,254514034,16172738814,-4599,,
14768177021,242.81167,16172793968,254564585,16172789424,-4544,,
14768228024,242.86267,16172844973,254615584,16172840484,-4489,,
14768278844,242.91349,16172895796,254666402,16172891361,-4435,,
14768329399,242.96405,16172946353,254716954,16172941973,-4380,,
14768380014,243.01466,16172996969,254767566,16172992643,-4326,,
14768430296,243.06494,16173047255,254817846,16173042987,-4268,,
14768480848,243.11550,16173097808,254868395,16173093590,-4218,,
14768531376,243.16602,16173148338,254918920,16173144175,-4163,,
14768581932,243.21658,16173198897,254969473,16173194787,-4110,,
14768632989,243.26764,16173249956,255020528,16173245903,-4053,,
14768683721,243.31837,16173300690,255071256,16173296691,-3999,,
14768734348,243.36900,16173351320,255121881,16173347374,-3946,,
14768784988,243.41964,16173401963,255172520,16173398073,-3890,,
14768835996,243.47064,16173452973,255223524,16173449136,-3837,,
14768886524,243.52117,16173503503,255274049,16173499721,-3782,,
14768937574,243.57222,16173554556,255325096,16173550828,-3728,,
14768988141,243.62279,16173605126,255375661,16173601453,-3673,,
14769039441,243.67409,16173656428,255426958,16173652809,-3619,,
14769090223,243.72487,16173707211,255477737,16173703648,-3563,,
14769140765,243.77541,16173757756,255528276,16173754247,-3509,,
14769191818,243.82647,16173808812,255579328,16173805358,-3454,,
14769242870,243.87752,16173859865,255630376,16173856467,-3398,,
14769293414,243.92806,16173910413,255680917,16173907068,-3345,,
14769343968,243.97862,16173960968,255731469,16173957678,-3290,,
14769394511,244.02916,16174011513,255782009,16174008277,-3236,,
14769445561,244.08021,16174062567,255833057,16174059385,-3182,,
14769496595,244.13124,16174113603,255884087,16174110476,-3127,,
14769547645,244.18229,16174164655,255935135,16174161583,-3072,,
14769598466,244.23311,16174215478,255985953,16174212461,-3017,,
14769649476,244.28412,16174266491,256036960,16174263528,-2963,,
14769699545,244.33419,16174316562,256087027,16174313653,-2909,,
14769750094,244.38474,16174367114,256137573,16174364260,-2854,,
14769800654,244.43530,16174417676,256188131,16174414876,-2800,,
14769851692,244.48634,16174468717,256239165,16174465970,-2747,,
14769902731,244.53738,16174519757,256290202,16174517067,-2690,,
14769953805,244.58845,16174570835,256341273,16174568199,-2636,,
14770004762,244.63941,16174621793,256392227,16174619212,-2581,,
14770055301,244.68995,16174672335,256442765,16174669809,-2526,,
14770106286,244.74093,16174723322,256493746,16174720850,-2472,,
14770157286,244.79193,16174774325,256544744,16174771909,-2416,,
14770208109,244.84276,16174825150,256595563,16174822788,-2362,,
14770258819,244.89347,16174875862,256646270,16174873554,-2308,,
14770309811,244.94446,16174926856,256697260,16174924603,-2253,,
14770360388,244.99504,16174977435,256747834,16174975236,-2199,,
14770411106,245.04575,16175028156,256798550,16175026012,-2144,,
14770461613,245.09626,16175078666,256849054,16175076576,-2090,,
14770511833,245.14648,16175128888,256899271,16175126851,-2037,,
14770562667,245.19732,16175179725,256950103,16175177743,-1982,,
14770612729,245.24738,16175229789,257000162,16175227862,-1927,,
14770663144,245.29779,16175280207,257050575,16175278334,-1873,,
14770713841,245.34849,16175330906,257101269,16175329086,-1820,,
14770764116,245.39876,16175381183,257151541,16175379418,-1765,,
14770814662,245.44931,16175431732,257202084,16175430021,-1711,,
14770865344,245.49999,16175482416,257252764,16175480759,-1657,,
14770917826,245.55247,16175534900,257305243,16175533300,-1600,,
14770968632,245.60328,16175585709,257356047,16175584164,-1545,,
14771021704,245.65635,16175638783,257409115,16175637295,-1488,,
14771072234,245.70688,16175689316,257459643,16175687882,-1434,,
14771122287,245.75693,16175739371,257509693,16175737990,-1381,,
14771172898,245.80755,16175789983,257560301,16175788657,-1326,,
14771223926,245.85857,16175841014,257611326,16175839742,-1272,,
14771274434,245.90908,16175891525,257661832,16175890308,-1217,,
14771325365,245.96001,16175942458,257712761,16175941296,-1162,,
14771376075,246.01072,16175993171,257763467,16175992063,-1108,,
14771426975,246.06162,16176044072,257814364,16176043019,-1053,,
14771477546,246.11219,16176094645,257864932,16176093646,-999,,
14771528218,246.16287,16176145320,257915602,16176144377,-943,,
14771578772,246.21342,16176195877,257966153,16176194986,-891,,
14771629624,246.26427,16176246731,258017002,16176245838,-893,,
14771680186,246.31483,16176297296,258067562,16176296398,-898,,
14771731249,246.36590,16176348361,258118623,16176347458,-903,,
14771782284,246.41693,16176399399,258169654,16176398490,-909,,
14771832832,246.46748,16176449949,258220200,16176449035,-914,,
14771883276,246.51792,16176500395,258270641,16176499476,-919,,
14771933805,246.56845,16176550927,258321168,16176550003,-924,,
14771984360,246.61901,16176601483,258371719,16176600554,-929,,
14772034939,246.66959,16176652065,258422296,16176651132,-933,,
14772085963,246.72061,16176703092,258473318,16176702153,-939,,
14772137033,246.77168,16176754163,258524384,16176753219,-944,,
14772187617,246.82226,16176804750,258574966,16176803801,-949,,
14772238203,246.87285,16176855338,258625549,16176854385,-953,,
14772288861,246.92351,16176905999,258676205,16176905040,-959,,
14772339355,246.97400,16176956494,258726695,16176955530,-964,,
14772390339,247.02499,16177007482,258777678,16177006513,-969,,
14772441373,247.07602,16177058518,258828709,16177057544,-974,,
14772492472,247.12712,16177109620,258879804,16177108640,-980,,
14772543063,247.17771,16177160213,258930402,16177159237,-976,,
14772594131,247.22878,16177211283,258981458,16177210293,-990,,
14772645149,247.27980,16177262303,259032473,16177261308,-995,,
14772695427,247.33007,16177312584,259082748,16177311584,-1000,,
14772745568,247.38022,16177362726,259132887,16177361722,-1004,,
14772796141,247.43079,16177413303,259183457,16177412292,-1011,,
14772846713,247.48136,16177463877,259234027,16177462862,-1015,,
14772897337,247.53198,16177514504,259284650,16177513485,-1019,,
14772947668,247.58232,16177564836,259334976,16177563811,-1025,,
14772997777,247.63243,16177614948,259385083,16177613918,-1030,,
14773048827,247.68347,16177666000,259436130,16177664965,-1035,,
14773099830,247.73448,16177717006,259487130,16177715965,-1041,,
14773150513,247.78516,16177767691,259537811,16177766646,-1045,,
14773200941,247.83559,16177818121,259588235,16177817071,-1050,,
14773251499,247.88615,16177868681,259638791,16177867626,-1055,,
14773302537,247.93718,16177919724,259689829,16177918665,-1059,,
14773353600,247.98825,16177970788,259740887,16177969722,-1066,,
14773404642,248.03929,16178021832,259791926,16178020761,-1071,,
14773455185,248.08983,16178072377,259842466,16178071302,-1075,,
14773506246,248.14089,16178123441,259893525,16178122360,-1081,,
14773556821,248.19147,16178174017,259944096,16178172931,-1086,,
14773607424,248.24207,16178224623,259994698,16178223533,-1090,,
14773657972,248.29262,16178275174,260045242,16178274078,-1096,,
14773708131,248.34278,16178325335,260095398,16178324234,-1101,,
14773758269,248.39292,16178375475,260145545,16178374380,-1095,,
14773809338,248.44399,16178426547,260196601,16178425436,-1111,,
14773860388,248.49504,16178477599,260247647,16178476483,-1116,,
14773910942,248.54559,16178528156,260298198,16178527033,-1123,,
14773961495,248.59614,16178578711,260348760,16178577596,-1115,,
14774012563,248.64721,16178629781,260399814,16178628650,-1131,,
14774063114,248.69776,16178680335,260450362,16178679198,-1137,,
14774114129,248.74878,16178731351,260501374,16178730209,-1142,,
14774164782,248.79943,16178782007,260552026,16178780861,-1146,,
14774215814,248.85046,16178833042,260603054,16178831890,-1152,,
14774265948,248.90060,16178883178,260653185,16178882021,-1157,,
14774316535,248.95118,16178933767,260703770,16178932606,-1161,,
14774366587,249.00124,16178983822,260753819,16178982655,-1167,,
14774417135,249.05178,16179034372,260804364,16179033200,-1172,,
14774468187,249.10283,16179085426,260855413,16179084249,-1177,,
14774519269,249.15392,16179136511,260906493,16179135329,-1182,,
14774570317,249.20496,16179187560,260957538,16179186374,-1186,,
14774621366,249.25601,16179238613,261008585,16179237420,-1193,,
14774672383,249.30703,16179289632,261059600,16179288435,-1197,,
14774723444,249.35809,16179340694,261110657,16179339493,-1201,,
14774773989,249.40864,16179391242,261161199,16179390034,-1208,,
14774824995,249.45964,16179442251,261212202,16179441038,-1213,,
14774875595,249.51024,16179492852,261262800,16179491635,-1217,,
14774926646,249.56129,16179543906,261313848,16179542683,-1223,,
14774977689,249.61234,16179594951,261364888,16179593723,-1228,,
14775028738,249.66339,16179646003,261415934,16179644770,-1233,,
14775079786,249.71443,16179697054,261466980,16179695816,-1238,,
14775130818,249.76547,16179748088,261518009,16179746845,-1243,,
14775181467,249.81611,16179798740,261568655,16179797491,-1249,,
14775232049,249.86670,16179849324,261619235,16179848071,-1253,,
14775282647,249.91729,16179899924,261669830,16179898665,-1259,,
14775333216,249.96786,16179950495,261720396,16179949231,-1264,,
14775383342,250.01799,16180000624,261770520,16179999365,-1259,,
14775434410,250.06906,16180051693,261821585,16180050420,-1273,,
14775484980,250.11963,16180102267,261872153,16180100988,-1279,,
14775535702,250.17035,16180152991,261922871,16180151706,-1285,,
14775586309,250.22096,16180203599,261973476,16180202311,-1288,,
14775636932,250.27158,16180254226,262024096,16180252932,-1294,,
14775687538,250.32219,16180304833,262074699,16180303534,-1299,,
14775738116,250.37276,16180355413,262125275,16180354110,-1303,,
14775789152,250.42380,16180406453,262176309,16180405144,-1309,,
14775839331,250.47398,16180456633,262226494,16180455329,-1304,,
14775890399,250.52505,16180507704,262277549,16180506384,-1320,,
14775941447,250.57610,16180558754,262328595,16180557430,-1324,,
14775992540,250.62719,16180609849,262379685,16180608520,-1329,,
14776043232,250.67788,16180660545,262430375,16180659210,-1335,,
14776093834,250.72848,16180711149,262480975,16180709810,-1339,,
14776144438,250.77909,16180761754,262531575,16180760411,-1343,,
14776195022,250.82967,16180812342,262582168,16180811003,-1339,,
14776245569,250.88022,16180862891,262632700,16180861546,-1345,,
14776295769,250.93042,16180913093,262682899,16180911734,-1359,,
14776346328,250.98098,16180963655,262733454,16180962290,-1365,,
14776396861,251.03151,16181014189,262783984,16181012820,-1369,,
14776447394,251.08204,16181064724,262834515,16181063350,-1374,,
14776497454,251.13210,16181114788,262884572,16181113408,-1380,,
14776547999,251.18265,16181165335,262935114,16181163950,-1385,,
14776598371,251.23302,16181215708,262985484,16181214319,-1389,,
14776648481,251.28313,16181265822,263035591,16181264427,-1395,,
14776699033,251.33368,16181316375,263086140,16181314975,-1400,,
14776750093,251.38474,16181367438,263137197,16181366042,-1396,,
14776800319,251.43497,16181417667,263187422,16181416257,-1410,,
14776850963,251.48561,16181468313,263238062,16181466898,-1415,,
14776901483,251.53613,16181518836,263288579,16181517415,-1421,,
14776952591,251.58724,16181569945,263339685,16181568520,-1425,,
14777003140,251.63779,16181620497,263390231,16181619066,-1431,,
14777054158,251.68881,16181671518,263441247,16181670082,-1436,,
14777105239,251.73989,16181722601,263492324,16181721160,-1441,,
14777156256,251.79090,16181773619,263543339,16181772174,-1445,,
14777206869,251.84152,16181824236,263593950,16181822785,-1451,,
14777257417,251.89207,16181874786,263644495,16181873330,-1456,,
14777307480,251.94213,16181924850,263694555,16181923390,-1460,,
14777358542,251.99319,16181975926,263745625,16181974460,-1466,,
14777409108,252.04376,16182026484,263796178,16182025013,-1471,,
14777460157,252.09481,16182077536,263847223,16182076059,-1477,,
14777511207,252.14586,16182128587,263898271,16182127107,-1480,,
14777562256,252.19690,16182179639,263949317,16182178153,-1486,,
14777613307,252.24795,16182230693,264000366,16182229201,-1492,,
14777664229,252.29888,16182281627,264051295,16182280130,-1497,,
14777715208,252.34986,16182332597,264102261,16182331096,-1501,,
14777765803,252.40045,16182383196,264152853,16182381688,-1508,,
14777816367,252.45102,16182433762,264203414,16182432249,-1513,,
14777867382,252.50203,16182484778,264254427,16182483262,-1516,,
14777918411,252.55306,16182535821,264305464,16182534299,-1522,,
14777969262,252.60391,16182586664,264356301,16182585137,-1527,,
14778019777,252.65443,16182637181,264406813,16182635648,-1533,,
14778070325,252.70497,16182687732,264457359,16182686194,-1538,,
14778120873,252.75552,16182738282,264507904,16182736740,-1542,,
14778171454,252.80610,16182788866,264558482,16182787318,-1548,,
14778221971,252.85662,16182839385,264608998,16182837833,-1552,,
14778273003,252.90765,16182890419,264660026,16182888862,-1557,,
14778323560,252.95821,16182940979,264710580,16182939416,-1563,,
14778373622,253.00827,16182991042,264760640,16182989475,-1567,,
14778424165,253.05881,16183041587,264811180,16183040015,-1572,,
14778475205,253.10985,16183092631,264862217,16183091053,-1578,,
14778525794,253.16044,16183143222,264912803,16183141639,-1583,,
14778576698,253.21135,16183194128,264963706,16183192541,-1587,,
14778626881,253.26153,16183244324,265013896,16183242731,-1593,,
14778677487,253.31214,16183294922,265064488,16183293324,-1598,,
14778728494,253.36314,16183345932,265115494,16183344329,-1603,,
14778779112,253.41376,16183396552,265166109,16183394944,-1608,,
14778829164,253.46381,16183446606,265216157,16183444992,-1614,,
14778880218,253.51487,16183497663,265267209,16183496044,-1619,,
14778930757,253.56540,16183548204,265317745,16183546581,-1623,,
14778981382,253.61603,16183598830,265368367,16183597202,-1628,,
14779032400,253.66705,16183649851,265419382,16183648217,-1634,,
14779082937,253.71759,16183700391,265469917,16183698753,-1638,,
14779133529,253.76818,16183750985,265520506,16183749342,-1643,,
14779184577,253.81922,16183802035,265571551,16183800386,-1649,,
14779235625,253.87027,16183853086,265622596,16183851432,-1654,,
14779286675,253.92132,16183904138,265673645,16183902480,-1658,,
14779337723,253.97237,16183955189,265724689,16183953524,-1665,,
14779388743,254.02339,16184006210,265775706,16184004541,-1669,,
14779439291,254.07394,16184056761,265826252,16184055087,-1674,,
14779490336,254.12498,16184107809,265877295,16184106131,-1678,,
14779540879,254.17553,16184158353,265927834,16184156669,-1684,,
14779591468,254.22612,16184208946,265978420,16184207255,-1691,,
14779642015,254.27666,16184259495,266028965,16184257801,-1694,,
14779693058,254.32771,16184310540,266080005,16184308841,-1699,,
14779743099,254.37775,16184360584,266130044,16184358879,-1705,,
14779793633,254.42828,16184411119,266180575,16184409410,-1709,,
14779844235,254.47888,16184461723,266231174,16184460010,-1713,,
14779894783,254.52943,16184512275,266281720,16184510555,-1720,,
14779945829,254.58048,16184563323,266332763,16184561598,-1725,,
14779996809,254.63146,16184614305,266383740,16184612575,-1730,,
14780047357,254.68201,16184664855,266434285,16184663121,-1734,,
14780097921,254.73257,16184715421,266484846,16184713681,-1740,,
14780148974,254.78362,16184766477,266535897,16184764732,-1745,,
14780199545,254.83419,16184817050,266586465,16184815300,-1750,,
14780250065,254.88471,16184867572,266636982,16184865817,-1755,,
14780300595,254.93524,16184918106,266687509,16184916345,-1761,,
14780351136,254.98578,16184968649,266738048,16184966884,-1765,,
14780401206,255.03585,16185018721,266788115,16185016951,-1770,,
14780452337,255.08698,16185069855,266839244,16185068079,-1776,,
14780502777,255.13743,16185120297,266889681,16185118517,-1780,,
14780552836,255.18748,16185170357,266939736,16185168572,-1785,,
14780603907,255.23855,16185221432,266990806,16185219641,-1791,,
14780654445,255.28909,16185271971,267041341,16185270176,-1795,,
14780705031,255.33968,16185322560,267091924,16185320760,-1800,,
14780756079,255.39073,16185373611,267142969,16185371805,-1806,,
14780807086,255.44173,16185424620,267193973,16185422809,-1811,,
14780857677,255.49232,16185475214,267244562,16185473398,-1816,,
14780908694,255.54334,16185526233,267295576,16185524412,-1821,,
14780959293,255.59394,16185576834,267346172,16185575008,-1826,,
14781009896,255.64454,16185627439,267396773,16185625608,-1831,,
14781060899,255.69555,16185678445,267447774,16185676609,-1836,,
14781111401,255.74605,16185728948,267498272,16185727107,-1841,,
14781162030,255.79668,16185779581,267548898,16185777733,-1848,,
14781212655,255.84730,16185830207,267599521,16185828356,-1851,,
14781262864,255.89751,16185880419,267649727,16185878562,-1857,,
14781313854,255.94850,16185931412,267700714,16185929550,-1862,,
14781364413,255.99906,16185981972,267751271,16185980106,-1866,,
14781414986,256.04963,16186032548,267801841,16186030677,-1871,,
14781466032,256.10068,16186083597,267852884,16186081720,-1877,,
14781516182,256.15083,16186133748,267903031,16186131866,-1882,,
14781566698,256.20135,16186184267,267953545,16186182380,-1887,,
14781616843,256.25149,16186234415,268003687,16186232522,-1893,,
14781667642,256.30229,16186285215,268054494,16186283329,-1886,,
14781718289,256.35294,16186335865,268105128,16186333963,-1902,,
14781768890,256.40354,16186386468,268155726,16186384561,-1907,,
14781819528,256.45418,16186437108,268206361,16186435196,-1912,,
14781870118,256.50477,16186487701,268256948,16186485783,-1918,,
14781921027,256.55568,16186538613,268307856,16186536691,-1922,,
14781971623,256.60627,16186589211,268358449,16186587284,-1927,,
14782022249,256.65690,16186639840,268409071,16186637906,-1934,,
14782072699,256.70735,16186690291,268459519,16186688354,-1937,,
14782123745,256.75839,16186741339,268510562,16186739397,-1942,,
14782173904,256.80855,16186791501,268560718,16186789553,-1948,,
14782224922,256.85957,16186842522,268611734,16186840570,-1952,,
14782275480,256.91013,16186893082,268662300,16186891136,-1946,,
14782325906,256.96055,16186943511,268712712,16186941547,-1964,,
14782376479,257.01113,16186994085,268763282,16186992117,-1968,,
14782427521,257.06217,16187045130,268814322,16187043158,-1972,,
14782478070,257.11272,16187095682,268864868,16187093703,-1979,,
14782528159,257.16281,16187145773,268914954,16187143790,-1983,,
14782579226,257.21387,16187196843,268966020,16187194855,-1988,,
14782629409,257.26406,16187247027,269016199,16187245034,-1993,,
14782680420,257.31507,16187298051,269067218,16187296053,-1998,,
14782731493,257.36614,16187349117,269118277,16187347113,-2004,,
14782782529,257.41718,16187400154,269169311,16187398147,-2007,,
14782832578,257.46723,16187450206,269219358,16187448193,-2013,,
14782883155,257.51780,16187500785,269269931,16187498766,-2019,,
14782933731,257.56838,16187551363,269320505,16187549340,-2023,,
14782984307,257.61896,16187601942,269371078,16187599914,-2028,,
14783035354,257.67000,16187652992,269422122,16187650957,-2035,,
14783085903,257.72055,16187703542,269472668,16187701503,-2039,,
14783136958,257.77161,16187754601,269523721,16187752557,-2044,,
14783187500,257.82215,16187805144,269574260,16187803095,-2049,,
14783238110,257.87276,16187855756,269624867,16187853702,-2054,,
14783288917,257.92356,16187906567,269675672,16187904508,-2059,,
14783339214,257.97386,16187956866,269725967,16187954802,-2064,,
14783390194,258.02484,16188007848,269776944,16188005779,-2069,,
14783440304,258.07495,16188057961,269827050,16188055885,-2076,,
14783491355,258.12600,16188109014,269878099,16188106935,-2079,,
14783541864,258.17651,16188159524,269928605,16188157440,-2084,,
14783592451,258.22710,16188210115,269979190,16188208025,-2090,,
14783643129,258.27778,16188260795,270029865,16188258701,-2094,,
14783693491,258.32814,16188311159,270080224,16188309059,-2100,,
14783744138,258.37879,16188361809,270130868,16188359704,-2105,,
14783795185,258.42983,16188412858,270181912,16188410748,-2110,,
14783846238,258.48089,16188463914,270232963,16188461799,-2115,,
14783897228,258.53188,16188514906,270283950,16188512786,-2120,,
14783947905,258.58255,16188565584,270334624,16188563459,-2125,,
14783998952,258.63360,16188616635,270385669,16188614505,-2130,,
14784049526,258.68417,16188667210,270436240,16188665075,-2135,,
14784100549,258.73520,16188718235,270487260,16188716095,-2140,,
14784151184,258.78583,16188768874,270537892,16188766728,-2146,,
14784201713,258.83636,16188819405,270588419,16188817255,-2150,,
14784252031,258.88668,16188869725,270638734,16188867570,-2155,,
14784303081,258.93773,16188920778,270689782,16188918617,-2161,,
14784353885,258.98853,16188971584,270740583,16188969418,-2166,,
14784404682,259.03933,16189022382,270791377,16189020212,-2170,,
14784454732,259.08938,16189072436,270841425,16189070260,-2176,,
14784504784,259.13943,16189122490,270891474,16189120310,-2180,,
14784555829,259.19048,16189173538,270942516,16189171351,-2187,,
14784606393,259.24104,16189224104,270993078,16189221913,-2191,,
14784657487,259.29213,16189275200,271044169,16189273004,-2196,,
14784708533,259.34318,16189326249,271095212,16189324047,-2202,,
14784759560,259.39421,16189377277,271146236,16189375071,-2206,,
14784810192,259.44484,16189427911,271196865,16189425700,-2211,,
14784860818,259.49547,16189478541,271247488,16189476324,-2217,,
14784911651,259.54630,16189529376,271298320,16189527155,-2221,,
14784961938,259.59659,16189579664,271348603,16189577438,-2226,,
14785012546,259.64719,16189630276,271399208,16189628044,-2232,,
14785063574,259.69822,16189681306,271450245,16189679081,-2225,,
14785114126,259.74877,16189731859,271500783,16189729618,-2241,,
14785165200,259.79985,16189782937,271551855,16189780690,-2247,,
14785216251,259.85090,16189833989,271602902,16189831737,-2252,,
14785266869,259.90152,16189884611,271653518,16189882354,-2257,,
14785317458,259.95211,16189935202,271704104,16189932940,-2262,,
14785368074,260.00272,16189985820,271754717,16189983553,-2267,,
14785418643,260.05329,16190036392,271805285,16190034120,-2272,,
14785469286,260.10393,16190087036,271855924,16190084759,-2277,,
14785520342,260.15499,16190138095,271906977,16190135813,-2282,,
14785571365,260.20601,16190189120,271957997,16190186832,-2288,,
14785622032,260.25668,16190239790,272008663,16190237498,-2292,,
14785672679,260.30733,16190290438,272059306,16190288141,-2297,,
14785723682,260.35833,16190341445,272110306,16190339142,-2303,,
14785773862,260.40851,16190391627,272160484,16190389320,-2307,,
14785824843,260.45949,16190442610,272211462,16190440297,-2313,,
14785875254,260.50990,16190493024,272261870,16190490706,-2318,,
14785925829,260.56048,16190543601,272312444,16190541279,-2322,,
14785976862,260.61151,16190594637,272363474,16190592309,-2328,,
14786027451,260.66210,16190645228,272414059,16190642895,-2333,,
14786078483,260.71313,16190696272,272465099,16190693934,-2338,,
14786129058,260.76371,16190746839,272515661,16190744496,-2343,,
14786180135,260.81478,16190797919,272566735,16190795571,-2348,,
14786231156,260.86580,16190848942,272617753,16190846589,-2353,,
14786282203,260.91685,16190899991,272668797,16190897632,-2359,,
14786332819,260.96747,16190950610,272719412,16190948247,-2363,,
14786383900,261.01855,16191001694,272770489,16190999325,-2369,,
14786434492,261.06914,16191052287,272821078,16191049913,-2374,,
14786485032,261.11968,16191102830,272871617,16191100452,-2378,,
14786535581,261.17023,16191153381,272922162,16191150997,-2384,,
14786586134,261.22078,16191203936,272972711,16191201547,-2389,,
14786636269,261.27092,16191254074,273022844,16191251680,-2394,,
14786686863,261.32151,16191304671,273073437,16191302272,-2399,,
14786737468,261.37212,16191355278,273124039,16191352874,-2404,,
14786788075,261.42272,16191405887,273174643,16191403478,-2409,,
14786839125,261.47377,16191456939,273225690,16191454525,-2414,,
14786889754,261.52440,16191507571,273276317,16191505152,-2419,,
14786940793,261.57544,16191558612,273327352,16191556187,-2425,,
14786990919,261.62557,16191608741,273377488,16191606323,-2418,,
14787041994,261.67664,16191659818,273428548,16191657384,-2434,,
14787093060,261.72771,16191710886,273479612,16191708447,-2439,,
14787143660,261.77831,16191761489,273530208,16191759044,-2445,,
14787194717,261.82936,16191812548,273581263,16191810099,-2449,,
14787245143,261.87979,16191862977,273631687,16191860522,-2455,,
14787295712,261.93036,16191913547,273682252,16191911087,-2460,,
14787345856,261.98050,16191963694,273732394,16191961230,-2464,,
14787396480,262.03113,16192014321,273783015,16192011850,-2471,,
14787447484,262.08213,16192065327,273834017,16192062852,-2475,,
14787498126,262.13277,16192115971,273884655,16192113491,-2480,,
14787548747,262.18340,16192166595,273935274,16192164110,-2485,,
14787599326,262.23397,16192217176,273985850,16192214685,-2491,,
14787649477,262.28413,16192267328,274035997,16192264833,-2495,,
14787700320,262.33497,16192318175,274086839,16192315675,-2500,,
14787750888,262.38554,16192368745,274137404,16192366240,-2505,,
14787801500,262.43615,16192419359,274188013,16192416848,-2511,,
14787852087,262.48674,16192469948,274238597,16192467432,-2516,,
14787903063,262.53771,16192520926,274289571,16192518406,-2520,,
14787953602,262.58825,16192571478,274340117,16192568953,-2525,,
14788004650,262.63930,16192622519,274391162,16192619998,-2521,,
14788055209,262.68986,16192673079,274441709,16192670544,-2535,,
14788105791,262.74044,16192723665,274492288,16192721124,-2541,,
14788155950,262.79060,16192773825,274542443,16192771279,-2546,,
14788206518,262.84117,16192824396,274593010,16192821845,-2551,,
14788256704,262.89135,16192874585,274643193,16192872028,-2557,,
14788307223,262.94187,16192925106,274693710,16192922545,-2561,,
14788358297,262.99295,16192976181,274744780,16192973615,-2566,,
14788409320,263.04397,16193027208,274795801,16193024636,-2572,,
14788460077,263.09472,16193077967,274846555,16193075391,-2576,,
14788510625,263.14527,16193128517,274897100,16193125936,-2581,,
14788561203,263.19585,16193179098,274947677,16193176512,-2586,,
14788612252,263.24690,16193230148,274998722,16193227558,-2590,,
14788662861,263.29751,16193280760,275049328,16193278164,-2596,,
14788713435,263.34808,16193331337,275099900,16193328735,-2602,,
14788764010,263.39866,16193381914,275150473,16193379308,-2606,,
14788814577,263.44923,16193432484,275201037,16193429872,-2612,,
14788865072,263.49972,16193482981,275251528,16193480363,-2618,,
14788915634,263.55028,16193533545,275302088,16193530935,-2610,,
14788966674,263.60132,16193584587,275353125,16193581960,-2627,,
14789017667,263.65231,16193635583,275404116,16193632951,-2632,,
14789068196,263.70284,16193686124,275454652,16193683488,-2636,,
14789118667,263.75331,16193736588,275505110,16193733956,-2632,,
14789169740,263.80439,16193787663,275556181,16193785016,-2647,,
14789220761,263.85541,16193838686,275607198,16193836034,-2652,,
14789271443,263.90609,16193889370,275657878,16193886713,-2657,,
14789322461,263.95711,16193940390,275708892,16193937728,-2662,,
14789373037,264.00768,16193990970,275759466,16193988302,-2668,,
14789423623,264.05827,16194041558,275810049,16194038885,-2673,,
14789474249,264.10890,16194092186,275860674,16194089509,-2677,,
14789524801,264.15945,16194142741,275911234,16194140069,-2672,,
14789575401,264.21005,16194193343,275961820,16194190655,-2688,,
14789626475,264.26112,16194244418,276012891,16194241726,-2692,,
14789676789,264.31144,16194294736,276063202,16194292037,-2699,,
14789727840,264.36249,16194345788,276114250,16194343086,-2702,,
14789778883,264.41353,16194396834,276165290,16194394125,-2709,,
14789829471,264.46412,16194447425,276215877,16194444712,-2713,,
14789880107,264.51475,16194498063,276266509,16194495344,-2719,,
14789930405,264.56505,16194548363,276316804,16194545640,-2723,,
14789980992,264.61564,16194598953,276367389,16194596225,-2728,,
14790031606,264.66625,16194649568,276418000,16194646835,-2733,,
14790082198,264.71685,16194700163,276468589,16194697424,-2739,,
14790132362,264.76701,16194750330,276518750,16194747586,-2744,,
14790183000,264.81765,16194800970,276569386,16194798222,-2748,,
14790233465,264.86811,16194851438,276619848,16194848684,-2754,,
14790284051,264.91870,16194902025,276670431,16194899269,-2756,,
14790335070,264.96972,16194953046,276721448,16194950283,-2763,,
14790385184,265.01983,16195003164,276771559,16195000395,-2769,,
14790436282,265.07093,16195054264,276822654,16195051490,-2774,,
14790486790,265.12144,16195104774,276873159,16195101995,-2779,,
14790536842,265.17149,16195154829,276923209,16195152044,-2785,,
14790587403,265.22205,16195205402,276973777,16195202613,-2789,,
14790637970,265.27262,16195255960,277024331,16195253166,-2794,,
14790689047,265.32369,16195307041,277075407,16195304242,-2799,,
14790739659,265.37431,16195357655,277126026,16195354861,-2794,,
14790790726,265.42537,16195408723,277177079,16195405914,-2809,,
14790841380,265.47603,16195459380,277227731,16195456566,-2814,,
14790892007,265.52666,16195510010,277278355,16195507191,-2819,,
14790942951,265.57760,16195560956,277329296,16195558131,-2825,,
14790993578,265.62823,16195611586,277379921,16195608756,-2830,,
14791044625,265.67927,16195662635,277430965,16195659801,-2834,,
14791095651,265.73030,16195713664,277481988,16195710824,-2840,,
14791146722,265.78137,16195764736,277533056,16195761891,-2845,,
14791197770,265.83242,16195815787,277584102,16195812937,-2850,,
14791248819,265.88347,16195866838,277635148,16195863983,-2855,,
14791299368,265.93402,16195917389,277685694,16195914529,-2860,,
14791349927,265.98458,16195967951,277736251,16195965086,-2865,,
14791400992,266.03564,16196019019,277787314,16196016149,-2870,,
14791451528,266.08618,16196069557,277837847,16196066682,-2875,,
14791502142,266.13679,16196120174,277888457,16196117303,-2871,,
14791553211,266.18786,16196171245,277939523,16196168358,-2887,,
14791604263,266.23891,16196222299,277990573,16196219409,-2890,,
14791655286,266.28993,16196273324,278041593,16196270428,-2896,,
14791705823,266.34047,16196323863,278092127,16196320962,-2901,,
14791756896,266.39154,16196374938,278143198,16196372033,-2905,,
14791807912,266.44256,16196425957,278194211,16196423047,-2910,,
14791858202,266.49285,16196476250,278244498,16196473334,-2916,,
14791908439,266.54309,16196526489,278294732,16196523568,-2921,,
14791958990,266.59364,16196577043,278345281,16196574116,-2927,,
14792009627,266.64427,16196627682,278395916,16196624751,-2931,,
14792060673,266.69532,16196678730,278446959,16196675794,-2936,,
14792111722,266.74637,16196729781,278498005,16196726840,-2941,,
14792162734,266.79738,16196780796,278549014,16196777861,-2935,,
14792213788,266.84844,16196831853,278600065,16196828901,-2952,,
14792264837,266.89949,16196882904,278651111,16196879947,-2957,,
14792315386,266.95003,16196933455,278701659,16196930494,-2961,,
14792366436,267.00108,16196984507,278752705,16196981540,-2967,,
14792417518,267.05217,16197035591,278803784,16197032619,-2972,,
14792468513,267.10316,16197086588,278854776,16197083612,-2976,,
14792519057,267.15371,16197137136,278905318,16197134154,-2982,,
14792569624,267.20427,16197187705,278955883,16197184718,-2987,,
14792620203,267.25485,16197238286,279006459,16197235294,-2992,,
14792671238,267.30589,16197289324,279057501,16197286336,-2988,,
14792721657,267.35631,16197339744,279107907,16197336742,-3002,,
14792772730,267.40738,16197390821,279158977,16197387812,-3009,,
14792823107,267.45776,16197441200,279209352,16197438197,-3003,,
14792873667,267.50831,16197491762,279259909,16197488745,-3017,,
14792924711,267.55936,16197542808,279310950,16197539786,-3022,,
14792975312,267.60996,16197593411,279361548,16197590383,-3028,,
14793025856,267.66050,16197643958,279412091,16197640926,-3032,,
14793076933,267.71158,16197695038,279463165,16197692000,-3038,,
14793127482,267.76213,16197745588,279513710,16197742546,-3042,,
14793178006,267.81265,16197796115,279564232,16197793068,-3047,,
14793228596,267.86324,16197846707,279614819,16197843655,-3052,,
14793279614,267.91426,16197897727,279665834,16197894669,-3058,,
14793330174,267.96482,16197948291,279716401,16197945237,-3054,,
14793380742,268.01539,16197998860,279766957,16197995792,-3068,,
14793431776,268.06642,16198049896,279817988,16198046824,-3072,,
14793482808,268.11746,16198100932,279869017,16198097853,-3079,,
14793533853,268.16850,16198151989,279920070,16198148905,-3084,,
14793584939,268.21959,16198203066,279971143,16198199979,-3087,,
14793635985,268.27063,16198254116,280022187,16198251022,-3094,,
14793686562,268.32121,16198304695,280072760,16198301596,-3099,,
14793737079,268.37173,16198355214,280123276,16198352111,-3103,,
14793787814,268.42246,16198405952,280174008,16198402843,-3109,,
14793838407,268.47305,16198456547,280224597,16198453433,-3114,,
14793889051,268.52370,16198507193,280275238,16198504074,-3119,,
14793939599,268.57425,16198557744,280325785,16198554620,-3124,,
14793989850,268.62450,16198607996,280376032,16198604867,-3129,,
14794040442,268.67509,16198658592,280426622,16198655457,-3135,,
14794091025,268.72567,16198709177,280477203,16198706039,-3138,,
14794141931,268.77658,16198760096,280528116,16198756952,-3144,,
14794192964,268.82761,16198811121,280579136,16198807971,-3150,,
14794244005,268.87865,16198862163,280630173,16198859008,-3155,,
14794294565,268.92921,16198912737,280680743,16198909578,-3159,,
14794345145,268.97979,16198963308,280731308,16198960143,-3165,,
14794396194,269.03084,16199014360,280782355,16199011190,-3170,,
14794447201,269.08185,16199065369,280833360,16199062195,-3174,,
14794528701,269.16335,16199146872,280914853,16199143689,-3183,,
14794586296,269.22094,16199204470,280972445,16199201281,-3189,,
14794637129,269.27178,16199255305,281023276,16199252111,-3194,,
14794689768,269.32442,16199307947,281075913,16199304748,-3199,,
14794740211,269.37486,16199358392,281126352,16199355188,-3204,,
14794790281,269.42493,16199408464,281176420,16199405255,-3209,,
14794841496,269.47614,16199459683,281227633,16199456469,-3214,,
14794892181,269.52683,16199510369,281278315,16199507157,-3212,,
14794942389,269.57704,16199560580,281328520,16199557356,-3224,,
14794992698,269.62735,16199610891,281378826,16199607661,-3230,,
14795042947,269.67759,16199661142,281429073,16199657908,-3234,,
14795093231,269.72788,16199711429,281479354,16199708189,-3240,,
14795143517,269.77817,16199761718,281529637,16199758473,-3245,,
14795194032,269.82868,16199812246,281580162,16199808997,-3249,,
14795244397,269.87905,16199862603,281630513,16199859348,-3255,,
14795295061,269.92971,16199913268,281681173,16199910009,-3259,,
14795345535,269.98018,16199963744,281731645,16199960480,-3264,,
14795395866,270.03051,16200014078,281781972,16200010808,-3270,,
14795446505,270.08115,16200064719,281832609,16200061444,-3275,,
14795496892,270.13154,16200115109,281882993,16200111829,-3280,,
14795547157,270.18180,16200165377,281933256,16200162092,-3285,,
14795597649,270.23230,16200215870,281983745,16200212580,-3290,,
14795648567,270.28321,16200266791,282034660,16200263495,-3296,,
14795698905,270.33355,16200317131,282084996,16200313831,-3300,,
14795749684,270.38433,16200367913,282135773,16200364608,-3305,,
14795799880,270.43453,16200418110,282185965,16200414800,-3310,,
14795851568,270.48622,16200469802,282237651,16200466486,-3316,,
14795901845,270.53649,16200520080,282287925,16200516760,-3320,,
14795952017,270.58666,16200570254,282338094,16200566929,-3325,,
14796002569,270.63722,16200620809,282388643,16200617479,-3330,,
14796053249,270.68790,16200671492,282439321,16200668157,-3335,,
14796103872,270.73852,16200722116,282489941,16200718776,-3340,,
14796154567,270.78922,16200772814,282540632,16200769468,-3346,,
14796204863,270.83951,16200823112,282590927,16200819762,-3350,,
14796255531,270.89018,16200873783,282641592,16200870427,-3356,,
14796305896,270.94054,16200924151,282691954,16200920790,-3361,,
14796356681,270.99133,16200974938,282742736,16200971572,-3366,,
14796406938,271.04159,16201025198,282792991,16201021827,-3371,,
14796457201,271.09185,16201075462,282843251,16201072086,-3376,,
14796507878,271.14253,16201126141,282893925,16201122760,-3381,,
14796558256,271.19290,16201176523,282944301,16201173137,-3386,,
14796608567,271.24322,16201226836,282994609,16201223445,-3391,,
14796659105,271.29375,16201277375,283045144,16201273980,-3395,,
14796709466,271.34411,16201327740,283095503,16201324339,-3401,,
14796760060,271.39471,16201378335,283146094,16201374930,-3405,,
14796810805,271.44545,16201429083,283196836,16201425672,-3411,,
14796861089,271.49574,16201479369,283247117,16201475952,-3417,,
14796911497,271.54615,16201529780,283297523,16201526359,-3421,,
14796961726,271.59637,16201580011,283347749,16201576585,-3426,,
14797011873,271.64652,16201630161,283397894,16201626729,-3432,,
14797062168,271.69682,16201680459,283448187,16201677023,-3436,,
14797112625,271.74727,16201730916,283498640,16201727476,-3440,,
14797162807,271.79746,16201781102,283548819,16201777655,-3447,,
14797213407,271.84805,16201831704,283599428,16201828264,-3440,,
14797263725,271.89837,16201882023,283649732,16201878567,-3456,,
14797313849,271.94850,16201932151,283699854,16201928689,-3462,,
14797364533,271.99918,16201982836,283750535,16201979370,-3466,,
14797415173,272.04982,16202033479,283801172,16202030007,-3472,,
14797465558,272.10021,16202083867,283851554,16202080390,-3477,,
14797516785,272.15143,16202135096,283902779,16202131615,-3481,,
14797566980,272.20163,16202185293,283952971,16202181806,-3487,,
14797617349,272.25200,16202235664,284003337,16202232172,-3492,,
14797667526,272.30217,16202285844,284053511,16202282346,-3498,,
14797718178,272.35283,16202336498,284104161,16202332996,-3502,,
14797769222,272.40387,16202387545,284155202,16202384038,-3507,,
14797819783,272.45443,16202438107,284205760,16202434595,-3512,,
14797870803,272.50545,16202489131,284256777,16202485613,-3518,,
14797921395,272.55604,16202539725,284307367,16202536203,-3522,,
14797972006,272.60665,16202590339,284357977,16202586812,-3527,,
14798023721,272.65837,16202642058,284409690,16202638525,-3533,,
14798074141,272.70879,16202692477,284460105,16202688941,-3536,,
14798125212,272.75986,16202743550,284511173,16202740008,-3542,,
14798176224,272.81087,16202794566,284562182,16202791018,-3548,,
14798226751,272.86140,16202845095,284612707,16202841542,-3553,,
14798276804,272.91145,16202895150,284662756,16202891592,-3558,,
14798326842,272.96149,16202945190,284712792,16202941628,-3562,,
14798376994,273.01164,16202995344,284762941,16202991776,-3568,,
14798427454,273.06210,16203045808,284813399,16203042235,-3573,,
14798478523,273.11317,16203096879,284864466,16203093301,-3578,,
14798529073,273.16372,16203147431,284915013,16203143848,-3583,,
14798580121,273.21477,16203198481,284966057,16203194893,-3588,,
14798631150,273.26580,16203249513,285017084,16203245920,-3593,,
14798681702,273.31635,16203300066,285067633,16203296468,-3598,,
14798732233,273.36688,16203350601,285118161,16203346997,-3604,,
14798783066,273.41771,16203401436,285168992,16203397828,-3608,,
14798833644,273.46829,16203452015,285219567,16203448402,-3613,,
14798884184,273.51883,16203502559,285270104,16203498939,-3620,,
14798935225,273.56987,16203553602,285321144,16203549979,-3623,,
14798985810,273.62046,16203604189,285371726,16203600561,-3628,,
14799036724,273.67137,16203655106,285422637,16203651472,-3634,,
14799087660,273.72231,16203706044,285473569,16203702405,-3639,,
14799137750,273.77240,16203756137,285523658,16203752493,-3644,,
14799187822,273.82247,16203806210,285573726,16203802561,-3649,,
14799238357,273.87300,16203856748,285624258,16203853094,-3654,,
14799288444,273.92309,16203906838,285674343,16203903178,-3660,,
14799339472,273.97412,16203957867,285725368,16203954203,-3664,,
14799391078,274.02573,16204009476,285776971,16204005807,-3669,,
14799442125,274.07677,16204060526,285828016,16204056851,-3675,,
14799493120,274.12777,16204111522,285879008,16204107843,-3679,,
14799543690,274.17834,16204162094,285929575,16204158410,-3684,,
14799594229,274.22888,16204212636,285980111,16204208946,-3690,,
14799645289,274.27994,16204263699,286031169,16204260005,-3694,,
14799696317,274.33096,16204314729,286082194,16204311029,-3700,,
14799746948,274.38160,16204365363,286132823,16204361658,-3705,,
14799797928,274.43258,16204416344,286183799,16204412635,-3709,,
14799848969,274.48362,16204467389,286234839,16204463674,-3715,,
14799899023,274.53367,16204517444,286284889,16204513724,-3720,,
14799949588,274.58424,16204568012,286335452,16204564287,-3725,,
14800000157,274.63480,16204618583,286386018,16204614853,-3730,,
14800051144,274.68579,16204669573,286437002,16204665838,-3735,,
14800102229,274.73688,16204720660,286488085,16204716920,-3740,,
14800152743,274.78739,16204771177,286538595,16204767431,-3746,,
14800203325,274.83797,16204821772,286589187,16204818023,-3749,,
14800253885,274.88853,16204872323,286639732,16204868567,-3756,,
14800304901,274.93955,16204923342,286690746,16204919581,-3761,,
14800355467,274.99012,16204973910,286741310,16204970145,-3765,,
14800406205,275.04085,16205024650,286792044,16205020879,-3771,,
14800457267,275.09191,16205075715,286843103,16205071939,-3776,,
14800508310,275.14296,16205126760,286894143,16205122979,-3781,,
14800558905,275.19355,16205177358,286944737,16205173572,-3786,,
14800610260,275.24491,16205228715,286996088,16205224924,-3791,,
14800660455,275.29510,16205278911,287046280,16205275115,-3796,,
14800711001,275.34565,16205329460,287096823,16205325658,-3802,,
14800762039,275.39669,16205380500,287147859,16205376695,-3805,,
14800812232,275.44688,16205430696,287198050,16205426885,-3811,,
14800863288,275.49794,16205481755,287249102,16205477938,-3817,,
14800914329,275.54898,16205532798,287300141,16205528977,-3821,,
14800965379,275.60003,16205583850,287351188,16205580023,-3827,,
14801016492,275.65114,16205634965,287402298,16205631133,-3832,,
14801069018,275.70367,16205687494,287454821,16205683657,-3837,,
14801120114,275.75476,16205738593,287505915,16205734751,-3842,,
14801171086,275.80573,16205789567,287556884,16205785720,-3847,,
14801222201,275.85685,16205840683,287607996,16205836831,-3852,,
14801273229,275.90788,16205891715,287659021,16205887857,-3858,,
14801326935,275.96158,16205945422,287712725,16205941560,-3862,,
14801377992,276.01264,16205996483,287763779,16205992614,-3869,,
14801428821,276.06347,16206047313,287814605,16206043441,-3872,,
14801481398,276.11605,16206099893,287867179,16206096015,-3878,,
14801532447,276.16710,16206150944,287918226,16206147061,-3883,,
14801584013,276.21866,16206202513,287969789,16206198625,-3888,,
14801635022,276.26967,16206253524,288020794,16206249630,-3894,,
14801685091,276.31974,16206303596,288070861,16206299697,-3899,,
14801749793,276.38444,16206368301,288135561,16206364396,-3905,,
14801800933,276.43558,16206419442,288186697,16206415532,-3910,,
14801854976,276.48962,16206473489,288240737,16206469572,-3917,,
14801906075,276.54072,16206524590,288291834,16206520669,-3921,,
14801959475,276.59412,16206577993,288345232,16206574067,-3926,,
14802010417,276.64506,16206628936,288396170,16206625005,-3931,,
14802063427,276.69808,16206681950,288449178,16206678013,-3937,,
14802132132,276.76678,16206750658,288517878,16206746714,-3944,,
14802182772,276.81742,16206801300,288568517,16206797352,-3948,,
14802237206,276.87185,16206855736,288622946,16206851782,-3954,,
14802296907,276.93156,16206915440,288682646,16206911481,-3959,,
14802348824,276.98347,16206967359,288734559,16206963394,-3965,,
14802400678,277.03533,16207019216,288786410,16207015245,-3971,,
14802451008,277.08566,16207069548,288836737,16207065573,-3975,,
14802501269,277.13592,16207119811,288886996,16207115831,-3980,,
14802551491,277.18614,16207170035,288937215,16207166051,-3984,,
14802601743,277.23639,16207220291,288987465,16207216300,-3991,,
14802651903,277.28655,16207270452,289037622,16207266458,-3994,,
14802702198,277.33685,16207320749,289087914,16207316749,-4000,,
14802752555,277.38720,16207371110,289138268,16207367104,-4006,,
14802802838,277.43749,16207421394,289188549,16207417384,-4010,,
14802853540,277.48819,16207472098,289239247,16207468083,-4015,,
14802904053,277.53870,16207522614,289289758,16207518593,-4021,,
14802954880,277.58953,16207573444,289340583,16207569418,-4026,,
14803009460,277.64411,16207628026,289395160,16207623995,-4031,,
14803067823,277.70247,16207686392,289453520,16207682355,-4037,,
14803118654,277.75330,16207737226,289504348,16207733184,-4042,,
14803168937,277.80358,16207787510,289554628,16207783464,-4046,,
14803233254,277.86790,16207851830,289618942,16207847777,-4053,,
14803283562,277.91821,16207902141,289669247,16207898083,-4058,,
14803334282,277.96893,16207952863,289719964,16207948800,-4063,,
14803384842,278.01949,16208003425,289770521,16207999356,-4069,,
14803435305,278.06995,16208053891,289820982,16208049818,-4073,,
14803486335,278.12098,16208104923,289872009,16208100844,-4079,,
14803537361,278.17201,16208155951,289923032,16208151867,-4084,,
14803588520,278.22317,16208207113,289974189,16208203024,-4089,,
14803649248,278.28390,16208267843,290034913,16208263748,-4095,,
14803699837,278.33448,16208318436,290085501,16208314336,-4100,,
14803750499,278.38515,16208369100,290136159,16208364994,-4106,,
14803800988,278.43564,16208419590,290186644,16208415480,-4110,,
14803852324,278.48697,16208470930,290237978,16208466814,-4116,,
14803902856,278.53750,16208521463,290288508,16208517343,-4120,,
14803953380,278.58803,16208571990,290339029,16208567865,-4125,,
14804003793,278.63844,16208622405,290389439,16208618274,-4131,,
14804054712,278.68936,16208673326,290440356,16208669191,-4135,,
14804105251,278.73990,16208723869,290490892,16208719728,-4141,,
14804155889,278.79054,16208774508,290541527,16208770362,-4146,,
14804206441,278.84109,16208825063,290592076,16208820912,-4151,,
14804257316,278.89196,16208875941,290642949,16208871785,-4156,,
14804307747,278.94239,16208926374,290693377,16208922212,-4162,,
14804358547,278.99320,16208977175,290744174,16208973009,-4166,,
14804409328,279.04398,16209027960,290794953,16209023789,-4171,,
14804459986,279.09463,16209078620,290845609,16209074444,-4176,,
14804510415,279.14506,16209129051,290896034,16209124870,-4181,,
14804561174,279.19582,16209179812,290946791,16209175626,-4186,,
14804611656,279.24630,16209230296,290997270,16209226105,-4191,,
14804662730,279.29738,16209281373,291048341,16209277177,-4196,,
14804713349,279.34800,16209331995,291098957,16209327792,-4203,,
14804764377,279.39902,16209383024,291149983,16209378818,-4206,,
14804815030,279.44968,16209433681,291200637,16209429473,-4208,,
14804865813,279.50046,16209484465,291251413,16209480248,-4217,,
14804916255,279.55090,16209534910,291301853,16209530688,-4222,,
14804966765,279.60141,16209585423,291352360,16209581196,-4227,,
14805017813,279.65246,16209636472,291403405,16209632240,-4232,,
14805069908,279.70456,16209688569,291455496,16209684332,-4237,,
14805123945,279.75859,16209742609,291509531,16209738367,-4242,,
14805175149,279.80980,16209793816,291560733,16209789569,-4247,,
14805228242,279.86289,16209846912,291613823,16209842658,-4254,,
14805283602,279.91825,16209902273,291669180,16209898015,-4258,,
14805334652,279.96930,16209953327,291720227,16209949063,-4264,,
14805385663,280.02031,16210004340,291771235,16210000071,-4269,,
14805436256,280.07090,16210054934,291821826,16210050661,-4273,,
14805487315,280.12196,16210105996,291872882,16210101717,-4279,,
14805538402,280.17305,16210157085,291923966,16210152801,-4284,,
14805591094,280.22574,16210209780,291976655,16210205490,-4290,,
14805654590,280.28924,16210273279,292040148,16210268984,-4295,,
14805705615,280.34026,16210324306,292091170,16210320005,-4301,,
14805756634,280.39128,16210375327,292142187,16210371022,-4305,,
14805807729,280.44238,16210426426,292193279,16210422114,-4312,,
14805858211,280.49286,16210476910,292243759,16210472595,-4315,,
14805908801,280.54345,16210527501,292294344,16210523180,-4321,,
14805960346,280.59499,16210579049,292345888,16210574723,-4326,,
14806011371,280.64602,16210630076,292396910,16210625745,-4331,,
14806062038,280.69669,16210680746,292447574,16210676409,-4337,,
14806128316,280.76296,16210747027,292513849,16210742684,-4343,,
14806178815,280.81346,16210797529,292564345,16210793181,-4348,,
14806229848,280.86450,16210848564,292615375,16210844211,-4353,,
14806280193,280.91484,16210898912,292665718,16210894553,-4359,,
14806331623,280.96627,16210950344,292717145,16210945981,-4363,,
14806382086,281.01673,16211000809,292767607,16210996443,-4366,,
14806432755,281.06740,16211051480,292818271,16211047107,-4373,,
14806483198,281.11785,16211101926,292868713,16211097548,-4378,,
14806533877,281.16852,16211152606,292919388,16211148224,-4382,,
14806585525,281.22017,16211204258,292971033,16211199869,-4389,,
14806636641,281.27129,16211255375,293022146,16211250981,-4394,,
14806704680,281.33933,16211323417,293090182,16211319017,-4400,,
14806755622,281.39027,16211374362,293141121,16211369956,-4406,,
14806805756,281.44040,16211424498,293191252,16211420087,-4411,,
14806856455,281.49110,16211475200,293241950,16211470785,-4415,,
14806906992,281.54164,16211525739,293292483,16211521318,-4421,,
14806957681,281.59233,16211576430,293343169,16211572004,-4426,,
14807008192,281.64284,16211626944,293393678,16211622513,-4431,,
14807058753,281.69340,16211677507,293444236,16211673071,-4436,,
14807109400,281.74405,16211728156,293494880,16211723715,-4441,,
14807161000,281.79565,16211779759,293546477,16211775312,-4447,,
14807211365,281.84601,16211830127,293596840,16211825676,-4451,,
14807262362,281.89701,16211881126,293647834,16211876670,-4456,,
14807313335,281.94798,16211932101,293698804,16211927639,-4462,,
14807364375,281.99902,16211983144,293749843,16211978678,-4466,,
14807414957,282.04960,16212033728,293800422,16212029257,-4471,,
14807465980,282.10063,16212084753,293851441,16212080276,-4477,,
14807516047,282.15069,16212134823,293901505,16212130340,-4483,,
14807566592,282.20124,16212185371,293952049,16212180884,-4487,,
14807617647,282.25230,16212236427,294003100,16212231935,-4492,,
14807668200,282.30285,16212286983,294053651,16212282486,-4497,,
14807719266,282.35391,16212338052,294104714,16212333550,-4502,,
14807770185,282.40483,16212388973,294155631,16212384466,-4507,,
14807821233,282.45588,16212440022,294206675,16212435510,-4512,,
14807872320,282.50697,16212491113,294257760,16212486595,-4518,,
14807923254,282.55790,16212542049,294308691,16212537526,-4523,,
14807973450,282.60810,16212592247,294358884,16212587720,-4527,,
14808024046,282.65869,16212642846,294409478,16212638313,-4533,,
14808074829,282.70948,16212693631,294460258,16212689094,-4537,,
14808125152,282.75980,16212743957,294510580,16212739415,-4542,,
14808175702,282.81035,16212794509,294561126,16212789961,-4548,,
14808226217,282.86086,16212845025,294611636,16212840472,-4553,,
14808277321,282.91197,16212896133,294662739,16212891575,-4558,,
14808328320,282.96297,16212947134,294713735,16212942571,-4563,,
14808379458,283.01411,16212998273,294764870,16212993705,-4568,,
14808429910,283.06456,16213048729,294815320,16213044156,-4573,,
14808479967,283.11462,16213098787,294865374,16213094210,-4577,,
14808530507,283.16516,16213149329,294915911,16213144746,-4583,,
14808581114,283.21576,16213199940,294966516,16213195351,-4589,,
14808632427,283.26707,16213251255,295017826,16213246662,-4593,,
14808682664,283.31731,16213301494,295068061,16213296896,-4598,,
14808733217,283.36786,16213352049,295118610,16213347445,-4604,,
14808783749,283.41840,16213402584,295169141,16213397976,-4608,,
14808833785,283.46843,16213452622,295219174,16213448009,-4613,,
14808883994,283.51864,16213502834,295269379,16213498214,-4620,,
14808934220,283.56887,16213553062,295319614,16213548449,-4613,,
14808984483,283.61913,16213603327,295369864,16213598699,-4628,,
14809034633,283.66928,16213653480,295420011,16213648846,-4634,,
14809085624,283.72027,16213704473,295470999,16213699834,-4639,,
14809135677,283.77033,16213754527,295521049,16213749884,-4643,,
14809189674,283.82432,16213808528,295575044,16213803879,-4649,,
14809240267,283.87491,16213859124,295625634,16213854470,-4654,,
14809290888,283.92554,16213909747,295676251,16213905087,-4660,,
14809341116,283.97576,16213959977,295726477,16213955313,-4664,,
14809391612,284.02626,16214010475,295776971,16214005806,-4669,,
14809442013,284.07666,16214060879,295827369,16214056205,-4674,,
14809492310,284.12696,16214111178,295877664,16214106499,-4679,,
14809542699,284.17735,16214161568,295928049,16214156884,-4684,,
14809593251,284.22790,16214212124,295978599,16214207435,-4689,,
14809643502,284.27815,16214262377,296028848,16214257683,-4694,,
14809694057,284.32871,16214312933,296079399,16214308235,-4698,,
14809744837,284.37948,16214363717,296130177,16214359012,-4705,,
14809796117,284.43077,16214414999,296181454,16214410289,-4710,,
14809846724,284.48137,16214465609,296232058,16214460894,-4715,,
14809897312,284.53196,16214516199,296282643,16214511479,-4720,,
14809947773,284.58242,16214566661,296333101,16214561936,-4725,,
14809998664,284.63331,16214617555,296383990,16214612825,-4730,,
14810048863,284.68351,16214667756,296434186,16214663021,-4735,,
14810099065,284.73371,16214717960,296484385,16214713220,-4740,,
14810149519,284.78417,16214768417,296534837,16214763673,-4744,,
14810199959,284.83461,16214818859,296585274,16214814109,-4750,,
14810250061,284.88471,16214868964,296635373,16214864209,-4755,,
14810300529,284.93518,16214919434,296685838,16214914673,-4761,,
14810350836,284.98548,16214969743,296736143,16214964978,-4765,,
14810401234,285.03588,16215020144,296786538,16215015374,-4770,,
14810451904,285.08655,16215070817,296837205,16215066041,-4776,,
14810502346,285.13699,16215121261,296887646,16215116481,-4780,,
14810553005,285.18765,16215171922,296938302,16215167137,-4785,,
14810604257,285.23890,16215223176,296989550,16215218385,-4791,,
14810658838,285.29349,16215277759,297044128,16215272963,-4796,,
14810709496,285.34414,16215328420,297094784,16215323620,-4800,,
14810760150,285.39480,16215379077,297145436,16215374271,-4806,,
14810810496,285.44514,16215429424,297195778,16215424613,-4811,,
14810861194,285.49584,16215480126,297246474,16215475309,-4817,,
14810911901,285.54655,16215530834,297297178,16215526013,-4821,,
14810962310,285.59696,16215581246,297347584,16215576420,-4826,,
14811012591,285.64724,16215631530,297397863,16215626698,-4832,,
14811063204,285.69785,16215682144,297448473,16215677308,-4836,,
14811113460,285.74811,16215732403,297498726,16215727561,-4842,,
14811164173,285.79882,16215783118,297549436,16215778272,-4846,,
14811214763,285.84941,16215833711,297600024,16215828860,-4851,,
14811265757,285.90040,16215884708,297651015,16215879851,-4857,,
14811316268,285.95092,16215935221,297701523,16215930359,-4862,,
14811366726,286.00137,16215985680,297751978,16215980813,-4867,,
14811417416,286.05206,16216036373,297802666,16216031502,-4871,,
14811467616,286.10226,16216086576,297852864,16216081699,-4877,,
14811517771,286.15242,16216136733,297903015,16216131851,-4882,,
14811568386,286.20303,16216187351,297953629,16216182464,-4887,,
14811618679,286.25333,16216237646,298003918,16216232763,-4883,,
14811668881,286.30353,16216287850,298054117,16216282952,-4898,,
14811719425,286.35407,16216338397,298104659,16216333495,-4902,,
14811769696,286.40434,16216388670,298154927,16216383762,-4908,,
14811819971,286.45462,16216438947,298205200,16216434036,-4911,,
14811870365,286.50501,16216489343,298255590,16216484425,-4918,,
14811921018,286.55567,16216539998,298306241,16216535076,-4922,,
14811971104,286.60575,16216590087,298356324,16216585160,-4927,,
14812022188,286.65684,16216641173,298407405,16216636241,-4932,,
14812072491,286.70714,16216691478,298457706,16216686541,-4937,,
14812123420,286.75807,16216742410,298508632,16216737468,-4942,,
14812174129,286.80878,16216793121,298559338,16216788173,-4948,,
14812224664,286.85931,16216843658,298609871,16216838706,-4952,,
14812275012,286.90966,16216894008,298660215,16216889051,-4957,,
14812325411,286.96006,16216944410,298710612,16216939447,-4963,,
14812375740,287.01039,16216994742,298760939,16216989774,-4968,,
14812426792,287.06144,16217045796,298811988,16217040824,-4972,,
14812477318,287.11197,16217096324,298862511,16217091346,-4978,,
14812528133,287.16278,16217147141,298913322,16217142158,-4983,,
14812578676,287.21332,16217197688,298963865,16217192700,-4988,,
14812628979,287.26363,16217247992,299014164,16217243000,-4992,,
14812679069,287.31372,16217298084,299064250,16217293086,-4998,,
14812729604,287.36425,16217348623,299114784,16217343620,-5003,,
14812779677,287.41433,16217398709,299164866,16217393702,-5007,,
14812830182,287.46483,16217449204,299215356,16217444191,-5013,,
14812880307,287.51495,16217499333,299265479,16217494314,-5019,,
14812931347,287.56599,16217550375,299316517,16217545352,-5023,,
14812981882,287.61653,16217600912,299367049,16217595884,-5028,,
14813032503,287.66715,16217651536,299417667,16217646502,-5034,,
14813083192,287.71784,16217702227,299468354,16217697189,-5038,,
14813134244,287.76889,16217753281,299519403,16217748238,-5043,,
14813184771,287.81942,16217803810,299569926,16217798761,-5049,,
14813235003,287.86965,16217854045,299620155,16217848991,-5054,,
14813285625,287.92027,16217904669,299670776,16217899611,-5058,,
14813336239,287.97089,16217955286,299721386,16217950222,-5064,,
14813386858,288.02151,16218005906,299772002,16218000837,-5069,,
14813437845,288.07249,16218056896,299822987,16218051823,-5073,,
14813488457,288.12311,16218107511,299873597,16218102432,-5079,,
14813539161,288.17381,16218158217,299924297,16218153133,-5084,,
14813589690,288.22434,16218208749,299974824,16218203659,-5090,,
14813640763,288.27541,16218259824,300025894,16218254730,-5094,,
14813691847,288.32650,16218310910,300076975,16218305811,-5099,,
14813742886,288.37753,16218361952,300128011,16218356847,-5105,,
14813793918,288.42857,16218412986,300179042,16218407877,-5109,,
14813844475,288.47912,16218463545,300229595,16218458431,-5114,,
14813895494,288.53014,16218514566,300280611,16218509446,-5120,,
14813946073,288.58072,16218565148,300331187,16218560023,-5125,,
14813996458,288.63111,16218615534,300381570,16218610405,-5129,,
14814047433,288.68208,16218666513,300432542,16218661378,-5135,,
14814098473,288.73312,16218717555,300483580,16218712415,-5140,,
14814148591,288.78324,16218767676,300533695,16218762530,-5146,,
14814199175,288.83382,16218818261,300584276,16218813112,-5149,,
14814249786,288.88443,16218868887,300634897,16218863732,-5155,,
14814300324,288.93497,16218919415,300685419,16218914254,-5161,,
14814350884,288.98553,16218969978,300735978,16218964813,-5165,,
14814401853,289.03650,16219020949,300786943,16219015779,-5170,,
14814452401,289.08705,16219071500,300837489,16219066324,-5176,,
14814502954,289.13760,16219122055,300888039,16219116875,-5180,,
14814553857,289.18851,16219172959,300938939,16219167774,-5185,,
14814604870,289.23952,16219223976,300989950,16219218785,-5191,,
14814655908,289.29056,16219275015,301040984,16219269819,-5196,,
14814706961,289.34161,16219326071,301092035,16219320870,-5201,,
14814757997,289.39265,16219377109,301143068,16219371903,-5206,,
14814808552,289.44320,16219427666,301193620,16219422455,-5211,,
14814859606,289.49425,16219478724,301244672,16219473508,-5216,,
14814910685,289.54533,16219529805,301295749,16219524584,-5221,,
14814961731,289.59638,16219580853,301346791,16219575626,-5227,,
14815012784,289.64743,16219631909,301397842,16219626677,-5232,,
14815063284,289.69793,16219682410,301448339,16219677174,-5236,,
14815113818,289.74847,16219732946,301498870,16219727706,-5240,,
14815163904,289.79855,16219783036,301548953,16219777789,-5247,,
14815214467,289.84911,16219833601,301599515,16219828350,-5251,,
14815265507,289.90015,16219884644,301650552,16219879387,-5257,,
14815316553,289.95120,16219935691,301701594,16219930429,-5262,,
14815367134,290.00178,16219986275,301752172,16219981007,-5268,,
14815418170,290.05282,16220037313,301803206,16220032041,-5272,,
14815469213,290.10386,16220088359,301854246,16220083081,-5278,,
14815519798,290.15445,16220138946,301904829,16220133664,-5282,,
14815570855,290.20550,16220190005,301955882,16220184718,-5287,,
14815621809,290.25646,16220240962,302006835,16220235670,-5292,,
14815672440,290.30709,16220291595,302057462,16220286298,-5297,,
14815722978,290.35763,16220342135,302107997,16220336832,-5303,,
14815774026,290.40867,16220393186,302159043,16220387879,-5307,,
14815824469,290.45912,16220443641,302209494,16220438330,-5311,,
14815875153,290.50980,16220494317,302260164,16220488999,-5318,,
14815925856,290.56050,16220545023,302310866,16220539701,-5322,,
14815976780,290.61143,16220595960,302361797,16220590632,-5328,,
14816027811,290.66246,16220646983,302412814,16220641650,-5333,,
14816078001,290.71265,16220697175,302463002,16220691837,-5338,,
14816129051,290.76370,16220748239,302514061,16220742896,-5343,,
14816180103,290.81475,16220799293,302565110,16220793945,-5348,,
14816230786,290.86543,16220849967,302615778,16220844614,-5353,,
14816281753,290.91640,16220900937,302666743,16220895578,-5359,,
14816332328,290.96698,16220951513,302717315,16220946150,-5363,,
14816382915,291.01756,16221002102,302767899,16220996734,-5368,,
14816433509,291.06816,16221052700,302818490,16221047326,-5374,,
14816484296,291.11894,16221103489,302869276,16221098111,-5378,,
14816534955,291.16960,16221154151,302919931,16221148767,-5384,,
14816585420,291.22007,16221204618,302970393,16221199229,-5389,,
14816635858,291.27051,16221255058,303020829,16221249665,-5393,,
14816686894,291.32154,16221306097,303071862,16221300698,-5399,,
14816737488,291.37214,16221356708,303122469,16221351305,-5403,,
14816788000,291.42265,16221407206,303172962,16221401797,-5409,,
14816838048,291.47270,16221457258,303223009,16221451844,-5414,,
14816889146,291.52379,16221508358,303274104,16221502939,-5419,,
14816939683,291.57433,16221558897,303324638,16221553473,-5424,,
14816989842,291.62449,16221609058,303374794,16221603630,-5428,,
14817040391,291.67504,16221659610,303425341,16221654176,-5434,,
14817090905,291.72555,16221710126,303475851,16221704687,-5439,,
14817141659,291.77631,16221760883,303526603,16221755438,-5445,,
14817192231,291.82688,16221811457,303577172,16221806008,-5449,,
14817242835,291.87748,16221862063,303627774,16221856609,-5454,,
14817293572,291.92822,16221912805,303678510,16221907345,-5460,,
14817344149,291.97880,16221963381,303729082,16221957918,-5463,,
14817394510,292.02916,16222013745,303779440,16222008275,-5470,,
14817444726,292.07937,16222063963,303829653,16222058488,-5475,,
14817494999,292.12965,16222114239,303879924,16222108760,-5479,,
14817545149,292.17980,16222164392,303930071,16222158906,-5486,,
14817595343,292.22999,16222214588,303980262,16222209097,-5491,,
14817645993,292.28064,16222265240,304030909,16222259745,-5495,,
14817696320,292.33097,16222315569,304081233,16222310069,-5500,,
14817746617,292.38126,16222365869,304131528,16222360364,-5505,,
14817796924,292.43157,16222416178,304181832,16222410668,-5510,,
14817847378,292.48203,16222466635,304232284,16222461120,-5515,,
14817897704,292.53235,16222516962,304282607,16222511443,-5519,,
14817948364,292.58301,16222567624,304333264,16222562099,-5525,,
14817998699,292.63335,16222617963,304383597,16222612433,-5530,,
14818048796,292.68344,16222668062,304433692,16222662527,-5535,,
14818099064,292.73371,16222718332,304483957,16222712792,-5540,,
14818150009,292.78466,16222769280,304534900,16222763735,-5545,,
14818200403,292.83505,16222819676,304585290,16222814126,-5550,,
14818251136,292.88578,16222870411,304636020,16222864856,-5555,,
14818301518,292.93617,16222920796,304686399,16222915235,-5561,,
14818351797,292.98645,16222971077,304736676,16222965512,-5565,,
14818402307,293.03695,16223021589,304787184,16223016019,-5570,,
14818452751,293.08740,16223072036,304837625,16223066460,-5576,,
14818503084,293.13773,16223122371,304887955,16223116791,-5580,,
14818553628,293.18828,16223172917,304938497,16223167332,-5585,,
14818603828,293.23848,16223223120,304988693,16223217529,-5591,,
14818654495,293.28914,16223273789,305039359,16223268194,-5595,,
14818705133,293.33978,16223324428,305089993,16223318828,-5600,,
14818755332,293.38998,16223374630,305140189,16223369024,-5606,,
14818805622,293.44027,16223424923,305190476,16223419311,-5612,,
14818855953,293.49060,16223475255,305240805,16223469640,-5615,,
14818906360,293.54101,16223525665,305291209,16223520045,-5620,,
14818957069,293.59172,16223576376,305341915,16223570751,-5625,,
14819007821,293.64247,16223627131,305392665,16223621501,-5630,,
14819058101,293.69275,16223677414,305442942,16223671778,-5636,,
14819108418,293.74307,16223727732,305493256,16223722091,-5641,,
14819158980,293.79363,16223778297,305543816,16223772651,-5646,,
14819209185,293.84383,16223828504,305594018,16223822854,-5650,,
14819259762,293.89441,16223879083,305644592,16223873428,-5655,,
14819310263,293.94491,16223929587,305695090,16223923925,-5662,,
14819360801,293.99545,16223980127,305745625,16223974461,-5666,,
14819411100,294.04575,16224030429,305795923,16224024758,-5671,,
14819461541,294.09619,16224080873,305846360,16224075196,-5677,,
14819511857,294.14650,16224131191,305896674,16224125510,-5681,,
14819562826,294.19747,16224182162,305947640,16224176476,-5686,,
14819613069,294.24772,16224232408,305997880,16224226715,-5693,,
14819664087,294.29874,16224283428,306048897,16224277732,-5696,,
14819714320,294.34897,16224333662,306099126,16224327961,-5701,,
14819764620,294.39927,16224383965,306149423,16224378258,-5707,,
14819815296,294.44994,16224434643,306200096,16224428932,-5711,,
14819865885,294.50053,16224485234,306250683,16224479519,-5715,,
14819916832,294.55148,16224536184,306301627,16224530462,-5722,,
14819967457,294.60210,16224586811,306352249,16224581084,-5727,,
14820017813,294.65246,16224637169,306402603,16224631438,-5731,,
14820068401,294.70305,16224687761,306453188,16224682024,-5737,,
14820118688,294.75334,16224738049,306503472,16224732307,-5742,,
14820169289,294.80394,16224788654,306554070,16224782906,-5748,,
14820219950,294.85460,16224839317,306604729,16224833565,-5752,,
14820270620,294.90527,16224889989,306655396,16224884232,-5757,,
14820320927,294.95558,16224940298,306705700,16224934535,-5763,,
14820371293,295.00594,16224990666,306756064,16224984899,-5767,,
14820421601,295.05625,16225040977,306806369,16225035204,-5773,,
14820472262,295.10691,16225091640,306857027,16225085862,-5778,,
14820522553,295.15720,16225141933,306907316,16225136151,-5782,,
14820572754,295.20740,16225192136,306957514,16225186349,-5787,,
14820623003,295.25765,16225242393,307007765,16225236601,-5792,,
14820673322,295.30797,16225292710,307058077,16225286913,-5797,,
14820724006,295.35865,16225343396,307108759,16225337594,-5802,,
14820774456,295.40910,16225393848,307159205,16225388040,-5808,,
14820825221,295.45987,16225444615,307209967,16225438802,-5813,,
14820875427,295.51007,16225494824,307260171,16225489006,-5818,,
14820925607,295.56025,16225545007,307310348,16225539184,-5823,,
14820976108,295.61076,16225595509,307360846,16225589681,-5828,,
14821026880,295.66153,16225646284,307411617,16225640452,-5832,,
14821077083,295.71173,16225696490,307461816,16225690652,-5838,,
14821141760,295.77641,16225761170,307526489,16225755324,-5846,,
14821192707,295.82736,16225812118,307577434,16225806269,-5849,,
14821246687,295.88133,16225866102,307631411,16225860247,-5855,,
14821297344,295.93199,16225916761,307682065,16225910901,-5860,,
14821348038,295.98269,16225967456,307732756,16225961591,-5865,,
14821398820,296.03347,16226018241,307783536,16226012372,-5869,,
14821448947,296.08360,16226068370,307833660,16226062496,-5874,,
14821499515,296.13416,16226118940,307884225,16226113060,-5880,,
14821550145,296.18479,16226169573,307934853,16226163688,-5885,,
14821600475,296.23512,16226219905,307985180,16226214015,-5890,,
14821650666,296.28531,16226270099,308035368,16226264204,-5895,,
14821700735,296.33538,16226320170,308085434,16226314270,-5900,,
14821750805,296.38545,16226370242,308135502,16226364337,-5905,,
14821800896,296.43554,16226420336,308185590,16226414426,-5910,,
14821851500,296.48615,16226470942,308236191,16226465026,-5916,,
14821901704,296.53635,16226521149,308286393,16226515229,-5920,,
14821951817,296.58646,16226571264,308336504,16226565339,-5925,,
14822001948,296.63660,16226621398,308386632,16226615467,-5931,,
14822052035,296.68668,16226671486,308436716,16226665552,-5934,,
14822102559,296.73721,16226722013,308487237,16226716073,-5940,,
14822153075,296.78772,16226772532,308537750,16226766586,-5946,,
14822203315,296.83796,16226822773,308587988,16226816823,-5950,,
14822253977,296.88862,16226873438,308638647,16226867483,-5955,,
14822304959,296.93961,16226924423,308689626,16226918462,-5961,,
14822355473,296.99012,16226974939,308740139,16226968974,-5965,,
14822405649,297.04030,16227025118,308790312,16227019147,-5971,,
14822456507,297.09116,16227075977,308841166,16227070001,-5976,,
14822507056,297.14170,16227126528,308891712,16227120547,-5981,,
14822558005,297.19265,16227177481,308942660,16227171495,-5986,,
14822608525,297.24317,16227228003,308993176,16227222012,-5991,,
14822658952,297.29360,16227278432,309043600,16227272436,-5996,,
14822709895,297.34454,16227329378,309094542,16227323377,-6001,,
14822760465,297.39511,16227379950,309145109,16227373944,-6006,,
14822812226,297.44687,16227431735,309196889,16227425725,-6010,,
14822865669,297.50032,16227485158,309250306,16227479141,-6017,,
14822919898,297.55455,16227539389,309304532,16227533367,-6022,,
14822970851,297.60550,16227590345,309355483,16227584318,-6027,,
14823021150,297.65580,16227640647,309405779,16227634614,-6033,,
14823072302,297.70695,16227691802,309456928,16227685763,-6039,,
14823124983,297.75963,16227744485,309509606,16227738442,-6043,,
14823175739,297.81039,16227795243,309560360,16227789196,-6047,,
14823226101,297.86075,16227845608,309610719,16227839555,-6053,,
14823276279,297.91093,16227895788,309660895,16227889730,-6058,,
14823326812,297.96146,16227946323,309711425,16227940261,-6062,,
14823377105,298.01175,16227996618,309761715,16227990550,-6068,,
14823427626,298.06227,16228047141,309812233,16228041068,-6073,,
14823478302,298.11295,16228097830,309862917,16228091752,-6078,,
14823528686,298.16333,16228148207,309913289,16228142124,-6083,,
14823578944,298.21359,16228198466,309963543,16228192378,-6088,,
14823629045,298.26369,16228248570,310013642,16228242477,-6093,,
14823679428,298.31408,16228298955,310064022,16228292857,-6098,,
14823729992,298.36464,16228349534,310114595,16228343431,-6103,,
14823780249,298.41490,16228399781,310164837,16228393673,-6108,,
14823830447,298.46510,16228449982,310215033,16228443869,-6113,,
14823881136,298.51578,16228500673,310265719,16228494555,-6118,,
14823931438,298.56609,16228550976,310316018,16228544854,-6122,,
14823981730,298.61638,16228601272,310366308,16228595144,-6128,,
14824031975,298.66662,16228651518,310416550,16228645385,-6133,,
14824082548,298.71720,16228702094,310467120,16228695956,-6138,,
14824132931,298.76758,16228752480,310517500,16228746336,-6144,,
14824183252,298.81790,16228802803,310567819,16228796655,-6148,,
14824233839,298.86849,16228853392,310618403,16228847238,-6154,,
14824284607,298.91926,16228904162,310669168,16228898003,-6159,,
14824334978,298.96963,16228954536,310719537,16228948373,-6163,,
14824385310,299.01996,16229004870,310769866,16228998701,-6169,,
14824435664,299.07031,16229055227,310820218,16229049053,-6174,,
14824486293,299.12094,16229105867,310870854,16229099689,-6178,,
14824536577,299.17122,16229156145,310921125,16229149961,-6184,,
14824587104,299.22175,16229206674,310971650,16229200485,-6189,,
14824637299,299.27195,16229256871,311021842,16229250677,-6194,,
14824688224,299.32287,16229307809,311072774,16229301610,-6199,,
14824738722,299.37337,16229358298,311123259,16229352094,-6204,,
14824789516,299.42416,16229409095,311174050,16229402886,-6209,,
14824839877,299.47453,16229459459,311224409,16229453245,-6214,,
14824890204,299.52485,16229509788,311274733,16229503569,-6219,,
14824940850,299.57550,16229560435,311325376,16229554211,-6224,,
14824991117,299.62577,16229610706,311375641,16229604477,-6229,,
14825041234,299.67588,16229660825,311425756,16229654591,-6234,,
14825091682,299.72633,16229711275,311476200,16229705036,-6239,,
14825141803,299.77645,16229761399,311526319,16229755154,-6245,,
14825192379,299.82703,16229811977,311576893,16229805728,-6249,,
14825242673,299.87732,16229862273,311627184,16229856019,-6254,,
14825292787,299.92744,16229912390,311677294,16229906129,-6261,,
14825342922,299.97757,16229962526,311727427,16229956262,-6264,,
14825393085,300.02773,16230012692,311777588,16230006423,-6269,,
14825443635,300.07828,16230063245,311828134,16230056969,-6276,,
14825494109,300.12876,16230113721,311878606,16230107442,-6279,,
14825544262,300.17891,16230163876,311928757,16230157592,-6284,,
14825594682,300.22933,16230214299,311979174,16230208009,-6290,,
14825644838,300.27949,16230264456,312029327,16230258162,-6294,,
14825695126,300.32977,16230314747,312079612,16230308448,-6299,,
14825745522,300.38017,16230365146,312130006,16230358841,-6305,,
14825796026,300.43067,16230415652,312180507,16230409342,-6310,,
14825846599,300.48125,16230466228,312231078,16230459913,-6315,,
14825896707,300.53136,16230516337,312281182,16230510017,-6320,,
14825947029,300.58168,16230566662,312331502,16230560337,-6325,,
14825997288,300.63194,16230616924,312381759,16230610594,-6330,,
14826047555,300.68220,16230667193,312432022,16230660858,-6335,,
14826098617,300.73327,16230718257,312483081,16230711917,-6340,,
14826149132,300.78378,16230768785,312533604,16230762440,-6345,,
14826199610,300.83426,16230819255,312584070,16230812905,-6350,,
14826249746,300.88439,16230869393,312634203,16230863049,-6344,,
14826300184,300.93483,16230919833,312684637,16230913473,-6360,,
14826350794,300.98544,16230970446,312735256,16230964091,-6355,,
14826401297,301.03595,16231020951,312785745,16231014580,-6371,,
14826452040,301.08669,16231071706,312836495,16231065330,-6376,,
14826502464,301.13711,16231122122,312886907,16231115742,-6380,,
14826552613,301.18726,16231172274,312937054,16231165889,-6385,,
14826602854,301.23750,16231222517,312987291,16231216126,-6391,,
14826837619,301.47227,16231457293,313222043,16231450879,-6414,16231457021,
14826863023,301.49767,16231482699,313247446,16231476313,-6386,,
14826914074,301.54872,16231533752,313298495,16231527425,-6327,,
14826964518,301.59917,16231584199,313348937,16231577928,-6271,,
14827015414,301.65006,16231635096,313399829,16231628884,-6212,,
14827065928,301.70058,16231685612,313450341,16231679457,-6155,,
14827116636,301.75128,16231736324,313501047,16231730226,-6098,,
14827167201,301.80185,16231786891,313551609,16231780849,-6042,,
14827217425,301.85207,16231837117,313601829,16231831132,-5985,,
14827267993,301.90264,16231887688,313652395,16231881760,-5928,,
14827318109,301.95276,16231937805,313702508,16231931935,-5870,,
14827368242,302.00289,16231987941,313752638,16231982125,-5816,,
14827418715,302.05336,16232038417,313803109,16232032659,-5758,,
14827469383,302.10403,16232089087,313853774,16232083387,-5700,,
14827519930,302.15458,16232139647,313904330,16232134004,-5643,,
14827570265,302.20491,16232189974,313954651,16232184386,-5588,,
14827620782,302.25543,16232240493,314005165,16232234964,-5529,,
14827670893,302.30554,16232290605,314055273,16232285132,-5473,,
14827721258,302.35591,16232340973,314105635,16232335557,-5416,,
14827771576,302.40622,16232391305,314155962,16232385946,-5359,,
14827822428,302.45708,16232442148,314206800,16232436846,-5302,,
14827872969,302.50762,16232492692,314257338,16232487446,-5246,,
14827923182,302.55783,16232542907,314307550,16232537719,-5188,,
14827974192,302.60884,16232593919,314358557,16232588790,-5129,,
14828024577,302.65922,16232644307,314408949,16232639244,-5063,,
14828075131,302.70978,16232694863,314459491,16232689847,-5016,,
14828125522,302.76017,16232745255,314509878,16232740296,-4959,,
14828175639,302.81029,16232795385,314560002,16232790482,-4903,,
14828226145,302.86079,16232845884,314610495,16232841037,-4847,,
14828276808,302.91146,16232896550,314661157,16232891761,-4789,,
14828328016,302.96266,16232947760,314712361,16232943029,-4731,,
14828378947,303.01360,16232998705,314763301,16232994031,-4674,,
14828429043,303.06369,16233048792,314813384,16233044175,-4617,,
14828479666,303.11431,16233099417,314864003,16233094857,-4560,,
14828530504,303.16515,16233150258,314914840,16233145755,-4503,,
14828580635,303.21528,16233200390,314964966,16233195943,-4447,,
14828631356,303.26600,16233251114,315015685,16233246725,-4389,,
14828681814,303.31646,16233301574,315066141,16233297242,-4332,,
14828732765,303.36741,16233352527,315117088,16233348253,-4274,,
14828783307,303.41796,16233403072,315167628,16233398855,-4217,,
14828833867,303.46852,16233453634,315218185,16233449474,-4160,,
14828883927,303.51857,16233503697,315268243,16233499593,-4104,,
14828934414,303.56906,16233554196,315318737,16233550149,-4047,,
14828984872,303.61952,16233604646,315369182,16233600657,-3989,,
14829035499,303.67015,16233655276,315419806,16233651343,-3933,,
14829085866,303.72051,16233705644,315470170,16233701768,-3876,,
14829135992,303.77064,16233755772,315520294,16233751954,-3818,,
14829186717,303.82137,16233806500,315571016,16233802738,-3762,,
14829237348,303.87200,16233857133,315621644,16233853429,-3704,,
14829287693,303.92234,16233907492,315671998,16233903844,-3648,,
14829337786,303.97243,16233957576,315722077,16233953984,-3592,,
14829388070,304.02272,16234007863,315772359,16234004328,-3535,,
14829438676,304.07332,16234058471,315822962,16234054993,-3478,,
14829488761,304.12341,16234108559,315873054,16234105148,-3411,,
14829539061,304.17371,16234158861,315923342,16234155497,-3364,,
14829589619,304.22427,16234209422,315973897,16234206114,-3308,,
14829640245,304.27489,16234260049,316024520,16234256799,-3250,,
14829690855,304.32550,16234310672,316075138,16234307479,-3193,,
14829741252,304.37590,16234361062,316125521,16234357925,-3137,,
14829791341,304.42599,16234411152,316175608,16234408074,-3078,,
14829841874,304.47652,16234461688,316226139,16234458666,-3022,,
14829892639,304.52729,16234512459,316276908,16234509497,-2962,,
14829942826,304.57747,16234562645,316327086,16234559737,-2908,,
14829992963,304.62761,16234612784,316377220,16234609932,-2852,,
14830043161,304.67781,16234662985,316427414,16234660189,-2796,,
14830093612,304.72826,16234713449,316477874,16234710711,-2738,,
14830144199,304.77885,16234764027,316528448,16234761346,-2681,,
14830195179,304.82983,16234815009,316579424,16234812386,-2623,,
14830246047,304.88070,16234865880,316630289,16234863313,-2567,,
14830296414,304.93106,16234916249,316680655,16234913740,-2509,,
14830347199,304.98185,16234967036,316731436,16234964584,-2452,,
14830397556,305.03220,16235017407,316781802,16235015012,-2395,,
14830448171,305.08282,16235068013,316832403,16235065676,-2337,,
14830498726,305.13337,16235118570,316882955,16235116289,-2281,,
14830549479,305.18413,16235169325,316933705,16235167101,-2224,,
14830599567,305.23422,16235219416,316983800,16235217258,-2158,,
14830649694,305.28434,16235269556,317033925,16235267445,-2111,,
14830700514,305.33516,16235320367,317084732,16235318314,-2053,,
14830750920,305.38557,16235370777,317135135,16235368780,-1997,,
14830801300,305.43595,16235421159,317185514,16235419220,-1939,,
14830851875,305.48652,16235471736,317236086,16235469854,-1882,,
14830902433,305.53708,16235522296,317286640,16235520470,-1826,,
14830952608,305.58726,16235572484,317336824,16235570715,-1769,,
14831003260,305.63791,16235623128,317387463,16235621417,-1711,,
14831053359,305.68801,16235673229,317437558,16235671573,-1656,,
14831103824,305.73847,16235723696,317488020,16235722097,-1599,,
14831154031,305.78868,16235773915,317538235,16235772374,-1541,,
14831204664,305.83931,16235824542,317588856,16235823057,-1485,,
14831255281,305.88993,16235875161,317639469,16235873733,-1428,,
14831305452,305.94010,16235925334,317689638,16235923964,-1370,,
14831356020,305.99067,16235975905,317740203,16235974590,-1315,,
14831406818,306.04147,16236026714,317791008,16236025459,-1255,,
14831457244,306.09189,16236077132,317841422,16236075934,-1198,,
14831507704,306.14235,16236127596,317891880,16236126454,-1142,,
14831558396,306.19304,16236178289,317942568,16236177204,-1085,,
14831608658,306.24331,16236228554,317992828,16236227526,-1028,,
14831659090,306.29374,16236278989,318043258,16236278018,-971,,
14831709623,306.34427,16236329534,318093798,16236328620,-914,,
14831759834,306.39448,16236379737,318143995,16236378879,-858,,
14831810333,306.44498,16236430239,318194492,16236429437,-802,,
14831860660,306.49531,16236480568,318244817,16236479796,-772,,
14831910806,306.54545,16236530716,318294959,16236529938,-778,,
14831960927,306.59557,16236580840,318345079,16236580058,-782,,
14832011539,306.64619,16236631453,318395687,16236630666,-787,,
14832061670,306.69632,16236681588,318445816,16236680795,-793,,
14832112260,306.74691,16236732190,318496413,16236731393,-797,,
14832162587,306.79724,16236782509,318546727,16236781707,-802,,
14832212709,306.84736,16236832634,318596846,16236831826,-808,,
14832263055,306.89770,16236882987,318647194,16236882174,-813,,
14832313371,306.94802,16236933300,318697503,16236932483,-817,,
14832363776,306.99842,16236983707,318747905,16236982884,-823,,
14832414304,307.04895,16237034238,318798430,16237033410,-828,,
14832464394,307.09904,16237084330,318848519,16237083498,-832,,
14832514670,307.14932,16237134609,318898791,16237133771,-838,,
14832564733,307.19938,16237184674,318948851,16237183831,-843,,
14832615395,307.25004,16237235337,318999511,16237234490,-847,,
14832665489,307.30014,16237285434,319049602,16237284582,-852,,
14832715823,307.35047,16237335771,319099933,16237334913,-858,,
14832766062,307.40071,16237386012,319150170,16237385150,-862,,
14832816624,307.45127,16237436577,319200729,16237435708,-869,,
14832867666,307.50231,16237487621,319251768,16237486748,-873,,
14832918285,307.55293,16237538241,319302384,16237537364,-877,,
14832968412,307.60306,16237588371,319352509,16237587488,-883,,
14833018825,307.65347,16237638786,319402919,16237637898,-888,,
14833068940,307.70359,16237688903,319453031,16237688010,-893,,
14833119069,307.75372,16237739036,319503159,16237738138,-898,,
14833169519,307.80417,16237789487,319553605,16237788585,-902,,
14833219924,307.85457,16237839895,319604008,16237838987,-908,,
14833270300,307.90495,16237890274,319654381,16237889360,-914,,
14833320445,307.95509,16237940421,319704523,16237939503,-918,,
14833371024,308.00567,16237991012,319755110,16237990090,-922,,
14833421184,308.05583,16238041165,319805257,16238040237,-928,,
14833471886,308.10653,16238091869,319855956,16238090936,-933,,
14833522659,308.15731,16238142644,319906726,16238141716,-928,,
14833573521,308.20817,16238193509,319957585,16238192564,-945,,
14833624225,308.25887,16238244214,320008287,16238243266,-948,,
14833674427,308.30908,16238294430,320058496,16238293476,-954,,
14833725406,308.36005,16238345401,320109462,16238344441,-960,,
14833776417,308.41107,16238396414,320160470,16238395450,-964,,
14833826977,308.46163,16238446976,320211028,16238446007,-969,,
14833878032,308.51268,16238498033,320262080,16238497059,-974,,
14833929081,308.56373,16238549085,320313126,16238548106,-979,,
14833979661,308.61431,16238599667,320363704,16238598683,-984,,
14834030209,308.66486,16238650217,320414249,16238649228,-989,,
14834081254,308.71590,16238701265,320465292,16238700271,-994,,
14834132295,308.76694,16238752309,320516329,16238751309,-1000,,
14834182854,308.81750,16238802880,320566897,16238801876,-1004,,
14834233840,308.86849,16238853859,320617879,16238852858,-1001,,
14834284437,308.91908,16238904458,320668464,16238903443,-1015,,
14834334507,308.96916,16238954530,320718531,16238953511,-1019,,
14834385558,309.02021,16239005584,320769579,16239004559,-1025,,
14834436116,309.07076,16239056154,320820145,16239055124,-1030,,
14834486867,309.12151,16239106897,320870882,16239105862,-1035,,
14834537487,309.17214,16239157520,320921500,16239156480,-1040,,
14834588566,309.22321,16239208600,320972576,16239207555,-1045,,
14834639602,309.27425,16239259639,321023609,16239258589,-1050,,
14834690534,309.32518,16239310574,321074540,16239309519,-1055,,
14834741110,309.37576,16239361152,321125113,16239360092,-1060,,
14834791654,309.42630,16239411699,321175654,16239410634,-1065,,
14834842211,309.47686,16239462257,321226207,16239461186,-1071,,
14834893232,309.52788,16239513281,321277226,16239512206,-1075,,
14834943807,309.57846,16239563867,321327807,16239562786,-1081,,
14834994888,309.62954,16239614942,321378877,16239613856,-1086,,
14835045406,309.68005,16239665462,321429393,16239664372,-1090,,
14835095966,309.73061,16239716034,321479959,16239714938,-1096,,
14835147015,309.78166,16239767075,321531006,16239765985,-1090,,
14835198086,309.83273,16239818149,321582064,16239817043,-1106,,
14835248620,309.88327,16239868686,321632596,16239867575,-1111,,
14835299650,309.93430,16239919717,321683622,16239918601,-1116,,
14835350568,309.98522,16239970648,321734548,16239969527,-1121,,
14835400952,310.03560,16240021035,321784929,16240019909,-1126,,
14835451876,310.08652,16240071951,321835840,16240070820,-1131,,
14835502436,310.13708,16240122514,321886397,16240121377,-1137,,
14835553038,310.18769,16240173118,321936997,16240171976,-1142,,
14835603591,310.23824,16240223672,321987547,16240222526,-1146,,
14835654556,310.28920,16240274641,322038510,16240273489,-1152,,
14835705014,310.33966,16240325101,322088964,16240323944,-1157,,
14835755752,310.39040,16240375840,322139700,16240374679,-1161,,
14835806778,310.44143,16240426870,322190724,16240425708,-1162,,
14835857341,310.49199,16240477435,322241284,16240476263,-1172,,
14835907393,310.54204,16240527489,322291333,16240526312,-1177,,
14835958020,310.59267,16240578119,322341958,16240576937,-1182,,
14836008580,310.64323,16240628681,322392514,16240627494,-1187,,
14836059173,310.69382,16240679276,322443105,16240678084,-1192,,
14836109909,310.74456,16240730014,322493838,16240728817,-1197,,
14836160442,310.79509,16240780550,322544380,16240779359,-1191,,
14836211505,310.84615,16240831615,322595429,16240830408,-1207,,
14836262601,310.89725,16240882714,322646522,16240881502,-1212,,
14836314073,310.94872,16240934187,322697991,16240932970,-1217,,
14836364597,310.99924,16240984716,322748514,16240983493,-1223,,
14836415145,311.04979,16241035265,322799057,16241034037,-1228,,
14836465697,311.10035,16241085820,322849608,16241084587,-1233,,
14836515756,311.15040,16241135881,322899664,16241134643,-1238,,
14836566300,311.20095,16241186427,322950204,16241185183,-1244,,
14836617358,311.25201,16241237487,323001260,16241236240,-1247,,
14836667899,311.30255,16241288032,323051799,16241286779,-1253,,
14836718953,311.35360,16241339087,323102849,16241337828,-1259,,
14836769501,311.40415,16241389637,323153394,16241388374,-1263,,
14836820917,311.45556,16241441056,323204808,16241439788,-1268,,
14836874726,311.50937,16241494866,323258614,16241493594,-1272,,
14836933229,311.56788,16241553373,323317114,16241552093,-1280,,
14836984487,311.61914,16241604633,323368369,16241603348,-1285,,
14837034759,311.66941,16241654907,323418638,16241653617,-1290,,
14837085308,311.71996,16241705458,323469184,16241704163,-1295,,
14837136339,311.77099,16241756491,323520213,16241755193,-1298,,
14837186882,311.82153,16241807038,323570753,16241805733,-1305,,
14837237476,311.87212,16241857633,323621344,16241856323,-1310,,
14837288504,311.92315,16241908665,323672370,16241907350,-1315,,
14837339522,311.97417,16241959685,323723386,16241958365,-1320,,
14837391033,312.02568,16242011197,323774893,16242009872,-1325,,
14837447762,312.08241,16242067930,323831619,16242066598,-1332,,
14837499606,312.13425,16242119776,323883460,16242118440,-1336,,
14837550341,312.18499,16242170514,323934193,16242169173,-1341,,
14837601271,312.23592,16242221446,323985120,16242220100,-1346,,
14837652363,312.28701,16242272540,324036209,16242271188,-1352,,
14837703498,312.33815,16242323677,324087340,16242322320,-1357,,
14837753895,312.38854,16242374076,324137736,16242372716,-1360,,
14837803961,312.43861,16242424145,324187799,16242422778,-1367,,
14837854420,312.48907,16242474607,324238255,16242473235,-1372,,
14837905470,312.54012,16242525659,324289303,16242524283,-1376,,
14837955533,312.59018,16242575725,324339364,16242574343,-1382,,
14838006088,312.64074,16242626282,324389916,16242624895,-1387,,
14838057224,312.69187,16242677420,324441049,16242676028,-1392,,
14838108181,312.74283,16242728380,324492003,16242726983,-1397,,
14838158721,312.79337,16242778921,324542540,16242777519,-1402,,
14838209282,312.84393,16242829484,324593098,16242828077,-1407,,
14838260323,312.89497,16242880528,324644136,16242879116,-1412,,
14838311134,312.94578,16242931341,324694945,16242929924,-1417,,
14838361724,312.99637,16242981933,324745532,16242980511,-1422,,
14838412758,313.04741,16243032971,324796563,16243031543,-1428,,
14838463325,313.09797,16243083540,324847128,16243082107,-1433,,
14838514358,313.14901,16243134576,324898158,16243133138,-1438,,
14838564918,313.19957,16243185137,324948726,16243183706,-1431,,
14838615946,313.25059,16243236168,324999741,16243234721,-1447,,
14838666540,313.30119,16243286764,325050332,16243285311,-1453,,
14838717565,313.35221,16243337791,325101354,16243336334,-1457,,
14838768625,313.40327,16243388855,325152412,16243387392,-1463,,
14838819640,313.45429,16243439872,325203425,16243438404,-1468,,
14838870197,313.50484,16243490431,325253978,16243488958,-1473,,
14838920754,313.55540,16243540990,325304532,16243539511,-1479,,
14838971784,313.60643,16243592022,325355560,16243590539,-1483,,
14839022211,313.65686,16243642451,325405984,16243640963,-1488,,
14839072423,313.70707,16243692667,325456194,16243691173,-1494,,
14839123451,313.75810,16243743696,325507218,16243742197,-1499,,
14839174396,313.80904,16243794644,325558161,16243793141,-1503,,
14839224548,313.85920,16243844798,325608310,16243843290,-1508,,
14839275590,313.91024,16243895843,325659349,16243894329,-1514,,
14839326656,313.96130,16243946911,325710413,16243945392,-1519,,
14839377694,314.01234,16243997951,325761448,16243996428,-1523,,
14839428237,314.06288,16244048496,325811988,16244046968,-1528,,
14839479271,314.11392,16244099533,325863019,16244097999,-1534,,
14839530333,314.16498,16244150597,325914079,16244149058,-1539,,
14839581368,314.21602,16244201634,325965111,16244200090,-1544,,
14839632434,314.26708,16244252703,326016174,16244251153,-1550,,
14839683504,314.31815,16244303775,326067241,16244302220,-1555,,
14839734558,314.36921,16244354832,326118294,16244353273,-1559,,
14839785085,314.41973,16244405362,326168818,16244403797,-1565,,
14839836131,314.47078,16244456410,326219861,16244454840,-1570,,
14839887294,314.52194,16244507575,326271022,16244506001,-1574,,
14839938100,314.57275,16244558383,326321824,16244556804,-1579,,
14839989148,314.62380,16244609434,326372869,16244607849,-1585,,
14840040197,314.67485,16244660495,326423925,16244658905,-1590,,
14840091246,314.72589,16244711548,326474973,16244709953,-1595,,
14840142318,314.77697,16244762611,326526032,16244761011,-1600,,
14840193854,314.82850,16244814149,326577564,16244812543,-1606,,
14840244363,314.87901,16244864660,326628070,16244863049,-1611,,
14840296056,314.93070,16244916356,326679761,16244914741,-1615,,
14840347417,314.98206,16244967719,326731119,16244966098,-1621,,
14840398012,315.03266,16245018317,326781711,16245016690,-1627,,
14840448068,315.08272,16245068375,326831766,16245066745,-1630,,
14840498601,315.13325,16245118911,326882295,16245117275,-1636,,
14840549148,315.18380,16245169459,326932839,16245167818,-1641,,
14840599704,315.23435,16245220019,326983392,16245218372,-1647,,
14840650352,315.28500,16245270669,327034038,16245269018,-1651,,
14840701352,315.33600,16245321671,327085035,16245320014,-1657,,
14840751919,315.38657,16245372240,327135599,16245370579,-1661,,
14840802512,315.43716,16245422835,327186190,16245421169,-1666,,
14840853525,315.48817,16245473850,327237200,16245472179,-1671,,
14840904572,315.53922,16245524900,327288244,16245523223,-1677,,
14840955030,315.58968,16245575361,327338700,16245573680,-1681,,
14841006042,315.64069,16245626375,327389710,16245624689,-1686,,
14841056569,315.69122,16245676904,327440233,16245675213,-1691,,
14841107617,315.74226,16245727954,327491277,16245726257,-1697,,
14841157679,315.79233,16245778018,327541338,16245776318,-1700,,
14841208701,315.84335,16245829044,327592357,16245827337,-1707,,
14841259278,315.89393,16245879622,327642931,16245877910,-1712,,
14841309806,315.94445,16245930153,327693456,16245928435,-1718,,
14841359870,315.99452,16245980220,327743518,16245978498,-1722,,
14841410521,316.04517,16246030872,327794174,16246029160,-1712,,
14841461016,316.09566,16246081371,327844658,16246079638,-1733,,
14841511563,316.14621,16246131920,327895204,16246130183,-1737,,
14841562098,316.19675,16246182457,327945735,16246180714,-1743,,
14841613147,316.24779,16246233509,327996781,16246231761,-1748,,
14841663708,316.29836,16246284072,328047340,16246282320,-1752,,
14841714744,316.34939,16246335110,328098374,16246333353,-1757,,
14841765283,316.39993,16246385652,328148909,16246383889,-1763,,
14841815854,316.45050,16246436224,328199477,16246434456,-1768,,
14841866883,316.50153,16246487256,328250504,16246485484,-1772,,
14841917443,316.55209,16246537819,328301061,16246536041,-1778,,
14841968466,316.60311,16246588843,328352080,16246587060,-1783,,
14842018552,316.65320,16246638944,328402177,16246637156,-1788,,
14842069623,316.70427,16246690005,328453233,16246688212,-1793,,
14842120113,316.75476,16246740498,328503720,16246738700,-1798,,
14842170701,316.80535,16246791088,328554304,16246789284,-1804,,
14842221748,316.85640,16246842138,328605350,16246840330,-1808,,
14842272804,316.90745,16246893196,328656403,16246891383,-1813,,
14842323320,316.95797,16246943714,328706916,16246941895,-1819,,
14842373804,317.00845,16246994201,328757399,16246992378,-1823,,
14842424840,317.05949,16247045238,328808431,16247043410,-1828,,
14842474884,317.10953,16247095286,328858472,16247093452,-1834,,
14842525335,317.15998,16247145739,328908920,16247143900,-1839,,
14842575863,317.21051,16247196268,328959446,16247194425,-1843,,
14842625912,317.26056,16247246320,329009492,16247244471,-1849,,
14842675960,317.31061,16247296370,329059537,16247294516,-1854,,
14842726041,317.36069,16247346454,329109617,16247344597,-1857,,
14842777074,317.41172,16247397489,329160646,16247395625,-1864,,
14842827604,317.46225,16247448022,329211173,16247446153,-1869,,
14842877673,317.51232,16247498092,329261240,16247496219,-1873,,
14842927745,317.56239,16247548168,329311309,16247546289,-1879,,
14842978273,317.61292,16247598698,329361835,16247596814,-1884,,
14843028820,317.66347,16247649247,329412378,16247647357,-1890,,
14843079847,317.71449,16247700277,329463403,16247698383,-1894,,
14843129899,317.76455,16247750331,329513453,16247748432,-1899,,
14843180458,317.81511,16247800892,329564008,16247798987,-1905,,
14843230743,317.86539,16247851180,329614292,16247849271,-1909,,
14843281152,317.91580,16247901590,329664697,16247899677,-1913,,
14843331791,317.96644,16247952233,329715333,16247950313,-1920,,
14843382561,318.01721,16248003005,329766101,16248001081,-1924,,
14843433107,318.06775,16248053553,329816644,16248051624,-1929,,
14843483195,318.11784,16248103644,329866729,16248101709,-1935,,
14843533859,318.16851,16248154309,329917390,16248152370,-1939,,
14843584224,318.21887,16248204677,329967753,16248202733,-1944,,
14843634317,318.26896,16248254772,330017843,16248252822,-1950,,
14843684840,318.31949,16248305297,330068363,16248303342,-1955,,
14843735240,318.36989,16248355700,330118761,16248353741,-1959,,
14843785672,318.42032,16248406135,330169190,16248404170,-1965,,
14843835814,318.47046,16248456288,330219339,16248454319,-1969,,
14843886012,318.52066,16248506479,330269525,16248504505,-1974,,
14843936279,318.57093,16248556749,330319789,16248554769,-1980,,
14843986433,318.62108,16248606915,330369951,16248604930,-1985,,
14844037438,318.67209,16248657911,330420943,16248655922,-1989,,
14844087624,318.72227,16248708101,330471127,16248706107,-1994,,
14844137721,318.77237,16248758200,330521220,16248756200,-2000,,
14844188030,318.82268,16248808511,330571527,16248806506,-2005,,
14844238463,318.87311,16248858947,330621958,16248856937,-2010,,
14844289102,318.92375,16248909588,330672594,16248907573,-2015,,
14844339225,318.97387,16248959712,330722713,16248957693,-2019,,
14844389756,319.02440,16249010247,330773242,16249008222,-2025,,
14844440129,319.07478,16249060622,330823613,16249058592,-2030,,
14844490700,319.12535,16249111194,330874180,16249109159,-2035,,
14844541149,319.17580,16249161657,330924637,16249159616,-2041,,
14844591316,319.22596,16249211816,330974792,16249209771,-2045,,
14844641906,319.27655,16249262408,331025378,16249260357,-2051,,
14844692037,319.32668,16249312553,331075518,16249310498,-2055,,
14844742508,319.37716,16249363015,331125975,16249360955,-2060,,
14844793054,319.42770,16249413564,331176518,16249411498,-2066,,
14844843613,319.47826,16249464125,331227074,16249462054,-2071,,
14844894631,319.52928,16249515144,331278090,16249513069,-2075,,
14844944681,319.57933,16249565197,331328137,16249563116,-2081,,
14844995268,319.62992,16249615787,331378722,16249613701,-2086,,
14845045517,319.68016,16249666038,331428969,16249663948,-2090,,
14845095626,319.73027,16249716160,331479085,16249714064,-2096,,
14845145753,319.78040,16249766279,331529198,16249764178,-2101,,
14845196087,319.83074,16249816615,331579531,16249814510,-2105,,
14845246905,319.88155,16249867436,331630345,16249865325,-2111,,
14845297598,319.93225,16249918131,331681035,16249916015,-2116,,
14845348485,319.98313,16249969020,331731920,16249966899,-2121,,
14845398696,320.03334,16250019234,331782129,16250017108,-2126,,
14845449257,320.08391,16250069798,331832687,16250067666,-2132,,
14845500293,320.13494,16250120835,331883720,16250118699,-2136,,
14845550851,320.18550,16250171396,331934275,16250169255,-2141,,
14845601285,320.23593,16250221832,331984706,16250219686,-2146,,
14845651453,320.28610,16250272002,332034872,16250269851,-2151,,
14845701679,320.33633,16250322231,332085095,16250320074,-2157,,
14845752146,320.38679,16250372700,332135560,16250370540,-2160,,
14845802361,320.43701,16250422917,332185772,16250420751,-2166,,
14845852472,320.48712,16250473031,332235879,16250470859,-2172,,
14845902593,320.53724,16250523154,332285999,16250520978,-2176,,
14845953189,320.58784,16250573762,332336601,16250571581,-2181,,
14846003450,320.63810,16250624016,332386850,16250621829,-2187,,
14846053855,320.68850,16250674423,332437253,16250672232,-2191,,
14846103980,320.73863,16250724560,332487384,16250722364,-2196,,
14846154895,320.78954,16250775477,332538296,16250773276,-2201,,
14846205424,320.84007,16250826009,332588824,16250823803,-2206,,
14846255974,320.89062,16250876552,332639360,16250874340,-2212,,
14846306502,320.94115,16250927082,332689886,16250924865,-2217,,
14846357110,320.99176,16250977692,332740490,16250975470,-2222,,
14846407846,321.04249,16251028431,332791224,16251026204,-2227,,
14846457979,321.09263,16251078566,332841355,16251076334,-2232,,
14846508537,321.14319,16251129125,332891919,16251126898,-2227,,
14846559044,321.19369,16251179636,332942415,16251177394,-2242,,
14846609552,321.24420,16251230146,332992919,16251227899,-2247,,
14846659821,321.29447,16251280417,333043186,16251278165,-2252,,
14846710327,321.34497,16251330926,333093690,16251328669,-2257,,
14846760767,321.39542,16251381368,333144126,16251379106,-2262,,
14846811177,321.44583,16251431780,333194534,16251429514,-2266,,
14846861454,321.49610,16251482060,333244807,16251479786,-2274,,
14846912015,321.54666,16251532623,333295366,16251530346,-2277,,
14846963062,321.59771,16251583675,333346414,16251581393,-2282,,
14847013654,321.64830,16251634267,333396999,16251631979,-2288,,
14847063843,321.69849,16251684458,333447187,16251682166,-2292,,
14847114607,321.74926,16251735223,333497947,16251732926,-2297,,
14847165202,321.79985,16251785822,333548540,16251783519,-2303,,
14847215600,321.85025,16251836222,333598935,16251833915,-2307,,
14847265704,321.90035,16251886329,333649036,16251884016,-2313,,
14847316245,321.95089,16251936882,333699585,16251934565,-2317,,
14847366799,322.00145,16251987428,333750126,16251985105,-2323,,
14847416938,322.05159,16252037570,333800263,16252035242,-2328,,
14847467300,322.10195,16252087934,333850622,16252085601,-2333,,
14847517879,322.15253,16252138515,333901198,16252136177,-2338,,
14847568087,322.20274,16252188726,333951403,16252186383,-2343,,
14847618194,322.25284,16252238845,334001518,16252236497,-2348,,
14847668504,322.30315,16252289158,334051825,16252286805,-2353,,
14847718992,322.35364,16252339638,334102301,16252337281,-2357,,
14847769463,322.40411,16252390111,334152768,16252387748,-2363,,
14847820018,322.45467,16252440667,334203320,16252438300,-2367,,
14847870193,322.50484,16252490846,334253493,16252488472,-2374,,
14847920779,322.55543,16252541434,334304076,16252539056,-2378,,
14847970914,322.60556,16252591571,334354209,16252589188,-2383,,
14848021058,322.65571,16252641718,334404349,16252639329,-2389,,
14848071170,322.70582,16252691832,334454460,16252689439,-2393,,
14848121780,322.75643,16252742444,334505066,16252740057,-2387,,
14848171993,322.80664,16252792671,334555288,16252790267,-2404,,
14848222560,322.85721,16252843229,334605842,16252840821,-2408,,
14848273051,322.90770,16252893722,334656330,16252891309,-2413,,
14848323160,322.95781,16252943844,334706445,16252941425,-2419,,
14848373287,323.00793,16252993962,334756560,16252991539,-2423,,
14848423452,323.05810,16253044130,334806723,16253041702,-2428,,
14848474284,323.10893,16253094965,334857551,16253092531,-2434,,
14848524484,323.15913,16253145167,334907748,16253142728,-2439,,
14848575238,323.20989,16253195922,334958500,16253193479,-2443,,
14848625865,323.26051,16253246553,335009124,16253244104,-2449,,
14848676313,323.31096,16253297003,335059570,16253294549,-2454,,
14848726788,323.36144,16253347480,335110043,16253345022,-2458,,
14848777165,323.41181,16253397860,335160417,16253395396,-2464,,
14848827280,323.46193,16253447977,335210529,16253445508,-2469,,
14848878289,323.51294,16253498988,335261536,16253496515,-2473,,
14848928841,323.56349,16253549543,335312084,16253547064,-2479,,
14848978880,323.61353,16253599584,335362121,16253597100,-2484,,
14849029034,323.66368,16253649741,335412272,16253647252,-2489,,
14849079174,323.71382,16253699882,335462409,16253697388,-2494,,
14849129757,323.76441,16253750468,335512990,16253747969,-2499,,
14849180184,323.81483,16253800898,335563413,16253798393,-2505,,
14849230319,323.86497,16253851035,335613547,16253848526,-2509,,
14849280875,323.91552,16253901593,335664100,16253899079,-2514,,
14849331024,323.96567,16253951745,335714246,16253949225,-2520,,
14849381160,324.01581,16254001883,335764380,16253999359,-2524,,
14849431539,324.06619,16254052264,335814756,16254049735,-2529,,
14849481937,324.11658,16254102665,335865150,16254100130,-2535,,
14849532062,324.16671,16254152792,335915273,16254150253,-2539,,
14849582176,324.21682,16254202908,335965384,16254200364,-2544,,
14849632724,324.26737,16254253459,336015929,16254250908,-2551,,
14849683078,324.31773,16254303815,336066281,16254301260,-2555,,
14849734136,324.36878,16254354875,336117336,16254352316,-2559,,
14849784289,324.41894,16254405031,336167487,16254402466,-2565,,
14849834821,324.46947,16254455565,336218016,16254452995,-2570,,
14849885219,324.51987,16254505965,336268411,16254503391,-2574,,
14849935276,324.56992,16254556025,336318465,16254553445,-2580,,
14849985387,324.62003,16254606138,336368573,16254603553,-2585,,
14850035631,324.67028,16254656383,336418815,16254653794,-2589,,
14850085691,324.72034,16254706446,336468872,16254703851,-2595,,
14850135881,324.77053,16254756639,336519059,16254754039,-2600,,
14850186445,324.82109,16254807204,336569621,16254804600,-2604,,
14850236597,324.87124,16254857359,336619770,16254854749,-2610,,
14850287142,324.92179,16254907906,336670312,16254905291,-2615,,
14850337439,324.97209,16254958206,336720607,16254955586,-2620,,
14850388361,325.02301,16255009141,336771536,16255006516,-2625,,
14850438468,325.07312,16255059240,336821630,16255056610,-2630,,
14850488607,325.12325,16255109381,336871767,16255106746,-2635,,
14850538964,325.17361,16255159741,336922121,16255157101,-2640,,
14850589674,325.22432,16255210452,336972828,16255207807,-2645,,
14850639916,325.27456,16255260697,337023067,16255258047,-2650,,
14850690330,325.32498,16255311114,337073479,16255308459,-2655,,
14850740477,325.37513,16255361263,337123623,16255358603,-2660,,
14850790953,325.42560,16255411741,337174097,16255409076,-2665,,
14850841116,325.47576,16255461917,337224267,16255459247,-2670,,
14850891921,325.52657,16255512714,337275059,16255510039,-2675,,
14850941969,325.57662,16255562764,337325105,16255560084,-2680,,
14850992911,325.62756,16255613709,337376044,16255611023,-2686,,
14851043023,325.67767,16255663823,337426153,16255661133,-2690,,
14851093579,325.72823,16255714381,337476706,16255711685,-2696,,
14851143785,325.77843,16255764589,337526909,16255761889,-2700,,
14851194377,325.82903,16255815184,337577510,16255812489,-2695,,
14851244500,325.87915,16255865310,337627620,16255862599,-2711,,
14851294658,325.92931,16255915470,337677774,16255912754,-2716,,
14851345201,325.97985,16255966015,337728315,16255963295,-2720,,
14851395450,326.03010,16256016267,337778561,16256013541,-2726,,
14851445588,326.08024,16256066407,337828697,16256063676,-2731,,
14851496039,326.13069,16256116859,337879144,16256114123,-2736,,
14851546533,326.18118,16256167357,337929636,16256164616,-2741,,
14851596787,326.23143,16256217613,337979887,16256214867,-2746,,
14851647609,326.28226,16256268437,338030706,16256265686,-2751,,
14851698139,326.33279,16256318970,338081234,16256316214,-2756,,
14851748532,326.38318,16256369365,338131625,16256366604,-2761,,
14851799133,326.43378,16256419967,338182222,16256417201,-2766,,
14851849625,326.48427,16256470462,338232712,16256467691,-2771,,
14851899907,326.53456,16256520746,338282991,16256517970,-2776,,
14851950055,326.58470,16256570897,338333136,16256568115,-2782,,
14852000315,326.63496,16256621160,338383395,16256618374,-2786,,
14852050821,326.68547,16256671678,338433908,16256668887,-2791,,
14852100971,326.73562,16256721819,338484044,16256719023,-2796,,
14852151433,326.78608,16256772285,338534503,16256769483,-2802,,
14852201581,326.83623,16256822435,338584649,16256819628,-2807,,
14852252242,326.88689,16256873098,338635308,16256870287,-2811,,
14852302833,326.93748,16256923692,338685895,16256920875,-2817,,
14852352949,326.98760,16256973809,338736009,16256970988,-2821,,
14852403024,327.03767,16257023887,338786082,16257021061,-2826,,
14852453181,327.08783,16257074046,338836246,16257071225,-2821,,
14852503659,327.13831,16257124527,338886712,16257121691,-2836,,
14852553788,327.18844,16257174657,338936837,16257171816,-2841,,
14852603980,327.23863,16257224853,338987026,16257222006,-2847,,
14852654503,327.28915,16257275377,339037547,16257272526,-2851,,
14852705047,327.33970,16257325924,339088089,16257323068,-2856,,
14852755370,327.39002,16257376250,339138408,16257373387,-2863,,
14852805915,327.44056,16257426797,339188950,16257423930,-2867,,
14852856552,327.49120,16257477435,339239585,16257474564,-2871,,
14852907095,327.54174,16257527982,339290125,16257525105,-2877,,
14852957650,327.59230,16257578538,339340677,16257575656,-2882,,
14853008285,327.64293,16257629177,339391310,16257626290,-2887,,
14853059071,327.69372,16257679965,339442093,16257677073,-2892,,
14853109695,327.74434,16257730591,339492714,16257727693,-2898,,
14853159870,327.79452,16257780769,339542886,16257777866,-2903,,
14853210360,327.84501,16257831272,339593386,16257828365,-2907,,
14853261023,327.89567,16257881925,339644034,16257879013,-2912,,
14853311348,327.94600,16257932254,339694356,16257929336,-2918,,
14853361557,327.99620,16257982465,339744564,16257979543,-2922,,
14853411940,328.04659,16258032850,339794944,16258029923,-2927,,
14853462541,328.09719,16258083454,339845542,16258080521,-2933,,
14853513115,328.14776,16258134029,339896113,16258131092,-2937,,
14853563499,328.19815,16258184416,339946494,16258181474,-2942,,
14853613787,328.24843,16258234707,339996779,16258231759,-2948,,
14853663903,328.29855,16258284835,340046904,16258281883,-2952,,
14853714205,328.34885,16258335129,340097192,16258332172,-2957,,
14853764740,328.39939,16258385667,340147724,16258382704,-2963,,
14853815462,328.45011,16258436400,340198453,16258433432,-2968,,
14853866349,328.50100,16258487280,340249329,16258484308,-2972,,
14853916608,328.55126,16258537542,340299585,16258534564,-2978,,
14853967098,328.60175,16258588033,340350071,16258585050,-2983,,
14854017241,328.65189,16258638178,340400212,16258635191,-2987,,
14854067827,328.70247,16258688767,340450795,16258685774,-2993,,
14854118344,328.75299,16258739288,340501311,16258736290,-2998,,
14854168798,328.80345,16258789744,340551762,16258786741,-3003,,
14854219370,328.85402,16258840318,340602331,16258837311,-3007,,
14854270216,328.90486,16258891165,340653173,16258888152,-3013,,
14854320430,328.95508,16258941382,340703384,16258938364,-3018,,
14854371047,329.00570,16258992002,340754000,16258988979,-3023,,
14854421271,329.05592,16259042227,340804220,16259039199,-3028,,
14854471746,329.10639,16259092706,340854693,16259089672,-3034,,
14854521889,329.15654,16259142851,340904834,16259139814,-3037,,
14854572350,329.20700,16259193314,340955291,16259190270,-3044,,
14854622458,329.25711,16259243424,341005396,16259240376,-3048,,
14854673121,329.30777,16259294090,341056057,16259291037,-3053,,
14854723287,329.35793,16259344257,341106219,16259341199,-3058,,
14854773341,329.40799,16259394315,341156271,16259391251,-3064,,
14854823886,329.45853,16259444861,341206813,16259441793,-3068,,
14854874825,329.50947,16259495803,341257750,16259492730,-3073,,
14854925889,329.56054,16259546869,341308811,16259543790,-3079,,
14854976756,329.61140,16259597739,341359675,16259594655,-3084,,
14855027417,329.66206,16259648402,341410335,16259645314,-3088,,
14855078056,329.71270,16259699045,341460972,16259695951,-3094,,
14855128443,329.76309,16259749432,341511354,16259746334,-3098,,
14855178621,329.81327,16259799612,341561529,16259796509,-3103,,
14855229635,329.86428,16259850630,341612542,16259847521,-3109,,
14855279790,329.91444,16259900786,341662693,16259897672,-3114,,
14855329932,329.96458,16259950930,341712832,16259947811,-3119,,
14855380407,330.01506,16260001409,341763306,16259998285,-3124,,
14855431223,330.06587,16260052227,341814119,16260049098,-3129,,
14855482159,330.11681,16260103165,341865051,16260100030,-3135,,
14855532734,330.16738,16260153743,341915625,16260150604,-3139,,
14855582896,330.21754,16260203907,341965783,16260200763,-3144,,
14855633450,330.26810,16260254463,342016334,16260251314,-3149,,
14855684445,330.31909,16260305461,342067327,16260302306,-3155,,
14855735006,330.36965,16260356024,342117886,16260352865,-3159,,
14855785560,330.42021,16260406581,342168437,16260403416,-3165,,
14855836243,330.47089,16260457266,342219117,16260454096,-3170,,
14855886448,330.52110,16260507473,342269320,16260504310,-3163,,
14855936954,330.57160,16260557982,342319823,16260554803,-3179,,
14855987480,330.62213,16260608509,342370344,16260605324,-3185,,
14856038106,330.67275,16260659138,342420969,16260655948,-3190,,
14856088671,330.72332,16260709706,342471531,16260706511,-3195,,
14856138928,330.77358,16260759965,342521785,16260756765,-3200,,
14856189613,330.82426,16260810651,342572467,16260807446,-3205,,
14856240582,330.87523,16260861623,342623434,16260858414,-3209,,
14856291146,330.92579,16260912189,342673995,16260908974,-3215,,
14856341728,330.97638,16260962775,342724574,16260959554,-3221,,
14856392269,331.02692,16261013317,342775113,16261010092,-3225,,
14856442943,331.07759,16261063994,342825785,16261060764,-3230,,
14856493057,331.12770,16261114120,342875905,16261110884,-3236,,
14856543168,331.17782,16261164223,342926003,16261160993,-3230,,
14856593587,331.22823,16261214644,342976420,16261211399,-3245,,
14856643985,331.27863,16261265057,343026826,16261261806,-3251,,
14856694619,331.32927,16261315692,343077457,16261312436,-3256,,
14856744762,331.37941,16261365827,343127587,16261362567,-3260,,
14856795100,331.42975,16261416167,343177922,16261412901,-3266,,
14856845705,331.48035,16261466775,343228524,16261463504,-3271,,
14856896272,331.53092,16261517344,343279089,16261514068,-3276,,
14856946809,331.58146,16261567883,343329623,16261564602,-3281,,
14856997343,331.63199,16261618420,343380155,16261615134,-3286,,
14857047417,331.68207,16261668506,343430235,16261665215,-3291,,
14857098458,331.73311,16261719540,343481265,16261716244,-3296,,
14857149519,331.78417,16261770602,343532322,16261767302,-3300,,
14857200567,331.83522,16261821653,343583368,16261818347,-3306,,
14857251201,331.88585,16261872289,343633999,16261868978,-3311,,
14857301854,331.93650,16261922945,343684649,16261919629,-3316,,
14857352382,331.98703,16261973476,343735174,16261970154,-3322,,
14857403191,332.03784,16262024287,343785981,16262020960,-3327,,
14857453797,332.08844,16262074895,343836595,16262071575,-3320,,
14857504833,332.13948,16262125934,343887617,16262122596,-3338,,
14857555383,332.19003,16262176485,343938164,16262173143,-3342,,
14857606416,332.24106,16262227521,343989195,16262224174,-3347,,
14857657011,332.29166,16262278119,344039787,16262274767,-3352,,
14857707572,332.34222,16262328682,344090345,16262325325,-3357,,
14857757699,332.39235,16262378811,344140469,16262375449,-3362,,
14857808745,332.44339,16262429859,344191513,16262426492,-3367,,
14857859326,332.49397,16262480443,344242092,16262477071,-3372,,
14857910374,332.54502,16262531493,344293137,16262528116,-3377,,
14857961405,332.59605,16262582527,344344166,16262579145,-3382,,
14858012473,332.64712,16262633597,344395230,16262630210,-3387,,
14858063003,332.69765,16262684130,344445758,16262680737,-3393,,
14858113549,332.74820,16262734677,344496300,16262731280,-3397,,
14858164126,332.79877,16262785256,344546875,16262781855,-3401,,
14858214653,332.84930,16262835787,344597399,16262832378,-3409,,
14858265246,332.89989,16262886382,344647989,16262882969,-3413,,
14858316258,332.95091,16262937396,344698999,16262933979,-3417,,
14858366425,333.00107,16262987566,344749163,16262984143,-3423,,
14858416952,333.05160,16263038094,344799687,16263034666,-3428,,
14858467500,333.10215,16263088644,344850233,16263085213,-3431,,
14858518565,333.15321,16263139713,344901296,16263136275,-3438,,
14858569071,333.20372,16263190221,344951798,16263186778,-3443,,
14858619677,333.25432,16263240829,345002401,16263237381,-3448,,
14858670694,333.30534,16263291849,345053417,16263288396,-3453,,
14858721744,333.35639,16263342901,345104463,16263339442,-3459,,
14858772267,333.40692,16263393427,345154983,16263389963,-3464,,
14858822827,333.45747,16263443988,345205541,16263440520,-3468,,
14858873389,333.50804,16263494552,345256100,16263491079,-3473,,
14858923936,333.55858,16263545102,345306644,16263541623,-3479,,
14858974484,333.60913,16263595653,345357189,16263592169,-3484,,
14859025034,333.65968,16263646205,345407737,16263642717,-3488,,
14859075776,333.71042,16263696949,345458476,16263693455,-3494,,
14859126442,333.76109,16263747618,345509140,16263744119,-3499,,
14859177022,333.81167,16263798199,345559717,16263794696,-3503,,
14859227574,333.86222,16263848755,345610266,16263845246,-3509,,
14859278618,333.91327,16263899801,345661307,16263896287,-3514,,
14859329206,333.96385,16263950391,345711892,16263946871,-3520,,
14859380205,334.01485,16264001393,345762889,16263997869,-3524,,
14859431052,334.06570,16264052241,345813733,16264048712,-3529,,
14859482105,334.11675,16264103297,345864783,16264099763,-3534,,
14859533140,334.16779,16264154334,345915816,16264150795,-3539,,
14859583205,334.21785,16264204402,345965878,16264200858,-3544,,
14859633755,334.26840,16264254955,346016425,16264251405,-3550,,
14859684292,334.31894,16264305493,346066959,16264301938,-3555,,
14859734859,334.36951,16264356062,346117524,16264352503,-3559,,
14859785506,334.42015,16264406712,346168168,16264403147,-3565,,
14859836049,334.47070,16264457258,346218709,16264453688,-3570,,
14859886684,334.52133,16264507895,346269342,16264504321,-3574,,
14859937187,334.57184,16264558401,346319841,16264554820,-3581,,
14859987748,334.62240,16264608964,346370400,16264605379,-3585,,
14860038571,334.67322,16264659788,346421219,16264656198,-3590,,
14860089240,334.72389,16264710460,346471886,16264706865,-3595,,
14860139750,334.77440,16264760973,346522394,16264757373,-3600,,
14860190779,334.82543,16264812005,346573420,16264808399,-3606,,
14860241721,334.87637,16264862948,346624359,16264859339,-3609,,
14860292386,334.92703,16264913615,346675021,16264910000,-3615,,
14860342729,334.97738,16264963962,346725362,16264960341,-3621,,
14860393566,335.02821,16265014801,346776196,16265011175,-3626,,
14860443953,335.07860,16265065189,346826580,16265061560,-3629,,
14860494536,335.12918,16265115788,346877173,16265112152,-3636,,
14860545516,335.18016,16265166757,346928137,16265163116,-3641,,
14860596049,335.23070,16265217293,346978669,16265213648,-3645,,
14860646840,335.28149,16265268087,347029456,16265264436,-3651,,
14860697445,335.33209,16265318694,347080058,16265315038,-3656,,
14860747713,335.38236,16265368964,347130325,16265365304,-3660,,
14860798292,335.43294,16265419545,347180900,16265415879,-3666,,
14860848951,335.48360,16265470206,347231556,16265466535,-3671,,
14860899227,335.53388,16265520484,347281829,16265516808,-3676,,
14860949253,335.58390,16265570514,347331853,16265566832,-3682,,
14860999811,335.63446,16265621074,347382409,16265617388,-3686,,
14861050342,335.68499,16265671607,347432936,16265667916,-3691,,
14861100901,335.73555,16265722169,347483493,16265718473,-3696,,
14861151948,335.78660,16265773217,347534537,16265769516,-3701,,
14861202050,335.83670,16265823322,347584636,16265819615,-3707,,
14861252344,335.88699,16265873618,347634928,16265869908,-3710,,
14861302467,335.93712,16265923743,347685060,16265920039,-3704,,
14861353342,335.98799,16265974622,347735920,16265970900,-3722,,
14861403486,336.03813,16266024768,347786061,16266021041,-3727,,
14861454034,336.08868,16266075318,347836607,16266071586,-3732,,
14861504659,336.13931,16266125946,347887229,16266122208,-3738,,
14861554859,336.18951,16266176160,347937438,16266172418,-3742,,
14861605928,336.24058,16266227219,347988494,16266223473,-3746,,
14861656985,336.29163,16266278279,348039547,16266274527,-3752,,
14861707099,336.34175,16266328405,348089669,16266324649,-3756,,
14861757682,336.39233,16266378979,348140239,16266375218,-3761,,
14861808237,336.44288,16266429538,348190802,16266425782,-3756,,
14861859276,336.49392,16266480579,348241828,16266476807,-3772,,
14861909824,336.54447,16266531129,348292372,16266527351,-3778,,
14861960890,336.59554,16266582198,348343436,16266578416,-3782,,
14862011996,336.64664,16266633306,348394540,16266629519,-3787,,
14862062992,336.69764,16266684305,348445532,16266680512,-3793,,
14862113526,336.74817,16266734841,348496064,16266731043,-3798,,
14862164113,336.79876,16266785430,348546648,16266781628,-3802,,
14862214705,336.84935,16266836025,348597238,16266832217,-3808,,
14862264849,336.89950,16266886171,348647378,16266882358,-3813,,
14862315912,336.95056,16266937235,348698439,16266933418,-3817,,
14862366400,337.00105,16266987726,348748924,16266983903,-3823,,
14862416509,337.05116,16267037838,348799030,16267034009,-3829,,
14862467085,337.10173,16267088415,348849604,16267084583,-3832,,
14862517641,337.15229,16267138975,348900158,16267135137,-3838,,
14862568684,337.20333,16267190020,348951198,16267186177,-3843,,
14862619177,337.25383,16267240515,349001687,16267236667,-3848,,
14862670195,337.30484,16267291536,349052703,16267287683,-3853,,
14862720768,337.35542,16267342111,349103273,16267338253,-3858,,
14862771791,337.40644,16267393136,349154293,16267389273,-3863,,
14862822285,337.45693,16267443632,349204785,16267439764,-3868,,
14862872894,337.50754,16267494243,349255391,16267490370,-3873,,
14862923439,337.55809,16267544791,349305933,16267540912,-3879,,
14862973981,337.60863,16267595336,349356472,16267591451,-3885,,
14863024522,337.65917,16267645878,349407011,16267641990,-3888,,
14863075086,337.70973,16267696445,349457572,16267692551,-3894,,
14863125640,337.76029,16267747001,349508123,16267743102,-3899,,
14863176238,337.81089,16267797602,349558719,16267793699,-3903,,
14863227061,337.86171,16267848428,349609539,16267844519,-3909,,
14863277688,337.91234,16267899057,349660164,16267895143,-3914,,
14863328217,337.96287,16267949588,349710689,16267945668,-3920,,
14863378780,338.01343,16268000154,349761251,16267996230,-3924,,
14863429338,338.06399,16268050714,349811805,16268046785,-3929,,
14863480391,338.11504,16268101769,349862855,16268097835,-3934,,
14863530967,338.16562,16268152347,349913429,16268148408,-3939,,
14863581580,338.21623,16268202963,349964039,16268199019,-3944,,
14863632124,338.26677,16268253509,350014580,16268249559,-3950,,
14863682737,338.31739,16268304134,350065201,16268300180,-3954,,
14863733301,338.36795,16268354690,350115752,16268350731,-3959,,
14863784364,338.41901,16268405757,350166812,16268401792,-3965,,
14863835432,338.47008,16268456826,350217877,16268452856,-3970,,
14863886434,338.52108,16268507831,350268878,16268503857,-3974,,
14863936540,338.57119,16268557940,350318991,16268553970,-3970,,
14863987607,338.62225,16268609008,350370044,16268605023,-3985,,
14864038657,338.67331,16268660061,350421091,16268656071,-3990,,
14864089706,338.72435,16268711113,350472138,16268707118,-3995,,
14864140285,338.77493,16268761694,350522715,16268757694,-4000,,
14864190853,338.82550,16268812265,350573279,16268808259,-4006,,
14864241854,338.87650,16268863268,350624279,16268859258,-4010,,
14864292521,338.92717,16268913937,350674942,16268909922,-4015,,
14864343091,338.97774,16268964510,350725509,16268960489,-4021,,
14864394152,339.02880,16269015573,350776569,16269011548,-4025,,
14864445184,339.07983,16269066606,350827597,16269062576,-4030,,
14864495778,339.13043,16269117204,350878188,16269113168,-4036,,
14864546799,339.18145,16269168227,350929207,16269164186,-4041,,
14864597874,339.23252,16269219304,350980280,16269215259,-4045,,
14864648896,339.28354,16269270329,351031298,16269266278,-4051,,
14864699945,339.33459,16269321380,351082345,16269317324,-4056,,
14864750941,339.38559,16269372379,351133338,16269368317,-4062,,
14864802015,339.43666,16269423456,351184411,16269419391,-4065,,
14864853000,339.48765,16269474442,351235392,16269470371,-4071,,
14864904027,339.53868,16269525472,351286415,16269521395,-4077,,
14864954584,339.58923,16269576031,351336969,16269571949,-4082,,
14865005613,339.64026,16269627061,351387996,16269622975,-4086,,
14865056237,339.69088,16269677688,351438617,16269673596,-4092,,
14865107262,339.74191,16269728727,351489651,16269724631,-4096,,
14865157891,339.79254,16269779358,351540278,16269775258,-4100,,
14865208528,339.84318,16269829986,351590900,16269825880,-4106,,
14865259535,339.89418,16269880996,351641905,16269876884,-4112,,
14865309977,339.94462,16269931440,351692343,16269927322,-4118,,
14865360564,339.99521,16269982030,351742928,16269977908,-4122,,
14865411198,340.04585,16270032665,351793559,16270028539,-4126,,
14865462146,340.09679,16270083618,351844505,16270079485,-4133,,
14865513207,340.14785,16270134679,351895563,16270130542,-4137,,
14865564229,340.19888,16270185704,351946583,16270181562,-4142,,
14865614838,340.24949,16270236316,351997188,16270232168,-4148,,
14865665414,340.30006,16270286893,352047761,16270282740,-4153,,
14865715997,340.35064,16270337479,352098342,16270333322,-4157,,
14865766963,340.40161,16270388447,352149305,16270384285,-4162,,
14865817532,340.45218,16270439019,352199871,16270434851,-4168,,
14865892990,340.52764,16270514480,352275325,16270510304,-4176,,
14865943989,340.57864,16270565481,352326322,16270561301,-4180,,
14865997132,340.63178,16270618627,352379462,16270614442,-4185,,
14866066471,340.70112,16270687969,352448796,16270683776,-4193,,
14866117469,340.75212,16270738970,352499792,16270734771,-4199,,
14866168778,340.80343,16270790281,352551099,16270786078,-4203,,
14866219322,340.85397,16270840828,352601640,16270836620,-4208,,
14866269920,340.90457,16270891427,352652235,16270887215,-4212,,
14866320858,340.95551,16270942369,352703170,16270938150,-4219,,
14866371246,341.00589,16270992759,352753556,16270988536,-4223,,
14866424346,341.05899,16271045860,352806652,16271041632,-4228,,
14866474588,341.10924,16271096105,352856892,16271091871,-4234,,
14866525814,341.16046,16271147333,352908116,16271143097,-4236,,
14866576044,341.21069,16271197565,352958343,16271193322,-4243,,
14866626757,341.26141,16271248282,353009054,16271244033,-4249,,
14866677562,341.31221,16271299088,353059855,16271294834,-4254,,
14866728208,341.36286,16271349737,353110499,16271345479,-4258,,
14866778682,341.41333,16271400214,353160970,16271395950,-4264,,
14866829406,341.46405,16271450940,353211692,16271446671,-4269,,
14866880208,341.51486,16271501744,353262489,16271497469,-4275,,
14866930524,341.56517,16271552062,353312804,16271547783,-4279,,
14866980795,341.61544,16271602335,353363072,16271598051,-4284,,
14867033543,341.66819,16271655087,353415817,16271650797,-4290,,
14867083868,341.71852,16271705413,353466140,16271701119,-4294,,
14867134254,341.76890,16271755801,353516523,16271751503,-4298,,
14867184718,341.81937,16271806268,353566983,16271801963,-4305,,
14867235297,341.86994,16271856850,353617560,16271852540,-4310,,
14867286126,341.92077,16271907681,353668388,16271903367,-4314,,
14867336660,341.97131,16271958218,353718918,16271953898,-4320,,
14867387263,342.02191,16272008822,353769518,16272004498,-4324,,
14867437655,342.07230,16272059218,353819908,16272054888,-4330,,
14867488099,342.12275,16272109664,353870350,16272105329,-4335,,
14867538483,342.17313,16272160049,353920730,16272155709,-4340,,
14867588811,342.22346,16272210380,353971056,16272206035,-4345,,
14867639247,342.27389,16272260819,354021489,16272256469,-4350,,
14867689571,342.32422,16272311144,354071810,16272306789,-4355,,
14867740137,342.37478,16272361713,354122373,16272357352,-4361,,
14867791531,342.42618,16272413109,354173765,16272408744,-4365,,
14867842027,342.47668,16272463607,354224257,16272459237,-4370,,
14867892664,342.52731,16272514247,354274892,16272509871,-4376,,
14867943433,342.57808,16272565018,354325659,16272560639,-4379,,
14867993843,342.62849,16272615431,354376066,16272611045,-4386,,
14868044510,342.67916,16272666101,354426730,16272661710,-4391,,
14868094839,342.72949,16272716431,354477055,16272712035,-4396,,
14868145523,342.78017,16272767117,354527738,16272762717,-4400,,
14868195842,342.83049,16272817440,354578055,16272813034,-4406,,
14868246334,342.88098,16272867933,354628543,16272863522,-4411,,
14868296812,342.93146,16272918413,354679018,16272913998,-4415,,
14868347350,342.98200,16272968955,354729555,16272964534,-4421,,
14868397688,343.03234,16273019295,354779890,16273014869,-4426,,
14868448365,343.08301,16273069975,354830565,16273065545,-4430,,
14868499109,343.13376,16273120720,354881305,16273116284,-4436,,
14868549784,343.18443,16273171397,354931977,16273166957,-4440,,
14868600541,343.23519,16273222158,354982732,16273217712,-4446,,
14868650944,343.28559,16273272563,355033133,16273268113,-4450,,
14868701404,343.33605,16273323025,355083589,16273318569,-4456,,
14868751738,343.38639,16273373362,355133921,16273368900,-4462,,
14868802121,343.43677,16273423747,355184302,16273419281,-4466,,
14868852700,343.48735,16273474327,355234877,16273469856,-4471,,
14868903106,343.53775,16273524737,355285281,16273520260,-4477,,
14868953687,343.58833,16273575320,355335859,16273570839,-4481,,
14869004380,343.63903,16273626014,355386549,16273621528,-4486,,
14869054651,343.68930,16273676288,355436817,16273671796,-4492,,
14869105027,343.73967,16273726667,355487191,16273722170,-4497,,
14869155634,343.79028,16273777276,355537795,16273772774,-4502,,
14869205963,343.84061,16273827608,355588121,16273823101,-4507,,
14869256288,343.89094,16273877935,355638443,16273873423,-4512,,
14869307059,343.94171,16273928708,355689213,16273924192,-4516,,
14869357507,343.99216,16273979159,355739657,16273974637,-4522,,
14869408073,344.04272,16274029727,355790221,16274025200,-4527,,
14869458837,344.09348,16274080492,355840981,16274075960,-4532,,
14869509278,344.14393,16274130937,355891421,16274126400,-4537,,
14869559610,344.19426,16274181271,355941749,16274176729,-4542,,
14869609894,344.24454,16274231558,355992030,16274227010,-4548,,
14869660217,344.29487,16274281883,356042352,16274277331,-4552,,
14869710823,344.34547,16274332491,356092955,16274327934,-4557,,
14869761474,344.39612,16274383145,356143603,16274378582,-4563,,
14869811531,344.44618,16274433204,356193658,16274428637,-4567,,
14869862070,344.49672,16274483745,356244194,16274479173,-4572,,
14869912619,344.54727,16274534297,356294739,16274529719,-4578,,
14869963063,344.59771,16274584753,356345192,16274580171,-4582,,
14870013307,344.64796,16274634989,356395422,16274630402,-4587,,
14870064345,344.69899,16274686030,356446457,16274681447,-4583,,
14870115372,344.75002,16274737059,356497481,16274732461,-4598,,
14870165504,344.80015,16274787192,356547611,16274782590,-4602,,
14870216591,344.85124,16274838283,356598696,16274833675,-4608,,
14870267167,344.90181,16274888861,356649269,16274884248,-4613,,
14870318243,344.95289,16274939938,356700342,16274935321,-4617,,
14870368336,345.00298,16274990034,356750432,16274985411,-4623,,
14870418949,345.05360,16275040650,356801043,16275036022,-4628,,
14870469802,345.10445,16275091506,356851893,16275086872,-4634,,
14870520837,345.15548,16275142543,356902925,16275137905,-4638,,
14870571377,345.20603,16275193086,356953463,16275188443,-4643,,
14870621935,345.25658,16275243646,357004017,16275238997,-4649,,
14870672956,345.30760,16275294669,357055036,16275290016,-4653,,
14870723498,345.35815,16275345213,357105575,16275340555,-4658,,
14870774032,345.40868,16275395750,357156107,16275391087,-4663,,
14870824111,345.45876,16275445831,357206182,16275441162,-4669,,
14870875190,345.50984,16275496912,357257259,16275492239,-4673,,
14870926238,345.56089,16275547963,357308305,16275543284,-4679,,
14870977249,345.61190,16275598976,357359312,16275594292,-4684,,
14871027302,345.66195,16275649031,357409364,16275644343,-4688,,
14871077863,345.71251,16275699595,357459922,16275694901,-4694,,
14871128944,345.76359,16275750678,357511000,16275745979,-4699,,
14871179119,345.81377,16275800855,357561172,16275796152,-4703,,
14871229653,345.86430,16275851392,357611704,16275846683,-4709,,
14871280186,345.91483,16275901928,357662234,16275897214,-4714,,
14871330784,345.96543,16275952528,357712829,16275947808,-4720,,
14871381376,346.01602,16276003122,357763418,16275998398,-4724,,
14871432409,346.06706,16276054156,357814448,16276049427,-4729,,
14871483467,346.11811,16276105218,357865504,16276100483,-4735,,
14871534065,346.16871,16276155829,357916109,16276151089,-4740,,
14871584776,346.21942,16276206542,357966819,16276201798,-4744,,
14871635879,346.27053,16276257637,358017907,16276252887,-4750,,
14871686923,346.32157,16276308683,358068948,16276303928,-4755,,
14871737941,346.37259,16276359702,358119964,16276354943,-4759,,
14871788536,346.42318,16276410301,358170556,16276405535,-4766,,
14871839586,346.47423,16276461353,358221604,16276456583,-4770,,
14871890407,346.52506,16276512177,358272421,16276507401,-4776,,
14871940951,346.57560,16276562723,358322963,16276557943,-4780,,
14871991512,346.62616,16276613297,358373533,16276608512,-4785,,
14872042132,346.67678,16276663909,358424138,16276659118,-4791,,
14872093097,346.72775,16276714876,358475101,16276710081,-4795,,
14872144153,346.77880,16276765934,358526155,16276761135,-4799,,
14872195129,346.82978,16276816913,358577127,16276812107,-4806,,
14872245186,346.87983,16276866971,358627181,16276862160,-4811,,
14872295760,346.93041,16276917547,358677753,16276912732,-4815,,
14872346814,346.98146,16276968605,358728805,16276963784,-4821,,
14872397826,347.03247,16277019619,358779814,16277014794,-4825,,
14872448383,347.08303,16277070178,358830368,16277065347,-4831,,
14872498953,347.13360,16277120762,358880947,16277115926,-4836,,
14872549574,347.18422,16277171373,358931553,16277166533,-4840,,
14872600616,347.23526,16277222418,358982592,16277217571,-4847,,
14872651310,347.28596,16277273114,359033284,16277268263,-4851,,
14872701893,347.33654,16277323699,359083864,16277318843,-4856,,
14872752413,347.38706,16277374223,359134381,16277369361,-4862,,
14872803268,347.43792,16277425079,359185234,16277420213,-4866,,
14872853837,347.48849,16277475650,359235800,16277470779,-4871,,
14872903995,347.53864,16277525811,359285955,16277520934,-4877,,
14872954925,347.58957,16277576744,359336882,16277571862,-4882,,
14873005982,347.64063,16277627802,359387936,16277622916,-4886,,
14873056658,347.69131,16277678482,359438610,16277673589,-4893,,
14873107562,347.74221,16277729388,359489511,16277724491,-4897,,
14873157604,347.79225,16277779432,359539551,16277774530,-4902,,
14873208010,347.84266,16277829841,359589954,16277824934,-4907,,
14873258968,347.89362,16277880800,359640909,16277875889,-4911,,
14873309963,347.94461,16277931799,359691902,16277926881,-4918,,
14873360347,347.99500,16277982185,359742283,16277977262,-4923,,
14873410925,348.04557,16278032765,359792859,16278027838,-4927,,
14873461934,348.09658,16278083777,359843864,16278078844,-4933,,
14873511989,348.14664,16278133834,359893918,16278128897,-4937,,
14873562590,348.19724,16278184437,359944516,16278179495,-4942,,
14873613157,348.24781,16278235006,359995079,16278230059,-4947,,
14873663783,348.29843,16278285635,360045703,16278280682,-4953,,
14873714383,348.34903,16278336236,360096300,16278331279,-4957,,
14873765406,348.40005,16278387263,360147320,16278382300,-4963,,
14873816007,348.45065,16278437876,360197929,16278432908,-4968,,
14873866601,348.50125,16278488462,360248510,16278483490,-4972,,
14873917621,348.55227,16278539485,360299527,16278534507,-4978,,
14873968380,348.60303,16278590246,360350283,16278585263,-4983,,
14874018847,348.65350,16278640716,360400749,16278635728,-4988,,
14874069884,348.70453,16278691755,360451783,16278686762,-4993,,
14874120906,348.75555,16278742779,360502801,16278737781,-4998,,
14874171518,348.80617,16278793394,360553410,16278788390,-5004,,
14874222602,348.85725,16278844480,360604492,16278839472,-5008,,
14874273164,348.90781,16278895044,360655052,16278890031,-5013,,
14874324085,348.95873,16278945968,360705969,16278940949,-5019,,
14874374709,349.00936,16278996594,360756591,16278991570,-5024,,
14874425757,349.06041,16279047643,360807636,16279042615,-5028,,
14874476783,349.11143,16279098672,360858670,16279093650,-5022,,
14874527856,349.16250,16279149748,360909730,16279144709,-5039,,
14874578905,349.21355,16279200800,360960777,16279195756,-5044,,
14874629953,349.26460,16279251850,361011821,16279246801,-5049,,
14874680970,349.31562,16279302869,361062835,16279297815,-5054,,
14874732052,349.36670,16279353954,361113915,16279348894,-5060,,
14874783102,349.41775,16279405006,361164963,16279399942,-5064,,
14874834209,349.46886,16279456114,361216066,16279451045,-5069,,
14874884759,349.51941,16279506667,361266613,16279501592,-5075,,
14874935575,349.57022,16279557486,361317427,16279552406,-5080,,
14874986158,349.62081,16279608072,361368008,16279602987,-5085,,
14875037178,349.67183,16279659094,361419024,16279654004,-5090,,
14875087246,349.72189,16279709163,361469089,16279704068,-5095,,
14875137800,349.77245,16279759721,361519642,16279754621,-5100,,
14875187938,349.82259,16279809861,361569777,16279804756,-5105,,
14875238967,349.87361,16279860892,361620802,16279855782,-5110,,
14875289675,349.92432,16279911603,361671509,16279906488,-5115,,
14875340600,349.97525,16279962530,361722430,16279957410,-5120,,
14875391191,350.02584,16280013123,361773019,16280007998,-5125,,
14875442260,350.07691,16280064195,361824084,16280059064,-5131,,
14875493308,350.12796,16280115245,361875130,16280110110,-5135,,
14875544331,350.17898,16280166270,361926150,16280161130,-5140,,
14875595357,350.23001,16280217299,361977174,16280212153,-5146,,
14875645432,350.28008,16280267387,362027258,16280262238,-5149,,
14875696480,350.33113,16280318426,362078291,16280313270,-5156,,
14875747530,350.38218,16280369489,362129349,16280364329,-5160,,
14875798568,350.43322,16280420518,362180373,16280415352,-5166,,
14875849598,350.48425,16280471552,362231401,16280466381,-5171,,
14875900183,350.53483,16280522138,362281983,16280516962,-5176,,
14875950759,350.58541,16280572717,362332556,16280567536,-5181,,
14876001500,350.63615,16280623461,362383294,16280618274,-5187,,
14876051811,350.68646,16280673773,362433603,16280668582,-5191,,
14876102775,350.73742,16280724740,362484565,16280719544,-5196,,
14876153849,350.78850,16280775817,362535636,16280770615,-5202,,
14876204897,350.83954,16280826867,362586682,16280821661,-5206,,
14876255954,350.89060,16280877927,362637736,16280872715,-5212,,
14876306978,350.94163,16280928952,362688756,16280923735,-5217,,
14876357553,350.99220,16280979541,362739340,16280974320,-5221,,
14876408129,351.04278,16281030109,362789902,16281024882,-5227,,
14876459177,351.09382,16281081159,362840948,16281075928,-5231,,
14876510208,351.14486,16281132192,362891975,16281126955,-5237,,
14876560799,351.19545,16281182786,362942565,16281177544,-5242,,
14876611344,351.24599,16281233333,362993106,16281228086,-5247,,
14876662370,351.29702,16281284361,363044129,16281279119,-5242,,
14876713415,351.34806,16281335409,363095171,16281330151,-5258,,
14876764453,351.39910,16281386449,363146208,16281381187,-5262,,
14876815039,351.44969,16281437037,363196790,16281431769,-5268,,
14876865526,351.50017,16281487527,363247275,16281482254,-5273,,
14876915952,351.55060,16281537955,363297709,16281532689,-5266,,
14876967020,351.60167,16281589026,363348763,16281583743,-5283,,
14877018071,351.65272,16281640078,363399811,16281634790,-5288,,
14877068629,351.70328,16281690639,363450366,16281685346,-5293,,
14877119189,351.75384,16281741202,363500924,16281735904,-5298,,
14877169796,351.80444,16281791822,363551539,16281786519,-5303,,
14877220836,351.85548,16281842852,363602565,16281837544,-5308,,
14877271438,351.90609,16281893458,363653166,16281888145,-5313,,
14877322091,351.95674,16281944113,363703816,16281938795,-5318,,
14877372640,352.00729,16281994664,363754362,16281989341,-5323,,
14877423125,352.05777,16282045152,363804843,16282039822,-5330,,
14877474159,352.10881,16282096188,363855875,16282090855,-5333,,
14877525236,352.15988,16282147268,363906950,16282141929,-5339,,
14877576269,352.21092,16282198302,363957979,16282192958,-5344,,
14877627289,352.26194,16282249324,364008996,16282243975,-5349,,
14877678341,352.31299,16282300380,364060046,16282295025,-5355,,
14877728519,352.36317,16282350560,364110222,16282345201,-5359,,
14877779584,352.41423,16282401627,364161284,16282396263,-5364,,
14877830608,352.46526,16282452653,364212305,16282447285,-5368,,
14877881214,352.51586,16282503262,364262908,16282497888,-5374,,
14877931803,352.56645,16282553853,364313495,16282548474,-5379,,
14877982809,352.61746,16282604862,364364498,16282599477,-5385,,
14878033392,352.66804,16282655446,364415078,16282650057,-5389,,
14878084215,352.71886,16282706273,364465898,16282700878,-5395,,
14878134762,352.76941,16282756822,364516442,16282751422,-5400,,
14878185845,352.82049,16282807906,364567523,16282802502,-5404,,
14878236893,352.87154,16282858958,364618568,16282853548,-5410,,
14878287462,352.92211,16282909529,364669135,16282904115,-5414,,
14878338485,352.97313,16282960554,364720154,16282955134,-5420,,
14878389559,353.02421,16283011631,364771226,16283006206,-5425,,
14878440606,353.07525,16283062680,364822270,16283057250,-5430,,
14878491386,353.12603,16283113463,364873048,16283108027,-5436,,
14878542035,353.17668,16283164114,364923695,16283158674,-5440,,
14878592651,353.22730,16283214732,364974308,16283209287,-5445,,
14878643211,353.27786,16283265295,365024865,16283259845,-5450,,
14878693855,353.32850,16283315940,365075505,16283310485,-5455,,
14878743954,353.37860,16283366042,365125603,16283360582,-5460,,
14878795001,353.42965,16283417092,365176647,16283411626,-5466,,
14878845377,353.48003,16283467470,365227019,16283461999,-5471,,
14878895434,353.53008,16283517529,365277074,16283512054,-5475,,
14878946036,353.58068,16283568134,365327673,16283562653,-5481,,
14878997076,353.63172,16283619176,365378711,16283613690,-5486,,
14879048083,353.68273,16283670184,365429714,16283664693,-5491,,
14879098197,353.73284,16283720310,365479835,16283714814,-5496,,
14879149191,353.78384,16283771298,365530818,16283765797,-5501,,
14879200245,353.83489,16283822354,365581868,16283816848,-5506,,
14879250795,353.88544,16283872907,365632417,16283867397,-5510,,
14879301342,353.93599,16283923456,365682961,16283917940,-5516,,
14879352384,353.98703,16283974501,365734000,16283968979,-5522,,
14879403448,354.03810,16284025567,365785060,16284020040,-5527,,
14879454017,354.08866,16284076138,365835628,16284070608,-5530,,
14879504513,354.13916,16284126637,365886121,16284121101,-5536,,
14879555079,354.18973,16284177204,365936683,16284171662,-5542,,
14879605630,354.24028,16284227757,365987232,16284222221,-5536,,
14879656275,354.29092,16284278406,366037874,16284272853,-5553,,
14879707217,354.34186,16284329350,366088814,16284323793,-5557,,
14879757776,354.39242,16284379911,366139369,16284374349,-5562,,
14879808314,354.44296,16284430452,366189905,16284424885,-5567,,
14879858863,354.49351,16284481003,366240451,16284475431,-5572,,
14879909410,354.54406,16284531552,366290996,16284525975,-5577,,
14879959984,354.59463,16284582128,366341567,16284576547,-5581,,
14880010519,354.64517,16284632665,366392109,16284627088,-5577,,
14880061556,354.69620,16284683706,366443133,16284678113,-5593,,
14880112105,354.74675,16284734257,366493681,16284728660,-5597,,
14880162749,354.79740,16284784902,366544321,16284779300,-5602,,
14880213774,354.84842,16284835932,366595344,16284830324,-5608,,
14880264822,354.89947,16284886981,366646389,16284881369,-5612,,
14880315334,354.94998,16284937494,366696898,16284931878,-5616,,
14880365392,355.00004,16284987555,366746953,16284981932,-5623,,
14880415547,355.05019,16285037713,366797105,16285032095,-5618,,
14880465652,355.10030,16285087819,366847208,16285082187,-5632,,
14880516201,355.15085,16285138372,366897754,16285132744,-5628,,
14880566318,355.20097,16285188491,366947869,16285182848,-5643,,
14880616397,355.25104,16285238582,366997955,16285232935,-5647,,
14880667006,355.30165,16285289183,367048551,16285283530,-5653,,
14880717587,355.35224,16285339766,367099129,16285334108,-5658,,
14880768161,355.40281,16285390342,367149700,16285384679,-5663,,
14880818813,355.45346,16285440997,367200350,16285435329,-5668,,
14880869293,355.50394,16285491480,367250827,16285485807,-5673,,
14880920309,355.55496,16285542498,367301841,16285536820,-5678,,
14880970868,355.60552,16285593060,367352398,16285587377,-5683,,
14881021770,355.65642,16285643964,367403297,16285638276,-5688,,
14881072325,355.70697,16285694522,367453849,16285688828,-5694,,
14881122867,355.75752,16285745066,367504387,16285739367,-5699,,
14881173441,355.80809,16285795652,367554970,16285789949,-5703,,
14881224472,355.85912,16285846676,367605988,16285840967,-5709,,
14881275500,355.91015,16285897706,367657013,16285891992,-5714,,
14881325906,355.96055,16285948114,367707417,16285942396,-5718,,
14881376482,356.01113,16285998723,367758020,16285992999,-5724,,
14881427486,356.06213,16286049699,367808990,16286043969,-5730,,
14881478532,356.11318,16286100747,367860033,16286095012,-5735,,
14881529575,356.16422,16286151793,367911074,16286146054,-5739,,
14881580645,356.21529,16286202865,367962141,16286197121,-5744,,
14881630731,356.26538,16286252953,368012236,16286247215,-5738,,
14881681742,356.31639,16286303967,368063234,16286298213,-5754,,
14881731805,356.36645,16286354032,368113294,16286348273,-5759,,
14881782365,356.41701,16286404594,368163860,16286398839,-5755,,
14881833078,356.46773,16286455311,368214562,16286449541,-5770,,
14881883976,356.51862,16286506210,368265457,16286500436,-5774,,
14881934551,356.56920,16286556788,368316028,16286551008,-5780,,
14881985581,356.62023,16286607821,368367056,16286602035,-5786,,
14882036075,356.67072,16286658315,368417547,16286652526,-5789,,
14882086786,356.72143,16286709030,368468255,16286703235,-5795,,
14882137299,356.77195,16286759545,368518765,16286753745,-5800,,
14882187838,356.82249,16286810086,368569302,16286804281,-5805,,
14882238410,356.87306,16286860672,368619882,16286854862,-5810,,
14882289461,356.92411,16286911724,368670929,16286905909,-5815,,
14882340528,356.97518,16286962783,368721984,16286956963,-5820,,
14882391548,357.02620,16287013805,368773001,16287007980,-5825,,
14882442596,357.07724,16287064856,368824046,16287059026,-5830,,
14882493634,357.12828,16287115897,368875082,16287110061,-5836,,
14882543693,357.17834,16287165957,368925137,16287160117,-5840,,
14882594264,357.22891,16287216531,368975717,16287210696,-5835,,
14882645289,357.27994,16287267559,369026729,16287261708,-5851,,
14882696385,357.33103,16287318657,369077821,16287312801,-5856,,
14882746975,357.38162,16287369259,369128420,16287363399,-5860,,
14882797531,357.43218,16287419807,369178962,16287413941,-5866,,
14882848325,357.48297,16287470604,369229754,16287464733,-5871,,
14882898875,357.53352,16287521156,369280301,16287515280,-5876,,
14882949454,357.58410,16287571738,369330878,16287565857,-5881,,
14882999994,357.63464,16287622280,369381414,16287616394,-5886,,
14883050553,357.68520,16287672842,369431970,16287666950,-5892,,
14883101104,357.73575,16287723395,369482519,16287717499,-5896,,
14883152170,357.78682,16287774474,369533594,16287768573,-5901,,
14883202734,357.83738,16287825029,369584143,16287819123,-5906,,
14883252890,357.88754,16287875187,369634297,16287869277,-5910,,
14883303469,357.93812,16287925769,369684874,16287919853,-5916,,
14883354510,357.98916,16287976813,369735912,16287970891,-5922,,
14883405102,358.03975,16288027406,369786500,16288021489,-5917,,
14883455624,358.09027,16288077930,369837020,16288071999,-5931,,
14883506151,358.14080,16288128461,369887545,16288122524,-5937,,
14883557180,358.19183,16288179493,369938571,16288173550,-5943,,
14883607743,358.24239,16288230057,369989131,16288224110,-5947,,
14883658189,358.29284,16288280506,370039574,16288274554,-5952,,
14883709234,358.34388,16288331553,370090616,16288325596,-5957,,
14883759774,358.39442,16288382095,370141154,16288376133,-5962,,
14883810048,358.44470,16288432372,370191426,16288426405,-5967,,
14883860606,358.49525,16288482932,370241981,16288476960,-5972,,
14883911155,358.54580,16288533483,370292526,16288527505,-5978,,
14883961706,358.59635,16288584037,370343075,16288578054,-5983,,
14884012253,358.64690,16288634586,370393619,16288628599,-5987,,
14884062799,358.69745,16288685135,370444162,16288679141,-5994,,
14884113339,358.74799,16288735676,370494699,16288729678,-5998,,
14884163953,358.79860,16288786293,370545311,16288780291,-6002,,
14884214456,358.84910,16288836799,370595811,16288830791,-6008,,
14884265059,358.89971,16288887404,370646412,16288881391,-6013,,
14884315544,358.95019,16288937891,370696895,16288931874,-6017,,
14884366095,359.00074,16288988445,370747443,16288982422,-6023,,
14884416641,359.05129,16289038993,370797985,16289032964,-6029,,
14884467494,359.10214,16289089848,370848837,16289083816,-6032,,
14884518531,359.15318,16289140888,370899871,16289134850,-6038,,
14884569168,359.20382,16289191527,370950505,16289185484,-6043,,
14884620215,359.25486,16289242575,371001548,16289236527,-6048,,
14884670794,359.30544,16289293157,371052125,16289287104,-6053,,
14884721454,359.35610,16289343819,371102782,16289337761,-6058,,
14884771674,359.40632,16289394043,371153000,16289387979,-6064,,
14884822209,359.45686,16289444579,371203532,16289438511,-6068,,
14884872270,359.50692,16289494643,371253590,16289488570,-6073,,
14884922831,359.55748,16289545217,371304159,16289539138,-6079,,
14884973862,359.60851,16289596240,371355176,16289590156,-6084,,
14885024213,359.65886,16289646593,371405526,16289640505,-6088,,
14885074760,359.70941,16289697143,371456070,16289691049,-6094,,
14885125319,359.75997,16289747703,371506625,16289741604,-6099,,
14885175848,359.81050,16289798235,371557152,16289792132,-6103,,
14885226417,359.86106,16289848806,371607717,16289842697,-6109,,
14885277464,359.91211,16289899856,371658762,16289893742,-6114,,
14885328015,359.96266,16289950409,371709311,16289944290,-6119,,
14885378306,360.01295,16290000703,371759600,16289994579,-6124,,
14885429317,360.06396,16290051716,371810608,16290045587,-6129,,
14885479387,360.11404,16290101788,371860674,16290095653,-6135,,
14885530421,360.16507,16290152825,371911707,16290146686,-6139,,
14885580505,360.21515,16290202911,371961787,16290196767,-6144,,
14885631032,360.26568,16290253440,372012311,16290247291,-6149,,
14885681611,360.31626,16290304022,372062888,16290297868,-6154,,
14885732659,360.36731,16290355071,372113933,16290348912,-6159,,
14885783707,360.41836,16290406123,372164978,16290399957,-6166,,
14885834226,360.46887,16290456644,372215495,16290450474,-6170,,
14885884843,360.51949,16290507262,372266109,16290501088,-6174,,
14885935425,360.57007,16290557848,372316688,16290551668,-6180,,
14885986027,360.62068,16290608452,372367287,16290602267,-6185,,
14886036876,360.67152,16290659303,372418135,16290653114,-6189,,
14886087595,360.72224,16290710026,372468851,16290703831,-6195,,
14886138077,360.77272,16290760508,372519329,16290754308,-6200,,
14886188190,360.82284,16290810624,372569440,16290804419,-6205,,
14886238712,360.87336,16290861149,372619959,16290854939,-6210,,
14886289675,360.92432,16290912113,372670919,16290905898,-6215,,
14886339788,360.97444,16290962228,372721029,16290956008,-6220,,
14886390385,361.02503,16291012829,372771624,16291006604,-6225,,
14886440622,361.07527,16291063068,372821859,16291056838,-6230,,
14886490777,361.12543,16291113225,372872010,16291106990,-6235,,
14886541689,361.17634,16291164140,372922921,16291157900,-6240,,
14886592307,361.22695,16291214761,372973536,16291208516,-6245,,
14886642908,361.27756,16291265363,373024133,16291259113,-6250,,
14886693351,361.32800,16291315809,373074573,16291309553,-6256,,
14886744026,361.37867,16291366496,373125257,16291360236,-6260,,
14886794968,361.42962,16291417430,373176185,16291411164,-6266,,
14886845535,361.48018,16291467999,373226749,16291461728,-6271,,
14887080529,361.71518,16291703004,373461742,16291696721,-6283,16291702536,
14887105804,361.74045,16291728281,373487005,16291722012,-6269,,
14887156378,361.79103,16291778857,373537577,16291772643,-6214,,
14887207406,361.84205,16291829888,373588601,16291823728,-6160,,
14887258478,361.89313,16291880963,373639672,16291874857,-6106,,
14887309490,361.94414,16291931977,373690679,16291925925,-6052,,
14887360059,361.99471,16291982547,373741246,16291976550,-5997,,
14887411111,362.04576,16292033613,373792307,16292027671,-5942,,
14887462173,362.09682,16292084671,373843359,16292078782,-5889,,
14887513198,362.14785,16292135693,373894377,16292129869,-5824,,
14887564279,362.19893,16292186777,373945456,16292180998,-5779,,
14887614790,362.24944,16292237302,373995975,16292231576,-5726,,
14887665832,362.30048,16292288335,374047003,16292282663,-5672,,
14887716683,362.35133,16292339188,374097851,16292333571,-5617,,
14887767027,362.40168,16292389535,374148192,16292383971,-5564,,
14887817627,362.45227,16292440137,374198789,16292434627,-5510,,
14887868176,362.50282,16292490688,374249336,16292485232,-5456,,
14887918843,362.55349,16292541358,374300001,16292535957,-5401,,
14887969946,362.60459,16292592463,374351100,16292587116,-5347,,
14888020881,362.65553,16292643401,374402043,16292638117,-5284,,
14888071026,362.70567,16292693547,374452175,16292688308,-5239,,
14888121620,362.75627,16292744144,374502766,16292738958,-5186,,
14888172224,362.80687,16292794750,374553377,16292789628,-5122,,
14888222792,362.85744,16292845320,374603933,16292840242,-5078,,
14888273461,362.90811,16292895992,374654599,16292890968,-5024,,
14888323605,362.95825,16292946138,374704740,16292941167,-4971,,
14888374344,363.00899,16292996891,374755489,16292991975,-4916,,
14888424882,363.05953,16293047432,374806024,16293042570,-4862,,
14888475386,363.11003,16293097926,374856513,16293093117,-4809,,
14888526504,363.16115,16293149047,374907629,16293144292,-4755,,
14888577046,363.21169,16293199591,374958168,16293194891,-4700,,
14888627614,363.26226,16293250162,375008734,16293245515,-4647,,
14888678663,363.31331,16293301212,375059779,16293296620,-4592,,
14888729272,363.36392,16293351824,375110386,16293347286,-4538,,
14888779876,363.41452,16293402430,375160987,16293397946,-4484,,
14888830792,363.46544,16293453349,375211900,16293448919,-4430,,
14888880894,363.51554,16293503465,375262010,16293499087,-4378,,
14888931484,363.56613,16293554045,375312587,16293549722,-4323,,
14888982466,363.61711,16293605029,375363566,16293600762,-4267,,
14889033114,363.66776,16293655680,375414211,16293651465,-4215,,
14889083660,363.71831,16293706229,375464756,16293702069,-4160,,
14889133761,363.76841,16293756331,375514853,16293752224,-4107,,
14889184871,363.81952,16293807444,375565960,16293803391,-4053,,
14889235798,363.87045,16293858373,375616884,16293854374,-3999,,
14889286867,363.92151,16293909445,375667951,16293905502,-3943,,
14889337382,363.97203,16293959963,375718464,16293956072,-3891,,
14889388011,364.02266,16294010593,375769089,16294006756,-3837,,
14889439068,364.07372,16294061654,375820144,16294057871,-3783,,
14889489703,364.12435,16294112291,375870776,16294108563,-3728,,
14889540269,364.17492,16294162858,375921339,16294159184,-3674,,
14889590804,364.22545,16294213397,375971871,16294209776,-3621,,
14889641856,364.27650,16294264451,376022921,16294260885,-3566,,
14889692427,364.32707,16294315033,376073499,16294311521,-3512,,
14889743498,364.37815,16294366097,376124557,16294362639,-3458,,
14889794516,364.42916,16294417118,376175573,16294413715,-3403,,
14889845597,364.48025,16294468201,376226651,16294464853,-3348,,
14889896395,364.53104,16294519001,376277446,16294515706,-3295,,
14889947392,364.58204,16294570001,376328441,16294566760,-3241,,
14889997957,364.63261,16294620569,376379003,16294617382,-3187,,
14890048579,364.68323,16294671193,376429622,16294668060,-3133,,
14890099191,364.73384,16294721807,376480231,16294718728,-3079,,
14890149716,364.78436,16294772345,376530764,16294769320,-3025,,
14890200786,364.83543,16294823407,376581821,16294820437,-2970,,
14890251803,364.88645,16294874425,376632835,16294871509,-2916,,
14890302381,364.93703,16294925007,376683410,16294922144,-2863,,
14890353433,364.98808,16294976061,376734460,16294973254,-2807,,
14890404460,365.03911,16295027099,376785494,16295024347,-2752,,
14890455027,365.08967,16295077660,376836048,16295074960,-2700,,
14890506067,365.14072,16295128702,376887085,16295126057,-2645,,
14890557094,365.19174,16295179732,376938111,16295177141,-2591,,
14890608173,365.24282,16295230813,376989186,16295228276,-2537,,
14890658722,365.29337,16295281363,377039732,16295278881,-2482,,
14890709285,365.34393,16295331929,377090293,16295329500,-2429,,
14890760364,365.39501,16295383011,377141369,16295380637,-2374,,
14890811412,365.44606,16295434061,377192414,16295431741,-2320,,
14890862445,365.49709,16295485097,377243455,16295482841,-2256,,
14890913511,365.54816,16295536164,377294508,16295533953,-2211,,
14890964545,365.59919,16295587202,377345539,16295585045,-2157,,
14891015638,365.65029,16295638297,377396629,16295636195,-2102,,
14891065885,365.70053,16295688546,377446875,16295686498,-2048,,
14891116609,365.75126,16295739273,377497595,16295737278,-1995,,
14891167126,365.80177,16295789791,377548109,16295787850,-1941,,
14891217246,365.85189,16295839913,377598226,16295838025,-1888,,
14891267829,365.90248,16295890499,377648807,16295888665,-1834,,
14891318469,365.95312,16295941141,377699444,16295939361,-1780,,
14891369017,366.00367,16295991692,377749990,16295989966,-1726,,
14891419477,366.05412,16296042155,377800448,16296040483,-1672,,
14891470050,366.10470,16296092730,377851017,16296091112,-1618,,
14891520622,366.15527,16296143304,377901587,16296141740,-1564,,
14891570795,366.20544,16296193480,377951756,16296191968,-1512,,
14891621440,366.25609,16296244127,378002462,16296242734,-1393,,
14891672030,366.30668,16296294719,378052986,16296293317,-1402,,
14891722647,366.35730,16296345349,378103611,16296344000,-1349,,
14891773204,366.40785,16296395898,378154156,16296394603,-1295,,
14891823322,366.45797,16296446017,378204270,16296444777,-1240,,
14891873527,366.50817,16296496226,378254473,16296495037,-1189,,
14891924587,366.55924,16296547288,378305530,16296546155,-1133,,
14891974984,366.60963,16296597686,378355924,16296596617,-1069,,
14892025830,366.66048,16296648535,378406767,16296647509,-1026,,
14892076879,366.71153,16296699586,378457813,16296698614,-972,,
14892127901,366.76255,16296750612,378508833,16296749640,-972,,
14892178479,366.81313,16296801192,378559409,16296800215,-977,,
14892229061,366.86371,16296851776,378609988,16296850794,-982,,
14892280108,366.91476,16296902826,378661033,16296901839,-987,,
14892331171,366.96582,16296953890,378712092,16296952899,-991,,
14892382162,367.01681,16297004884,378763081,16297003887,-997,,
14892432716,367.06736,16297055440,378813631,16297054438,-1002,,
14892483302,367.11795,16297106029,378864215,16297105022,-1007,,
14892534326,367.16897,16297157056,378915237,16297156043,-1013,,
14892585375,367.22002,16297208107,378966282,16297207089,-1018,,
14892636418,367.27107,16297259151,379017322,16297258128,-1023,,
14892686997,367.32164,16297309734,379067899,16297308706,-1028,,
14892737170,367.37182,16297359909,379118070,16297358876,-1033,,
14892787765,367.42241,16297410506,379168661,16297409477,-1029,,
14892838775,367.47342,16297461519,379219669,16297460476,-1043,,
14892889377,367.52402,16297512122,379270268,16297511074,-1048,,
14892939909,367.57456,16297562657,379320797,16297561603,-1054,,
14892990107,367.62475,16297612857,379370993,16297611799,-1058,,
14893040694,367.67534,16297663447,379421577,16297662384,-1063,,
14893091302,367.72595,16297714057,379472182,16297712989,-1068,,
14893141863,367.77651,16297764621,379522740,16297763546,-1075,,
14893191933,367.82658,16297814692,379572808,16297813614,-1078,,
14893242579,367.87723,16297865341,379623452,16297864258,-1083,,
14893293189,367.92784,16297915954,379674058,16297914875,-1079,,
14893344252,367.97890,16297967019,379725120,16297965931,-1088,,
14893395309,368.02996,16298018078,379776173,16298016979,-1099,,
14893445900,368.08055,16298068672,379826762,16298067568,-1104,,
14893496337,368.13099,16298119111,379877195,16298118002,-1109,,
14893546940,368.18159,16298169716,379927796,16298168602,-1114,,
14893597512,368.23216,16298220291,379978375,16298219181,-1110,,
14893648552,368.28320,16298271333,380029402,16298270209,-1124,,
14893699137,368.33378,16298321921,380079986,16298320792,-1129,,
14893750185,368.38483,16298372971,380131030,16298371837,-1134,,
14893800764,368.43541,16298423551,380181606,16298422412,-1139,,
14893851779,368.48643,16298474569,380232618,16298473424,-1145,,
14893902411,368.53706,16298525204,380283248,16298524054,-1150,,
14893953363,368.58801,16298576157,380334197,16298575003,-1154,,
14894003518,368.63817,16298626316,380384349,16298625156,-1160,,
14894054014,368.68866,16298676813,380434843,16298675649,-1164,,
14894104189,368.73884,16298726991,380485015,16298725822,-1169,,
14894154751,368.78940,16298777556,380535585,16298776392,-1164,,
14894205513,368.84016,16298828319,380586334,16298827140,-1179,,
14894256112,368.89076,16298878922,380636930,16298877736,-1186,,
14894307126,368.94177,16298929938,380687941,16298928748,-1190,,
14894357963,368.99261,16298980776,380738775,16298979581,-1195,,
14894409010,369.04366,16299031827,380789821,16299030627,-1200,,
14894460059,369.09471,16299082878,380840866,16299081673,-1205,,
14894511100,369.14575,16299133921,380891914,16299132721,-1200,,
14894561710,369.19636,16299184534,380942512,16299183318,-1216,,
14894612758,369.24741,16299235583,380993557,16299234363,-1220,,
14894663759,369.29841,16299286588,381044556,16299285362,-1226,,
14894714368,369.34902,16299337199,381095162,16299335968,-1231,,
14894765414,369.40006,16299388246,381146205,16299387011,-1235,,
14894816411,369.45106,16299439247,381197199,16299438006,-1241,,
14894867003,369.50165,16299489841,381247788,16299488595,-1246,,
14894917143,369.55179,16299539982,381297925,16299538731,-1251,,
14894967721,369.60237,16299590563,381348501,16299589307,-1256,,
14895018357,369.65301,16299641202,381399134,16299639940,-1262,,
14895068941,369.70359,16299691788,381449715,16299690521,-1267,,
14895119540,369.75419,16299742389,381500312,16299741118,-1271,,
14895170124,369.80477,16299792975,381550893,16299791699,-1276,,
14895220686,369.85533,16299843549,381601462,16299842268,-1281,,
14895271712,369.90636,16299894569,381652476,16299893283,-1286,,
14895321855,369.95650,16299944713,381702615,16299943432,-1281,,
14895372137,370.00678,16299994998,381752896,16299993702,-1296,,
14895422710,370.05736,16300045574,381803466,16300044272,-1302,,
14895473352,370.10800,16300096217,381854105,16300094911,-1306,,
14895524406,370.15905,16300147274,381905156,16300145962,-1312,,
14895575454,370.21010,16300198325,381956201,16300197008,-1317,,
14895626522,370.26117,16300249395,382007267,16300248074,-1321,,
14895677554,370.31220,16300300440,382058307,16300299113,-1327,,
14895728621,370.36327,16300351499,382109360,16300350167,-1332,,
14895779626,370.41427,16300402506,382160362,16300401168,-1338,,
14895830190,370.46484,16300453073,382210924,16300451741,-1332,,
14895881217,370.51587,16300504102,382261948,16300502754,-1348,,
14895931809,370.56646,16300554695,382312537,16300553343,-1352,,
14895982824,370.61747,16300605713,382363549,16300604355,-1358,,
14896033910,370.66856,16300656802,382414633,16300655440,-1362,,
14896084538,370.71919,16300707433,382465258,16300706065,-1368,,
14896135087,370.76974,16300757984,382515804,16300756611,-1373,,
14896186137,370.82079,16300809036,382566852,16300807658,-1378,,
14896237185,370.87183,16300860087,382617898,16300858704,-1383,,
14896288233,370.92288,16300911137,382668942,16300909749,-1388,,
14896338913,370.97356,16300961818,382719619,16300960426,-1392,,
14896389616,371.02426,16301012525,382770321,16301011127,-1398,,
14896440202,371.07485,16301063113,382820903,16301061710,-1403,,
14896490743,371.12539,16301113656,382871442,16301112248,-1408,,
14896541294,371.17594,16301164210,382921990,16301162797,-1413,,
14896592378,371.22703,16301215295,382973071,16301213877,-1418,,
14896643427,371.27808,16301266347,383024117,16301264923,-1424,,
14896694013,371.32866,16301316935,383074700,16301315506,-1429,,
14896745031,371.37968,16301367956,383125717,16301366523,-1433,,
14896795590,371.43024,16301418528,383176283,16301417089,-1439,,
14896846639,371.48129,16301469579,383227329,16301468135,-1444,,
14896897186,371.53183,16301520118,383277863,16301518670,-1448,,
14896947876,371.58252,16301570811,383328550,16301569357,-1454,,
14896998478,371.63313,16301621425,383379160,16301619966,-1459,,
14897049088,371.68374,16301672026,383429755,16301670562,-1464,,
14897099722,371.73437,16301722663,383480388,16301721194,-1469,,
14897150350,371.78500,16301773294,383531014,16301771820,-1474,,
14897200833,371.83548,16301823779,383581493,16301822300,-1479,,
14897251398,371.88605,16301874356,383632066,16301872873,-1483,,
14897301912,371.93656,16301924874,383682579,16301923385,-1489,,
14897352974,371.98762,16301975927,383733626,16301974432,-1495,,
14897403392,372.03804,16302026359,383784053,16302024859,-1500,,
14897454139,372.08879,16302077097,383834786,16302075593,-1504,,
14897504671,372.13932,16302127631,383885315,16302126121,-1510,,
14897555300,372.18995,16302178263,383935942,16302176748,-1515,,
14897605936,372.24058,16302228911,383986586,16302227393,-1518,,
14897656968,372.29162,16302279935,384037604,16302278410,-1525,,
14897707521,372.34217,16302330491,384088154,16302328960,-1531,,
14897758057,372.39270,16302381029,384138687,16302379494,-1535,,
14897808779,372.44343,16302431753,384189407,16302430213,-1540,,
14897859850,372.49450,16302482827,384240475,16302481282,-1545,,
14897910886,372.54553,16302533865,384291508,16302532314,-1551,,
14897961935,372.59658,16302584917,384342556,16302583362,-1555,,
14898013004,372.64765,16302635988,384393622,16302634428,-1560,,
14898063530,372.69818,16302686517,384444145,16302684951,-1566,,
14898114564,372.74921,16302737564,384495187,16302735994,-1570,,
14898165104,372.79975,16302788095,384545713,16302786520,-1575,,
14898215653,372.85030,16302838646,384596259,16302837065,-1581,,
14898266733,372.90138,16302889729,384647336,16302888143,-1586,,
14898317268,372.95192,16302940276,384697879,16302938685,-1591,,
14898367842,373.00249,16302990843,384748441,16302989247,-1596,,
14898418296,373.05294,16303041299,384798891,16303039698,-1601,,
14898468841,373.10349,16303091846,384849433,16303090240,-1606,,
14898518997,373.15364,16303142005,384899597,16303140404,-1601,,
14898569576,373.20422,16303192586,384950163,16303190970,-1616,,
14898620665,373.25531,16303243677,385001249,16303242055,-1622,,
14898671292,373.30594,16303294318,385051886,16303292692,-1626,,
14898721870,373.35652,16303344886,385102449,16303343255,-1631,,
14898772895,373.40754,16303395915,385153472,16303394278,-1637,,
14898823946,373.45859,16303446968,385204519,16303445326,-1642,,
14898874542,373.50919,16303497565,385255113,16303495919,-1646,,
14898924615,373.55926,16303547652,385305193,16303546000,-1652,,
14898975656,373.61030,16303598685,385356221,16303597028,-1657,,
14899026220,373.66087,16303649251,385406783,16303647590,-1661,,
14899077097,373.71175,16303700131,385457657,16303698463,-1668,,
14899127993,373.76264,16303751041,385508562,16303749368,-1673,,
14899179037,373.81369,16303802074,385559591,16303800397,-1677,,
14899229614,373.86426,16303852654,385610166,16303850972,-1682,,
14899280183,373.91483,16303903226,385660733,16303901539,-1687,,
14899331055,373.96570,16303954100,385711601,16303952407,-1693,,
14899381174,374.01582,16304004221,385761730,16304002536,-1685,,
14899431640,374.06629,16304054689,385812181,16304052987,-1702,,
14899482268,374.11692,16304105321,385862806,16304103613,-1708,,
14899532881,374.16753,16304155935,385913417,16304154223,-1712,,
14899583442,374.21809,16304206499,385963975,16304204781,-1718,,
14899634446,374.26909,16304257506,386014976,16304255783,-1723,,
14899685501,374.32015,16304308562,386066028,16304306834,-1728,,
14899736066,374.37071,16304359130,386116592,16304357398,-1732,,
14899786630,374.42128,16304409697,386167153,16304407959,-1738,,
14899837132,374.47178,16304460200,386217651,16304458457,-1743,,
14899888185,374.52283,16304511257,386268703,16304509509,-1748,,
14899938718,374.57337,16304561791,386319232,16304560038,-1753,,
14899989302,374.62395,16304612378,386369814,16304610621,-1757,,
14900039839,374.67449,16304662918,386420348,16304661154,-1764,,
14900090388,374.72504,16304713469,386470895,16304711701,-1768,,
14900141418,374.77607,16304764501,386521922,16304762728,-1773,,
14900191483,374.82613,16304814568,386571983,16304812789,-1779,,
14900242036,374.87668,16304865124,386622534,16304863341,-1783,,
14900293061,374.92771,16304916151,386673556,16304914362,-1789,,
14900351702,374.98635,16304974794,386732194,16304973000,-1794,,
14900402482,375.03713,16305025577,386782972,16305023778,-1799,,
14900453185,375.08783,16305076282,386833671,16305074477,-1805,,
14900504236,375.13888,16305127336,386884721,16305125527,-1809,,
14900555255,375.18990,16305178357,386935736,16305176543,-1814,,
14900606693,375.24134,16305229798,386987172,16305227978,-1820,,
14900656792,375.29144,16305279898,387037267,16305278073,-1825,,
14900707584,375.34223,16305330693,387088057,16305328863,-1830,,
14900757819,375.39247,16305380931,387138289,16305379096,-1835,,
14900808407,375.44306,16305431532,387188885,16305429692,-1840,,
14900859457,375.49410,16305482574,387239922,16305480729,-1845,,
14900910015,375.54466,16305533134,387290488,16305531294,-1840,,
14900961055,375.59570,16305584175,387341514,16305582320,-1855,,
14901011146,375.64579,16305634270,387391603,16305632409,-1861,,
14901061714,375.69636,16305684840,387442169,16305682975,-1865,,
14901112746,375.74739,16305735874,387493198,16305734005,-1869,,
14901162820,375.79747,16305785950,387543268,16305784074,-1876,,
14901213374,375.84802,16305836507,387593820,16305834627,-1880,,
14901263964,375.89861,16305887099,387644408,16305885214,-1885,,
14901314489,375.94914,16305937626,387694929,16305935736,-1890,,
14901365040,375.99969,16305988180,387745479,16305986285,-1895,,
14901415621,376.05027,16306038762,387796056,16306036862,-1900,,
14901466093,376.10074,16306089238,387846525,16306087332,-1906,,
14901517147,376.15179,16306140293,387897576,16306138382,-1911,,
14901567243,376.20189,16306190393,387947670,16306188477,-1916,,
14901618284,376.25293,16306241435,387998708,16306239514,-1921,,
14901668339,376.30299,16306291493,388048760,16306289567,-1926,,
14901719392,376.35404,16306342549,388099812,16306340618,-1931,,
14901770471,376.40512,16306393629,388150887,16306391693,-1936,,
14901821489,376.45614,16306444650,388201902,16306442709,-1941,,
14901872562,376.50721,16306495726,388252972,16306493779,-1947,,
14901923611,376.55826,16306546776,388304019,16306544825,-1951,,
14901974666,376.60931,16306597834,388355072,16306595878,-1956,,
14902025195,376.65984,16306648365,388405597,16306646403,-1962,,
14902076121,376.71077,16306699305,388456532,16306697338,-1967,,
14902126962,376.76161,16306750138,388507359,16306748166,-1972,,
14902177534,376.81218,16306800712,388557928,16306798734,-1978,,
14902228153,376.86280,16306851333,388608545,16306849351,-1982,,
14902278792,376.91344,16306901974,388659181,16306899988,-1986,,
14902329317,376.96396,16306952502,388709703,16306950510,-1992,,
14902380378,377.01503,16307003565,388760761,16307001568,-1997,,
14902431222,377.06587,16307054420,388811611,16307052417,-2003,,
14902481728,377.11638,16307104920,388862106,16307102912,-2008,,
14902532271,377.16692,16307155465,388912646,16307153452,-2013,,
14902583339,377.21799,16307206536,388963711,16307204518,-2018,,
14902633839,377.26849,16307257037,389014208,16307255015,-2022,,
14902684400,377.31905,16307307600,389064767,16307305573,-2027,,
14902735462,377.37011,16307358666,389115827,16307356633,-2033,,
14902786281,377.42093,16307409487,389166642,16307407449,-2038,,
14902837250,377.47190,16307460458,389217609,16307458415,-2043,,
14902887820,377.52247,16307511043,389268189,16307508996,-2047,,
14902938861,377.57351,16307562074,389319215,16307560021,-2053,,
14902989414,377.62406,16307612629,389369765,16307610572,-2057,,
14903040462,377.67511,16307663680,389420811,16307661617,-2063,,
14903091036,377.72568,16307714255,389471381,16307712187,-2068,,
14903142065,377.77671,16307765288,389522407,16307763214,-2074,,
14903192614,377.82726,16307815839,389572954,16307813760,-2079,,
14903243656,377.87830,16307866882,389623993,16307864799,-2083,,
14903293749,377.92840,16307916979,389674084,16307914891,-2088,,
14903344124,377.97877,16307967356,389724457,16307965263,-2093,,
14903394702,378.02935,16308017936,389775031,16308015837,-2099,,
14903444816,378.07946,16308068053,389825154,16308065961,-2092,,
14903495675,378.13032,16308118914,389875999,16308116806,-2108,,
14903546251,378.18090,16308169493,389926572,16308167379,-2114,,
14903596827,378.23147,16308220071,389977146,16308217953,-2118,,
14903647382,378.28203,16308270628,390027698,16308268504,-2124,,
14903697950,378.33260,16308321199,390078264,16308319070,-2129,,
14903748674,378.38332,16308371925,390128984,16308369791,-2134,,
14903799131,378.43378,16308422384,390179439,16308420245,-2139,,
14903850157,378.48480,16308473412,390230462,16308471269,-2143,,
14903901063,378.53571,16308524321,390281366,16308522172,-2149,,
14903951642,378.58629,16308574901,390331941,16308572747,-2154,,
14904002679,378.63733,16308625941,390382975,16308623781,-2160,,
14904053010,378.68766,16308676275,390433304,16308674111,-2164,,
14904103927,378.73858,16308727194,390484219,16308725025,-2169,,
14904154923,378.78957,16308778192,390535211,16308776017,-2175,,
14904205774,378.84042,16308829046,390586060,16308826867,-2179,,
14904256828,378.89148,16308880103,390637111,16308877918,-2185,,
14904307870,378.94252,16308931147,390688150,16308928957,-2190,,
14904358450,378.99310,16308981729,390738728,16308979535,-2194,,
14904409487,379.04413,16309032769,390789763,16309030569,-2200,,
14904460242,379.09489,16309083525,390840514,16309081320,-2205,,
14904511292,379.14594,16309134577,390891561,16309132367,-2210,,
14904561385,379.19603,16309184674,390941653,16309182459,-2215,,
14904612081,379.24673,16309235372,390992345,16309233152,-2220,,
14904662719,379.29737,16309286012,391042980,16309283786,-2226,,
14904713520,379.34817,16309336816,391093778,16309334585,-2231,,
14904764155,379.39880,16309387452,391144411,16309385217,-2235,,
14904814698,379.44935,16309437998,391194951,16309435757,-2241,,
14904865229,379.49988,16309488532,391245480,16309486286,-2246,,
14904915433,379.55008,16309538738,391295682,16309536488,-2250,,
14904966478,379.60113,16309589786,391346724,16309587530,-2256,,
14905017461,379.65211,16309640771,391397703,16309638510,-2261,,
14905067598,379.70225,16309690921,391447848,16309688654,-2267,,
14905118132,379.75278,16309741447,391498369,16309739176,-2271,,
14905168729,379.80338,16309792046,391548963,16309789770,-2276,,
14905219733,379.85438,16309843052,391599964,16309840771,-2281,,
14905270767,379.90542,16309894089,391650997,16309891803,-2286,,
14905321354,379.95600,16309944678,391701581,16309942387,-2291,,
14905372403,380.00705,16309995729,391752626,16309993433,-2296,,
14905423450,380.05810,16310046779,391803671,16310044477,-2302,,
14905474492,380.10914,16310097823,391854720,16310095527,-2296,,
14905525566,380.16021,16310148900,391905781,16310146587,-2313,,
14905576125,380.21077,16310199461,391956337,16310197144,-2317,,
14905627139,380.26179,16310250477,392007359,16310248166,-2311,,
14905677767,380.31241,16310301108,392057975,16310298781,-2327,,
14905728817,380.36347,16310352160,392109022,16310349828,-2332,,
14905779401,380.41405,16310402747,392159603,16310400409,-2338,,
14905830367,380.46501,16310453715,392210566,16310451373,-2342,,
14905881436,380.51608,16310504786,392261633,16310502439,-2347,,
14905931994,380.56664,16310555345,392312187,16310552993,-2352,,
14905982804,380.61745,16310606159,392362994,16310603801,-2358,,
14906033809,380.66846,16310657166,392413998,16310654804,-2362,,
14906083917,380.71857,16310707277,392464103,16310704909,-2368,,
14906135012,380.76966,16310758374,392515194,16310756001,-2373,,
14906185982,380.82063,16310809346,392566162,16310806969,-2377,,
14906236353,380.87100,16310859720,392616530,16310857337,-2383,,
14906286881,380.92153,16310910262,392667067,16310907873,-2389,,
14906337456,380.97210,16310960828,392717628,16310958435,-2393,,
14906388437,381.02308,16311011811,392768607,16311009413,-2398,,
14906439034,381.07368,16311062421,392819211,16311060018,-2403,,
14906489645,381.12429,16311113022,392869808,16311110614,-2408,,
14906540730,381.17538,16311164111,392920891,16311161698,-2413,,
14906591330,381.22598,16311214713,392971489,16311212295,-2418,,
14906641916,381.27656,16311265302,393022082,16311262888,-2414,,
14906692926,381.32757,16311316314,393073078,16311313885,-2429,,
14906743475,381.37812,16311366865,393123625,16311364431,-2434,,
14906794380,381.42903,16311417772,393174527,16311415333,-2439,,
14906844881,381.47953,16311468276,393225026,16311465843,-2433,,
14906895919,381.53057,16311519316,393276061,16311516867,-2449,,
14906947000,381.58165,16311570400,393327140,16311567946,-2454,,
14906997628,381.63228,16311621029,393377764,16311618570,-2459,,
14907048646,381.68329,16311672061,393428791,16311669598,-2463,,
14907099234,381.73388,16311722641,393479365,16311720172,-2469,,
14907149807,381.78445,16311773216,393529935,16311770742,-2474,,
14907200425,381.83507,16311823836,393580550,16311821357,-2479,,
14907250529,381.88518,16311873943,393630652,16311871459,-2484,,
14907300846,381.93549,16311924261,393680966,16311921772,-2489,,
14907351227,381.98588,16311974645,393731344,16311972151,-2494,,
14907401805,382.03645,16312025225,393781920,16312022726,-2499,,
14907452597,382.08724,16312076020,393832710,16312073516,-2504,,
14907503000,382.13765,16312126425,393883109,16312123916,-2509,,
14907553445,382.18809,16312176872,393933550,16312174357,-2515,,
14907604051,382.23870,16312227481,393984155,16312224962,-2519,,
14907654215,382.28886,16312277648,394034316,16312275122,-2526,,
14907705255,382.33990,16312328689,394085353,16312326170,-2519,,
14907755815,382.39046,16312379252,394135912,16312376718,-2534,,
14907806369,382.44102,16312429810,394186464,16312427270,-2540,,
14907857401,382.49205,16312480843,394237492,16312478298,-2545,,
14907908444,382.54309,16312531888,394288531,16312529337,-2551,,
14907959501,382.59415,16312582948,394339587,16312580393,-2555,,
14908010091,382.64474,16312633540,394390173,16312630980,-2560,,
14908061132,382.69578,16312684582,394441211,16312682017,-2565,,
14908111700,382.74635,16312735153,394491777,16312732583,-2570,,
14908162309,382.79696,16312785764,394542383,16312783189,-2575,,
14908212463,382.84711,16312835921,394592534,16312833340,-2581,,
14908262861,382.89751,16312886321,394642929,16312883735,-2586,,
14908313091,382.94774,16312936553,394693157,16312933963,-2590,,
14908363526,382.99817,16312986992,394743589,16312984395,-2597,,
14908414549,383.04920,16313038017,394794609,16313035415,-2602,,
14908465152,383.09980,16313088622,394845211,16313086017,-2605,,
14908515501,383.15015,16313138974,394895556,16313136363,-2611,,
14908566571,383.20122,16313190046,394946624,16313187431,-2615,,
14908617128,383.25178,16313240605,394997178,16313237985,-2620,,
14908667647,383.30230,16313291127,395047694,16313288501,-2626,,
14908718554,383.35320,16313342036,395098599,16313339405,-2631,,
14908769077,383.40373,16313392561,395149119,16313389925,-2636,,
14908820107,383.45475,16313443594,395200147,16313440953,-2641,,
14908871194,383.50584,16313494688,395251236,16313492042,-2646,,
14908921735,383.55638,16313545227,395301768,16313542575,-2652,,
14908972761,383.60741,16313596255,395352791,16313593598,-2657,,
14909023490,383.65814,16313646986,395403518,16313644325,-2661,,
14909074102,383.70875,16313697601,395454127,16313694934,-2667,,
14909125015,383.75966,16313748515,395505037,16313745843,-2672,,
14909176030,383.81068,16313799533,395556050,16313796857,-2676,,
14909226782,383.86143,16313850288,395606800,16313847606,-2682,,
14909277316,383.91196,16313900823,395657330,16313898136,-2687,,
14909327492,383.96214,16313951002,395707505,16313948311,-2691,,
14909378040,384.01269,16314001553,395758050,16313998856,-2697,,
14909429088,384.06374,16314052602,395809094,16314049901,-2701,,
14909479693,384.11434,16314103210,395859696,16314100503,-2707,,
14909530300,384.16495,16314153820,395910301,16314151108,-2712,,
14909580865,384.21551,16314204387,395960863,16314201670,-2717,,
14909631493,384.26614,16314255018,396011489,16314252295,-2723,,
14909681996,384.31664,16314305523,396061989,16314302796,-2727,,
14909733069,384.36772,16314356598,396113059,16314353866,-2732,,
14909784098,384.41875,16314407629,396164085,16314404891,-2738,,
14909834717,384.46936,16314458250,396214701,16314455507,-2743,,
14909884801,384.51945,16314508337,396264783,16314505590,-2747,,
14909935356,384.57000,16314558894,396315335,16314556142,-2752,,
14909985924,384.62057,16314609465,396365901,16314606707,-2758,,
14910036515,384.67116,16314660057,396416489,16314657295,-2762,,
14910086634,384.72128,16314710180,396466606,16314707412,-2768,,
14910137202,384.77185,16314760761,396517182,16314757989,-2772,,
14910188161,384.82281,16314811711,396568127,16314808933,-2778,,
14910239228,384.87388,16314862781,396619191,16314859998,-2783,,
14910290281,384.92493,16314913835,396670240,16314911047,-2788,,
14910341468,384.97612,16314965026,396721426,16314962232,-2794,,
14910391868,385.02652,16315015428,396771824,16315012630,-2798,,
14910442900,385.07755,16315066462,396822852,16315063659,-2803,,
14910493460,385.12811,16315117025,396873409,16315114215,-2810,,
14910544526,385.17917,16315168093,396924472,16315165279,-2814,,
14910595501,385.23015,16315219069,396975445,16315216252,-2817,,
14910646102,385.28075,16315269673,397026043,16315266849,-2824,,
14910696678,385.33133,16315320251,397076615,16315317422,-2829,,
14910747722,385.38237,16315371297,397127658,16315368465,-2832,,
14910797894,385.43254,16315421473,397177827,16315418634,-2839,,
14910848045,385.48269,16315471626,397227975,16315468782,-2844,,
14910899112,385.53376,16315522694,397279039,16315519846,-2848,,
14910950164,385.58481,16315573749,397330089,16315570895,-2854,,
14911000309,385.63496,16315623896,397380231,16315621037,-2859,,
14911050614,385.68526,16315674205,397430533,16315671340,-2865,,
14911100989,385.73564,16315724582,397480907,16315721713,-2869,,
14911151517,385.78616,16315775112,397531431,16315772238,-2874,,
14911201744,385.83639,16315825342,397581655,16315822461,-2881,,
14911252321,385.88697,16315875920,397632230,16315873036,-2884,,
14911303374,385.93802,16315926976,397683280,16315924087,-2889,,
14911353948,385.98860,16315977553,397733852,16315974658,-2895,,
14911405002,386.03965,16316028609,397784903,16316025710,-2899,,
14911455540,386.09019,16316079159,397835449,16316076256,-2903,,
14911506186,386.14083,16316129798,397886082,16316126889,-2909,,
14911556642,386.19129,16316180268,397936546,16316177353,-2915,,
14911607240,386.24189,16316230867,397987141,16316227948,-2919,,
14911658310,386.29296,16316281929,398038197,16316279004,-2925,,
14911709369,386.34402,16316332990,398089254,16316330060,-2930,,
14911760359,386.39501,16316383983,398140240,16316381047,-2936,,
14911810946,386.44559,16316434583,398190837,16316431643,-2940,,
14911861724,386.49637,16316485352,398241601,16316482407,-2945,,
14911912825,386.54747,16316536455,398292698,16316533504,-2951,,
14911963823,386.59847,16316587455,398343693,16316584499,-2956,,
14912014397,386.64905,16316638032,398394265,16316635072,-2960,,
14912065422,386.70007,16316689070,398445298,16316686105,-2965,,
14912116469,386.75112,16316740109,398496331,16316737137,-2972,,
14912167081,386.80173,16316790723,398546942,16316787758,-2965,,
14912217692,386.85234,16316841337,398597550,16316838366,-2971,,
14912267834,386.90248,16316891481,398647688,16316888494,-2987,,
14912318070,386.95272,16316941718,398697922,16316938728,-2990,,
14912368650,387.00330,16316992301,398748499,16316989306,-2995,,
14912418721,387.05337,16317042374,398798567,16317039373,-3001,,
14912469305,387.10395,16317092961,398849149,16317089955,-3006,,
14912519825,387.15447,16317143484,398899666,16317140473,-3011,,
14912570420,387.20507,16317194081,398950259,16317191066,-3015,,
14912621421,387.25607,16317245085,399001268,16317242074,-3011,,
14912671974,387.30662,16317295640,399051807,16317292614,-3026,,
14912722525,387.35717,16317346193,399102356,16317343162,-3031,,
14912773528,387.40818,16317397198,399153355,16317394161,-3037,,
14912824089,387.45874,16317447762,399203913,16317444720,-3042,,
14912875145,387.50979,16317498820,399254967,16317495774,-3046,,
14912925270,387.55992,16317548948,399305090,16317545897,-3051,,
14912976243,387.61089,16317599923,399356059,16317596866,-3057,,
14913027257,387.66190,16317650938,399407071,16317647878,-3060,,
14913077827,387.71247,16317701512,399457638,16317698445,-3067,,
14913128389,387.76304,16317752076,399508197,16317749003,-3073,,
14913178971,387.81362,16317802659,399558776,16317799582,-3077,,
14913229493,387.86414,16317853185,399609297,16317850103,-3082,,
14913280565,387.91521,16317904259,399660365,16317901172,-3087,,
14913331101,387.96575,16317954797,399710898,16317951704,-3093,,
14913382170,388.01682,16318005869,399761965,16318002772,-3097,,
14913432746,388.06739,16318056446,399812538,16318053344,-3102,,
14913483560,388.11821,16318107264,399863350,16318104156,-3108,,
14913534589,388.16924,16318158294,399914375,16318155181,-3113,,
14913585124,388.21977,16318208832,399964908,16318205715,-3117,,
14913635773,388.27042,16318259484,400015555,16318256361,-3123,,
14913686174,388.32082,16318309899,400065964,16318306771,-3128,,
14913737266,388.37191,16318360993,400117054,16318357861,-3132,,
14913787899,388.42255,16318411617,400167673,16318408480,-3137,,
14913838877,388.47352,16318462597,400218648,16318459454,-3143,,
14913889312,388.52396,16318513034,400269079,16318509885,-3149,,
14913939822,388.57447,16318563547,400319598,16318560405,-3142,,
14913990864,388.62551,16318614591,400370627,16318611433,-3158,,
14914041454,388.67610,16318665184,400421213,16318662020,-3164,,
14914092087,388.72674,16318715819,400471845,16318712651,-3168,,
14914142627,388.77727,16318766361,400522382,16318763188,-3173,,
14914193689,388.82834,16318817425,400573440,16318814246,-3179,,
14914244237,388.87889,16318867976,400623985,16318864792,-3184,,
14914294783,388.92943,16318918524,400674530,16318915336,-3188,,
14914345658,388.98031,16318969402,400725401,16318966208,-3194,,
14914396261,389.03091,16319020007,400776001,16319016808,-3199,,
14914446801,389.08145,16319070549,400826539,16319067346,-3203,,
14914497409,389.13206,16319121160,400877145,16319117951,-3209,,
14914547507,389.18216,16319171260,400927240,16319168046,-3214,,
14914598091,389.23274,16319221846,400977822,16319218628,-3218,,
14914648216,389.28286,16319271974,401027943,16319268750,-3224,,
14914699264,389.33391,16319323023,401078988,16319319795,-3228,,
14914750311,389.38496,16319374074,401130033,16319370839,-3235,,
14914800869,389.43552,16319424633,401180587,16319421394,-3239,,
14914852005,389.48665,16319475772,401231722,16319472528,-3244,,
14914902579,389.53723,16319526349,401282292,16319523099,-3250,,
14914953589,389.58824,16319577361,401333300,16319574106,-3255,,
14915004691,389.63934,16319628465,401384399,16319625206,-3259,,
14915055688,389.69034,16319679464,401435393,16319676199,-3265,,
14915105869,389.74052,16319729647,401485571,16319726377,-3270,,
14915156412,389.79106,16319780192,401536112,16319776918,-3274,,
14915207464,389.84211,16319831247,401587161,16319827967,-3280,,
14915258508,389.89316,16319882294,401638203,16319879009,-3285,,
14915309521,389.94417,16319933310,401689212,16319930019,-3291,,
14915359606,389.99425,16319983397,401739295,16319980102,-3295,,
14915410417,390.04507,16320034209,401790103,16320030909,-3300,,
14915461063,390.09571,16320084859,401840746,16320081563,-3296,,
14915511630,390.14628,16320135428,401891311,16320132117,-3311,,
14915561715,390.19636,16320185515,401941393,16320182200,-3315,,
14915612342,390.24699,16320236145,401992017,16320232824,-3321,,
14915663390,390.29804,16320287195,402043064,16320283870,-3325,,
14915714443,390.34909,16320338249,402094113,16320334920,-3329,,
14915765018,390.39967,16320388839,402144696,16320385503,-3336,,
14915816084,390.45073,16320439896,402195748,16320436555,-3341,,
14915867139,390.50179,16320490952,402246801,16320487607,-3345,,
14915917654,390.55230,16320541471,402297313,16320538120,-3351,,
14915968203,390.60285,16320592021,402347859,16320588665,-3356,,
14916018774,390.65342,16320642596,402398428,16320639234,-3362,,
14916069361,390.70401,16320693185,402449012,16320689819,-3366,,
14916120358,390.75501,16320744184,402500007,16320740813,-3371,,
14916170825,390.80547,16320794653,402550470,16320791276,-3377,,
14916221139,390.85579,16320844970,402600783,16320841589,-3381,,
14916271726,390.90637,16320895559,402651367,16320892173,-3386,,
14916322807,390.95745,16320946642,402702444,16320943250,-3392,,
14916373818,391.00847,16320997656,402753454,16320994260,-3396,,
14916423927,391.05858,16321047766,402803559,16321044365,-3401,,
14916474544,391.10919,16321098387,402854173,16321094980,-3407,,
14916525166,391.15981,16321149011,402904792,16321145599,-3412,,
14916576243,391.21089,16321200090,402955867,16321196673,-3417,,
14916627275,391.26192,16321251125,403006896,16321247703,-3422,,
14916678238,391.31289,16321302090,403057857,16321298664,-3426,,
14916728888,391.36354,16321352742,403108504,16321349311,-3431,,
14916779934,391.41458,16321403791,403159548,16321400354,-3437,,
14916830317,391.46497,16321454176,403209927,16321450734,-3442,,
14916881365,391.51601,16321505226,403260972,16321501778,-3448,,
14916931943,391.56659,16321555806,403311548,16321552354,-3452,,
14916982939,391.61759,16321606805,403362541,16321603348,-3457,,
14917033560,391.66821,16321657428,403413159,16321653965,-3463,,
14917084202,391.71885,16321708073,403463799,16321704606,-3467,,
14917135220,391.76987,16321759093,403514814,16321755620,-3473,,
14917186271,391.82092,16321810147,403565862,16321806669,-3478,,
14917236850,391.87150,16321860728,403616439,16321857245,-3483,,
14917286963,391.92161,16321910842,403666549,16321907355,-3487,,
14917337605,391.97225,16321961488,403717188,16321957995,-3493,,
14917388017,392.02267,16322011902,403767598,16322008404,-3498,,
14917438104,392.07275,16322061992,403817682,16322058489,-3503,,
14917488709,392.12336,16322112598,403868294,16322109100,-3498,,
14917539777,392.17442,16322163669,403919349,16322160156,-3513,,
14917590625,392.22527,16322214520,403970194,16322211001,-3519,,
14917640720,392.27537,16322264617,404020287,16322261094,-3523,,
14917690835,392.32548,16322314733,404070399,16322311205,-3528,,
14917741353,392.37600,16322365254,404120914,16322361720,-3534,,
14917792409,392.42706,16322416313,404171968,16322412785,-3528,,
14917842968,392.47762,16322466874,404222524,16322463331,-3543,,
14917894031,392.52868,16322517940,404273585,16322514391,-3549,,
14917945055,392.57970,16322568966,404324606,16322565412,-3554,,
14917996130,392.63078,16322620043,404375679,16322616485,-3558,,
14918047153,392.68180,16322671069,404426699,16322667505,-3564,,
14918098230,392.73288,16322722148,404477773,16322718579,-3569,,
14918149266,392.78391,16322773186,404528806,16322769612,-3574,,
14918199796,392.83444,16322823719,404579333,16322820140,-3579,,
14918250419,392.88507,16322874344,404629953,16322870760,-3584,,
14918301469,392.93612,16322925397,404681000,16322921806,-3591,,
14918352541,392.98719,16322976471,404732071,16322972877,-3594,,
14918403616,393.03826,16323027547,404783142,16323023948,-3599,,
14918454628,393.08928,16323078563,404834151,16323074958,-3605,,
14918505712,393.14036,16323129648,404885232,16323126038,-3610,,
14918556762,393.19141,16323180702,404936281,16323177087,-3615,,
14918607346,393.24199,16323231288,404986861,16323227667,-3621,,
14918657912,393.29256,16323281856,405037425,16323278231,-3625,,
14918708318,393.34297,16323332265,405087829,16323328635,-3630,,
14918758935,393.39358,16323382883,405138442,16323379248,-3635,,
14918809981,393.44463,16323433932,405189486,16323430292,-3640,,
14918860604,393.49525,16323484558,405240106,16323480912,-3646,,
14918911206,393.54585,16323535162,405290705,16323531522,-3640,,
14918962278,393.59693,16323586236,405341774,16323582580,-3656,,
14919012910,393.64756,16323636870,405392403,16323633209,-3661,,
14919063496,393.69814,16323687459,405442988,16323683794,-3665,,
14919114111,393.74876,16323738075,405493598,16323734405,-3670,,
14919165114,393.79976,16323789082,405544600,16323785406,-3676,,
14919216118,393.85077,16323840088,405595611,16323836418,-3670,,
14919267164,393.90181,16323891149,405646657,16323887463,-3686,,
14919318221,393.95287,16323942196,405697698,16323938505,-3691,,
14919368813,394.00346,16323992790,405748288,16323989094,-3696,,
14919419306,394.05395,16324043286,405798778,16324039585,-3701,,
14919469880,394.10453,16324093861,405849349,16324090155,-3706,,
14919520405,394.15505,16324144389,405899871,16324140677,-3712,,
14919570988,394.20564,16324194975,405950451,16324191258,-3717,,
14919622038,394.25669,16324246026,406001499,16324242305,-3721,,
14919672650,394.30730,16324296640,406052108,16324292914,-3726,,
14919723197,394.35784,16324347190,406102652,16324343458,-3732,,
14919773770,394.40842,16324397775,406153233,16324394039,-3736,,
14919824823,394.45947,16324448821,406204273,16324445079,-3742,,
14919875205,394.50985,16324499206,406254653,16324495459,-3747,,
14919925805,394.56045,16324549808,406305250,16324546057,-3751,,
14919976378,394.61103,16324600383,406355830,16324596637,-3746,,
14920026945,394.66159,16324650953,406406384,16324647191,-3762,,
14920077898,394.71255,16324701908,406457334,16324698141,-3767,,
14920128515,394.76316,16324752528,406507949,16324748756,-3772,,
14920179122,394.81377,16324803136,406558553,16324799359,-3777,,
14920229299,394.86395,16324853315,406608727,16324849533,-3782,,
14920279849,394.91450,16324903869,406659276,16324900082,-3787,,
14920330852,394.96550,16324954874,406710275,16324951082,-3792,,
14920380945,395.01559,16325004969,406760365,16325001172,-3797,,
14920431567,395.06621,16325055593,406810984,16325051790,-3803,,
14920482182,395.11683,16325106211,406861597,16325102404,-3807,,
14920533232,395.16788,16325157263,406912644,16325153450,-3813,,
14920583780,395.21843,16325207814,406963189,16325203995,-3819,,
14920634434,395.26908,16325258469,407013841,16325254648,-3821,,
14920684991,395.31964,16325309029,407064395,16325305201,-3828,,
14920735598,395.37025,16325359639,407114999,16325355806,-3833,,
14920786647,395.42129,16325410689,407166045,16325406851,-3838,,
14920837651,395.47230,16325461697,407217048,16325457854,-3843,,
14920888244,395.52289,16325512292,407267637,16325508444,-3848,,
14920939273,395.57392,16325563323,407318663,16325559469,-3854,,
14920990382,395.62503,16325614434,407369769,16325610576,-3858,,
14921041448,395.67610,16325665503,407420833,16325661639,-3864,,
14921092496,395.72714,16325716562,407471888,16325712695,-3867,,
14921142669,395.77732,16325766729,407522048,16325762854,-3875,,
14921193272,395.82792,16325817334,407572650,16325813456,-3878,,
14921243877,395.87853,16325867941,407623251,16325864069,-3872,,
14921294478,395.92913,16325918557,407673861,16325914668,-3889,,
14921344589,395.97924,16325968657,407723958,16325964764,-3893,,
14921395627,396.03028,16326019699,407774993,16326015800,-3899,,
14921446290,396.08094,16326070363,407825653,16326066459,-3904,,
14921497316,396.13196,16326121392,407876686,16326117492,-3900,,
14921548210,396.18286,16326172288,407927568,16326168374,-3914,,
14921598758,396.23341,16326222839,407978114,16326218920,-3919,,
14921649350,396.28400,16326273433,408028702,16326269509,-3924,,
14921699473,396.33412,16326323559,408078823,16326319630,-3929,,
14921750522,396.38517,16326374610,408129869,16326370676,-3934,,
14921801537,396.43619,16326425627,408180881,16326421688,-3939,,
14921852142,396.48679,16326476235,408231483,16326472290,-3945,,
14921902713,396.53736,16326526817,408282062,16326522868,-3949,,
14921953337,396.58799,16326577434,408332673,16326573480,-3954,,
14922004370,396.63902,16326628470,408383703,16326624510,-3960,,
14922055400,396.69005,16326679502,408434731,16326675547,-3955,,
14922106499,396.74115,16326730604,408485827,16326726633,-3971,,
14922157049,396.79170,16326781156,408536375,16326777181,-3975,,
14922207658,396.84231,16326831767,408586980,16326827786,-3981,,
14922257831,396.89248,16326881943,408637151,16326877957,-3986,,
14922308379,396.94303,16326932503,408687706,16326928513,-3990,,
14922359016,396.99366,16326983131,408738341,16326979147,-3984,,
14922410086,397.04473,16327034205,408789399,16327030205,-4000,,
14922460612,397.09526,16327084733,408839931,16327080738,-3995,,
14922511667,397.14632,16327135790,408890973,16327131780,-4010,,
14922562256,397.19690,16327186382,408941559,16327182366,-4016,,
14922613306,397.24795,16327237434,408992607,16327233414,-4020,,
14922663424,397.29807,16327287554,409042722,16327283528,-4026,,
14922713962,397.34861,16327338095,409093257,16327334064,-4031,,
14922765042,397.39969,16327389176,409144335,16327385141,-4035,,
14922816121,397.45077,16327440259,409195411,16327436217,-4042,,
14922866748,397.50140,16327490887,409246035,16327486841,-4046,,
14922917784,397.55243,16327541926,409297069,16327537875,-4051,,
14922968867,397.60352,16327593012,409348150,16327588956,-4056,,
14923019915,397.65456,16327644061,409399194,16327640000,-4061,,
14923070452,397.70510,16327694601,409449729,16327690535,-4066,,
14923120596,397.75524,16327744747,409499870,16327740677,-4070,,
14923170693,397.80534,16327794847,409549964,16327790780,-4067,,
14923220823,397.85547,16327844979,409600091,16327840898,-4081,,
14923271192,397.90584,16327895351,409650459,16327891265,-4086,,
14923321444,397.95609,16327945604,409700707,16327941514,-4090,,
14923372488,398.00714,16327996651,409751748,16327992555,-4096,,
14923423036,398.05768,16328047202,409802293,16328043100,-4102,,
14923473119,398.10777,16328097287,409852374,16328093180,-4107,,
14923523652,398.15830,16328147823,409902904,16328143720,-4103,,
14923574223,398.20887,16328198396,409953472,16328194278,-4118,,
14923624899,398.25955,16328249074,410004147,16328244953,-4121,,
14923675958,398.31061,16328300136,410055203,16328296009,-4127,,
14923726431,398.36108,16328350622,410105683,16328346490,-4132,,
14923776978,398.41163,16328401159,410156216,16328397023,-4136,,
14923828027,398.46267,16328452212,410207263,16328448070,-4142,,
14923878725,398.51337,16328502912,410257958,16328498765,-4147,,
14923929349,398.56400,16328553537,410308579,16328549385,-4152,,
14923979510,398.61416,16328603701,410358738,16328599544,-4157,,
14924030003,398.66465,16328654197,410409228,16328650034,-4163,,
14924081084,398.71573,16328705280,410460307,16328701113,-4167,,
14924132120,398.76677,16328756319,410511339,16328752146,-4173,,
14924182300,398.81695,16328806500,410561517,16328802333,-4167,,
14924232922,398.86757,16328857125,410612136,16328852943,-4182,,
14924283067,398.91771,16328907273,410662278,16328903084,-4189,,
14924333817,398.96846,16328958025,410713027,16328953833,-4192,,
14924384835,399.01948,16329009045,410764041,16329004847,-4198,,
14924435448,399.07010,16329059661,410814651,16329055457,-4204,,
14924485592,399.12024,16329109807,410864793,16329105599,-4208,,
14924536175,399.17082,16329160392,410915372,16329156179,-4213,,
14924586803,399.22145,16329211022,410965998,16329206804,-4218,,
14924637322,399.27197,16329261544,411016514,16329257321,-4223,,
14924687964,399.32261,16329312189,411067154,16329307961,-4228,,
14924738513,399.37316,16329362739,411117700,16329358506,-4233,,
14924789562,399.42421,16329413790,411168746,16329409552,-4238,,
14924840611,399.47526,16329464842,411219793,16329460599,-4243,,
14924891659,399.52631,16329515893,411270839,16329511645,-4248,,
14924942707,399.57736,16329566943,411321883,16329562690,-4253,,
14924993236,399.62788,16329617475,411372410,16329613226,-4249,,
14925044309,399.67896,16329668550,411423480,16329664287,-4263,,
14925095359,399.73001,16329719603,411474527,16329715334,-4269,,
14925145988,399.78064,16329770234,411525154,16329765960,-4274,,
14925196982,399.83163,16329821230,411576144,16329816951,-4279,,
14925247587,399.88223,16329871838,411626748,16329867554,-4284,,
14925298195,399.93284,16329922447,411677352,16329918158,-4289,,
14925348345,399.98299,16329972600,411727500,16329968307,-4293,,
14925398877,400.03352,16330023135,411778029,16330018836,-4299,,
14925449411,400.08406,16330073671,411828560,16330069366,-4305,,
14925499535,400.13418,16330123797,411878681,16330119487,-4310,,
14925550133,400.18478,16330174398,411929277,16330170084,-4314,,
14925600651,400.23530,16330224918,411979792,16330220599,-4319,,
14925650816,400.28546,16330275085,412029955,16330270761,-4324,,
14925701343,400.33599,16330325625,412080490,16330321297,-4328,,
14925752122,400.38677,16330376396,412131256,16330372062,-4334,,
14925802751,400.43740,16330427026,412181881,16330422688,-4338,,
14925853292,400.48794,16330477583,412232431,16330473238,-4345,,
14925904291,400.53894,16330528573,412283418,16330524224,-4349,,
14925954899,400.58955,16330579183,412334022,16330574828,-4355,,
14926005872,400.64052,16330630157,412384991,16330625797,-4360,,
14926056429,400.69108,16330680717,412435546,16330676353,-4364,,
14926106482,400.74113,16330730772,412485596,16330726402,-4370,,
14926157040,400.79169,16330781332,412536151,16330776957,-4375,,
14926208080,400.84273,16330832375,412587189,16330827995,-4380,,
14926259176,400.89382,16330883474,412638283,16330879089,-4385,,
14926310236,400.94488,16330934536,412689340,16330930146,-4390,,
14926361258,400.99591,16330985560,412740359,16330981165,-4395,,
14926412312,401.04696,16331036618,412791411,16331032217,-4401,,
14926463345,401.09799,16331087652,412842441,16331083247,-4405,,
14926513931,401.14858,16331138241,412893024,16331133830,-4411,,
14926564930,401.19958,16331189241,412944019,16331184825,-4416,,
14926615561,401.25021,16331239875,412994648,16331235455,-4420,,
14926666105,401.30075,16331290421,413045189,16331285996,-4425,,
14926717131,401.35178,16331341449,413096212,16331337018,-4431,,
14926767800,401.40245,16331392121,413146878,16331387685,-4436,,
14926818370,401.45302,16331442694,413197447,16331438253,-4441,,
14926869451,401.50410,16331493777,413248525,16331489331,-4446,,
14926919979,401.55463,16331544318,413299061,16331539868,-4450,,
14926971051,401.60570,16331595382,413350120,16331590926,-4456,,
14927021190,401.65584,16331645523,413400255,16331641062,-4461,,
14927071906,401.70655,16331696241,413450969,16331691776,-4465,,
14927122490,401.75714,16331746828,413501549,16331742356,-4472,,
14927173057,401.80770,16331797396,413552114,16331792920,-4476,,
14927224128,401.85878,16331848471,413603183,16331843989,-4482,,
14927275200,401.90985,16331899544,413654251,16331895057,-4487,,
14927325382,401.96003,16331949729,413704431,16331945238,-4491,,
14927376442,402.01109,16332000791,413755488,16331996295,-4496,,
14927427443,402.06209,16332051794,413806486,16332047292,-4502,,
14927477989,402.11264,16332102342,413857029,16332097836,-4506,,
14927528139,402.16279,16332152496,413907189,16332147995,-4501,,
14927578791,402.21344,16332203149,413957826,16332198633,-4516,,
14927629719,402.26437,16332254079,414008751,16332249557,-4522,,
14927679751,402.31440,16332304115,414058781,16332299588,-4527,,
14927730335,402.36498,16332354701,414109362,16332350169,-4532,,
14927780929,402.41558,16332405297,414159953,16332400760,-4537,,
14927831493,402.46614,16332455863,414210515,16332451321,-4542,,
14927882507,402.51716,16332506880,414261527,16332502333,-4547,,
14927932841,402.56749,16332557217,414311857,16332552664,-4553,,
14927983386,402.61803,16332607764,414362399,16332603206,-4558,,
14928033542,402.66819,16332657922,414412553,16332653360,-4562,,
14928084168,402.71882,16332708551,414463176,16332703983,-4568,,
14928134728,402.76938,16332759113,414513734,16332754540,-4573,,
14928185742,402.82039,16332810129,414564745,16332805563,-4566,,
14928236795,402.87144,16332861185,414615795,16332856602,-4583,,
14928287858,402.92251,16332912249,414666855,16332907673,-4576,,
14928338423,402.97307,16332962817,414717418,16332958224,-4593,,
14928389036,403.02368,16333013433,414768029,16333008835,-4598,,
14928439598,403.07425,16333063997,414818588,16333059394,-4603,,
14928490173,403.12482,16333114574,414869159,16333109966,-4608,,
14928540687,403.17534,16333165091,414919672,16333160478,-4613,,
14928590835,403.22548,16333215241,414969816,16333210623,-4618,,
14928641387,403.27603,16333265795,415020365,16333261172,-4623,,
14928692434,403.32708,16333316845,415071410,16333312216,-4629,,
14928743015,403.37766,16333367428,415121988,16333362795,-4633,,
14928794031,403.42868,16333418447,415173002,16333413808,-4639,,
14928844589,403.47924,16333469018,415223567,16333464374,-4644,,
14928895174,403.52982,16333519593,415274151,16333514958,-4635,,
14928946202,403.58085,16333570624,415325164,16333565970,-4654,,
14928996367,403.63101,16333620792,415375327,16333616133,-4659,,
14929047006,403.68165,16333671433,415425963,16333666770,-4663,,
14929097984,403.73263,16333722413,415476938,16333717744,-4669,,
14929148169,403.78282,16333772601,415527120,16333767926,-4675,,
14929199220,403.83387,16333823653,415578168,16333818974,-4679,,
14929249794,403.88444,16333874231,415628741,16333869547,-4684,,
14929300232,403.93488,16333924671,415679175,16333919981,-4690,,
14929350322,403.98497,16333974763,415729262,16333970069,-4694,,
14929400467,404.03512,16334024910,415779405,16334020211,-4699,,
14929450972,404.08562,16334075417,415829907,16334070713,-4704,,
14929502040,404.13669,16334126488,415880973,16334121779,-4709,,
14929553094,404.18774,16334177545,415932024,16334172830,-4715,,
14929603262,404.23791,16334227715,415982189,16334222996,-4719,,
14929653867,404.28852,16334278323,416032791,16334273598,-4725,,
14929704395,404.33904,16334328864,416083327,16334324134,-4730,,
14929755027,404.38968,16334379487,416133949,16334374757,-4730,,
14929805798,404.44045,16334430260,416184714,16334425520,-4740,,
14929855938,404.49059,16334480402,416234851,16334475657,-4745,,
14929906964,404.54161,16334531431,416285876,16334526682,-4749,,
14929958007,404.59265,16334582477,416336916,16334577722,-4755,,
14930009043,404.64369,16334633514,416387948,16334628754,-4760,,
14930059596,404.69424,16334684069,416438498,16334679304,-4765,,
14930109648,404.74430,16334734125,416488549,16334729355,-4770,,
14930159741,404.79439,16334784220,416538638,16334779445,-4775,,
14930210258,404.84491,16334834738,416589152,16334829958,-4780,,
14930261296,404.89594,16334885780,416640188,16334880995,-4785,,
14930312362,404.94701,16334936847,416691251,16334932057,-4790,,
14930363389,404.99804,16334987878,416742275,16334983082,-4796,,
14930413959,405.04861,16335038450,416792842,16335033649,-4801,,
14930465007,405.09965,16335089500,416843889,16335084695,-4805,,
14930515433,405.15008,16335139928,416894311,16335135117,-4811,,
14930566275,405.20092,16335190773,416945150,16335185957,-4816,,
14930617336,405.25198,16335241836,416996210,16335237016,-4820,,
14930668377,405.30302,16335292880,417047248,16335288054,-4826,,
14930719418,405.35407,16335343923,417098285,16335339091,-4832,,
14930770045,405.40469,16335394552,417148909,16335389715,-4837,,
14930821078,405.45573,16335445588,417199940,16335440747,-4841,,
14930871727,405.50637,16335496239,417250587,16335491393,-4846,,
14930921911,405.55656,16335546426,417300768,16335541574,-4852,,
14930972463,405.60711,16335596980,417351317,16335592124,-4856,,
14931023486,405.65813,16335648005,417402337,16335643144,-4861,,
14931074534,405.70918,16335699056,417453382,16335694188,-4868,,
14931125133,405.75978,16335749657,417503978,16335744784,-4873,,
14931175750,405.81040,16335800276,417554593,16335795400,-4876,,
14931226539,405.86119,16335851067,417605379,16335846185,-4882,,
14931277391,405.91204,16335901921,417656227,16335897044,-4877,,
14931327513,405.96216,16335952045,417706348,16335947155,-4890,,
14931378560,406.01321,16336003095,417757392,16335998198,-4897,,
14931429371,406.06402,16336053909,417808201,16336049007,-4902,,
14931479918,406.11457,16336104458,417858744,16336099550,-4908,,
14931530554,406.16520,16336155096,417909378,16336150184,-4912,,
14931580609,406.21526,16336205154,417959430,16336200237,-4917,,
14931630656,406.26530,16336255203,418009474,16336250281,-4922,,
14931681290,406.31594,16336305840,418060107,16336300913,-4927,,
14931731871,406.36652,16336356423,418110684,16336351491,-4932,,
14931782880,406.41753,16336407434,418161690,16336402496,-4938,,
14931833500,406.46815,16336458057,418212308,16336453114,-4943,,
14931884505,406.51915,16336509064,418263310,16336504117,-4947,,
14931935078,406.56973,16336559650,418313891,16336554697,-4953,,
14931985698,406.62035,16336610261,418364497,16336605303,-4958,,
14932036149,406.67080,16336660715,418414946,16336655753,-4962,,
14932086741,406.72139,16336711309,418465535,16336706341,-4968,,
14932137351,406.77200,16336761922,418516143,16336756949,-4973,,
14932187881,406.82253,16336812464,418566679,16336807486,-4978,,
14932238508,406.87316,16336863083,418617294,16336858100,-4983,,
14932289411,406.92406,16336913988,418668194,16336909000,-4988,,
14932340438,406.97509,16336965018,418719219,16336960025,-4993,,
14932390783,407.02543,16337015377,418769572,16337010379,-4998,,
14932441664,407.07631,16337066249,418820439,16337061246,-5003,,
14932492265,407.12691,16337116853,418871037,16337111844,-5009,,
14932542796,407.17744,16337167397,418921577,16337162384,-5013,,
14932593341,407.22799,16337217933,418972109,16337212915,-5018,,
14932643949,407.27860,16337268543,419022713,16337263520,-5023,,
14932694964,407.32961,16337319560,419073725,16337314531,-5029,,
14932745584,407.38023,16337370183,419124343,16337365150,-5033,,
14932796605,407.43125,16337421206,419175361,16337416168,-5038,,
14932847147,407.48179,16337471751,419225900,16337466707,-5044,,
14932898207,407.53285,16337522813,419276957,16337517764,-5049,,
14932948795,407.58344,16337573403,419327543,16337568349,-5054,,
14932999793,407.63444,16337624404,419378538,16337619345,-5059,,
14933050854,407.68550,16337675478,419429607,16337670414,-5064,,
14933101390,407.73604,16337726005,419480130,16337720937,-5068,,
14933151937,407.78659,16337776555,419530675,16337771481,-5074,,
14933202485,407.83713,16337827106,419581220,16337822026,-5080,,
14933253046,407.88769,16337877679,419631788,16337872594,-5085,,
14933304084,407.93873,16337928720,419682824,16337923631,-5089,,
14933354725,407.98937,16337979353,419733451,16337974258,-5095,,
14933405767,408.04041,16338030396,419784490,16338025296,-5100,,
14933456316,408.09096,16338080947,419835037,16338075843,-5104,,
14933506859,408.14151,16338131494,419885577,16338126384,-5110,,
14933557393,408.19204,16338182030,419936108,16338176915,-5115,,
14933608009,408.24266,16338232647,419986722,16338227529,-5118,,
14933659045,408.29369,16338283687,420037755,16338278562,-5125,,
14933709632,408.34428,16338334276,420088340,16338329147,-5129,,
14933759909,408.39456,16338384566,420138624,16338379431,-5135,,
14933810916,408.44556,16338435565,420189618,16338430425,-5140,,
14933861555,408.49620,16338486205,420240254,16338481060,-5145,,
14933912602,408.54725,16338537256,420291299,16338532105,-5151,,
14933963418,408.59807,16338588073,420342111,16338582917,-5156,,
14934014473,408.64912,16338639131,420393165,16338633971,-5160,,
14934065004,408.69965,16338689665,420443693,16338684502,-5163,,
14934116066,408.75071,16338740728,420494751,16338735557,-5171,,
14934166614,408.80126,16338791278,420545296,16338786103,-5175,,
14934217167,408.85181,16338841834,420595847,16338836653,-5181,,
14934267797,408.90245,16338892466,420646474,16338887280,-5186,,
14934318302,408.95295,16338942974,420696977,16338937783,-5191,,
14934368862,409.00351,16338993537,420747535,16338988341,-5196,,
14934419313,409.05396,16339043990,420797982,16339038789,-5201,,
14934470320,409.10497,16339095000,420848987,16339089793,-5207,,
14934520858,409.15551,16339145540,420899522,16339140328,-5212,,
14934571343,409.20599,16339196027,420950005,16339190811,-5216,,
14934621951,409.25660,16339246638,421000609,16339241416,-5222,,
14934673000,409.30765,16339297689,421051656,16339292463,-5226,,
14934724065,409.35871,16339348756,421102718,16339343525,-5231,,
14934774712,409.40936,16339399416,421153372,16339394178,-5238,,
14934825666,409.46031,16339450362,421204313,16339445120,-5242,,
14934876231,409.51088,16339500929,421254876,16339495683,-5246,,
14934927308,409.56196,16339552009,421305951,16339546757,-5252,,
14934977845,409.61249,16339602548,421356485,16339597291,-5257,,
14935028912,409.66356,16339653617,421407548,16339648355,-5262,,
14935079970,409.71462,16339704678,421458604,16339699411,-5267,,
14935130581,409.76523,16339755291,421509212,16339750019,-5272,,
14935180987,409.81563,16339805700,421559615,16339800422,-5278,,
14935231612,409.86626,16339856326,421610238,16339851044,-5282,,
14935282671,409.91732,16339907398,421661304,16339902111,-5287,,
14935333273,409.96792,16339957993,421711894,16339952700,-5293,,
14935383829,410.01848,16340008551,421762448,16340003254,-5297,,
14935434391,410.06904,16340059115,421813007,16340053813,-5302,,
14935484940,410.11959,16340109667,421863552,16340104359,-5308,,
14935535981,410.17063,16340160710,421914591,16340155397,-5313,,
14935586538,410.22119,16340211269,421965145,16340205952,-5317,,
14935637564,410.27221,16340262298,422016168,16340256975,-5323,,
14935688643,410.32329,16340313379,422067244,16340308050,-5329,,
14935739196,410.37384,16340363935,422117795,16340358601,-5334,,
14935789587,410.42424,16340414328,422168183,16340408990,-5338,,
14935840617,410.47526,16340465359,422219210,16340460016,-5343,,
14935890759,410.52541,16340515505,422269350,16340510156,-5349,,
14935941367,410.57601,16340566122,422319962,16340560769,-5353,,
14935991868,410.62652,16340616618,422370453,16340611260,-5358,,
14936042060,410.67671,16340666813,422420642,16340661449,-5364,,
14936093033,410.72768,16340717787,422471613,16340712419,-5368,,
14936143500,410.77815,16340768257,422522077,16340762884,-5373,,
14936193672,410.82832,16340818432,422572247,16340813053,-5379,,
14936244190,410.87884,16340868951,422622761,16340863567,-5384,,
14936294770,410.92942,16340919534,422673339,16340914146,-5388,,
14936344850,410.97950,16340969617,422723416,16340964222,-5395,,
14936395306,411.02995,16341020075,422773869,16341014676,-5399,,
14936446072,411.08072,16341070843,422824644,16341065451,-5392,,
14936496974,411.13162,16341121747,422875532,16341116338,-5409,,
14936547554,411.18220,16341172330,422926109,16341166916,-5414,,
14936598595,411.23324,16341223373,422977148,16341217955,-5418,,
14936649179,411.28383,16341273959,423027729,16341268535,-5424,,
14936700161,411.33481,16341324944,423078708,16341319515,-5429,,
14936750262,411.38491,16341375048,423128806,16341369613,-5435,,
14936800494,411.43514,16341425282,423179036,16341419843,-5439,,
14936851435,411.48608,16341476225,423229974,16341470781,-5444,,
14936902004,411.53665,16341526797,423280540,16341521346,-5451,,
14936952605,411.58725,16341577400,423331140,16341571946,-5454,,
14937003169,411.63782,16341627966,423381701,16341622507,-5459,,
14937053693,411.68834,16341678504,423432233,16341673039,-5465,,
14937104261,411.73891,16341729063,423482787,16341723593,-5470,,
14937154840,411.78949,16341779655,423533374,16341774181,-5474,,
14937205420,411.84007,16341830226,423583940,16341824746,-5480,,
14937256325,411.89097,16341881134,423634843,16341875649,-5485,,
14937307415,411.94206,16341932226,423685931,16341926737,-5489,,
14937358458,411.99311,16341983272,423736970,16341977776,-5496,,
14937408962,412.04361,16342033778,423787471,16342028278,-5500,,
14937459246,412.09389,16342084065,423837753,16342078559,-5506,,
14937509582,412.14423,16342134403,423888086,16342128892,-5511,,
14937560118,412.19477,16342184941,423938619,16342179426,-5515,,
14937610743,412.24539,16342235568,423989241,16342230047,-5521,,
14937661600,412.29625,16342286428,424040096,16342280903,-5525,,
14937712234,412.34688,16342337064,424090727,16342331534,-5530,,
14937762782,412.39743,16342387615,424141272,16342382079,-5536,,
14937813797,412.44844,16342438632,424192284,16342433091,-5541,,
14937864305,412.49895,16342489141,424242790,16342483596,-5545,,
14937915091,412.54974,16342539931,424293573,16342534380,-5551,,
14937965493,412.60014,16342590335,424343972,16342584778,-5557,,
14938016017,412.65067,16342640861,424394495,16342635302,-5559,,
14938066571,412.70122,16342691418,424445045,16342685852,-5566,,
14938117584,412.75223,16342742433,424496055,16342736862,-5571,,
14938168636,412.80328,16342793497,424547115,16342787922,-5575,,
14938219226,412.85387,16342844079,424597692,16342838498,-5581,,
14938269787,412.90443,16342894642,424648250,16342889056,-5586,,
14938320181,412.95483,16342945039,424698641,16342939447,-5592,,
14938370266,413.00491,16342995126,424748724,16342989530,-5596,,
14938421312,413.05596,16343046175,424799767,16343040574,-5601,,
14938471420,413.10607,16343096286,424849872,16343090678,-5608,,
14938522002,413.15665,16343146870,424900453,16343141260,-5610,,
14938572631,413.20728,16343197501,424951078,16343191885,-5616,,
14938623629,413.25828,16343248502,425002073,16343242880,-5622,,
14938673728,413.30838,16343298603,425052170,16343292976,-5627,,
14938724767,413.35942,16343349644,425103206,16343344013,-5631,,
14938775329,413.40998,16343400208,425153765,16343394572,-5636,,
14938825953,413.46060,16343450835,425204387,16343445194,-5641,,
14938877017,413.51166,16343501901,425255448,16343496255,-5646,,
14938928048,413.56270,16343552934,425306476,16343547283,-5651,,
14938979083,413.61373,16343603972,425357508,16343598315,-5657,,
14939029652,413.66430,16343654544,425408075,16343648882,-5662,,
14939080699,413.71535,16343705592,425459119,16343699925,-5667,,
14939131728,413.76638,16343756623,425510145,16343750951,-5672,,
14939182794,413.81744,16343807693,425561208,16343802015,-5678,,
14939233712,413.86836,16343858613,425612124,16343852930,-5683,,
14939284149,413.91880,16343909051,425662558,16343903364,-5687,,
14939335195,413.96984,16343960106,425713607,16343954414,-5692,,
14939385754,414.02040,16344010662,425764157,16344004964,-5698,,
14939436759,414.07141,16344061668,425815160,16344055967,-5701,,
14939487379,414.12203,16344112292,425865777,16344106583,-5709,,
14939537893,414.17254,16344162807,425916288,16344157095,-5712,,
14939588457,414.22310,16344213386,425966861,16344207668,-5718,,
14939639482,414.27413,16344264402,426017872,16344258679,-5723,,
14939690009,414.32466,16344314931,426068397,16344309203,-5728,,
14939740564,414.37521,16344365489,426118948,16344359755,-5734,,
14939791146,414.42579,16344416073,426169528,16344410335,-5738,,
14939842230,414.47688,16344467159,426220609,16344461416,-5743,,
14939892305,414.52695,16344517237,426270682,16344511488,-5749,,
14939942369,414.57702,16344567303,426320744,16344561550,-5753,,
14939993078,414.62773,16344618014,426371450,16344612257,-5757,,
14940044061,414.67871,16344669000,426422430,16344663236,-5764,,
14940094631,414.72928,16344719572,426472996,16344713803,-5769,,
14940145572,414.78022,16344770515,426523935,16344764741,-5774,,
14940196623,414.83127,16344821569,426574984,16344815790,-5779,,
14940247154,414.88180,16344872102,426625511,16344866318,-5784,,
14940298188,414.93284,16344923139,426676543,16344917350,-5789,,
14940349266,414.98391,16344974219,426727619,16344968425,-5794,,
14940399848,415.03450,16345024803,426778197,16345019003,-5800,,
14940450407,415.08506,16345075365,426828753,16345069560,-5805,,
14940501426,415.13607,16345126386,426879771,16345120577,-5809,,
14940552504,415.18715,16345177466,426930846,16345171652,-5814,,
14940602851,415.23750,16345227816,426981189,16345221996,-5820,,
14940653040,415.28769,16345278007,427031376,16345272183,-5824,,
14940703602,415.33825,16345328570,427081935,16345322742,-5828,,
14940754606,415.38925,16345379577,427132936,16345373742,-5835,,
14940805142,415.43979,16345430116,427183470,16345424276,-5840,,
14940856231,415.49088,16345481207,427234556,16345475363,-5844,,
14940907283,415.54193,16345532262,427285606,16345526412,-5850,,
14940958322,415.59297,16345583303,427336642,16345577448,-5855,,
14941008889,415.64354,16345633873,427387207,16345628013,-5860,,
14941059917,415.69457,16345684902,427438231,16345679037,-5865,,
14941110466,415.74511,16345735453,427488777,16345729583,-5870,,
14941161032,415.79568,16345786023,427539340,16345780147,-5876,,
14941211582,415.84623,16345836575,427589888,16345830695,-5880,,
14941262621,415.89727,16345887616,427640925,16345881731,-5885,,
14941313185,415.94783,16345938183,427691485,16345932292,-5891,,
14941363299,415.99795,16345988299,427741598,16345982404,-5895,,
14941413897,416.04854,16346038898,427792192,16346032998,-5900,,
14941464949,416.09960,16346089954,427843241,16346084048,-5906,,
14941515955,416.15060,16346140962,427894245,16346135051,-5911,,
14941566497,416.20114,16346191505,427944784,16346185590,-5915,,
14941616539,416.25119,16346241551,427994823,16346235630,-5921,,
14941667115,416.30176,16346292129,428045397,16346286203,-5926,,
14941718190,416.35284,16346343207,428096470,16346337276,-5931,,
14941768650,416.40330,16346393669,428146926,16346387733,-5936,,
14941818864,416.45351,16346443885,428197137,16346437944,-5941,,
14941869899,416.50455,16346494922,428248169,16346488976,-5946,,
14941920944,416.55559,16346545969,428299212,16346540018,-5951,,
14941971948,416.60660,16346596976,428350213,16346591020,-5956,,
14942022509,416.65716,16346647540,428400771,16346641578,-5962,,
14942073586,416.70823,16346698619,428451846,16346692653,-5966,,
14942124590,416.75924,16346749625,428502847,16346743653,-5972,,
14942174684,416.80933,16346799722,428552938,16346793745,-5977,,
14942225396,416.86004,16346850436,428603648,16346844454,-5982,,
14942275948,416.91060,16346900990,428654197,16346895004,-5986,,
14942326972,416.96162,16346952016,428705229,16346946036,-5980,,
14942378046,417.01269,16347003092,428756289,16346997095,-5997,,
14942429094,417.06374,16347054144,428807335,16347048142,-6002,,
14942479641,417.11429,16347104692,428857879,16347098685,-6007,,
14942530190,417.16484,16347155244,428908425,16347149232,-6012,,
14942580738,417.21539,16347205795,428958971,16347199777,-6018,,
14942631810,417.26646,16347256868,429010040,16347250846,-6022,,
14942682452,417.31710,16347307513,429060679,16347301485,-6028,,
14942733456,417.36810,16347358520,429111680,16347352487,-6033,,
14942783575,417.41822,16347408641,429161798,16347402604,-6037,,
14942834590,417.46924,16347459658,429212810,16347453616,-6042,,
14942885668,417.52032,16347510739,429263884,16347504691,-6048,,
14942936717,417.57137,16347561790,429314930,16347555737,-6053,,
14942987766,417.62241,16347612842,429365977,16347606784,-6058,,
14943038315,417.67296,16347663393,429416523,16347657330,-6063,,
14943088920,417.72357,16347714000,429467125,16347707931,-6069,,
14943139452,417.77410,16347764535,429517655,16347758462,-6073,,
14943190048,417.82470,16347815133,429568248,16347809055,-6078,,
14943240661,417.87531,16347865748,429618858,16347859665,-6083,,
14943291183,417.92583,16347916273,429669377,16347910184,-6089,,
14943341333,417.97598,16347966425,429719526,16347960332,-6093,,
14943392405,418.02705,16348017498,429770594,16348011400,-6098,,
14943443077,418.07772,16348068174,429821263,16348062069,-6105,,
14943494072,418.12872,16348119170,429872256,16348113062,-6108,,
14943544683,418.17933,16348169784,429922865,16348163671,-6113,,
14943594821,418.22947,16348219925,429972999,16348213806,-6119,,
14943645868,418.28052,16348270974,430024043,16348264849,-6125,,
14943696964,418.33161,16348322073,430075137,16348315943,-6130,,
14943747093,418.38174,16348372204,430125263,16348366070,-6134,,
14943797681,418.43233,16348422794,430175849,16348416655,-6139,,
14943847833,418.48248,16348472949,430225998,16348466805,-6144,,
14943898467,418.53312,16348523596,430276641,16348517448,-6148,,
14943949563,418.58421,16348574682,430327722,16348568528,-6154,,
14944000175,418.63482,16348625298,430378333,16348619139,-6159,,
14944051181,418.68583,16348676305,430429335,16348670141,-6164,,
14944101723,418.73637,16348726849,430479874,16348720680,-6169,,
14944152347,418.78699,16348777477,430530495,16348771302,-6175,,
14944202920,418.83757,16348828052,430581066,16348821873,-6179,,
14944253532,418.88818,16348878666,430631675,16348872482,-6184,,
14944304166,418.93881,16348929303,430682306,16348923113,-6190,,
14944354258,418.98891,16348979397,430732396,16348973203,-6194,,
14944405288,419.03994,16349030430,430783423,16349024230,-6200,,
14944456337,419.09098,16349081481,430834469,16349075276,-6205,,
14944507386,419.14203,16349132531,430885515,16349126321,-6210,,
14944557961,419.19261,16349183109,430936088,16349176894,-6215,,
14944608545,419.24319,16349233701,430986675,16349227481,-6220,,
14944659148,419.29380,16349284301,431037270,16349278076,-6225,,
14944709695,419.34434,16349334851,431087815,16349328621,-6230,,
14944760746,419.39539,16349385903,431138862,16349379668,-6235,,
14944810856,419.44550,16349436016,431188970,16349429776,-6240,,
14944861418,419.49607,16349486580,431239528,16349480334,-6246,,
14944912333,419.54698,16349537498,431290441,16349531248,-6250,,
14944962503,419.59715,16349587670,431340608,16349581415,-6255,,
14945013052,419.64770,16349638221,431391154,16349631960,-6261,,
14945064065,419.69871,16349689237,431442166,16349682972,-6265,,
14945115108,419.74976,16349740283,431493205,16349734012,-6271,,
14945165674,419.80032,16349790851,431543768,16349784575,-6276,,
14945215843,419.85049,16349841022,431593935,16349834741,-6281,,
14945266493,419.90114,16349891674,431644582,16349885388,-6286,,
14945317518,419.95217,16349942717,431695620,16349936427,-6290,,
14945368443,420.00309,16349993629,431746527,16349987333,-6296,,
14945418594,420.05324,16350043783,431796676,16350037482,-6301,,
14945469674,420.10432,16350094865,431847753,16350088559,-6306,,
14945520271,420.15492,16350145464,431898347,16350139153,-6311,,
14945571264,420.20591,16350196460,431949336,16350190143,-6317,,
14945621601,420.25625,16350246800,431999673,16350240480,-6320,,
14945672014,420.30666,16350297214,432050082,16350290888,-6326,,
14945723059,420.35771,16350348262,432101124,16350341930,-6332,,
14945773687,420.40834,16350398891,432151749,16350392556,-6335,,
14945824254,420.45890,16350449461,432202313,16350443120,-6341,,
14945874818,420.50947,16350500027,432252874,16350493680,-6347,,
14945925456,420.56010,16350550667,432303510,16350544316,-6351,,
14945975999,420.61065,16350601214,432354050,16350594857,-6357,,
14946026578,420.66123,16350651794,432404626,16350645442,-6352,,
14946077166,420.71181,16350702384,432455211,16350696018,-6366,,
14946128193,420.76284,16350753414,432506247,16350747053,-6361,,
14946178759,420.81341,16350803983,432556800,16350797606,-6377,,
14946229348,420.86400,16350854574,432607386,16350848192,-6382,,
14946280397,420.91505,16350905625,432658432,16350899238,-6387,,
14946331422,420.96607,16350956653,432709455,16350950261,-6392,,
14946382232,421.01688,16351007465,432760262,16351001068,-6397,,
14946433146,421.06779,16351058382,432811172,16351051979,-6403,,
14946484226,421.11887,16351109463,432862250,16351103056,-6407,,
14946534771,421.16942,16351160011,432912792,16351153598,-6413,,
14946585857,421.22051,16351211100,432963875,16351204682,-6418,,
14946636899,421.27155,16351262144,433014914,16351255721,-6423,,
14946687520,421.32217,16351312768,433065534,16351306340,-6428,,
14946738144,421.37279,16351363394,433116154,16351356961,-6433,,
14946788730,421.42338,16351413982,433166737,16351407544,-6438,,
14946839338,421.47399,16351464592,433217354,16351458160,-6432,,
14946889854,421.52450,16351515111,433267856,16351508663,-6448,,
14946940925,421.57557,16351566184,433318925,16351559731,-6453,,
14946991059,421.62571,16351616321,433369057,16351609863,-6458,,
14947041604,421.67625,16351666867,433419598,16351660404,-6463,,
14947092608,421.72726,16351717873,433470599,16351711405,-6468,,
14947327168,421.96182,16351952444,433705147,16351945953,-6491,16351951924,
14947352242,421.98689,16351977520,433730219,16351971055,-6465,,
14947402788,422.03744,16352028069,433780763,16352021658,-6411,,
14947453836,422.08848,16352079119,433831808,16352072765,-6354,,
14947504884,422.13953,16352130169,433882853,16352123870,-6299,,
14947555399,422.19005,16352180687,433933366,16352174444,-6243,,
14947606011,422.24066,16352231301,433983976,16352225114,-6187,,
14947657084,422.29173,16352282377,434035045,16352276245,-6132,,
14947707618,422.34227,16352332912,434085576,16352326836,-6076,,
14947758114,422.39276,16352383411,434136069,16352377390,-6021,,
14947809109,422.44376,16352434408,434187062,16352428443,-5965,,
14947859653,422.49430,16352484955,434237604,16352479045,-5910,,
14947910779,422.54543,16352536084,434288726,16352530228,-5856,,
14947961629,422.59628,16352586946,434339585,16352581148,-5798,,
14948012673,422.64732,16352637982,434390616,16352632240,-5742,,
14948062766,422.69741,16352688078,434440706,16352682390,-5688,,
14948113827,422.74847,16352739140,434491763,16352733508,-5632,,
14948164632,422.79928,16352789948,434542567,16352784373,-5575,,
14948215418,422.85007,16352840737,434593349,16352835216,-5521,,
14948266051,422.90070,16352891372,434643979,16352885907,-5465,,
14948317004,422.95165,16352942327,434694930,16352936919,-5408,,
14948367364,423.00201,16352992690,434745297,16352987345,-5345,,
14948418432,423.05308,16353043760,434796353,16353038462,-5298,,
14948469437,423.10408,16353094767,434847354,16353089525,-5242,,
14948519984,423.15463,16353145317,434897899,16353140129,-5188,,
14948570032,423.20468,16353195367,434947944,16353190235,-5132,,
14948620156,423.25480,16353245493,434998066,16353240416,-5077,,
14948670663,423.30531,16353296003,435048571,16353290981,-5022,,
14948721760,423.35641,16353347101,435099664,16353342135,-4966,,
14948772719,423.40737,16353398063,435150620,16353393152,-4911,,
14948823039,423.45769,16353448385,435200938,16353443530,-4855,,
14948874089,423.50874,16353499437,435251985,16353494638,-4799,,
14948925126,423.55977,16353550477,435303019,16353545734,-4743,,
14948976189,423.61084,16353601543,435354080,16353596855,-4688,,
14949026770,423.66142,16353652138,435404670,16353647506,-4632,,
14949077760,423.71241,16353703118,435455645,16353698541,-4577,,
14949128366,423.76301,16353753727,435506248,16353749206,-4521,,
14949179380,423.81403,16353804743,435557259,16353800278,-4465,,
14949229929,423.86458,16353855294,435607806,16353850884,-4410,,
14949280978,423.91563,16353906346,435658853,16353901992,-4354,,
14949331542,423.96619,16353956913,435709413,16353952613,-4300,,
14949381681,424.01633,16354007054,435759551,16354002810,-4244,,
14949432737,424.06739,16354058112,435810604,16354053924,-4188,,
14949483773,424.11842,16354109151,435861636,16354105018,-4133,,
14949534318,424.16897,16354159698,435912179,16354155621,-4077,,
14949584399,424.21905,16354209780,435962257,16354205760,-4020,,
14949634969,424.26962,16354260353,436012824,16354256386,-3967,,
14949685551,424.32020,16354310938,436063404,16354307026,-3912,,
14949736602,424.37125,16354361991,436114452,16354358136,-3855,,
14949787625,424.42227,16354413017,436165473,16354409217,-3800,,
14949837732,424.47238,16354463125,436215576,16354459381,-3744,,
14949888424,424.52307,16354513819,436266266,16354510131,-3688,,
14949938757,424.57340,16354564156,436316596,16354560522,-3634,,
14949989576,424.62422,16354614977,436367412,16354611399,-3578,,
14950039710,424.67436,16354665114,436417543,16354661589,-3525,,
14950090240,424.72489,16354715655,436468081,16354712188,-3467,,
14950141288,424.77594,16354766696,436519117,16354763284,-3412,,
14950192321,424.82697,16354817731,436570146,16354814374,-3357,,
14950242897,424.87754,16354868310,436620721,16354865009,-3301,,
14950293009,424.92766,16354918423,436670829,16354915178,-3245,,
14950343557,424.97821,16354968975,436721375,16354965783,-3192,,
14950393735,425.02838,16355019155,436771550,16355016018,-3137,,
14950444330,425.07898,16355069752,436822143,16355066672,-3080,,
14950494908,425.12956,16355120333,436872717,16355117307,-3026,,
14950545869,425.18052,16355171295,436923675,16355168326,-2969,,
14950596927,425.23158,16355222355,436974731,16355219442,-2913,,
14950647548,425.28220,16355272980,437025349,16355270121,-2859,,
14950698408,425.33306,16355323841,437076206,16355321038,-2803,,
14950748972,425.38362,16355374408,437126768,16355371661,-2747,,
14950799417,425.43406,16355424855,437177210,16355422163,-2692,,
14950849781,425.48443,16355475222,437227571,16355472585,-2637,,
14950900775,425.53542,16355526218,437278562,16355523636,-2582,,
14950951807,425.58646,16355577252,437329592,16355574727,-2525,,
14951002705,425.63735,16355628153,437380487,16355625684,-2469,,
14951052957,425.68761,16355678408,437430736,16355675993,-2415,,
14951103231,425.73788,16355728684,437481009,16355726325,-2359,,
14951154280,425.78893,16355779734,437532054,16355777432,-2302,,
14951205275,425.83992,16355830732,437583046,16355828485,-2247,,
14951255653,425.89030,16355881112,437633421,16355878920,-2192,,
14951305889,425.94054,16355931351,437683655,16355929213,-2138,,
14951356418,425.99107,16355981883,437734182,16355979800,-2083,,
14951407445,426.04209,16356032911,437785204,16356030884,-2027,,
14951458485,426.09313,16356083954,437836244,16356081984,-1970,,
14951509492,426.14414,16356134964,437887248,16356133049,-1915,,
14951560539,426.19519,16356186013,437938291,16356184154,-1859,,
14951610634,426.24528,16356236110,437988383,16356234305,-1805,,
14951661643,426.29629,16356287122,438039390,16356285374,-1748,,
14951712650,426.34730,16356338131,438090394,16356336438,-1693,,
14951763497,426.39814,16356388981,438141239,16356387344,-1637,,
14951814046,426.44869,16356439532,438191784,16356437950,-1582,,
14951864595,426.49924,16356490083,438242332,16356488557,-1526,,
14951915612,426.55026,16356541103,438293345,16356539631,-1472,,
14951966692,426.60134,16356592185,438344422,16356590769,-1416,,
14952017242,426.65189,16356642736,438394970,16356641378,-1358,,
14952068246,426.70289,16356693744,438445971,16356692441,-1303,,
14952118829,426.75348,16356744328,438496551,16356743081,-1247,,
14952169333,426.80398,16356794836,438547052,16356793642,-1194,,
14952220312,426.85496,16356845817,438598030,16356844680,-1137,,
14952270932,426.90558,16356896439,438648646,16356895358,-1081,,
14952321461,426.95611,16356946970,438699183,16356945955,-1015,,
14952371595,427.00624,16356997107,438749305,16356996083,-1024,,
14952422110,427.05676,16357047624,438799816,16357046595,-1029,,
14952472686,427.10733,16357098202,438850389,16357097167,-1035,,
14952523725,427.15837,16357149248,438901431,16357148209,-1039,,
14952573840,427.20849,16357199360,438951538,16357198317,-1043,,
14952624441,427.25909,16357249965,439002136,16357248915,-1050,,
14952674994,427.30964,16357300532,439052698,16357299477,-1055,,
14952726014,427.36066,16357351542,439103705,16357350483,-1059,,
14952776611,427.41126,16357402141,439154298,16357401076,-1065,,
14952826679,427.46133,16357452211,439204363,16357451141,-1070,,
14952876772,427.51142,16357502307,439254455,16357501233,-1074,,
14952927396,427.56204,16357552944,439305086,16357551864,-1080,,
14952978422,427.61307,16357603961,439356098,16357602876,-1085,,
14953028520,427.66317,16357654061,439406194,16357652972,-1089,,
14953079151,427.71380,16357704696,439456822,16357703600,-1096,,
14953130144,427.76479,16357755691,439507812,16357754590,-1101,,
14953180731,427.81538,16357806281,439558396,16357805175,-1106,,
14953230824,427.86547,16357856376,439608487,16357855265,-1111,,
14953281392,427.91604,16357906946,439659052,16357905831,-1115,,
14953331487,427.96614,16357957044,439709145,16357955923,-1121,,
14953382036,428.01668,16358007594,439759691,16358006469,-1125,,
14953432412,428.06706,16358057973,439810065,16358056843,-1130,,
14953483416,428.11806,16358108980,439861066,16358107844,-1136,,
14953534014,428.16866,16358159580,439911661,16358158440,-1140,,
14953584547,428.21920,16358210115,439962191,16358208970,-1145,,
14953635074,428.26972,16358260645,440012715,16358259494,-1151,,
14953685163,428.31981,16358310736,440062802,16358309580,-1156,,
14953735562,428.37021,16358361147,440113209,16358359988,-1159,,
14953786623,428.42127,16358412200,440164256,16358411034,-1166,,
14953837394,428.47204,16358462973,440215024,16358461803,-1170,,
14953887964,428.52261,16358513545,440265592,16358512370,-1175,,
14953938970,428.57362,16358564554,440316595,16358563373,-1181,,
14953990023,428.62467,16358615610,440367645,16358614424,-1186,,
14954040576,428.67522,16358666165,440418195,16358664974,-1191,,
14954091667,428.72631,16358717258,440469284,16358716062,-1196,,
14954142181,428.77683,16358767774,440519795,16358766574,-1200,,
14954193203,428.82785,16358818799,440570813,16358817592,-1207,,
14954243781,428.87843,16358869379,440621389,16358868168,-1211,,
14954294858,428.92951,16358920459,440672465,16358919243,-1216,,
14954345863,428.98051,16358971466,440723466,16358970244,-1222,,
14954396923,429.03157,16359022528,440774523,16359021301,-1227,,
14954447507,429.08216,16359073115,440825105,16359071884,-1231,,
14954498534,429.13318,16359124144,440876129,16359122931,-1213,,
14954549577,429.18423,16359175190,440927169,16359173948,-1242,,
14954600628,429.23528,16359226244,440978217,16359224996,-1248,,
14954651172,429.28582,16359276789,441028759,16359275537,-1252,,
14954701731,429.33638,16359327351,441079316,16359326094,-1257,,
14954752283,429.38693,16359377906,441129864,16359376643,-1263,,
14954803349,429.43800,16359428973,441180928,16359427707,-1266,,
14954854404,429.48905,16359480031,441231981,16359478759,-1272,,
14954904956,429.53960,16359530586,441282529,16359529308,-1278,,
14954956035,429.59068,16359581667,441333606,16359580384,-1283,,
14955007084,429.64173,16359632718,441384652,16359631431,-1287,,
14955058096,429.69274,16359683733,441435662,16359682440,-1293,,
14955108729,429.74338,16359734367,441486291,16359733069,-1298,,
14955159312,429.79396,16359784953,441536872,16359783650,-1303,,
14955209958,429.84461,16359835613,441587527,16359834305,-1308,,
14955260117,429.89477,16359885763,441637671,16359884450,-1313,,
14955311112,429.94576,16359936761,441688663,16359935441,-1320,,
14955361697,429.99635,16359987359,441739258,16359986037,-1322,,
14955412758,430.04741,16360038412,441790306,16360037084,-1328,,
14955463427,430.09807,16360089083,441840971,16360087749,-1334,,
14955513925,430.14857,16360139582,441891466,16360138244,-1338,,
14955564559,430.19921,16360190218,441942097,16360188876,-1342,,
14955615558,430.25021,16360241221,441993093,16360239872,-1349,,
14955666153,430.30080,16360291818,442043685,16360290463,-1355,,
14955716764,430.35141,16360342431,442094294,16360341072,-1359,,
14955767343,430.40199,16360393012,442144870,16360391648,-1364,,
14955818378,430.45303,16360444050,442195903,16360442681,-1369,,
14955868922,430.50357,16360494596,442246444,16360493222,-1374,,
14955919037,430.55368,16360544714,442296556,16360543335,-1379,,
14955970085,430.60473,16360595764,442347602,16360594380,-1384,,
14956020529,430.65518,16360646211,442398042,16360644821,-1390,,
14956070641,430.70529,16360696325,442448153,16360694931,-1394,,
14956121225,430.75587,16360746912,442498735,16360745514,-1398,,
14956172189,430.80684,16360797878,442549695,16360796473,-1405,,
14956222843,430.85749,16360848533,442600346,16360847124,-1409,,
14956273420,430.90807,16360899113,442650920,16360897710,-1403,,
14956323998,430.95865,16360949694,442701495,16360948274,-1420,,
14956374198,431.00885,16360999896,442751693,16360998472,-1424,,
14956425229,431.05988,16361050929,442802721,16361049499,-1430,,
14956475794,431.11044,16361101497,442853284,16361100062,-1435,,
14956526770,431.16142,16361152486,442904268,16361151047,-1439,,
14956577478,431.21213,16361203185,442954962,16361201740,-1445,,
14956628030,431.26268,16361253739,443005511,16361252289,-1450,,
14956678213,431.31286,16361303925,443055691,16361302470,-1455,,
14956729225,431.36387,16361354939,443106701,16361353491,-1448,,
14956779887,431.41454,16361405604,443157360,16361404139,-1465,,
14956830458,431.46511,16361456177,443207929,16361454707,-1470,,
14956881570,431.51622,16361507292,443259038,16361505816,-1476,,
14956932403,431.56705,16361558127,443309869,16361556647,-1480,,
14956983015,431.61766,16361608740,443360477,16361607255,-1485,,
14957033223,431.66787,16361658952,443410683,16361657461,-1491,,
14957084327,431.71898,16361710058,443461784,16361708563,-1495,,
14957134969,431.76962,16361760701,443512423,16361759202,-1499,,
14957185513,431.82016,16361811249,443562964,16361809743,-1506,,
14957236562,431.87121,16361862300,443614010,16361860788,-1512,,
14957287589,431.92224,16361913330,443665035,16361911814,-1516,,
14957338649,431.97330,16361964392,443716092,16361962870,-1522,,
14957389199,432.02385,16362014944,443766639,16362013418,-1526,,
14957440244,432.07489,16362065991,443817681,16362064459,-1532,,
14957491292,432.12594,16362117042,443868727,16362115506,-1536,,
14957542312,432.17696,16362168063,443919744,16362166522,-1541,,
14957593389,432.22804,16362219144,443970818,16362217597,-1547,,
14957643903,432.27855,16362269660,444021330,16362268109,-1551,,
14957694966,432.32961,16362320725,444072390,16362319169,-1556,,
14957746012,432.38066,16362371774,444123434,16362370212,-1562,,
14957797044,432.43169,16362422808,444174472,16362421251,-1557,,
14957847710,432.48236,16362473477,444225126,16362471905,-1572,,
14957898303,432.53295,16362524072,444275716,16362522495,-1577,,
14957949204,432.58385,16362574974,444326614,16362573392,-1582,,
14957999374,432.63402,16362625148,444376782,16362623560,-1588,,
14958049912,432.68456,16362675698,444427328,16362674106,-1592,,
14958100961,432.73561,16362726738,444478363,16362725141,-1597,,
14958152010,432.78666,16362777791,444529409,16362776188,-1603,,
14958203054,432.83770,16362828837,444580452,16362827230,-1607,,
14958253637,432.88828,16362879422,444631031,16362877810,-1612,,
14958304654,432.93930,16362930442,444682045,16362928824,-1618,,
14958355715,432.99036,16362981504,444733104,16362979882,-1622,,
14958406786,433.04143,16363032578,444784172,16363030950,-1628,,
14958457833,433.09248,16363083628,444835216,16363081995,-1633,,
14958508869,433.14352,16363134666,444886250,16363133028,-1638,,
14958559946,433.19459,16363185745,444937324,16363184102,-1643,,
14958610947,433.24559,16363236749,444988323,16363235101,-1648,,
14958661136,433.29578,16363286939,445038508,16363285286,-1653,,
14958711394,433.34604,16363337201,445088763,16363335542,-1659,,
14958761773,433.39642,16363387582,445139140,16363385919,-1663,,
14958812195,433.44684,16363438005,445189559,16363436337,-1668,,
14958863269,433.49792,16363489083,445240630,16363487409,-1674,,
14958913853,433.54850,16363539668,445291212,16363537991,-1677,,
14958964463,433.59911,16363590282,445341819,16363588598,-1684,,
14959015006,433.64965,16363640827,445392359,16363639137,-1690,,
14959065478,433.70013,16363691313,445442841,16363689620,-1693,,
14959116185,433.75083,16363742011,445493534,16363740312,-1699,,
14959167230,433.80188,16363793057,445544575,16363791354,-1703,,
14959217853,433.85250,16363843683,445595196,16363841974,-1709,,
14959268436,433.90308,16363894269,445645776,16363892554,-1715,,
14959319374,433.95402,16363945209,445696711,16363943490,-1719,,
14959370422,434.00507,16363996258,445747756,16363994534,-1724,,
14959420970,434.05562,16364046809,445798302,16364045081,-1728,,
14959471631,434.10628,16364097473,445848961,16364095739,-1734,,
14959522679,434.15733,16364148533,445900016,16364146794,-1739,,
14959573240,434.20789,16364199088,445950565,16364197344,-1744,,
14959623531,434.25818,16364249380,446000852,16364247631,-1749,,
14959674097,434.30874,16364299950,446051416,16364298194,-1756,,
14959724837,434.35949,16364350691,446102152,16364348931,-1760,,
14959775026,434.40967,16364400882,446152340,16364399118,-1764,,
14959826016,434.46066,16364451875,446203327,16364450105,-1770,,
14959876087,434.51074,16364501948,446253395,16364500173,-1775,,
14959927100,434.56175,16364552963,446304404,16364551183,-1780,,
14959977214,434.61186,16364603079,446354516,16364601295,-1784,,
14960028193,434.66284,16364654061,446405492,16364652270,-1791,,
14960078785,434.71343,16364704655,446456082,16364702860,-1795,,
14960129328,434.76398,16364755201,446506623,16364753401,-1800,,
14960179740,434.81439,16364805615,446557032,16364803810,-1805,,
14960230738,434.86539,16364856614,446608026,16364854804,-1810,,
14960280824,434.91547,16364906704,446658110,16364904888,-1816,,
14960331389,434.96604,16364957271,446708672,16364955450,-1821,,
14960381951,435.01660,16365007834,446759231,16365006009,-1825,,
14960432545,435.06719,16365058432,446809823,16365056601,-1831,,
14960483604,435.11825,16365109506,446860892,16365107671,-1835,,
14960534490,435.16914,16365160382,446911763,16365158541,-1841,,
14960585136,435.21978,16365211030,446962406,16365209184,-1846,,
14960636125,435.27077,16365262021,447013392,16365260171,-1850,,
14960686777,435.32142,16365312678,447064043,16365310822,-1856,,
14960737370,435.37202,16365363270,447114631,16365361410,-1860,,
14960788396,435.42304,16365414299,447165655,16365412433,-1866,,
14960839182,435.47383,16365465088,447216438,16365463217,-1871,,
14960890301,435.52495,16365516209,447267554,16365514333,-1876,,
14960941352,435.57600,16365567262,447318602,16365565381,-1881,,
14960991898,435.62655,16365617811,447369145,16365615924,-1887,,
14961042967,435.67762,16365668882,447420212,16365666991,-1891,,
14961094015,435.72866,16365719933,447471258,16365718036,-1897,,
14961145091,435.77974,16365771011,447522330,16365769109,-1902,,
14961196100,435.83075,16365822022,447573338,16365820116,-1906,,
14961246652,435.88130,16365872577,447623886,16365870664,-1913,,
14961297742,435.93239,16365923669,447674974,16365921752,-1917,,
14961348195,435.98284,16365974124,447725424,16365972202,-1922,,
14961399243,436.03389,16366025175,447776469,16366023248,-1927,,
14961449743,436.08439,16366075677,447826967,16366073745,-1932,,
14961499908,436.13456,16366125844,447877139,16366123917,-1927,,
14961550432,436.18508,16366176371,447927651,16366174429,-1942,,
14961600583,436.23523,16366226524,447977798,16366224577,-1947,,
14961651609,436.28626,16366277552,448028821,16366275600,-1952,,
14961702182,436.33683,16366328128,448079392,16366326171,-1957,,
14961752728,436.38738,16366378676,448129935,16366376713,-1963,,
14961803351,436.43800,16366429301,448180555,16366427334,-1967,,
14961853916,436.48856,16366479868,448231117,16366477895,-1973,,
14961904484,436.53913,16366530449,448281693,16366528472,-1977,,
14961955056,436.58970,16366581013,448332252,16366579030,-1983,,
14962006066,436.64071,16366632025,448383259,16366630038,-1987,,
14962056975,436.69162,16366682937,448434165,16366680944,-1993,,
14962107963,436.74261,16366733927,448485151,16366731929,-1998,,
14962158583,436.79323,16366784551,448535770,16366782549,-2002,,
14962209650,436.84430,16366835619,448586832,16366833611,-2008,,
14962260694,436.89534,16366886677,448637885,16366884664,-2013,,
14962311778,436.94643,16366937752,448688955,16366935734,-2018,,
14962362825,436.99747,16366988802,448739999,16366986778,-2024,,
14962413844,437.04849,16367039822,448791015,16367037793,-2029,,
14962464251,437.09890,16367090231,448841420,16367088199,-2032,,
14962514849,437.14950,16367140833,448892016,16367138794,-2039,,
14962565942,437.20059,16367191927,448943105,16367189883,-2044,,
14962616870,437.25152,16367242858,448994032,16367240810,-2048,,
14962667432,437.30208,16367293423,449044590,16367291369,-2054,,
14962718389,437.35304,16367344382,449095545,16367342323,-2059,,
14962769398,437.40405,16367395393,449146551,16367393329,-2064,,
14962820406,437.45505,16367446404,449197557,16367444335,-2069,,
14962870506,437.50515,16367496506,449247653,16367494432,-2074,,
14962921551,437.55620,16367547554,449298696,16367545474,-2080,,
14962972604,437.60725,16367598609,449349747,16367596525,-2084,,
14963023159,437.65781,16367649165,449400298,16367647076,-2089,,
14963073703,437.70835,16367699712,449450839,16367697617,-2095,,
14963124717,437.75937,16367750729,449501851,16367748629,-2100,,
14963175243,437.80989,16367801257,449552375,16367799153,-2104,,
14963226323,437.86097,16367852340,449603452,16367850230,-2110,,
14963277316,437.91196,16367903334,449654441,16367901219,-2115,,
14963327934,437.96258,16367953955,449705057,16367951835,-2120,,
14963379005,438.01365,16368005029,449756126,16368002904,-2125,,
14963429703,438.06435,16368055729,449806821,16368053599,-2130,,
14963480210,438.11486,16368106237,449857324,16368104102,-2135,,
14963530762,438.16541,16368156793,449907874,16368154653,-2140,,
14963580898,438.21555,16368206930,449958007,16368204785,-2145,,
14963630998,438.26565,16368257032,450008104,16368254882,-2150,,
14963681544,438.31619,16368307582,450058648,16368305427,-2155,,
14963732646,438.36729,16368358685,450109747,16368356525,-2160,,
14963783197,438.41784,16368409240,450160296,16368407074,-2166,,
14963833399,438.46805,16368459443,450210494,16368457272,-2171,,
14963883916,438.51856,16368509963,450261009,16368507788,-2175,,
14963934936,438.56958,16368560986,450312026,16368558804,-2182,,
14963985986,438.62063,16368612038,450363074,16368609852,-2186,,
14964037069,438.67172,16368663132,450414164,16368660942,-2190,,
14964088058,438.72271,16368714126,450465152,16368711930,-2196,,
14964139129,438.77378,16368765188,450516208,16368762987,-2201,,
14964189685,438.82433,16368815746,450566762,16368813540,-2206,,
14964240251,438.87490,16368866315,450617326,16368864104,-2211,,
14964291305,438.92595,16368917371,450668377,16368915155,-2216,,
14964342155,438.97680,16368968224,450719223,16368966002,-2222,,
14964392698,439.02735,16369018769,450769764,16369016543,-2226,,
14964443212,439.07786,16369069285,450820275,16369067054,-2231,,
14964493781,439.12843,16369119857,450870841,16369117620,-2237,,
14964544868,439.17952,16369170945,450921925,16369168703,-2242,,
14964594990,439.22964,16369221070,450972045,16369218823,-2247,,
14964645596,439.28024,16369271679,451022648,16369269427,-2252,,
14964696684,439.33133,16369322769,451073733,16369320512,-2257,,
14964747355,439.38200,16369373442,451124403,16369371181,-2261,,
14964798087,439.43273,16369424177,451175132,16369421910,-2267,,
14964848269,439.48292,16369474372,451225322,16369472100,-2272,,
14964899293,439.53394,16369525387,451276332,16369523110,-2277,,
14964950353,439.58500,16369576450,451327390,16369574168,-2282,,
14965000958,439.63561,16369627056,451377991,16369624769,-2287,,
14965051998,439.68665,16369678100,451429029,16369675807,-2293,,
14965102721,439.73737,16369728825,451479750,16369726528,-2297,,
14965153807,439.78845,16369779912,451530832,16369777610,-2302,,
14965204427,439.83907,16369830535,451581449,16369828228,-2307,,
14965255007,439.88966,16369881118,451632027,16369878805,-2313,,
14965306043,439.94069,16369932155,451683060,16369929838,-2317,,
14965356594,439.99124,16369982710,451733609,16369980387,-2323,,
14965407102,440.04175,16370033220,451784113,16370030892,-2328,,
14965457229,440.09188,16370083349,451834238,16370081017,-2332,,
14965507753,440.14240,16370133876,451884760,16370131538,-2338,,
14965558314,440.19296,16370184439,451935317,16370182095,-2344,,
14965608869,440.24352,16370234996,451985870,16370232648,-2348,,
14965659414,440.29406,16370285544,452036412,16370283191,-2353,,
14965709945,440.34459,16370336077,452086940,16370333719,-2358,,
14965760489,440.39514,16370386623,452137481,16370384259,-2364,,
14965810577,440.44522,16370436714,452187567,16370434346,-2368,,
14965861634,440.49628,16370487773,452238621,16370485399,-2374,,
14965912177,440.54683,16370538319,452289161,16370535940,-2379,,
14965963196,440.59784,16370589340,452340178,16370586957,-2383,,
14966013749,440.64840,16370639894,452390728,16370637506,-2388,,
14966064309,440.69896,16370690467,452441295,16370688073,-2394,,
14966115344,440.74999,16370741495,452492317,16370739096,-2399,,
14966166199,440.80085,16370792361,452543179,16370789958,-2403,,
14966216820,440.85147,16370842976,452593789,16370840567,-2409,,
14966267869,440.90252,16370894027,452644834,16370891613,-2414,,
14966318921,440.95357,16370945081,452695884,16370942662,-2419,,
14966369467,441.00412,16370995630,452746428,16370993206,-2424,,
14966420507,441.05516,16371046672,452797464,16371044243,-2429,,
14966471101,441.10575,16371097269,452848056,16371094834,-2435,,
14966521614,441.15626,16371147783,452898566,16371145344,-2439,,
14966572173,441.20682,16371198355,452949133,16371195911,-2444,,
14966622713,441.25736,16371248888,452999659,16371246438,-2450,,
14966673759,441.30841,16371299936,453050703,16371297481,-2455,,
14966724307,441.35895,16371350486,453101248,16371348027,-2459,,
14966774394,441.40904,16371400576,453151332,16371398111,-2465,,
14966824521,441.45917,16371450705,453201457,16371448235,-2470,,
14966875055,441.50970,16371501240,453251988,16371498766,-2474,,
14966925190,441.55984,16371551379,453302120,16371548899,-2480,,
14966975908,441.61056,16371602099,453352835,16371599614,-2485,,
14967026489,441.66114,16371652682,453403415,16371650193,-2489,,
14967077524,441.71217,16371703719,453454446,16371701224,-2495,,
14967128112,441.76276,16371754310,453505032,16371751810,-2500,,
14967178651,441.81330,16371804851,453555567,16371802346,-2505,,
14967229728,441.86438,16371855931,453606642,16371853420,-2511,,
14967280752,441.91540,16371906968,453657674,16371904453,-2515,,
14967331775,441.96642,16371957983,453708684,16371955462,-2521,,
14967382883,442.01753,16372009093,453759790,16372006568,-2525,,
14967433905,442.06855,16372060116,453810808,16372057587,-2529,,
14967484923,442.11957,16372111137,453861823,16372108601,-2536,,
14967535495,442.17014,16372161712,453912393,16372159171,-2541,,
14967586079,442.22073,16372212298,453962975,16372209753,-2545,,
14967637076,442.27172,16372263298,454013968,16372260746,-2552,,
14967687126,442.32177,16372313350,454064016,16372310794,-2556,,
14967737694,442.37234,16372363920,454114582,16372361360,-2560,,
14967788236,442.42288,16372414465,454165120,16372411899,-2566,,
14967838793,442.47344,16372465023,454215674,16372462452,-2571,,
14967889872,442.52452,16372516106,454266750,16372513529,-2577,,
14967940932,442.57558,16372567180,454317821,16372564599,-2581,,
14967991526,442.62617,16372617764,454368399,16372615177,-2587,,
14968042131,442.67678,16372668372,454419002,16372665780,-2592,,
14968092681,442.72733,16372718923,454469549,16372716327,-2596,,
14968143729,442.77838,16372769974,454520595,16372767373,-2601,,
14968194315,442.82896,16372820563,454571177,16372817956,-2607,,
14968245385,442.88003,16372871634,454622244,16372869022,-2612,,
14968295492,442.93014,16372921744,454672350,16372919128,-2616,,
14968345946,442.98059,16372972201,454722800,16372969579,-2622,,
14968396510,443.03116,16373022767,454773361,16373020140,-2627,,
14968446664,443.08131,16373072924,454823515,16373070293,-2631,,
14968497692,443.13234,16373123953,454874538,16373121316,-2637,,
14968548245,443.18289,16373174509,454925089,16373171867,-2642,,
14968598899,443.23355,16373225165,454975739,16373222517,-2648,,
14968649875,443.28452,16373276143,455026713,16373273491,-2652,,
14968700923,443.33557,16373327194,455077759,16373324537,-2657,,
14968751931,443.38658,16373378205,455128763,16373375542,-2663,,
14968802073,443.43672,16373428349,455178903,16373425692,-2657,,
14968853142,443.48779,16373479419,455229969,16373476747,-2672,,
14968903931,443.53858,16373530211,455280754,16373527533,-2678,,
14968954972,443.58962,16373581255,455331793,16373578572,-2683,,
14969005627,443.64027,16373631913,455382447,16373629226,-2687,,
14969055949,443.69060,16373682237,455432766,16373679544,-2693,,
14969106540,443.74119,16373732829,455483353,16373730132,-2697,,
14969157067,443.79172,16373783369,455533889,16373780668,-2701,,
14969207601,443.84225,16373833895,455584409,16373831187,-2708,,
14969258184,443.89283,16373884481,455634989,16373881767,-2714,,
14969309233,443.94388,16373935533,455686035,16373932814,-2719,,
14969360282,443.99493,16373986583,455737082,16373983860,-2723,,
14969411290,444.04594,16374037594,455788087,16374034866,-2728,,
14969461378,444.09603,16374087696,455838184,16374084963,-2733,,
14969512403,444.14705,16374138722,455889206,16374135985,-2737,,
14969562985,444.19763,16374189295,455939774,16374186553,-2742,,
14969613502,444.24815,16374239816,455990288,16374237067,-2749,,
14969663604,444.29825,16374289920,456040388,16374287167,-2753,,
14969713700,444.34835,16374340018,456090482,16374337260,-2758,,
14969764316,444.39896,16374390637,456141095,16374387873,-2764,,
14969814941,444.44959,16374441264,456191716,16374438494,-2770,,
14969865981,444.50063,16374492306,456242755,16374489534,-2772,,
14969916583,444.55123,16374542922,456293365,16374540144,-2778,,
14969967226,444.60187,16374593556,456343993,16374590772,-2784,,
14970017793,444.65244,16374644124,456394568,16374641347,-2777,,
14970068881,444.70353,16374695215,456445643,16374692421,-2794,,
14970119942,444.75459,16374746279,456496702,16374743480,-2799,,
14970170574,444.80522,16374796914,456547331,16374794109,-2805,,
14970221576,444.85622,16374847918,456598330,16374845109,-2809,,
14970271665,444.90631,16374898020,456648428,16374895206,-2814,,
14970322149,444.95680,16374948496,456698897,16374945676,-2820,,
14970373222,445.00787,16374999571,456749968,16374996747,-2824,,
14970424222,445.05887,16375050573,456800966,16375047744,-2829,,
14970474792,445.10944,16375101146,456851532,16375098310,-2836,,
14970525346,445.15999,16375151713,456902094,16375148873,-2840,,
14970576263,445.21091,16375202621,456952999,16375199777,-2844,,
14970627370,445.26202,16375253730,457004102,16375250880,-2850,,
14970678246,445.31289,16375304609,457054976,16375301754,-2855,,
14970728469,445.36312,16375354845,457105206,16375351985,-2860,,
14970779415,445.41406,16375405782,457156139,16375402917,-2865,,
14970829909,445.46456,16375456279,457206630,16375453409,-2870,,
14970880462,445.51511,16375506835,457257181,16375503959,-2876,,
14970931496,445.56614,16375557871,457308212,16375554990,-2881,,
14970981594,445.61624,16375607971,457358308,16375605086,-2885,,
14971031932,445.66658,16375658312,457408643,16375655421,-2891,,
14971082756,445.71740,16375709138,457459464,16375706243,-2895,,
14971133385,445.76803,16375759768,457510090,16375756869,-2899,,
14971183971,445.81862,16375810369,457560684,16375807463,-2906,,
14971234995,445.86964,16375861383,457611694,16375858472,-2911,,
14971285579,445.92023,16375911969,457662276,16375909054,-2915,,
14971336627,445.97127,16375963021,457713321,16375960099,-2922,,
14971387662,446.02231,16376014057,457764353,16376011131,-2926,,
14971438212,446.07286,16376064611,457814911,16376061690,-2921,,
14971489104,446.12375,16376115505,457865791,16376112569,-2936,,
14971539662,446.17431,16376166065,457916345,16376163124,-2941,,
14971589754,446.22440,16376216159,457966434,16376213212,-2947,,
14971640789,446.27544,16376267197,458017467,16376264246,-2951,,
14971690920,446.32557,16376317330,458067596,16376314374,-2956,,
14971741436,446.37608,16376367848,458118108,16376364886,-2962,,
14971792486,446.42713,16376418900,458169156,16376415934,-2966,,
14971843149,446.47780,16376469566,458219816,16376466595,-2971,,
14971894150,446.52880,16376520569,458270814,16376517592,-2977,,
14971944225,446.57887,16376570646,458320887,16376567665,-2981,,
14971994824,446.62947,16376621248,458371483,16376618262,-2986,,
14972045521,446.68017,16376671947,458422177,16376668956,-2991,,
14972096590,446.73124,16376723019,458473243,16376720021,-2998,,
14972147629,446.78228,16376774061,458524280,16376771059,-3002,,
14972197749,446.83240,16376824183,458574398,16376821186,-2997,,
14972248822,446.88347,16376875257,458625467,16376872245,-3012,,
14972299868,446.93452,16376926307,458676510,16376923289,-3018,,
14972350862,446.98551,16376977303,458727503,16376974281,-3022,,
14972401465,447.03611,16377027908,458778102,16377024881,-3027,,
14972452473,447.08712,16377078919,458829107,16377075895,-3024,,
14972503106,447.13775,16377129554,458879739,16377126517,-3037,,
14972554154,447.18880,16377180603,458930783,16377177561,-3042,,
14972605112,447.23976,16377231575,458981748,16377228527,-3048,,
14972656149,447.29080,16377282604,459032772,16377279551,-3053,,
14972707209,447.34186,16377333677,459083840,16377330619,-3058,,
14972757807,447.39245,16377384267,459134426,16377381204,-3063,,
14972808836,447.44348,16377435298,459185451,16377432240,-3058,,
14972859398,447.49405,16377485862,459236011,16377482789,-3073,,
14972909980,447.54463,16377536447,459286591,16377533369,-3078,,
14972960634,447.59528,16377587102,459337241,16377584020,-3082,,
14973011245,447.64589,16377637717,459387849,16377634628,-3089,,
14973062311,447.69696,16377688785,459438913,16377685692,-3093,,
14973113410,447.74806,16377739886,459490009,16377736787,-3099,,
14973163935,447.79858,16377790414,459540531,16377787310,-3104,,
14973215022,447.84967,16377841503,459591616,16377838395,-3108,,
14973266058,447.90071,16377892542,459642650,16377889428,-3114,,
14973317107,447.95175,16377943593,459693696,16377940474,-3119,,
14973368155,448.00280,16377994643,459744740,16377991519,-3124,,
14973419187,448.05383,16378045678,459795771,16378042549,-3129,,
14973470250,448.10490,16378096743,459846831,16378093609,-3134,,
14973521269,448.15592,16378147764,459897847,16378144625,-3139,,
14973571850,448.20650,16378198358,459948435,16378195213,-3145,,
14973621969,448.25662,16378248468,459998541,16378245319,-3149,,
14973672084,448.30673,16378298586,460048653,16378295441,-3145,,
14973722712,448.35736,16378349217,460099278,16378346056,-3161,,
14973773258,448.40791,16378399765,460149822,16378396601,-3164,,
14973823884,448.45853,16378450393,460200445,16378447224,-3169,,
14973874415,448.50906,16378500927,460250973,16378497762,-3165,,
14973924519,448.55917,16378551033,460301075,16378547854,-3179,,
14973975169,448.60982,16378601685,460351722,16378598501,-3184,,
14974026232,448.66088,16378652751,460402783,16378649561,-3190,,
14974077291,448.71194,16378703811,460453848,16378700626,-3185,,
14974128381,448.76303,16378754904,460504926,16378751704,-3200,,
14974178926,448.81357,16378805452,460555468,16378802246,-3206,,
14974229948,448.86460,16378856475,460606487,16378853265,-3210,,
14974281028,448.91568,16378907559,460657566,16378904344,-3215,,
14974332076,448.96672,16378958609,460708610,16378955389,-3220,,
14974383125,449.01777,16379009660,460759657,16379006435,-3225,,
14974434173,449.06882,16379060711,460810701,16379057480,-3231,,
14974485193,449.11984,16379111733,460861719,16379108498,-3235,,
14974536250,449.17090,16379162793,460912784,16379159562,-3231,,
14974586801,449.22145,16379213356,460963332,16379210110,-3246,,
14974637816,449.27246,16379264363,461014333,16379261112,-3251,,
14974688399,449.32305,16379314960,461064925,16379311704,-3256,,
14974738962,449.37361,16379365513,461115474,16379362253,-3260,,
14974789668,449.42432,16379416221,461166177,16379412955,-3266,,
14974839810,449.47446,16379466370,461216325,16379463113,-3257,,
14974889973,449.52462,16379516532,461266477,16379513256,-3276,,
14974940987,449.57563,16379567548,461317501,16379564280,-3268,,
14974991546,449.62619,16379618110,461368056,16379614834,-3276,,
14975042110,449.67676,16379668676,461418606,16379665385,-3291,,
14975092554,449.72720,16379719122,461469047,16379715826,-3296,,
14975143580,449.77823,16379770151,461520070,16379766849,-3302,,
14975194221,449.82887,16379820793,461570709,16379817487,-3306,,
14975244975,449.87962,16379871551,461621460,16379868239,-3312,,
14975295711,449.93036,16379922289,461672194,16379918972,-3317,,
14975346771,449.98142,16379973350,461723250,16379970028,-3322,,
14975397818,450.03247,16380024401,461774296,16380021074,-3327,,
14975448886,450.08353,16380075471,461825361,16380072139,-3332,,
14975499896,450.13454,16380126483,461876367,16380123146,-3337,,
14975550348,450.18500,16380176938,461926818,16380173597,-3341,,
14975600571,450.23522,16380227163,461977038,16380223816,-3347,,
14975650787,450.28544,16380277393,462027262,16380274041,-3352,,
14975701405,450.33605,16380328001,462077866,16380324644,-3357,,
14975752424,450.38707,16380379023,462128883,16380375661,-3362,,
14975803424,450.43807,16380430026,462179879,16380426658,-3368,,
14975854007,450.48865,16380480612,462230460,16380477239,-3373,,
14975905070,450.53972,16380531689,462281534,16380528313,-3376,,
14975955682,450.59033,16380582291,462332130,16380578920,-3371,,
14976006735,450.64138,16380633346,462383180,16380629958,-3388,,
14976057778,450.69243,16380684403,462434232,16380681010,-3393,,
14976108339,450.74299,16380734955,462484779,16380731558,-3397,,
14976159376,450.79402,16380786006,462535824,16380782603,-3403,,
14976210424,450.84507,16380837055,462586869,16380833648,-3407,,
14976260813,450.89546,16380887436,462637244,16380884023,-3413,,
14976311401,450.94605,16380938026,462687830,16380934608,-3418,,
14976362499,450.99715,16380989127,462738924,16380985703,-3424,,
14976413108,451.04776,16381039737,462789530,16381036309,-3428,,
14976463474,451.09812,16381090106,462839894,16381086673,-3433,,
14976513826,451.14847,16381140461,462890244,16381137022,-3439,,
14976564334,451.19898,16381190971,462940748,16381187527,-3444,,
14976614799,451.24945,16381241438,462991212,16381237990,-3448,,
14976665388,451.30004,16381292030,463041798,16381288576,-3454,,
14976715957,451.35060,16381342601,463092363,16381339142,-3459,,
14976766490,451.40114,16381393136,463142895,16381389673,-3463,,
14976817052,451.45170,16381443701,463193454,16381440232,-3469,,
14976867610,451.50226,16381494261,463244008,16381490786,-3475,,
14976918645,451.55329,16381545298,463295040,16381541819,-3479,,
14976969571,451.60422,16381596227,463345965,16381592744,-3483,,
14977020314,451.65496,16381646972,463396705,16381643483,-3489,,
14977070954,451.70560,16381697615,463447343,16381694121,-3494,,
14977121101,451.75575,16381747764,463497487,16381744265,-3499,,
14977171678,451.80633,16381798343,463548061,16381794840,-3503,,
14977222223,451.85687,16381848889,463598602,16381845380,-3509,,
14977273246,451.90789,16381899915,463649622,16381896400,-3515,,
14977323357,451.95801,16381950028,463699731,16381946510,-3518,,
14977373857,452.00851,16382000531,463750228,16381997007,-3524,,
14977424919,452.05957,16382051607,463801299,16382048078,-3529,,
14977475508,452.11016,16382102187,463851885,16382098664,-3523,,
14977526540,452.16119,16382153222,463902903,16382149682,-3540,,
14977577109,452.21176,16382203793,463953470,16382200248,-3545,,
14977628117,452.26277,16382254803,464004475,16382251253,-3550,,
14977678713,452.31336,16382305401,464055068,16382301846,-3555,,
14977729697,452.36435,16382356388,464106050,16382352828,-3560,,
14977780105,452.41475,16382406797,464156454,16382403232,-3565,,
14977830670,452.46532,16382457366,464207017,16382453796,-3570,,
14977881715,452.51636,16382508413,464258059,16382504837,-3576,,
14977932796,452.56744,16382559496,464309137,16382555916,-3580,,
14977983410,452.61806,16382610113,464359748,16382606527,-3586,,
14978033974,452.66862,16382660689,464410321,16382657100,-3589,,
14978084526,452.71917,16382711234,464460859,16382707638,-3596,,
14978134645,452.76929,16382761355,464510975,16382757754,-3601,,
14978185208,452.81986,16382811919,464561536,16382808314,-3605,,
14978236251,452.87090,16382862977,464612587,16382859366,-3611,,
14978286577,452.92122,16382913293,464662899,16382909677,-3616,,
14978337637,452.97228,16382964355,464713956,16382960734,-3621,,
14978388195,453.02284,16383014928,464764524,16383011302,-3626,,
14978439239,453.07389,16383065963,464815554,16383062344,-3619,,
14978490306,453.12495,16383117032,464866617,16383113396,-3636,,
14978540846,453.17549,16383167575,464917156,16383163934,-3641,,
14978591387,453.22604,16383218118,464967693,16383214472,-3646,,
14978641948,453.27660,16383268692,465018262,16383265041,-3651,,
14978692996,453.32764,16383319732,465069297,16383316075,-3657,,
14978743221,453.37787,16383369969,465119530,16383366308,-3661,,
14978794218,453.42887,16383420969,465170524,16383417302,-3667,,
14978844785,453.47943,16383471528,465221077,16383467856,-3672,,
14978895852,453.53050,16383522597,465272142,16383518921,-3676,,
14978946023,453.58067,16383572771,465322310,16383569089,-3682,,
14978996105,453.63075,16383622855,465372390,16383619168,-3687,,
14979046291,453.68094,16383673042,465422573,16383669351,-3691,,
14979096422,453.73107,16383723187,465472712,16383719491,-3696,,
14979147497,453.78215,16383774254,465523773,16383770552,-3702,,
14979198516,453.83316,16383825275,465574789,16383821568,-3707,,
14979249113,453.88376,16383875875,465625385,16383872163,-3712,,
14979300119,453.93477,16383926883,465676387,16383923166,-3717,,
14979351178,453.98583,16383977944,465727443,16383974222,-3722,,
14979401779,454.03643,16384028547,465778042,16384024820,-3727,,
14979452395,454.08704,16384079166,465828655,16384075433,-3733,,
14979503456,454.13810,16384130229,465879713,16384126491,-3738,,
14979553928,454.18858,16384180714,465930193,16384176971,-3743,,
14979604507,454.23915,16384231295,465980770,16384227548,-3747,,
14979655068,454.28972,16384281860,466031329,16384278107,-3753,,
14979705850,454.34050,16384332643,466082107,16384328885,-3758,,
14979756888,454.39154,16384383672,466133132,16384379910,-3762,,
14979807925,454.44257,16384434713,466184167,16384430945,-3768,,
14979858985,454.49363,16384485775,466235224,16384482002,-3773,,
14979910053,454.54470,16384536856,466286299,16384533077,-3779,,
14979960696,454.59534,16384587490,466336929,16384583707,-3783,,
14980011759,454.64641,16384638556,466387989,16384634767,-3789,,
14980061960,454.69661,16384688770,466438197,16384684976,-3794,,
14980113011,454.74766,16384739812,466489235,16384736013,-3799,,
14980163136,454.79778,16384789940,466539359,16384786137,-3803,,
14980213714,454.84836,16384840521,466589934,16384836713,-3808,,
14980264766,454.89941,16384891575,466640983,16384887762,-3813,,
14980315305,454.94995,16384942116,466691519,16384938297,-3819,,
14980365853,455.00050,16384992667,466742064,16384988843,-3824,,
14980416403,455.05105,16385043230,466792623,16385039402,-3828,,
14980466985,455.10163,16385093802,466843191,16385089970,-3832,,
14980518064,455.15271,16385144884,466894267,16385141045,-3839,,
14980569113,455.20376,16385195936,466945313,16385192092,-3844,,
14980620138,455.25479,16385246962,466996335,16385243114,-3848,,
14980671161,455.30581,16385297989,467047357,16385294135,-3854,,
14980721770,455.35642,16385348600,467097963,16385344742,-3858,,
14980772330,455.40698,16385399163,467148520,16385395298,-3865,,
14980823367,455.45801,16385450202,467199554,16385446332,-3870,,
14980874427,455.50907,16385501264,467250612,16385497390,-3874,,
14980925017,455.55966,16385551857,467301199,16385547977,-3880,,
14980975629,455.61028,16385602471,467351808,16385598587,-3884,,
14981026666,455.66131,16385653522,467402855,16385649633,-3889,,
14981077781,455.71243,16385704628,467453955,16385700734,-3894,,
14981128791,455.76344,16385755651,467504973,16385751751,-3900,,
14981179865,455.81451,16385806717,467556032,16385802811,-3906,,
14981230424,455.86507,16385857278,467606590,16385853368,-3910,,
14981280995,455.91564,16385907851,467657157,16385903935,-3916,,
14981332086,455.96673,16385958945,467708245,16385955024,-3921,,
14981382623,456.01727,16386009484,467758781,16386005559,-3925,,
14981433710,456.06836,16386060583,467809875,16386056654,-3929,,
14981484019,456.11867,16386110885,467860170,16386106949,-3936,,
14981535042,456.16969,16386161909,467911190,16386157968,-3941,,
14981585825,456.22047,16386212695,467961972,16386208751,-3944,,
14981636397,456.27105,16386263269,468012540,16386259318,-3951,,
14981687338,456.32199,16386314213,468063478,16386310256,-3957,,
14981738404,456.37305,16386365281,468114543,16386361331,-3950,,
14981789000,456.42365,16386415880,468165135,16386411914,-3966,,
14981839514,456.47416,16386466395,468215646,16386462424,-3971,,
14981890145,456.52479,16386517029,468266274,16386513052,-3977,,
14981940533,456.57518,16386567420,468316661,16386563439,-3981,,
14981991125,456.62577,16386618014,468367250,16386614029,-3985,,
14982041646,456.67629,16386668538,468417767,16386664546,-3992,,
14982092233,456.72688,16386719126,468468352,16386715130,-3996,,
14982142762,456.77741,16386769658,468518878,16386765656,-4002,,
14982193806,456.82845,16386820709,468569924,16386816702,-4007,,
14982244839,456.87949,16386871740,468620949,16386867728,-4012,,
14982295912,456.93056,16386922815,468672021,16386918799,-4016,,
14982346962,456.98161,16386973867,468723067,16386969846,-4021,,
14982397545,457.03219,16387024453,468773648,16387020426,-4027,,
14982448600,457.08325,16387075511,468824700,16387071479,-4032,,
14982499649,457.13430,16387126562,468875746,16387122525,-4037,,
14982550711,457.18536,16387177626,468926805,16387173584,-4042,,
14982601079,457.23573,16387227997,468977171,16387223949,-4048,,
14982651730,457.28638,16387278660,469027830,16387274609,-4051,,
14982702599,457.33725,16387329521,469078686,16387325464,-4057,,
14982753169,457.38782,16387380094,469129252,16387376031,-4063,,
14982803752,457.43840,16387430679,469179833,16387426611,-4068,,
14982854334,457.48898,16387481263,469230413,16387477191,-4072,,
14982904502,457.53915,16387531433,469280577,16387527355,-4078,,
14982954855,457.58950,16387581789,469330928,16387577706,-4083,,
14983005143,457.63979,16387632078,469381213,16387627991,-4087,,
14983055705,457.69035,16387682644,469431773,16387678551,-4093,,
14983106352,457.74100,16387733304,469482428,16387729206,-4098,,
14983156950,457.79160,16387783905,469533024,16387779803,-4102,,
14983207983,457.84263,16387834928,469584042,16387830821,-4107,,
14983259013,457.89366,16387885961,469635070,16387881848,-4113,,
14983310282,457.94493,16387937232,469686335,16387933113,-4119,,
14983360430,457.99508,16387987383,469736481,16387983260,-4123,,
14983411001,458.04565,16388037956,469787060,16388033839,-4117,,
14983461773,458.09642,16388088742,469837829,16388084609,-4133,,
14983512811,458.14746,16388139770,469888854,16388135632,-4138,,
14983563871,458.19852,16388190833,469939924,16388186703,-4130,,
14983614536,458.24918,16388241501,469990573,16388237351,-4150,,
14983665132,458.29978,16388292099,470041166,16388287945,-4154,,
14983715703,458.35035,16388342671,470091735,16388338513,-4158,,
14983766267,458.40091,16388393239,470142297,16388389075,-4164,,
14983816869,458.45152,16388443844,470192897,16388439675,-4169,,
14983867475,458.50212,16388494451,470243510,16388490289,-4162,,
14983918008,458.55266,16388544986,470294029,16388540807,-4179,,
14983968549,458.60320,16388595530,470344567,16388591345,-4185,,
14984019130,458.65378,16388646114,470395146,16388641924,-4190,,
14984070144,458.70479,16388697130,470446157,16388692935,-4195,,
14984120273,458.75492,16388747271,470496294,16388743072,-4199,,
14984170901,458.80555,16388797892,470546909,16388793688,-4204,,
14984221927,458.85658,16388848919,470597932,16388844710,-4209,,
14984272494,458.90714,16388899489,470648497,16388895275,-4214,,
14984322684,458.95733,16388949682,470698684,16388945462,-4220,,
14984373281,459.00793,16389000280,470749278,16388996056,-4224,,
14984423829,459.05848,16389050831,470799824,16389046602,-4229,,
14984474845,459.10949,16389101850,470850836,16389097615,-4235,,
14984525494,459.16014,16389152501,470901482,16389148261,-4240,,
14984576396,459.21104,16389203405,470952382,16389199161,-4244,,
14984627461,459.26211,16389254472,471003444,16389250222,-4250,,
14984677976,459.31262,16389304990,471053956,16389300735,-4255,,
14984729046,459.36369,16389356063,471105024,16389351802,-4261,,
14984779662,459.41431,16389406680,471155637,16389402415,-4265,,
14984830650,459.46530,16389457671,471206622,16389453401,-4270,,
14984881260,459.51591,16389508284,471257230,16389504008,-4276,,
14984931818,459.56647,16389558855,471307797,16389554576,-4279,,
14984982073,459.61672,16389609101,471358037,16389604816,-4285,,
14985032200,459.66685,16389659230,471408161,16389654939,-4291,,
14985082330,459.71698,16389709362,471458289,16389705068,-4294,,
14985132925,459.76757,16389759960,471508881,16389755660,-4300,,
14985183020,459.81767,16389810058,471558973,16389805752,-4306,,
14985233601,459.86825,16389860652,471609564,16389856342,-4310,,
14985284162,459.91881,16389911204,471660111,16389906889,-4315,,
14985334690,459.96934,16389961735,471710636,16389957414,-4321,,
14985385771,460.02042,16390012818,471761714,16390008492,-4326,,
14985436802,460.07145,16390063851,471812742,16390059521,-4330,,
14985487850,460.12250,16390114901,471863787,16390110565,-4336,,
14985538897,460.17354,16390165951,471914831,16390161610,-4341,,
14985589403,460.22405,16390216459,471965335,16390212113,-4346,,
14985640452,460.27510,16390267511,472016382,16390263160,-4351,,
14985691044,460.32569,16390318105,472066971,16390313749,-4356,,
14985742075,460.37672,16390369148,472118008,16390364786,-4362,,
14985793158,460.42781,16390420223,472169079,16390415857,-4366,,
14985844147,460.47879,16390471215,472220066,16390466844,-4371,,
14985894697,460.52934,16390521768,472270612,16390517391,-4377,,
14985944888,460.57954,16390571960,472320800,16390567579,-4381,,
14985995862,460.63051,16390622937,472371772,16390618551,-4386,,
14986046426,460.68107,16390673504,472422334,16390669112,-4392,,
14986096970,460.73162,16390724050,472472875,16390719653,-4397,,
14986147501,460.78215,16390774584,472523403,16390770181,-4403,,
14986197738,460.83239,16390824823,472573637,16390820416,-4407,,
14986248180,460.88283,16390875267,472624076,16390870855,-4412,,
14986299272,460.93392,16390926362,472675167,16390921945,-4417,,
14986350252,460.98490,16390977343,472726143,16390972921,-4422,,
14986400844,461.03549,16391027944,472776738,16391023516,-4428,,
14986451865,461.08651,16391078962,472827750,16391074539,-4423,,
14986502934,461.13758,16391130033,472878817,16391125596,-4437,,
14986553484,461.18813,16391180585,472929365,16391176143,-4442,,
14986604493,461.23914,16391231597,472980370,16391227149,-4448,,
14986655081,461.28973,16391282187,473030956,16391277734,-4453,,
14986705633,461.34028,16391332741,473081506,16391328284,-4457,,
14986756684,461.39133,16391383795,473132553,16391379332,-4463,,
14986807703,461.44235,16391434816,473183570,16391430348,-4468,,
14986858774,461.49342,16391485891,473234640,16391481419,-4472,,
14986909335,461.54398,16391536452,473285196,16391531974,-4478,,
14986960376,461.59502,16391587496,473336234,16391583024,-4472,,
14987010511,461.64516,16391637634,473386366,16391633145,-4489,,
14987061520,461.69617,16391688645,473437374,16391684152,-4493,,
14987112620,461.74727,16391739746,473488470,16391735249,-4497,,
14987163173,461.79782,16391790303,473539020,16391785799,-4504,,
14987213795,461.84844,16391840926,473589640,16391836418,-4508,,
14987264814,461.89946,16391891948,473640657,16391887435,-4513,,
14987315405,461.95005,16391942541,473691244,16391938022,-4519,,
14987365504,462.00015,16391992642,473741340,16391988118,-4524,,
14987416529,462.05118,16392043682,473792375,16392039153,-4529,,
14987467575,462.10222,16392094719,473843407,16392090185,-4534,,
14987518604,462.15325,16392145750,473894432,16392141211,-4539,,
14987569171,462.20382,16392196319,473944997,16392191776,-4543,,
14987619746,462.25439,16392246897,473995569,16392242348,-4549,,
14987670808,462.30546,16392297960,474046628,16392293407,-4553,,
14987721353,462.35600,16392348509,474097171,16392343949,-4560,,
14987772195,462.40684,16392399353,474148011,16392394789,-4564,,
14987822984,462.45763,16392450143,474198796,16392445574,-4569,,
14987873530,462.50818,16392500692,474249339,16392496117,-4575,,
14987924169,462.55882,16392551333,474299976,16392546754,-4579,,
14987974670,462.60932,16392601836,474350474,16392597253,-4583,,
14988025699,462.66035,16392652868,474401500,16392648278,-4590,,
14988076269,462.71092,16392703440,474452067,16392698845,-4595,,
14988127326,462.76197,16392754500,474503122,16392749900,-4600,,
14988177867,462.81252,16392805043,474553660,16392800438,-4605,,
14988228193,462.86284,16392855371,474603983,16392850761,-4610,,
14988278762,462.91341,16392905944,474654550,16392901329,-4615,,
14988329807,462.96445,16392956991,474705593,16392952371,-4620,,
14988379948,463.01460,16393007133,474755730,16393002509,-4624,,
14988430476,463.06512,16393057675,474806266,16393053045,-4630,,
14988481545,463.11619,16393108736,474857323,16393104101,-4635,,
14988532111,463.16676,16393159304,474907886,16393154664,-4640,,
14988583160,463.21781,16393210355,474958931,16393205710,-4645,,
14988633966,463.26861,16393261164,475009735,16393256514,-4650,,
14988684919,463.31957,16393312119,475060685,16393307463,-4656,,
14988735458,463.37011,16393362661,475111221,16393357999,-4662,,
14988786041,463.42069,16393413246,475161802,16393408580,-4666,,
14988836592,463.47124,16393463799,475212350,16393459129,-4670,,
14988887649,463.52230,16393514859,475263404,16393510183,-4676,,
14988937717,463.57236,16393564928,475313469,16393560248,-4680,,
14988988255,463.62290,16393615470,475364005,16393610783,-4687,,
14989038421,463.67307,16393665638,475414168,16393660947,-4691,,
14989088487,463.72314,16393715705,475464231,16393711010,-4695,,
14989139094,463.77374,16393766316,475514836,16393761615,-4701,,
14989190172,463.82482,16393817396,475565912,16393812690,-4706,,
14989240769,463.87542,16393867995,475616505,16393863284,-4711,,
14989291397,463.92604,16393918626,475667130,16393913908,-4718,,
14989341989,463.97664,16393969219,475717720,16393964498,-4721,,
14989392203,464.02685,16394019436,475767932,16394014710,-4726,,
14989442365,464.07701,16394069601,475818090,16394064868,-4733,,
14989492964,464.12761,16394120202,475868687,16394115465,-4737,,
14989544019,464.17867,16394171259,475919739,16394166518,-4741,,
14989594599,464.22925,16394221842,475970316,16394217095,-4747,,
14989645147,464.27979,16394272392,476020863,16394267641,-4751,,
14989696168,464.33082,16394323416,476071881,16394318659,-4757,,
14989746297,464.38094,16394373547,476122006,16394368785,-4762,,
14989796865,464.43151,16394424128,476172583,16394419361,-4767,,
14989847434,464.48208,16394474689,476223138,16394469917,-4772,,
14989897505,464.53215,16394524762,476273206,16394519985,-4777,,
14989948556,464.58320,16394575814,476324254,16394571033,-4781,,
14989998726,464.63337,16394625988,476374422,16394621201,-4787,,
14990049267,464.68392,16394676531,476424960,16394671739,-4792,,
14990099848,464.73450,16394727113,476475538,16394722317,-4796,,
14990150827,464.78548,16394778106,476526525,16394773303,-4803,,
14990201445,464.83609,16394828720,476577135,16394823913,-4807,,
14990251985,464.88663,16394879257,476627667,16394874445,-4812,,
14990303035,464.93768,16394930310,476678714,16394925493,-4817,,
14990353614,464.98826,16394980891,476729291,16394976069,-4822,,
14990404465,465.03911,16395031745,476780140,16395026918,-4827,,
14990455027,465.08967,16395082310,476830698,16395077477,-4833,,
14990505557,465.14020,16395132842,476881225,16395128004,-4838,,
14990556096,465.19074,16395183384,476931762,16395178541,-4843,,
14990606623,465.24127,16395233913,476982287,16395229065,-4848,,
14990657148,465.29180,16395284450,477032819,16395279597,-4853,,
14990707684,465.34233,16395334978,477083342,16395330120,-4858,,
14990758567,465.39321,16395385864,477134223,16395381001,-4863,,
14990808708,465.44336,16395436006,477184360,16395431138,-4868,,
14990859276,465.49392,16395486577,477234926,16395481704,-4873,,
14990910293,465.54494,16395537597,477285941,16395532719,-4878,,
14990960843,465.59549,16395588148,477336487,16395583266,-4882,,
14991011470,465.64612,16395638778,477387111,16395633889,-4889,,
14991061974,465.69662,16395689285,477437613,16395684391,-4894,,
14991112587,465.74723,16395739899,477488233,16395735012,-4887,,
14991163190,465.79784,16395790505,477538823,16395785602,-4903,,
14991213686,465.84833,16395841003,477589316,16395836095,-4908,,
14991263824,465.89847,16395891144,477639452,16395886231,-4913,,
14991314808,465.94946,16395942130,477690433,16395937211,-4919,,
14991365850,466.00050,16395993174,477741472,16395988251,-4923,,
14991416495,466.05114,16396043823,477792116,16396038894,-4929,,
14991467068,466.10172,16396094398,477842696,16396089474,-4924,,
14991517635,466.15228,16396144967,477893250,16396140028,-4939,,
14991567749,466.20240,16396195084,477943361,16396190140,-4944,,
14991618803,466.25345,16396246139,477994412,16396241190,-4949,,
14991669438,466.30409,16396296777,478045045,16396291823,-4954,,
14991720490,466.35514,16396347832,478096093,16396342872,-4960,,
14991771086,466.40573,16396398429,478146687,16396393465,-4964,,
14991821684,466.45633,16396449029,478197293,16396444071,-4958,,
14991872249,466.50690,16396499598,478247844,16396494622,-4976,,
14991922748,466.55740,16396550099,478298341,16396545119,-4980,,
14991972815,466.60746,16396600168,478348405,16396595184,-4984,,
14992023913,466.65856,16396651269,478399500,16396646279,-4990,,
14992074528,466.70918,16396701885,478450113,16396696891,-4994,,
14992125136,466.75978,16396752496,478500719,16396747497,-4999,,
14992176197,466.81084,16396803559,478551786,16396798564,-4995,,
14992226834,466.86148,16396854199,478602410,16396849189,-5010,,
14992277884,466.91253,16396905251,478653458,16396900236,-5015,,
14992328493,466.96314,16396955863,478704064,16396950843,-5020,,
14992379056,467.01370,16397006428,478754624,16397001402,-5026,,
14992429633,467.06428,16397057008,478805200,16397051978,-5030,,
14992480637,467.11528,16397108014,478856201,16397102979,-5035,,
14992531726,467.16637,16397159105,478907287,16397154065,-5040,,
14992582727,467.21738,16397210109,478958284,16397205063,-5046,,
14992633086,467.26773,16397260481,479008653,16397255431,-5050,,
14992683635,467.31828,16397311020,479059187,16397305965,-5055,,
14992734211,467.36886,16397361600,479109760,16397356539,-5061,,
14992784760,467.41941,16397412151,479160308,16397407086,-5065,,
14992834900,467.46955,16397462293,479210444,16397457223,-5070,,
14992885515,467.52016,16397512911,479261056,16397507835,-5076,,
14992936590,467.57124,16397563988,479312129,16397558907,-5081,,
14992987051,467.62170,16397614452,479362587,16397609366,-5086,,
14993038115,467.67276,16397665518,479413648,16397660427,-5091,,
14993088238,467.72289,16397715642,479463768,16397710546,-5096,,
14993138359,467.77301,16397765766,479513887,16397760665,-5101,,
14993188912,467.82356,16397816322,479564437,16397811216,-5106,,
14993239495,467.87414,16397866907,479615017,16397861796,-5111,,
14993289656,467.92430,16397917071,479665177,16397911955,-5116,,
14993340284,467.97493,16397967700,479715801,16397962579,-5121,,
14993391356,468.02600,16398018775,479766870,16398013649,-5126,,
14993442087,468.07673,16398069508,479817598,16398064376,-5132,,
14993493140,468.12779,16398120563,479868649,16398115428,-5135,,
14993543895,468.17854,16398171320,479919401,16398166179,-5141,,
14993594943,468.22959,16398222372,479970447,16398217225,-5147,,
14993644993,468.27964,16398272424,480020494,16398267273,-5151,,
14993695164,468.32981,16398322597,480070662,16398317441,-5156,,
14993746185,468.38083,16398373621,480121681,16398368459,-5162,,
14993796343,468.43099,16398423781,480171835,16398418614,-5167,,
14993846952,468.48160,16398474403,480222453,16398469232,-5171,,
14993897412,468.53206,16398524855,480272900,16398519678,-5177,,
14993948467,468.58312,16398575922,480323962,16398570740,-5182,,
14993999047,468.63369,16398626495,480374529,16398621308,-5187,,
14994049361,468.68401,16398676811,480424840,16398671619,-5192,,
14994099660,468.73431,16398727111,480475136,16398721915,-5196,,
14994150329,468.78498,16398777783,480525802,16398772581,-5202,,
14994200927,468.83558,16398828384,480576399,16398823177,-5207,,
14994251381,468.88603,16398878840,480626849,16398873628,-5212,,
14994301960,468.93661,16398929421,480677425,16398924203,-5218,,
14994352499,468.98715,16398979973,480727973,16398974752,-5221,,
14994403518,469.03817,16399031126,480779121,16399025899,-5227,,
14994454621,469.08927,16399082090,480830078,16399076857,-5233,,
14994505670,469.14032,16399133141,480881124,16399127903,-5238,,
14994556698,469.19135,16399184172,480932150,16399178929,-5243,,
14994607330,469.24198,16399234806,480982779,16399229558,-5248,,
14994657468,469.29212,16399284945,481032914,16399279692,-5253,,
14994708524,469.34317,16399336005,481083968,16399330747,-5258,,
14994759536,469.39418,16399387019,481134977,16399381756,-5263,,
14994810358,469.44501,16399437843,481185796,16399432574,-5269,,
14994860456,469.49510,16399487944,481235892,16399482671,-5273,,
14994910574,469.54522,16399538063,481286007,16399532785,-5278,,
14994961623,469.59627,16399589114,481337053,16399583832,-5282,,
14995012163,469.64681,16399639657,481387590,16399634368,-5289,,
14995062771,469.69742,16399690277,481438206,16399684986,-5291,,
14995113780,469.74843,16399741278,481489202,16399735980,-5298,,
14995164868,469.79952,16399792370,481540287,16399787066,-5304,,
14995215461,469.85011,16399842975,481590889,16399837667,-5308,,
14995266193,469.90084,16399893700,481641619,16399888398,-5302,,
14995317248,469.95190,16399944757,481692659,16399939438,-5319,,
14995368295,470.00294,16399995806,481743703,16399990482,-5324,,
14995418852,470.05350,16400046366,481794258,16400041037,-5329,,
14995469896,470.10454,16400097412,481845300,16400092078,-5334,,
14995520422,470.15507,16400147940,481895822,16400142601,-5339,,
14995570993,470.20564,16400198514,481946391,16400193180,-5334,,
14995621551,470.25620,16400249074,481996946,16400243725,-5349,,
14995672602,470.30725,16400300127,482048004,16400294783,-5344,,
14995723674,470.35832,16400351202,482099063,16400345842,-5360,,
14995774720,470.40937,16400402249,482150107,16400396885,-5364,,
14995825769,470.46042,16400453302,482201153,16400447932,-5370,,
14995876809,470.51146,16400504344,482252190,16400498969,-5375,,
14995927821,470.56247,16400555358,482303200,16400549978,-5380,,
14995977907,470.61255,16400605447,482353284,16400600062,-5385,,
14996028957,470.66361,16400656498,482404330,16400651108,-5390,,
14996079625,470.71427,16400707169,482454996,16400701774,-5395,,
14996129764,470.76441,16400757311,482505143,16400751921,-5390,,
14996180856,470.81550,16400808404,482556221,16400802999,-5405,,
14996230965,470.86561,16400858515,482606327,16400853105,-5410,,
14996281573,470.91622,16400909127,482656932,16400903710,-5417,,
14996332174,470.96682,16400959730,482707532,16400954311,-5419,,
14996382340,471.01699,16401009910,482757706,16401004485,-5425,,
14996433390,471.06804,16401060950,482808741,16401055519,-5431,,
14996483883,471.11853,16401111445,482859232,16401106011,-5434,,
14996534524,471.16917,16401162089,482909870,16401156649,-5440,,
14996585038,471.21969,16401212605,482960381,16401207159,-5446,,
14996636079,471.27073,16401263649,483011420,16401258199,-5450,,
14996686197,471.32085,16401313769,483061535,16401308313,-5456,,
14996736831,471.37148,16401364406,483112166,16401358945,-5461,,
14996787448,471.42210,16401415024,483162780,16401409558,-5466,,
14996838478,471.47313,16401466058,483213809,16401460587,-5471,,
14996889005,471.52365,16401516587,483264332,16401511110,-5477,,
14996939604,471.57425,16401567188,483314928,16401561707,-5481,,
14996990328,471.62498,16401617915,483365650,16401612429,-5486,,
14997040955,471.67560,16401668543,483416274,16401663052,-5491,,
14997091977,471.72663,16401719568,483467294,16401714072,-5496,,
14997143006,471.77765,16401770600,483518319,16401765098,-5502,,
14997193131,471.82778,16401820727,483568442,16401815221,-5506,,
14997243658,471.87831,16401871256,483618966,16401865745,-5511,,
14997294723,471.92937,16401922324,483670029,16401916807,-5517,,
14997345625,471.98027,16401973228,483720929,16401967707,-5521,,
14997396126,472.03077,16402023732,483771427,16402018205,-5527,,
14997446208,472.08086,16402073816,483821506,16402068284,-5532,,
14997497271,472.13192,16402124881,483872566,16402119344,-5537,,
14997548295,472.18294,16402175920,483923600,16402170379,-5541,,
14997599317,472.23397,16402226932,483974607,16402221385,-5547,,
14997649916,472.28456,16402277533,484025202,16402271981,-5552,,
14997700966,472.33561,16402328585,484076250,16402323029,-5556,,
14997751915,472.38656,16402379537,484127197,16402373975,-5562,,
14997803023,472.43767,16402430646,484178301,16402425080,-5566,,
14997853572,472.48822,16402481199,484228847,16402475626,-5573,,
14997904566,472.53921,16402532195,484279840,16402526618,-5577,,
14997954641,472.58929,16402582273,484329911,16402576690,-5583,,
14998005714,472.64036,16402633348,484380982,16402627760,-5588,,
14998056348,472.69100,16402683984,484431613,16402678392,-5592,,
14998107309,472.74196,16402734948,484482572,16402729350,-5598,,
14998157933,472.79258,16402785574,484533193,16402779971,-5603,,
14998208983,472.84363,16402836626,484584239,16402831018,-5608,,
14998260006,472.89465,16402887652,484635261,16402882039,-5613,,
14998310636,472.94528,16402938296,484685899,16402932678,-5618,,
14998361209,472.99586,16402988859,484736457,16402983236,-5623,,
14998412230,473.04688,16403039882,484787475,16403034253,-5629,,
14998462805,473.09745,16403090460,484838048,16403084827,-5633,,
14998513836,473.14848,16403141493,484889076,16403135854,-5639,,
14998564442,473.19909,16403192102,484939679,16403186458,-5644,,
14998614780,473.24943,16403242442,484990016,16403236794,-5648,,
14998665377,473.30003,16403293042,485040609,16403287388,-5654,,
14998716437,473.35109,16403344104,485091677,16403338456,-5648,,
14998766613,473.40126,16403394282,485141840,16403388619,-5663,,
14998817176,473.45182,16403444848,485192400,16403439179,-5669,,
14998868263,473.50291,16403495937,485243484,16403490263,-5674,,
14998919313,473.55396,16403546988,485294531,16403541310,-5678,,
14998969839,473.60449,16403597528,485345066,16403591844,-5684,,
14999020372,473.65502,16403648053,485395585,16403642364,-5689,,
14999070951,473.70560,16403698634,485446161,16403692940,-5694,,
14999121544,473.75619,16403749230,485496752,16403743541,-5689,,
14999172098,473.80675,16403799785,485547303,16403794081,-5704,,
14999222163,473.85681,16403849852,485597365,16403844144,-5708,,
14999272326,473.90697,16403900028,485647535,16403894314,-5714,,
14999322959,473.95761,16403950654,485698156,16403944935,-5719,,
14999373564,474.00821,16404001262,485748759,16403995537,-5725,,
14999424583,474.05923,16404052282,485799774,16404046552,-5730,,
14999475641,474.11029,16404103354,485850842,16404097620,-5734,,
14999526679,474.16133,16404154383,485901865,16404148643,-5740,,
14999577386,474.21203,16404205092,485952569,16404199357,-5735,,
14999628051,474.26270,16404255759,486003231,16404250009,-5750,,
14999678599,474.31325,16404306311,486053777,16404300556,-5755,,
14999728779,474.36343,16404356492,486103954,16404350733,-5759,,
14999779343,474.41399,16404407059,486154516,16404401294,-5765,,
14999829963,474.46461,16404457682,486205133,16404451912,-5770,,
14999880565,474.51521,16404508286,486255733,16404502511,-5775,,
14999931091,474.56574,16404558814,486306256,16404553034,-5780,,
14999981640,474.61629,16404609366,486356803,16404603581,-5785,,
15000032172,474.66682,16404659900,486407332,16404654110,-5790,,
15000082733,474.71738,16404710473,486457899,16404704678,-5795,,
15000133317,474.76797,16404761049,486508480,16404755259,-5790,,
15000183879,474.81853,16404811614,486559030,16404805809,-5805,,
15000234839,474.86949,16404862577,486609987,16404856766,-5811,,
15000285511,474.92016,16404913250,486660656,16404907434,-5816,,
15000336125,474.97077,16404963867,486711269,16404958047,-5820,,
15000386695,475.02134,16405014451,486761846,16405008625,-5826,,
15000437245,475.07189,16405064991,486812382,16405059160,-5831,,
15000487787,475.12243,16405115535,486862921,16405109699,-5836,,
15000538443,475.17309,16405166195,486913575,16405160354,-5841,,
15000589323,475.22397,16405217076,486964452,16405211230,-5846,,
15000639910,475.27456,16405267666,487015048,16405261826,-5840,,
15000691001,475.32565,16405318759,487066125,16405312903,-5856,,
15000741517,475.37617,16405369278,487116638,16405363427,-5851,,
15000792079,475.42673,16405419842,487167207,16405413986,-5856,,
15000842724,475.47737,16405470490,487217850,16405464628,-5862,,
15000893759,475.52841,16405521527,487268872,16405515651,-5876,,
15000944357,475.57900,16405572138,487319478,16405566256,-5882,,
15000994900,475.62955,16405622673,487370008,16405616786,-5887,,
15001045935,475.68058,16405673710,487421041,16405667819,-5891,,
15001096575,475.73122,16405724362,487471687,16405718466,-5896,,
15001147505,475.78215,16405775284,487522604,16405769382,-5902,,
15001197668,475.83232,16405825450,487572764,16405819543,-5907,,
15001248048,475.88270,16405875833,487623142,16405869921,-5912,,
15001298843,475.93349,16405926630,487673934,16405920713,-5917,,
15001349602,475.98425,16405977391,487724690,16405971469,-5922,,
15001400476,476.03512,16406028268,487775563,16406022341,-5927,,
15001451597,476.08625,16406079391,487826681,16406073459,-5932,,
15001502432,476.13708,16406130239,487877522,16406124300,-5939,,
15001553052,476.18770,16406180850,487928129,16406174907,-5943,,
15001603635,476.23828,16406231436,487978711,16406225489,-5947,,
15001654278,476.28893,16406282082,488029351,16406276129,-5953,,
15001705164,476.33981,16406332969,488080233,16406327011,-5958,,
15001755823,476.39047,16406383631,488130890,16406377668,-5963,,
15001806102,476.44075,16406433913,488181167,16406427945,-5968,,
15001856980,476.49163,16406484792,488232041,16406478819,-5973,,
15001907514,476.54216,16406535328,488282572,16406529350,-5978,,
15001958084,476.59273,16406585902,488333140,16406579919,-5983,,
15002008626,476.64327,16406636445,488383679,16406630458,-5987,,
15002059173,476.69382,16406686995,488434224,16406681002,-5993,,
15002109278,476.74393,16406737102,488484326,16406731104,-5998,,
15002159881,476.79453,16406787708,488534926,16406781705,-6003,,
15002210344,476.84499,16406838173,488585386,16406832165,-6008,,
15002260935,476.89558,16406888766,488635975,16406882753,-6013,,
15002311983,476.94663,16406939817,488687020,16406933799,-6018,,
15002362557,476.99721,16406990394,488737591,16406984369,-6025,,
15002413622,477.04827,16407041461,488788664,16407035443,-6018,,
15002463951,477.09860,16407091791,488838980,16407085759,-6032,,
15002514534,477.14918,16407142378,488889561,16407136339,-6039,,
15002564714,477.19936,16407192559,488939737,16407186515,-6044,,
15002615289,477.24994,16407243137,488990310,16407237089,-6048,,
15002665514,477.30016,16407293365,489040543,16407287321,-6044,,
15002716585,477.35123,16407344438,489091601,16407338379,-6059,,
15002767212,477.40186,16407395067,489142224,16407389003,-6064,,
15002818219,477.45287,16407446076,489193229,16407440007,-6069,,
15002869256,477.50390,16407497116,489244264,16407491042,-6074,,
15002919416,477.55406,16407547277,489294420,16407541198,-6079,,
15002970467,477.60512,16407598331,489345469,16407592247,-6084,,
15003020726,477.65537,16407648592,489395725,16407642504,-6088,,
15003071778,477.70643,16407699646,489446774,16407693552,-6094,,
15003122596,477.75724,16407750468,489497590,16407744368,-6100,,
15003173165,477.80781,16407801040,489548157,16407794936,-6104,,
15003224260,477.85891,16407852137,489599248,16407846027,-6110,,
15003274811,477.90946,16407902689,489649796,16407896574,-6115,,
15003325437,477.96008,16407953317,489700420,16407947199,-6118,,
15003376487,478.01114,16408004370,489751467,16407998245,-6125,,
15003427102,478.06175,16408054988,489802079,16408048858,-6130,,
15003478116,478.11276,16408106003,489853090,16408099868,-6135,,
15003528710,478.16336,16408156601,489903683,16408150461,-6140,,
15003579300,478.21395,16408207193,489954269,16408201048,-6145,,
15003630353,478.26500,16408258247,490005319,16408252098,-6149,,
15003680968,478.31562,16408308866,490055933,16408302711,-6155,,
15003732015,478.36666,16408359915,490106976,16408353755,-6160,,
15003782606,478.41725,16408410520,490157575,16408404354,-6166,,
15003832914,478.46756,16408460819,490207869,16408454647,-6172,,
15003883911,478.51856,16408511818,490258865,16408505643,-6175,,
15003934070,478.56872,16408561980,490309020,16408555799,-6181,,
15003984679,478.61933,16408612590,490359626,16408606404,-6186,,
15004035185,478.66983,16408663098,490410130,16408656908,-6190,,
15004085289,478.71994,16408713206,490460232,16408707010,-6196,,
15004136371,478.77102,16408764290,490511311,16408758089,-6201,,
15004186963,478.82161,16408814884,490561901,16408808679,-6205,,
15004237575,478.87222,16408865500,490612510,16408859289,-6211,,
15004288170,478.92282,16408916095,490663101,16408909879,-6216,,
15004338757,478.97341,16408966684,490713685,16408960464,-6220,,
15004389764,479.02441,16409017695,490764690,16409011469,-6226,,
15004440331,479.07498,16409068274,490815265,16409062043,-6231,,
15004491369,479.12602,16409119305,490866289,16409113068,-6237,,
15004542429,479.17708,16409170376,490917357,16409164135,-6241,,
15004593449,479.22810,16409221389,490968364,16409215143,-6246,,
15004643934,479.27858,16409271887,491018856,16409265635,-6252,,
15004694102,479.32875,16409322046,491069011,16409315789,-6257,,
15004745108,479.37976,16409373054,491120015,16409366793,-6261,,
15004795655,479.43030,16409423605,491170559,16409417338,-6267,,
15004846209,479.48086,16409474161,491221111,16409467889,-6272,,
15004896776,479.53142,16409524742,491271687,16409518466,-6276,,
15004947812,479.58246,16409575781,491322721,16409569500,-6281,,
15004997950,479.63260,16409625908,491372843,16409619622,-6286,,
15005048959,479.68361,16409676920,491423849,16409670627,-6293,,
15005100048,479.73470,16409728011,491474936,16409721714,-6297,,
15005151053,479.78570,16409779019,491525938,16409772717,-6302,,
15005201258,479.83591,16409829227,491576141,16409822919,-6308,,
15005252015,479.88666,16409879986,491626895,16409873674,-6312,,
15005302581,479.93723,16409930554,491677459,16409924237,-6317,,
15005353214,479.98786,16409981190,491728088,16409974867,-6323,,
15005403714,480.03836,16410031691,491778585,16410025364,-6327,,
15005454735,480.08938,16410082715,491829604,16410076383,-6332,,
15005505790,480.14044,16410133772,491880655,16410127434,-6338,,
15005556858,480.19151,16410184843,491931722,16410178500,-6343,,
15005607907,480.24255,16410235894,491982769,16410229547,-6347,,
15005658523,480.29317,16410286513,492033381,16410280159,-6354,,
15005709543,480.34419,16410337535,492084399,16410331177,-6358,,
15005760099,480.39475,16410388105,492134963,16410381741,-6364,,
15005810637,480.44529,16410438633,492185487,16410432265,-6368,,
15005861211,480.49586,16410489210,492236059,16410482837,-6373,,
15005912215,480.54686,16410540216,492287059,16410533837,-6379,,
15005962808,480.59746,16410590812,492337650,16410584429,-6383,,
15006013857,480.64851,16410641863,492388696,16410635474,-6389,,
15006064863,480.69951,16410692872,492439700,16410686478,-6394,,
15006114956,480.74960,16410742967,492489789,16410736568,-6399,,
15006166033,480.80068,16410794045,492540864,16410787642,-6403,,
15006216587,480.85123,16410844603,492591416,16410838194,-6409,,
15006267595,480.90224,16410895613,492642421,16410889199,-6414,,
15006318206,480.95285,16410946225,492693029,16410939807,-6418,,
15006369305,481.00395,16410997328,492744125,16410990904,-6424,,
15006420299,481.05495,16411048324,492795116,16411041895,-6429,,
15006470529,481.10518,16411098557,492845343,16411092122,-6435,,
15006521063,481.15571,16411149093,492895876,16411142655,-6438,,
15006571200,481.20585,16411199232,492946009,16411192788,-6444,,
15006621806,481.25645,16411249841,492996613,16411243391,-6450,,
15006671952,481.30660,16411299989,493046767,16411293546,-6443,,
15006722616,481.35726,16411350654,493097417,16411344195,-6459,,
15006773143,481.40779,16411401195,493147951,16411394730,-6465,,
15006824180,481.45883,16411452224,493198975,16411445754,-6470,,
15006874759,481.50941,16411502805,493249552,16411496330,-6475,,
15006925311,481.55996,16411553359,493300101,16411546879,-6480,,
15006975428,481.61008,16411603479,493350215,16411596994,-6485,,
15007026023,481.66067,16411654076,493400819,16411647598,-6478,,
15007076771,481.71142,16411704827,493451554,16411698332,-6495,,
15007127606,481.76225,16411755663,493502385,16411749163,-6500,,
15007178567,481.81322,16411806627,493553344,16411800122,-6505,,
15007229342,481.86399,16411857405,493604116,16411850895,-6510,,
15007280449,481.91510,16411908513,493655220,16411901998,-6515,,
15007330959,481.96561,16411959037,493705737,16411952516,-6521,,
15007565919,482.20057,16412193997,493940675,16412187453,-6544,16412193349,
15007591409,482.22606,16412219488,493966163,16412212970,-6518,,
15007642145,482.27679,16412270227,494016897,16412263765,-6462,,
15007692763,482.32741,16412320847,494067513,16412314440,-6407,,
15007743769,482.37842,16412371855,494118515,16412365502,-6353,,
15007794381,482.42903,16412422470,494169126,16412416173,-6297,,
15007844956,482.47960,16412473047,494219697,16412466805,-6242,,
15007895555,482.53020,16412523648,494270293,16412517459,-6189,,
15007946172,482.58082,16412574268,494320907,16412568133,-6135,,
15007996689,482.63134,16412624788,494371423,16412618709,-6079,,
15008047222,482.68187,16412675322,494421952,16412669297,-6025,,
15008098320,482.73297,16412726422,494473047,16412720452,-5970,,
15008148858,482.78351,16412776964,494523584,16412771049,-5915,,
15008199940,482.83459,16412828048,494574662,16412822188,-5860,,
15008250953,482.88560,16412879062,494625672,16412873258,-5804,,
15008301117,482.93577,16412929229,494675833,16412923478,-5751,,
15008352134,482.98678,16412980249,494726849,16412974554,-5695,,
15008402732,483.03738,16413030849,494777443,16413025208,-5641,,
15008453729,483.08838,16413081848,494828437,16413076262,-5586,,
15008504376,483.13902,16413132497,494879082,16413126976,-5521,,
15008555445,483.19009,16413183569,494930148,16413178094,-5475,,
15008606469,483.24112,16413234596,494981169,16413229174,-5422,,
15008657008,483.29166,16413285136,495031705,16413279769,-5367,,
15008707555,483.34220,16413335687,495082250,16413330375,-5312,,
15008758619,483.39327,16413386753,495133311,16413381496,-5257,,
15008809592,483.44424,16413437728,495184282,16413432526,-5202,,
15008860221,483.49487,16413488360,495234909,16413483213,-5147,,
15008910828,483.54548,16413538969,495285513,16413533877,-5092,,
15008960941,483.59559,16413589084,495335622,16413584046,-5038,,
15009011751,483.64640,16413639897,495386430,16413634913,-4984,,
15009062287,483.69693,16413690434,495436963,16413685505,-4929,,
15009112881,483.74753,16413741030,495487554,16413736156,-4874,,
15009163409,483.79806,16413791572,495538089,16413786752,-4820,,
15009214464,483.84911,16413842619,495589132,16413837855,-4764,,
15009265492,483.90014,16413893650,495640157,16413888940,-4710,,
15009316033,483.95068,16413944204,495690707,16413939549,-4655,,
15009366900,484.00155,16413995061,495741559,16413990461,-4600,,
15009417811,484.05246,16414045975,495792468,16414041430,-4545,,
15009468512,484.10316,16414096679,495843166,16414092189,-4490,,
15009519041,484.15369,16414147219,495893702,16414142784,-4435,,
15009569524,484.20417,16414197696,495944173,16414193315,-4381,,
15009620576,484.25522,16414248749,495995222,16414244423,-4326,,
15009671611,484.30626,16414299786,496046254,16414295515,-4271,,
15009722262,484.35691,16414350441,496096902,16414346224,-4217,,
15009773305,484.40795,16414401486,496147943,16414397325,-4161,,
15009823849,484.45850,16414452032,496198485,16414447926,-4106,,
15009874732,484.50938,16414502918,496249364,16414498866,-4052,,
15009925751,484.56040,16414553939,496300382,16414549943,-3996,,
15009976312,484.61096,16414604519,496350955,16414600577,-3942,,
15010026778,484.66143,16414654970,496401402,16414651083,-3887,,
15010077348,484.71200,16414705544,496451971,16414701712,-3832,,
15010127913,484.76256,16414756111,496502533,16414752332,-3779,,
15010178027,484.81268,16414806227,496552643,16414802501,-3726,,
15010229041,484.86369,16414857242,496603654,16414853573,-3669,,
15010280109,484.91476,16414908314,496654720,16414904700,-3614,,
15010330717,484.96537,16414958924,496705326,16414955365,-3559,,
15010381767,485.01641,16415009976,496756372,16415006472,-3504,,
15010432268,485.06692,16415060480,496806871,16415057029,-3451,,
15010483318,485.11797,16415111531,496857918,16415108137,-3394,,
15010533867,485.16852,16415162083,496908464,16415158743,-3340,,
15010584876,485.21952,16415213094,496959470,16415209808,-3286,,
15010635431,485.27008,16415263651,497010023,16415260421,-3230,,
15010685872,485.32052,16415314096,497060462,16415310920,-3176,,
15010736472,485.37112,16415364708,497111069,16415361586,-3122,,
15010787092,485.42174,16415415320,497161675,16415412253,-3067,,
15010837638,485.47229,16415465879,497212230,16415462867,-3012,,
15010888264,485.52291,16415516497,497262842,16415513539,-2958,,
15010938914,485.57356,16415567149,497313489,16415564246,-2903,,
15010989925,485.62457,16415618163,497364498,16415615315,-2848,,
15011040582,485.67523,16415668822,497415153,16415666029,-2793,,
15011091126,485.72577,16415719368,497465693,16415716630,-2738,,
15011141695,485.77634,16415769939,497516259,16415767254,-2685,,
15011191997,485.82664,16415820244,497566559,16415817615,-2629,,
15011243050,485.87770,16415871298,497617620,16415868736,-2562,,
15011294074,485.92872,16415922325,497668630,16415919805,-2520,,
15011344222,485.97887,16415972476,497718777,16415970011,-2465,,
15011394340,486.02899,16416022596,497768892,16416020185,-2411,,
15011444903,486.07955,16416073162,497819451,16416070804,-2358,,
15011495339,486.12999,16416123600,497869885,16416121298,-2302,,
15011546362,486.18101,16416174626,497920906,16416172379,-2247,,
15011597388,486.23204,16416225654,497971929,16416223462,-2192,,
15011647980,486.28263,16416276248,498022519,16416274111,-2137,,
15011698559,486.33321,16416326830,498073095,16416324748,-2082,,
15011749575,486.38422,16416377859,498124119,16416375831,-2028,,
15011800213,486.43486,16416428487,498174742,16416426515,-1972,,
15011850736,486.48538,16416479014,498225264,16416477097,-1917,,
15011901312,486.53596,16416529601,498275846,16416527737,-1864,,
15011952397,486.58704,16416580679,498326918,16416578870,-1809,,
15012003444,486.63809,16416631729,498377962,16416629975,-1754,,
15012054447,486.68910,16416682734,498428963,16416681036,-1698,,
15012104989,486.73964,16416733279,498479503,16416731634,-1645,,
15012156074,486.79072,16416784366,498530584,16416782777,-1589,,
15012206622,486.84127,16416834916,498581129,16416833381,-1535,,
15012257671,486.89232,16416885968,498632177,16416884489,-1479,,
15012308721,486.94337,16416937019,498683223,16416935595,-1424,,
15012359262,486.99391,16416987562,498733761,16416986192,-1370,,
15012409383,487.04403,16417037686,498783880,16417036370,-1316,,
15012459496,487.09414,16417087806,498833994,16417086545,-1261,,
15012510086,487.14473,16417138394,498884578,16417137187,-1207,,
15012560698,487.19535,16417189009,498935188,16417187857,-1152,,
15012611728,487.24638,16417240041,498986214,16417238890,-1151,,
15012662297,487.29694,16417290612,499036780,16417289456,-1156,,
15012712369,487.34702,16417340687,499086850,16417339525,-1162,,
15012762731,487.39738,16417391050,499137209,16417389884,-1166,,
15012813758,487.44841,16417442080,499188233,16417440909,-1171,,
15012864808,487.49946,16417493133,499239281,16417491957,-1176,,
15012915005,487.54965,16417543332,499289476,16417542151,-1181,,
15012965522,487.60017,16417593851,499339989,16417592664,-1187,,
15013015922,487.65057,16417644254,499390386,16417643062,-1192,,
15013066247,487.70090,16417694581,499440719,16417693394,-1187,,
15013116393,487.75104,16417744729,499490852,16417743527,-1202,,
15013167386,487.80203,16417795725,499541842,16417794518,-1207,,
15013217869,487.85252,16417846209,499592333,16417845008,-1201,,
15013268929,487.90358,16417897273,499643380,16417896056,-1217,,
15013319987,487.95463,16417948333,499694436,16417947111,-1222,,
15013371004,488.00565,16417999352,499745450,16417998125,-1227,,
15013422087,488.05674,16418050438,499796529,16418049205,-1233,,
15013472860,488.10751,16418101213,499847301,16418099976,-1237,,
15013523935,488.15858,16418152291,499898372,16418151048,-1243,,
15013574971,488.20962,16418203329,499949406,16418202082,-1247,,
15013625529,488.26018,16418253888,499999961,16418252637,-1251,,
15013676567,488.31122,16418304930,500050996,16418303681,-1249,,
15013727637,488.36228,16418356002,500102064,16418354739,-1263,,
15013778655,488.41330,16418407021,500153078,16418405754,-1267,,
15013829714,488.46436,16418458084,500204135,16418456821,-1263,,
15013880788,488.51544,16418509160,500255207,16418507882,-1278,,
15013931801,488.56645,16418560175,500306217,16418558892,-1283,,
15013982880,488.61753,16418611257,500357292,16418609968,-1289,,
15014033931,488.66858,16418662310,500408341,16418661017,-1293,,
15014084434,488.71908,16418712815,500458841,16418711516,-1299,,
15014135488,488.77014,16418763872,500509892,16418762568,-1304,,
15014186317,488.82097,16418814703,500560719,16418813395,-1308,,
15014236892,488.87154,16418865281,500611291,16418863967,-1314,,
15014287490,488.92214,16418915880,500661896,16418914572,-1308,,
15014338599,488.97325,16418966992,500712993,16418965668,-1324,,
15014389187,489.02384,16419017594,500763590,16419016265,-1329,,
15014439825,489.07447,16419068223,500814213,16419066889,-1334,,
15014490849,489.12550,16419119248,500865234,16419117910,-1338,,
15014541887,489.17654,16419170290,500916270,16419168946,-1344,,
15014592925,489.22757,16419221329,500967305,16419219980,-1349,,
15014643498,489.27815,16419271915,501017886,16419270562,-1353,,
15014694575,489.32922,16419322984,501068949,16419321625,-1359,,
15014745109,489.37976,16419373521,501119482,16419372168,-1353,,
15014795729,489.43038,16419424144,501170098,16419422774,-1370,,
15014846276,489.48092,16419474692,501220642,16419473317,-1375,,
15014896754,489.53140,16419525173,501271119,16419523794,-1379,,
15014947809,489.58246,16419576231,501322171,16419574846,-1385,,
15014998834,489.63348,16419627258,501373193,16419625868,-1390,,
15015049395,489.68404,16419677821,501423751,16419676426,-1395,,
15015100447,489.73510,16419728875,501474800,16419727476,-1399,,
15015151032,489.78568,16419779463,501525382,16419778058,-1405,,
15015201562,489.83621,16419830007,501575921,16419828597,-1410,,
15015252141,489.88679,16419880577,501626486,16419879162,-1415,,
15015303196,489.93784,16419931634,501677538,16419930214,-1420,,
15015354273,489.98892,16419982713,501728612,16419981287,-1426,,
15015404646,490.03929,16420033099,501778993,16420031668,-1431,,
15015455711,490.09036,16420084155,501830045,16420082720,-1435,,
15015506466,490.14111,16420134914,501880797,16420133473,-1441,,
15015557447,490.19209,16420185897,501931776,16420184451,-1446,,
15015608043,490.24269,16420236495,501982369,16420235045,-1450,,
15015659077,490.29372,16420287531,502033400,16420286076,-1455,,
15015710079,490.34473,16420338536,502084399,16420337075,-1461,,
15015760185,490.39483,16420388645,502134503,16420387178,-1467,,
15015811232,490.44588,16420439693,502185547,16420438222,-1471,,
15015861356,490.49600,16420489820,502235669,16420488344,-1476,,
15015912382,490.54703,16420540848,502286691,16420539367,-1481,,
15015963421,490.59807,16420591889,502337726,16420590402,-1487,,
15016013980,490.64863,16420642451,502388285,16420640960,-1491,,
15016065072,490.69972,16420693545,502439373,16420692048,-1497,,
15016115569,490.75022,16420744044,502489867,16420742542,-1502,,
15016166111,490.80076,16420794589,502540407,16420793082,-1507,,
15016216676,490.85132,16420845157,502590969,16420843645,-1512,,
15016267201,490.90185,16420895683,502641491,16420894167,-1516,,
15016317864,490.95251,16420946348,502692152,16420944827,-1521,,
15016368915,491.00356,16420997403,502743201,16420995876,-1527,,
15016419519,491.05417,16421048009,502793801,16421046477,-1532,,
15016470089,491.10474,16421098582,502844368,16421097044,-1538,,
15016520643,491.15529,16421149139,502894922,16421147597,-1542,,
15016570924,491.20557,16421199420,502945198,16421197874,-1546,,
15016621253,491.25590,16421249753,502995524,16421248200,-1553,,
15016672309,491.30696,16421300811,503046579,16421299254,-1557,,
15016723341,491.35799,16421351844,503097607,16421350282,-1562,,
15016773899,491.40855,16421402405,503148162,16421400837,-1568,,
15016824483,491.45913,16421452992,503198744,16421451419,-1573,,
15016875492,491.51014,16421504003,503249751,16421502426,-1577,,
15016926544,491.56119,16421555068,503300810,16421553486,-1582,,
15016977623,491.61227,16421606138,503351875,16421604551,-1587,,
15017028659,491.66331,16421657177,503402910,16421655585,-1592,,
15017079732,491.71438,16421708253,503453979,16421706655,-1598,,
15017130769,491.76542,16421759291,503505013,16421757688,-1603,,
15017181268,491.81592,16421809794,503555509,16421808185,-1609,,
15017231957,491.86660,16421860485,503606196,16421858872,-1613,,
15017283039,491.91769,16421911569,503657276,16421909951,-1618,,
15017334112,491.96876,16421962644,503708345,16421961021,-1623,,
15017384491,492.01914,16422013026,503758732,16422011408,-1618,,
15017434961,492.06961,16422063498,503809190,16422061865,-1633,,
15017485547,492.12020,16422114087,503859772,16422112448,-1639,,
15017536478,492.17113,16422165020,503910700,16422163376,-1644,,
15017587512,492.22216,16422216056,503961733,16422214408,-1648,,
15017637639,492.27229,16422266197,504011867,16422264543,-1654,,
15017687894,492.32254,16422316443,504062109,16422314784,-1659,,
15017738496,492.37314,16422367047,504112708,16422365383,-1664,,
15017789015,492.42366,16422417568,504163224,16422415899,-1669,,
15017840068,492.47472,16422468624,504214275,16422466950,-1674,,
15017890635,492.52528,16422519195,504264839,16422517515,-1680,,
15017941250,492.57590,16422569811,504315452,16422568127,-1684,,
15017992142,492.62679,16422620705,504366340,16422619016,-1689,,
15018042830,492.67748,16422671396,504417027,16422669702,-1694,,
15018093386,492.72803,16422721954,504467580,16422720255,-1699,,
15018143985,492.77863,16422772555,504518176,16422770851,-1704,,
15018194599,492.82925,16422823171,504568786,16422821461,-1710,,
15018245588,492.88024,16422874162,504619772,16422872447,-1715,,
15018295757,492.93041,16422924334,504669939,16422922615,-1719,,
15018346378,492.98103,16422974958,504720558,16422973233,-1725,,
15018397418,493.03207,16423026001,504771595,16423024271,-1730,,
15018447623,493.08227,16423076218,504821808,16423074484,-1734,,
15018498186,493.13283,16423126773,504872357,16423125033,-1740,,
15018548610,493.18326,16423177210,504922790,16423175465,-1745,,
15018599672,493.23432,16423228264,504973838,16423226513,-1751,,
15018650238,493.28489,16423278832,505024401,16423277077,-1755,,
15018701232,493.33588,16423329828,505075393,16423328068,-1760,,
15018751785,493.38643,16423380383,505125942,16423378617,-1766,,
15018802835,493.43748,16423431435,505176990,16423429665,-1770,,
15018853894,493.48854,16423482496,505228046,16423480722,-1774,,
15018904908,493.53956,16423533513,505279057,16423531733,-1780,,
15018955545,493.59019,16423584153,505329692,16423582367,-1786,,
15019006582,493.64123,16423635192,505380726,16423633402,-1790,,
15019057621,493.69227,16423686233,505431762,16423684437,-1796,,
15019108657,493.74331,16423737271,505482795,16423735471,-1800,,
15019159212,493.79386,16423787829,505533348,16423786023,-1806,,
15019209798,493.84445,16423838418,505583931,16423836607,-1811,,
15019260362,493.89501,16423888983,505634492,16423887167,-1816,,
15019311448,493.94610,16423940072,505685575,16423938250,-1822,,
15019362189,493.99684,16423990816,505736314,16423988990,-1826,,
15019412511,494.04716,16424041150,505786644,16424039320,-1830,,
15019463104,494.09775,16424091735,505837223,16424089898,-1837,,
15019513672,494.14832,16424142305,505887789,16424140464,-1841,,
15019564749,494.19940,16424193385,505938863,16424191539,-1846,,
15019615764,494.25041,16424244402,505989875,16424242551,-1851,,
15019666845,494.30149,16424295486,506040954,16424293629,-1857,,
15019717859,494.35251,16424346503,506091965,16424344641,-1862,,
15019768439,494.40309,16424397085,506142542,16424395218,-1867,,
15019819434,494.45408,16424448082,506193534,16424446210,-1872,,
15019870552,494.50520,16424499203,506244649,16424497325,-1878,,
15019921557,494.55620,16424550209,506295652,16424548327,-1882,,
15019972593,494.60724,16424601248,506346686,16424599361,-1887,,
15020023574,494.65822,16424652232,506397664,16424650340,-1892,,
15020074622,494.70927,16424703283,506448711,16424701387,-1896,,
15020125638,494.76029,16424754299,506499722,16424752397,-1902,,
15020176217,494.81086,16424804883,506550300,16424802975,-1908,,
15020226767,494.86142,16424855434,506600846,16424853521,-1913,,
15020277765,494.91241,16424906435,506651853,16424904528,-1907,,
15020328323,494.96297,16424956994,506702396,16424955071,-1923,,
15020378860,495.01351,16425007534,506752930,16425005606,-1928,,
15020429010,495.06366,16425057697,506803089,16425055765,-1932,,
15020480056,495.11470,16425108735,506854121,16425106797,-1938,,
15020530600,495.16525,16425159281,506904663,16425157338,-1943,,
15020581682,495.21633,16425210365,506955741,16425208417,-1948,,
15020632686,495.26733,16425261371,507006743,16425259418,-1953,,
15020683722,495.31837,16425312410,507057776,16425310452,-1958,,
15020733813,495.36846,16425362504,507107865,16425360541,-1963,,
15020784866,495.41951,16425413559,507158916,16425411591,-1968,,
15020835395,495.47004,16425464091,507209441,16425462117,-1974,,
15020886465,495.52111,16425515163,507260508,16425513184,-1979,,
15020937495,495.57214,16425566195,507311535,16425564211,-1984,,
15020988094,495.62274,16425616797,507362133,16425614808,-1989,,
15021039177,495.67383,16425667881,507413212,16425665888,-1993,,
15021089830,495.72448,16425718537,507463863,16425716538,-1999,,
15021140422,495.77507,16425769132,507514452,16425767128,-2004,,
15021191448,495.82610,16425820160,507565486,16425818161,-1999,,
15021242517,495.87716,16425871230,507616541,16425869216,-2014,,
15021293101,495.92775,16425921818,507667123,16425919798,-2020,,
15021343212,495.97786,16425971930,507717231,16425969906,-2024,,
15021394212,496.02886,16426022933,507768228,16426020904,-2029,,
15021444290,496.07894,16426073014,507818304,16426070979,-2035,,
15021494388,496.12904,16426123113,507868399,16426121074,-2039,,
15021544593,496.17924,16426173320,507918601,16426171276,-2044,,
15021595569,496.23022,16426224299,507969574,16426222249,-2050,,
15021646120,496.28077,16426274853,508020123,16426272798,-2055,,
15021696669,496.33132,16426325405,508070669,16426323344,-2061,,
15021747708,496.38236,16426376446,508121705,16426374381,-2065,,
15021798265,496.43291,16426427005,508172260,16426424935,-2070,,
15021849311,496.48396,16426478054,508223303,16426475979,-2075,,
15021900364,496.53501,16426529109,508274353,16426527029,-2080,,
15021951398,496.58605,16426580145,508325384,16426578060,-2085,,
15022001984,496.63663,16426630734,508375967,16426628643,-2091,,
15022053009,496.68766,16426681760,508426990,16426679676,-2084,,
15022103554,496.73820,16426732308,508477532,16426730208,-2100,,
15022154595,496.78924,16426783352,508528571,16426781246,-2106,,
15022205664,496.84031,16426834422,508579637,16426832313,-2109,,
15022256210,496.89086,16426884972,508630181,16426882856,-2116,,
15022306636,496.94128,16426935399,508680603,16426933279,-2120,,
15022357201,496.99185,16426985967,508731165,16426983841,-2126,,
15022408192,497.04284,16427036961,508782155,16427034830,-2131,,
15022459182,497.09383,16427087953,508833141,16427085817,-2136,,
15022509293,497.14394,16427138065,508883249,16427135925,-2140,,
15022560323,497.19497,16427189098,508934277,16427186952,-2146,,
15022610883,497.24553,16427239661,508984834,16427237510,-2151,,
15022661503,497.29615,16427290283,509035451,16427288127,-2156,,
15022712555,497.34720,16427341338,509086501,16427339176,-2162,,
15022762648,497.39730,16427391443,509136602,16427389278,-2165,,
15022812969,497.44762,16427441756,509186910,16427439585,-2171,,
15022863541,497.49819,16427492331,509237479,16427490154,-2177,,
15022914137,497.54879,16427542929,509288073,16427540748,-2181,,
15022965148,497.59980,16427593943,509339080,16427591756,-2187,,
15023015478,497.65013,16427644275,509389408,16427642083,-2192,,
15023065607,497.70026,16427694417,509439546,16427692221,-2196,,
15023116594,497.75124,16427745396,509490518,16427743194,-2202,,
15023167510,497.80216,16427796313,509541441,16427794117,-2196,,
15023217657,497.85231,16427846463,509591586,16427844261,-2202,,
15023268261,497.90291,16427897071,509642179,16427894855,-2216,,
15023318850,497.95350,16427947661,509692764,16427945439,-2222,,
15023369408,498.00406,16427998232,509743329,16427996005,-2227,,
15023420436,498.05508,16428049252,509794345,16428047020,-2232,,
15023470872,498.10552,16428099690,509844777,16428097453,-2237,,
15023521919,498.15657,16428150738,509895821,16428148496,-2242,,
15023572945,498.20759,16428201768,509946845,16428199520,-2248,,
15023623999,498.25865,16428252823,509997895,16428250571,-2252,,
15023674053,498.30870,16428302880,510047948,16428300623,-2257,,
15023724606,498.35925,16428353436,510098498,16428351173,-2263,,
15023775152,498.40980,16428403984,510149041,16428401717,-2267,,
15023825710,498.46036,16428454544,510199596,16428452271,-2273,,
15023876763,498.51141,16428505599,510250646,16428503321,-2278,,
15023927805,498.56245,16428556644,510301686,16428554361,-2283,,
15023978834,498.61348,16428607675,510352712,16428605387,-2288,,
15024029383,498.66403,16428658226,510403258,16428655933,-2293,,
15024079847,498.71449,16428708692,510453719,16428706394,-2298,,
15024130431,498.76508,16428759280,510504301,16428756977,-2303,,
15024180984,498.81563,16428809834,510554851,16428807526,-2308,,
15024231992,498.86664,16428860845,510605857,16428858532,-2313,,
15024283019,498.91767,16428911886,510656892,16428909567,-2319,,
15024333624,498.96827,16428962482,510707484,16428960159,-2323,,
15024384214,499.01886,16429013075,510758071,16429010746,-2329,,
15024435062,499.06971,16429063924,510808915,16429061591,-2333,,
15024485622,499.12027,16429114487,510859474,16429112149,-2338,,
15024536136,499.17078,16429165004,510909984,16429162660,-2344,,
15024586735,499.22138,16429215605,510960580,16429213256,-2349,,
15024637258,499.27191,16429266130,511011101,16429263777,-2353,,
15024688299,499.32295,16429317174,511062139,16429314814,-2360,,
15024739378,499.37403,16429368255,511113215,16429365891,-2364,,
15024790367,499.42501,16429419245,511164201,16429416876,-2369,,
15024841010,499.47566,16429469892,511214842,16429467518,-2374,,
15024891601,499.52625,16429520484,511265430,16429518106,-2378,,
15024942170,499.57682,16429571055,511315996,16429568671,-2384,,
15024993211,499.62786,16429622100,511367034,16429619710,-2390,,
15025043756,499.67840,16429672646,511417577,16429670252,-2394,,
15025094302,499.72895,16429723195,511468120,16429720795,-2400,,
15025144899,499.77955,16429773795,511518714,16429771390,-2405,,
15025195395,499.83004,16429824293,511569208,16429821884,-2409,,
15025245466,499.88011,16429874367,511619277,16429871952,-2415,,
15025296561,499.93121,16429925463,511670368,16429923044,-2419,,
15025347583,499.98223,16429976488,511721387,16429974063,-2425,,
15025398116,500.03276,16430027024,511771918,16430024594,-2430,,
15025448699,500.08335,16430077608,511822498,16430075173,-2435,,
15025499238,500.13389,16430128150,511873035,16430125710,-2440,,
15025549603,500.18425,16430178518,511923398,16430176073,-2445,,
15025600639,500.23529,16430229556,511974430,16430227106,-2450,,
15025651615,500.28626,16430280534,512025404,16430278079,-2455,,
15025702155,500.33680,16430331077,512075941,16430328616,-2461,,
15025752732,500.38738,16430381655,512126515,16430379190,-2465,,
15025803120,500.43777,16430432047,512176901,16430429576,-2471,,
15025854158,500.48881,16430483087,512227935,16430480611,-2476,,
15025904246,500.53889,16430533177,512278021,16430530697,-2480,,
15025955182,500.58983,16430584116,512328954,16430581630,-2486,,
15026006213,500.64086,16430635149,512379983,16430632658,-2491,,
15026056362,500.69101,16430685300,512430130,16430682805,-2495,,
15026107216,500.74186,16430736157,512480981,16430733656,-2501,,
15026157861,500.79251,16430786803,512531621,16430784297,-2506,,
15026208408,500.84306,16430837353,512582167,16430834842,-2511,,
15026258942,500.89359,16430887890,512632699,16430885374,-2516,,
15026309041,500.94369,16430937991,512682794,16430935470,-2521,,
15026360048,500.99470,16430989000,512733799,16430986474,-2526,,
15026410624,501.04527,16431039579,512784372,16431037048,-2531,,
15026461621,501.09627,16431090577,512835366,16431088041,-2536,,
15026512194,501.14684,16431141153,512885937,16431138612,-2541,,
15026562838,501.19749,16431191800,512936578,16431189253,-2547,,
15026613669,501.24832,16431242632,512987406,16431240081,-2551,,
15026664692,501.29934,16431293659,513038426,16431291102,-2557,,
15026715732,501.35038,16431344700,513089462,16431342138,-2562,,
15026766318,501.40097,16431395288,513140047,16431392722,-2566,,
15026817359,501.45201,16431446332,513191085,16431443760,-2572,,
15026867433,501.50208,16431496410,513241158,16431493833,-2577,,
15026918151,501.55280,16431547129,513291872,16431544547,-2582,,
15026968473,501.60312,16431597466,513342204,16431594879,-2587,,
15027019521,501.65417,16431648504,513393237,16431645912,-2592,,
15027069713,501.70436,16431698698,513443425,16431696101,-2597,,
15027120762,501.75541,16431749749,513494472,16431747147,-2602,,
15027171191,501.80584,16431800191,513544909,16431797585,-2606,,
15027221794,501.85644,16431850797,513595509,16431848185,-2612,,
15027272829,501.90748,16431901824,513646530,16431899206,-2618,,
15027323014,501.95766,16431952011,513696714,16431949389,-2622,,
15027373651,502.00830,16432002651,513747347,16432000023,-2628,,
15027424657,502.05930,16432053659,513798351,16432051026,-2633,,
15027475183,502.10983,16432104186,513848874,16432101549,-2637,,
15027525726,502.16037,16432154733,513899415,16432152090,-2643,,
15027576633,502.21128,16432205642,513950318,16432202993,-2649,,
15027627193,502.26184,16432256203,514000875,16432253550,-2653,,
15027678225,502.31287,16432307239,514051920,16432304595,-2644,,
15027728797,502.36345,16432357813,514102474,16432355150,-2663,,
15027779865,502.41451,16432408882,514153539,16432406214,-2668,,
15027830503,502.46515,16432459535,514204186,16432456862,-2673,,
15027881073,502.51572,16432510096,514254742,16432507418,-2678,,
15027931615,502.56626,16432560640,514305282,16432557958,-2682,,
15027982138,502.61679,16432611166,514355801,16432608477,-2689,,
15028032222,502.66687,16432661262,514405893,16432658568,-2694,,
15028082299,502.71695,16432711330,514455957,16432708632,-2698,,
15028133333,502.76798,16432762368,514506988,16432759664,-2704,,
15028183401,502.81805,16432812438,514557054,16432809730,-2708,,
15028233460,502.86811,16432862500,514607110,16432859786,-2714,,
15028284045,502.91869,16432913087,514657693,16432910368,-2719,,
15028334623,502.96927,16432963666,514708268,16432960943,-2723,,
15028385211,503.01986,16433014258,514758853,16433011529,-2729,,
15028435769,503.07042,16433064818,514809408,16433062084,-2734,,
15028486326,503.12097,16433115377,514859964,16433112639,-2738,,
15028536879,503.17153,16433165933,514910513,16433163188,-2745,,
15028587014,503.22166,16433216069,514960645,16433213320,-2749,,
15028637532,503.27218,16433266590,515011160,16433263836,-2754,,
15028688122,503.32277,16433317182,515061748,16433314424,-2758,,
15028738706,503.37335,16433367769,515112329,16433365005,-2764,,
15028789684,503.42433,16433418749,515163305,16433415980,-2769,,
15028840249,503.47490,16433469328,515213879,16433466554,-2774,,
15028890809,503.52546,16433519879,515264425,16433517101,-2778,,
15028941825,503.57647,16433570896,515315437,16433568112,-2784,,
15028992361,503.62701,16433621436,515365971,16433618646,-2790,,
15029042925,503.67757,16433672002,515416532,16433669208,-2794,,
15029093491,503.72814,16433722570,515467105,16433719780,-2790,,
15029144581,503.77923,16433773663,515518182,16433770858,-2805,,
15029195586,503.83023,16433824669,515569185,16433821860,-2809,,
15029246154,503.88080,16433875240,515619750,16433872425,-2815,,
15029296742,503.93139,16433925831,515670335,16433923011,-2820,,
15029347281,503.98193,16433976372,515720872,16433973547,-2825,,
15029397364,504.03201,16434026458,515770952,16434023628,-2830,,
15029447454,504.08210,16434076549,515821039,16434073714,-2835,,
15029498020,504.13267,16434127129,515871613,16434124289,-2840,,
15029548769,504.18342,16434177871,515922350,16434175026,-2845,,
15029599508,504.23416,16434228610,515973085,16434225760,-2850,,
15029650080,504.28473,16434279185,516023654,16434276330,-2855,,
15029700668,504.33532,16434329875,516074340,16434327016,-2859,,
15029751200,504.38585,16434380309,516124769,16434377444,-2865,,
15029801820,504.43647,16434430932,516175386,16434428061,-2871,,
15029852366,504.48701,16434481491,516225940,16434478615,-2876,,
15029902927,504.53758,16434532044,516276488,16434529164,-2880,,
15029953008,504.58766,16434582127,516326578,16434579253,-2874,,
15030004040,504.63869,16434633162,516377606,16434630281,-2881,,
15030054602,504.68925,16434683726,516428156,16434680831,-2895,,
15030104805,504.73945,16434733932,516478355,16434731031,-2901,,
15030154936,504.78958,16434784064,516528483,16434781159,-2905,,
15030205936,504.84058,16434835066,516579481,16434832156,-2910,,
15030256011,504.89066,16434885154,516629563,16434882239,-2915,,
15030306156,504.94080,16434935291,516679695,16434932370,-2921,,
15030356760,504.99141,16434985898,516730297,16434982972,-2926,,
15030407314,505.04196,16435036455,516780849,16435033524,-2931,,
15030458368,505.09302,16435087510,516831899,16435084574,-2936,,
15030509011,505.14366,16435138156,516882539,16435135215,-2941,,
15030559528,505.19418,16435188676,516933054,16435185729,-2947,,
15030610133,505.24478,16435239282,516983656,16435236331,-2951,,
15030661153,505.29580,16435290305,517034673,16435287349,-2956,,
15030712205,505.34685,16435341359,517085722,16435338397,-2962,,
15030762791,505.39744,16435391948,517136307,16435388983,-2965,,
15030813792,505.44844,16435442951,517187304,16435439980,-2971,,
15030864351,505.49900,16435493513,517237860,16435490536,-2977,,
15030914902,505.54955,16435544066,517288409,16435541085,-2981,,
15030965462,505.60011,16435594638,517338976,16435591652,-2986,,
15031016000,505.65065,16435645169,517389502,16435642177,-2992,,
15031067048,505.70170,16435696219,517440547,16435693222,-2997,,
15031118132,505.75278,16435747306,517491628,16435744304,-3002,,
15031169154,505.80380,16435798330,517542647,16435795323,-3007,,
15031220203,505.85485,16435849381,517593693,16435846369,-3012,,
15031270754,505.90540,16435899935,517644253,16435896928,-3007,,
15031321330,505.95598,16435950513,517694815,16435947490,-3023,,
15031371936,506.00658,16436001121,517745418,16435998094,-3027,,
15031422484,506.05713,16436051683,517795975,16436048650,-3033,,
15031473070,506.10772,16436102260,517846548,16436099223,-3037,,
15031523190,506.15784,16436152382,517896664,16436149339,-3043,,
15031573266,506.20791,16436202460,517946737,16436199412,-3048,,
15031623826,506.25847,16436253033,517997305,16436249981,-3052,,
15031674875,506.30952,16436304075,518048341,16436301016,-3059,,
15031725900,506.36055,16436355103,518099364,16436352040,-3063,,
15031776473,506.41112,16436405676,518149933,16436402608,-3068,,
15031827021,506.46167,16436456228,518200479,16436453155,-3073,,
15031878057,506.51270,16436507265,518251512,16436504188,-3077,,
15031928464,506.56311,16436557675,518301917,16436554592,-3083,,
15031979084,506.61373,16436608297,518352534,16436605209,-3088,,
15032029632,506.66428,16436658848,518403079,16436655754,-3094,,
15032080225,506.71487,16436709442,518453669,16436706344,-3098,,
15032131279,506.76593,16436760500,518504722,16436757397,-3103,,
15032182327,506.81698,16436811560,518555777,16436808452,-3108,,
15032232432,506.86708,16436861657,518605869,16436858544,-3113,,
15032283126,506.91777,16436912354,518656560,16436909235,-3119,,
15032334167,506.96882,16436963397,518707598,16436960273,-3124,,
15032385194,507.01984,16437014427,518758623,16437011298,-3129,,
15032436222,507.07087,16437065466,518809657,16437062333,-3133,,
15032487273,507.12192,16437116510,518860695,16437113371,-3139,,
15032537434,507.17208,16437166674,518910854,16437163530,-3144,,
15032587552,507.22220,16437216794,518960969,16437213645,-3149,,
15032638079,507.27273,16437267322,519011493,16437264168,-3154,,
15032689152,507.32380,16437318408,519062574,16437315249,-3159,,
15032740191,507.37484,16437369440,519113600,16437366276,-3164,,
15032791239,507.42589,16437420490,519164646,16437417321,-3169,,
15032841799,507.47645,16437471064,519215214,16437467889,-3175,,
15032892837,507.52749,16437522093,519266238,16437518914,-3179,,
15032943885,507.57853,16437573143,519317283,16437569958,-3185,,
15032994444,507.62909,16437623715,519367849,16437620525,-3190,,
15033045469,507.68012,16437674732,519418862,16437671538,-3194,,
15033096031,507.73068,16437725297,519469422,16437722097,-3200,,
15033147079,507.78173,16437776347,519520467,16437773142,-3205,,
15033198115,507.83276,16437827384,519571499,16437824174,-3210,,
15033249177,507.88383,16437878462,519622572,16437875247,-3215,,
15033299756,507.93440,16437929032,519673137,16437925812,-3220,,
15033350751,507.98540,16437980028,519724127,16437976803,-3225,,
15033401374,508.03602,16438030654,519774749,16438027424,-3230,,
15033452186,508.08683,16438081468,519825557,16438078233,-3235,,
15033502794,508.13744,16438132079,519876162,16438128838,-3241,,
15033553408,508.18806,16438182695,519926773,16438179449,-3246,,
15033604387,508.23904,16438233676,519977750,16438230425,-3251,,
15033655477,508.29012,16438284768,520028837,16438281512,-3256,,
15033706487,508.34114,16438335781,520079844,16438332520,-3261,,
15033757545,508.39219,16438386841,520130901,16438383576,-3265,,
15033808118,508.44277,16438437416,520181481,16438434156,-3260,,
15033859141,508.49379,16438488441,520232490,16438485165,-3276,,
15033909703,508.54435,16438539006,520283049,16438535725,-3281,,
15033960743,508.59539,16438590048,520334087,16438586762,-3286,,
15034011778,508.64643,16438641086,520385119,16438637794,-3292,,
15034062322,508.69697,16438691632,520435660,16438688335,-3297,,
15034112384,508.74703,16438741697,520485721,16438738396,-3301,,
15034163458,508.79811,16438792784,520536802,16438789478,-3306,,
15034214026,508.84867,16438843344,520587356,16438840032,-3312,,
15034264549,508.89920,16438893869,520637876,16438890551,-3318,,
15034315103,508.94975,16438944424,520688428,16438941103,-3321,,
15034366190,509.00084,16438995515,520739512,16438992188,-3327,,
15034416746,509.05139,16439046073,520790065,16439042741,-3332,,
15034467756,509.10240,16439097085,520841073,16439093749,-3336,,
15034518848,509.15350,16439148180,520892163,16439144839,-3341,,
15034569363,509.20401,16439198696,520942674,16439195349,-3347,,
15034619925,509.25457,16439249260,520993233,16439245909,-3351,,
15034670468,509.30512,16439299806,521043774,16439296450,-3356,,
15034721003,509.35565,16439350344,521094306,16439346982,-3362,,
15034771058,509.40571,16439400402,521144358,16439397034,-3368,,
15034822098,509.45675,16439451443,521195396,16439448071,-3372,,
15034872682,509.50733,16439502030,521245978,16439498653,-3377,,
15034923695,509.55834,16439553046,521296988,16439549663,-3383,,
15034974345,509.60899,16439603698,521347635,16439600310,-3388,,
15035024922,509.65957,16439654277,521398210,16439650886,-3391,,
15035075936,509.71058,16439705294,521449221,16439701896,-3398,,
15035126486,509.76113,16439755846,521499767,16439752443,-3403,,
15035177550,509.81220,16439806912,521550830,16439803505,-3407,,
15035228591,509.86324,16439857956,521601867,16439854543,-3413,,
15035281037,509.91568,16439910404,521654310,16439906986,-3418,,
15035334675,509.96932,16439964045,521707946,16439960621,-3424,,
15035386112,510.02076,16440015484,521759380,16440012055,-3429,,
15035438773,510.07342,16440068148,521812039,16440064715,-3433,,
15035489319,510.12397,16440118696,521862582,16440115257,-3439,,
15035539882,510.17453,16440169261,521913141,16440165817,-3444,,
15035590331,510.22498,16440219713,521963588,16440216263,-3450,,
15035640877,510.27553,16440270260,522014131,16440266807,-3453,,
15035691538,510.32619,16440320924,522064789,16440317465,-3459,,
15035742252,510.37690,16440371641,522115500,16440368176,-3465,,
15035792476,510.42712,16440421867,522165722,16440418398,-3469,,
15035842627,510.47728,16440472019,522215870,16440468546,-3473,,
15035893559,510.52821,16440522955,522266799,16440519475,-3480,,
15035943713,510.57836,16440573110,522316951,16440569626,-3484,,
15035994443,510.62909,16440623843,522367679,16440620354,-3489,,
15036045127,510.67978,16440674529,522418359,16440671034,-3495,,
15036095402,510.73005,16440724807,522468632,16440721307,-3500,,
15036145646,510.78029,16440775053,522518874,16440771549,-3504,,
15036196105,510.83075,16440825515,522569329,16440822005,-3510,,
15036246858,510.88151,16440876269,522620079,16440872754,-3515,,
15036297253,510.93190,16440926666,522670472,16440923147,-3519,,
15036348030,510.98268,16440977446,522721246,16440973921,-3525,,
15036398149,511.03280,16441027568,522771363,16441024038,-3530,,
15036448595,511.08324,16441078016,522821806,16441074481,-3535,,
15036499281,511.13393,16441128705,522872489,16441125165,-3540,,
15036549801,511.18445,16441179227,522923006,16441175681,-3546,,
15036600573,511.23522,16441230001,522973775,16441226451,-3550,,
15036651052,511.28570,16441280483,523024252,16441276928,-3555,,
15036701441,511.33609,16441330873,523074638,16441327313,-3560,,
15036752062,511.38671,16441381497,523125256,16441377932,-3565,,
15036802674,511.43732,16441432111,523175866,16441428541,-3570,,
15036853025,511.48767,16441482464,523226214,16441478889,-3575,,
15036903198,511.53785,16441532640,523276384,16441529060,-3580,,
15036954011,511.58866,16441583455,523327194,16441579869,-3586,,
15037004485,511.63913,16441633932,523377666,16441630341,-3591,,
15037054873,511.68952,16441684323,523428051,16441680727,-3596,,
15037105193,511.73984,16441734645,523478368,16441731044,-3601,,
15037155311,511.78996,16441784764,523528484,16441781159,-3605,,
15037205812,511.84046,16441835269,523578982,16441831658,-3611,,
15037256214,511.89086,16441885673,523629381,16441882056,-3617,,
15037306649,511.94130,16441936109,523679814,16441932489,-3620,,
15037357457,511.99210,16441986920,523730619,16441983294,-3626,,
15037408229,512.04288,16442037695,523781389,16442034064,-3631,,
15037458816,512.09346,16442088284,523831972,16442084647,-3637,,
15037509258,512.14391,16442138728,523882412,16442135087,-3641,,
15037559598,512.19425,16442189070,523932749,16442185424,-3646,,
15037609940,512.24459,16442239415,523983088,16442235763,-3652,,
15037660503,512.29515,16442289980,524033649,16442286325,-3655,,
15037710783,512.34543,16442340263,524083926,16442336602,-3661,,
15037761359,512.39601,16442390841,524134499,16442387174,-3667,,
15037811523,512.44617,16442441008,524184661,16442437337,-3671,,
15037861992,512.49664,16442491479,524235127,16442487803,-3676,,
15037913011,512.54766,16442542501,524286143,16442538818,-3683,,
15037963236,512.59788,16442592728,524336366,16442589042,-3686,,
15038013846,512.64849,16442643339,524386973,16442639648,-3691,,
15038064886,512.69953,16442694382,524438010,16442690685,-3697,,
15038115444,512.75009,16442744943,524488566,16442741241,-3702,,
15038166180,512.80083,16442795691,524539310,16442791986,-3705,,
15038217274,512.85192,16442846778,524590390,16442843066,-3712,,
15038268287,512.90293,16442897793,524641400,16442894076,-3717,,
15038318358,512.95301,16442947866,524691469,16442944145,-3721,,
15038368472,513.00312,16442997982,524741580,16442994256,-3726,,
15038419497,513.05414,16443049009,524792602,16443045277,-3732,,
15038470136,513.10478,16443099652,524843238,16443095914,-3738,,
15038520817,513.15547,16443150334,524893917,16443146592,-3742,,
15038571383,513.20603,16443200902,524944480,16443197155,-3747,,
15038621964,513.25661,16443251486,524995057,16443247733,-3753,,
15038672993,513.30764,16443302517,525046085,16443298760,-3757,,
15038723046,513.35769,16443352572,525096135,16443348810,-3762,,
15038774092,513.40874,16443403622,525147178,16443399854,-3768,,
15038824644,513.45929,16443454176,525197727,16443450402,-3774,,
15038875207,513.50986,16443504752,525248300,16443500976,-3776,,
15038926253,513.56090,16443555790,525299331,16443552007,-3783,,
15038976595,513.61124,16443606134,525349681,16443602356,-3778,,
15039027629,513.66228,16443657169,525400702,16443653377,-3792,,
15039077728,513.71238,16443707272,525450799,16443703485,-3787,,
15039128363,513.76301,16443757909,525501431,16443754106,-3803,,
15039179414,513.81406,16443808962,525552479,16443805154,-3808,,
15039230408,513.86506,16443859958,525603470,16443856145,-3813,,
15039280971,513.91562,16443910535,525654042,16443906718,-3817,,
15039331303,513.96595,16443960858,525704359,16443957034,-3824,,
15039382335,514.01698,16444011893,525755389,16444008065,-3828,,
15039432785,514.06743,16444062344,525805836,16444058511,-3833,,
15039483544,514.11819,16444113107,525856593,16444109268,-3839,,
15039534547,514.16919,16444164111,525907592,16444160267,-3844,,
15039585560,514.22021,16444215126,525958602,16444211278,-3848,,
15039635675,514.27032,16444265244,526008715,16444261390,-3854,,
15039686724,514.32137,16444316295,526059761,16444312436,-3859,,
15039737760,514.37241,16444367335,526110797,16444363472,-3863,,
15039788619,514.42327,16444418195,526161651,16444414327,-3868,,
15039839662,514.47431,16444469241,526212692,16444465367,-3874,,
15039890597,514.52525,16444520178,526263623,16444516298,-3880,,
15039941164,514.57581,16444570747,526314188,16444566863,-3884,,
15039991533,514.62618,16444621119,526364554,16444617230,-3889,,
15040042097,514.67674,16444671685,526415115,16444667790,-3895,,
15040092682,514.72733,16444722273,526465699,16444718374,-3899,,
15040142826,514.77747,16444772419,526515839,16444768515,-3904,,
15040193543,514.82819,16444823139,526566553,16444819229,-3910,,
15040243652,514.87830,16444873250,526616660,16444869336,-3914,,
15040294233,514.92888,16444923833,526667238,16444919914,-3919,,
15040345309,514.97996,16444974912,526718311,16444970987,-3925,,
15040396354,515.03100,16445025959,526769354,16445022029,-3930,,
15040446917,515.08156,16445076524,526819915,16445072590,-3934,,
15040497460,515.13211,16445127070,526870455,16445123130,-3940,,
15040548482,515.18313,16445178093,526921473,16445174148,-3945,,
15040599099,515.23375,16445228713,526972087,16445224762,-3951,,
15040649216,515.28386,16445278833,527022203,16445274878,-3955,,
15040699794,515.33444,16445329413,527072789,16445325464,-3949,,
15040750316,515.38496,16445379950,527123309,16445375984,-3966,,
15040801377,515.43602,16445431001,527174356,16445427032,-3969,,
15040851999,515.48665,16445481636,527224985,16445477660,-3976,,
15040903072,515.53772,16445532700,527276044,16445528719,-3981,,
15040953661,515.58831,16445583292,527326631,16445579307,-3985,,
15041004207,515.63886,16445633840,527377175,16445629850,-3990,,
15041055139,515.68979,16445684775,527428104,16445680789,-3986,,
15041106177,515.74082,16445735815,527479138,16445731814,-4001,,
15041156744,515.79139,16445786396,527529716,16445782391,-4005,,
15041207406,515.84205,16445837049,527580362,16445833038,-4011,,
15041258298,515.89295,16445887943,527631252,16445883927,-4016,,
15041309382,515.94403,16445939030,527682333,16445935008,-4022,,
15041360414,515.99506,16445990063,527733362,16445986037,-4026,,
15041410639,516.04529,16446040291,527783585,16446036260,-4031,,
15041460943,516.09559,16446090598,527833885,16446086561,-4037,,
15041511991,516.14664,16446141648,527884932,16446137607,-4041,,
15041562536,516.19718,16446192195,527935473,16446188149,-4046,,
15041613169,516.24782,16446242831,527986103,16446238779,-4052,,
15041664125,516.29877,16446293799,528037068,16446289743,-4056,,
15041715173,516.34982,16446344839,528088113,16446340788,-4051,,
15041765760,516.40041,16446395428,528138686,16446391362,-4066,,
15041816818,516.45147,16446446489,528189743,16446442418,-4071,,
15041867591,516.50224,16446497264,528240512,16446493188,-4076,,
15041918671,516.55332,16446548347,528291589,16446544265,-4082,,
15041968792,516.60344,16446598470,528341719,16446594395,-4075,,
15042019846,516.65449,16446649526,528392758,16446645433,-4093,,
15042070417,516.70506,16446700100,528443327,16446696003,-4097,,
15042121023,516.75567,16446750707,528493930,16446746605,-4102,,
15042171622,516.80627,16446801309,528544526,16446797202,-4107,,
15042222680,516.85733,16446852370,528595593,16446848269,-4101,,
15042273750,516.90840,16446903441,528646649,16446899324,-4117,,
15042324265,516.95891,16446953959,528697161,16446949836,-4123,,
15042375308,517.00996,16447005005,528748202,16447000877,-4128,,
15042425870,517.06052,16447055569,528798762,16447051437,-4132,,
15042476947,517.11159,16447106648,528849835,16447102511,-4137,,
15042528019,517.16267,16447157722,528900904,16447153579,-4143,,
15042578633,517.21328,16447208352,528951528,16447204204,-4148,,
15042629270,517.26392,16447258979,529002151,16447254826,-4153,,
15042679927,517.31457,16447309638,529052804,16447305480,-4158,,
15042730659,517.36531,16447360373,529103533,16447356208,-4165,,
15042781294,517.41594,16447411010,529154166,16447406841,-4169,,
15042831900,517.46655,16447461618,529204769,16447457445,-4173,,
15042882948,517.51760,16447512669,529255814,16447508490,-4179,,
15042933997,517.56864,16447563720,529306862,16447559537,-4183,,
15042984743,517.61939,16447614468,529357604,16447610280,-4188,,
15043035267,517.66991,16447664995,529408125,16447660811,-4184,,
15043086367,517.72101,16447716097,529459222,16447711898,-4199,,
15043136747,517.77139,16447766479,529509600,16447762275,-4204,,
15043186880,517.82153,16447816615,529559730,16447812405,-4210,,
15043237713,517.87236,16447867449,529610560,16447863235,-4214,,
15043288009,517.92266,16447917749,529660855,16447913530,-4219,,
15043338088,517.97274,16447967830,529710930,16447963606,-4224,,
15043388713,518.02336,16448018456,529761551,16448014227,-4229,,
15043439326,518.07397,16448069073,529812164,16448064839,-4234,,
15043489918,518.12457,16448119667,529862753,16448115428,-4239,,
15043540524,518.17517,16448170275,529913366,16448166041,-4234,,
15043591154,518.22580,16448220908,529963982,16448216658,-4250,,
15043641529,518.27618,16448271284,530014355,16448267030,-4254,,
15043692108,518.32676,16448321865,530064931,16448317606,-4259,,
15043743112,518.37776,16448372872,530115932,16448368608,-4264,,
15043793966,518.42861,16448423729,530166795,16448419471,-4258,,
15043845059,518.47971,16448474823,530217874,16448470550,-4273,,
15043895625,518.53027,16448525393,530268437,16448521123,-4270,,
15043946121,518.58077,16448575891,530318931,16448571606,-4285,,
15043996752,518.63140,16448626524,530369559,16448622234,-4290,,
15044047802,518.68245,16448677577,530420606,16448673282,-4295,,
15044098383,518.73303,16448728160,530471185,16448723870,-4290,,
15044148973,518.78362,16448778753,530521772,16448774448,-4305,,
15044199119,518.83377,16448828900,530571915,16448824591,-4309,,
15044249720,518.88437,16448879504,530622513,16448875189,-4315,,
15044300791,518.93544,16448930578,530673581,16448926256,-4322,,
15044351039,518.98569,16448980827,530723827,16448976502,-4325,,
15044402083,519.03673,16449031874,530774868,16449027543,-4331,,
15044452179,519.08683,16449081973,530824962,16449077637,-4336,,
15044503038,519.13769,16449132834,530875818,16449128494,-4340,,
15044553862,519.18851,16449183660,530926639,16449179314,-4346,,
15044604806,519.23945,16449234607,530977581,16449230257,-4350,,
15044655879,519.29053,16449285682,531028651,16449281326,-4356,,
15044706506,519.34115,16449336312,531079275,16449331951,-4361,,
15044757539,519.39219,16449387347,531130306,16449382981,-4366,,
15044808100,519.44275,16449437910,531180864,16449433539,-4371,,
15044858684,519.49333,16449488507,531231456,16449484132,-4375,,
15044909232,519.54388,16449539058,531282001,16449534677,-4381,,
15044960283,519.59493,16449590100,531333049,16449585725,-4375,,
15045011334,519.64598,16449641154,531384086,16449636762,-4392,,
15045061914,519.69656,16449691736,531434664,16449687340,-4396,,
15045112941,519.74759,16449742765,531485689,16449738374,-4391,,
15045163989,519.79864,16449793816,531536734,16449789409,-4407,,
15045215063,519.84971,16449844891,531587805,16449840481,-4410,,
15045266112,519.90076,16449895944,531638852,16449891527,-4417,,
15045316751,519.95140,16449946585,531689487,16449942163,-4422,,
15045367334,520.00198,16449997170,531740067,16449992743,-4427,,
15045418381,520.05303,16450048220,531791112,16450043788,-4432,,
15045469442,520.10409,16450099283,531842171,16450094846,-4437,,
15045519585,520.15423,16450149428,531892310,16450144986,-4442,,
15045570523,520.20517,16450200369,531943247,16450195922,-4447,,
15045620962,520.25561,16450250810,531993682,16450246358,-4452,,
15045671999,520.30665,16450301848,532044716,16450297392,-4456,,
15045723062,520.35771,16450352914,532095776,16450348452,-4462,,
15045773714,520.40836,16450403569,532146426,16450399102,-4467,,
15045824306,520.45895,16450454162,532197015,16450449691,-4471,,
15045874888,520.50954,16450504748,532247595,16450500270,-4478,,
15045925439,520.56009,16450555300,532298143,16450550818,-4482,,
15045976421,520.61107,16450606285,532349121,16450601797,-4488,,
15046026622,520.66127,16450656489,532399320,16450651996,-4493,,
15046077236,520.71188,16450707104,532449931,16450702606,-4498,,
15046127872,520.76252,16450757744,532500565,16450753241,-4503,,
15046178924,520.81357,16450808798,532551615,16450804290,-4508,,
15046229498,520.86415,16450859374,532602185,16450854861,-4513,,
15046279651,520.91430,16450909529,532652336,16450905011,-4518,,
15046330219,520.96487,16450960099,532702900,16450955576,-4523,,
15046381251,521.01590,16451011133,532753930,16451006605,-4528,,
15046431347,521.06600,16451061233,532804023,16451056698,-4535,,
15046481866,521.11651,16451111753,532854540,16451107215,-4538,,
15046532002,521.16665,16451161903,532904685,16451157361,-4542,,
15046583075,521.21772,16451212968,532955744,16451208420,-4548,,
15046634091,521.26874,16451263986,533006758,16451259433,-4553,,
15046684686,521.31933,16451314583,533057350,16451310025,-4558,,
15046735236,521.36988,16451365136,533107897,16451360572,-4564,,
15046785822,521.42047,16451415725,533158480,16451411156,-4569,,
15046836831,521.47148,16451466736,533209487,16451462162,-4574,,
15046887407,521.52206,16451517314,533260059,16451512735,-4579,,
15046938480,521.57313,16451568389,533311129,16451563805,-4584,,
15046989003,521.62365,16451618915,533361651,16451614326,-4589,,
15047040052,521.67470,16451669966,533412697,16451665372,-4594,,
15047090690,521.72534,16451720606,533463331,16451716007,-4599,,
15047141302,521.77595,16451771220,533513940,16451766615,-4605,,
15047191828,521.82648,16451821749,533564465,16451817140,-4609,,
15047242853,521.87750,16451872776,533615486,16451868162,-4614,,
15047293420,521.92807,16451923346,533666050,16451918726,-4620,,
15047344006,521.97865,16451973934,533716635,16451969310,-4624,,
15047394615,522.02926,16452024545,533767240,16452019916,-4629,,
15047445738,522.08039,16452075670,533818360,16452071035,-4635,,
15047496751,522.13140,16452126686,533869370,16452122045,-4641,,
15047547817,522.18246,16452177755,533920434,16452173110,-4645,,
15047598809,522.23346,16452228748,533971423,16452224098,-4650,,
15047649645,522.28429,16452279586,534022256,16452274932,-4654,,
15047700229,522.33488,16452330174,534072839,16452325524,-4650,,
15047750871,522.38552,16452380817,534123477,16452376152,-4665,,
15047801944,522.43659,16452431892,534174547,16452427223,-4669,,
15047852506,522.48715,16452482458,534225106,16452477781,-4677,,
15047903217,522.53787,16452533170,534275815,16452528491,-4679,,
15047954270,522.58892,16452584227,534326875,16452579551,-4676,,
15048004819,522.63947,16452634777,534377421,16452630097,-4680,,
15048054953,522.68960,16452684914,534427543,16452680219,-4695,,
15048105978,522.74063,16452735942,534478565,16452731240,-4702,,
15048156432,522.79108,16452786398,534529016,16452781692,-4706,,
15048206535,522.84118,16452836502,534579116,16452831792,-4710,,
15048257245,522.89189,16452887215,534629824,16452882499,-4716,,
15048307677,522.94232,16452937649,534680253,16452932928,-4721,,
15048358406,522.99305,16452988381,534730979,16452983655,-4726,,
15048408958,523.04361,16453038936,534781529,16453034205,-4731,,
15048459521,523.09417,16453089501,534832089,16453084765,-4736,,
15048510158,523.14481,16453140140,534882723,16453135399,-4741,,
15048560771,523.19542,16453190756,534933334,16453186009,-4747,,
15048611811,523.24646,16453241798,534984372,16453237048,-4750,,
15048662795,523.29744,16453292783,535035352,16453288027,-4756,,
15048713616,523.34826,16453343607,535086170,16453338858,-4749,,
15048764249,523.39890,16453394243,535136802,16453389477,-4766,,
15048814823,523.44947,16453444820,535187373,16453440049,-4771,,
15048865873,523.50052,16453495872,535238419,16453491095,-4777,,
15048916858,523.55151,16453546859,535289401,16453542076,-4783,,
15048967468,523.60212,16453597472,535340010,16453592685,-4787,,
15049018133,523.65278,16453648138,535390682,16453643358,-4780,,
15049069073,523.70372,16453699080,535441608,16453694284,-4796,,
15049119667,523.75432,16453749678,535492200,16453744875,-4803,,
15049170715,523.80536,16453800728,535543245,16453795920,-4808,,
15049221768,523.85642,16453851782,535594295,16453846970,-4812,,
15049272814,523.90746,16453902832,535645338,16453898014,-4818,,
15049323863,523.95851,16453953882,535696385,16453949060,-4822,,
15049374913,524.00956,16454004935,535747432,16454000107,-4828,,
15049425938,524.06059,16454055962,535798454,16454051129,-4833,,
15049477012,524.11166,16454107038,535849526,16454102202,-4836,,
15049527645,524.16229,16454157675,535900156,16454152832,-4843,,
15049578179,524.21283,16454208211,535950687,16454203362,-4849,,
15049628759,524.26341,16454258803,536001275,16454253950,-4853,,
15049679325,524.31397,16454309362,536051829,16454304504,-4858,,
15049729933,524.36458,16454359972,536102433,16454355108,-4864,,
15049780540,524.41519,16454410580,536153037,16454405713,-4867,,
15049831592,524.46624,16454461635,536204087,16454456762,-4873,,
15049882460,524.51711,16454512506,536254953,16454507628,-4878,,
15049933342,524.56799,16454563390,536305841,16454558516,-4874,,
15049983916,524.61856,16454613966,536356402,16454609077,-4889,,
15050034965,524.66961,16454665030,536407461,16454660137,-4893,,
15050086038,524.72069,16454716094,536458519,16454711195,-4899,,
15050136588,524.77124,16454766646,536509067,16454761742,-4904,,
15050187605,524.82225,16454817664,536560080,16454812755,-4909,,
15050238194,524.87284,16454868257,536610667,16454863343,-4914,,
15050289242,524.92389,16454919307,536661712,16454914388,-4919,,
15050340267,524.97492,16454970334,536712734,16454965420,-4914,,
15050391303,525.02595,16455021373,536763768,16455016444,-4929,,
15050442361,525.07701,16455072433,536814823,16455067499,-4934,,
15050492938,525.12759,16455123012,536865397,16455118072,-4940,,
15050543945,525.17859,16455174021,536916401,16455169076,-4945,,
15050594320,525.22897,16455224398,536966774,16455219449,-4949,,
15050645361,525.28001,16455275443,537017813,16455270489,-4954,,
15050696466,525.33111,16455326549,537068914,16455321589,-4960,,
15050747062,525.38171,16455377148,537119508,16455372184,-4964,,
15050797691,525.43234,16455427780,537170134,16455422810,-4970,,
15050847962,525.48261,16455478053,537220403,16455473078,-4975,,
15050898029,525.53268,16455528121,537270466,16455523142,-4979,,
15050948654,525.58330,16455578750,537321089,16455573765,-4985,,
15050999454,525.63410,16455629552,537371886,16455624562,-4990,,
15051050062,525.68471,16455680162,537422491,16455675167,-4995,,
15051101142,525.73579,16455731244,537473569,16455726244,-5000,,
15051152189,525.78684,16455782294,537524613,16455777289,-5005,,
15051203241,525.83789,16455833360,537575674,16455828349,-5011,,
15051254291,525.88894,16455884412,537626721,16455879397,-5015,,
15051305334,525.93998,16455935445,537677750,16455930426,-5019,,
15051355909,525.99056,16455986023,537728322,16455980997,-5026,,
15051406458,526.04111,16456036575,537778869,16456031544,-5031,,
15051457051,526.09170,16456087169,537829459,16456082135,-5034,,
15051507353,526.14200,16456137475,537879768,16456132443,-5032,,
15051558425,526.19307,16456188549,537930827,16456183503,-5046,,
15051609459,526.24411,16456239585,537981858,16456234534,-5051,,
15051659973,526.29462,16456290102,538032371,16456285046,-5056,,
15051711052,526.34570,16456341183,538083446,16456336122,-5061,,
15051761849,526.39650,16456391983,538134251,16456386926,-5057,,
15051812474,526.44712,16456442610,538184864,16456437539,-5071,,
15051863035,526.49768,16456493173,538235422,16456488098,-5075,,
15051914099,526.54875,16456544241,538286483,16456539159,-5082,,
15051964633,526.59928,16456594776,538337014,16456589700,-5076,,
15052015256,526.64990,16456645400,538387634,16456640309,-5091,,
15052065806,526.70045,16456695954,538438181,16456690857,-5097,,
15052116855,526.75150,16456747004,538489227,16456741902,-5102,,
15052167940,526.80259,16456798092,538540310,16456792985,-5107,,
15052218441,526.85309,16456848596,538590808,16456843484,-5112,,
15052269032,526.90368,16456899188,538641396,16456894071,-5117,,
15052320107,526.95475,16456950266,538692468,16456945143,-5123,,
15052370691,527.00534,16457000852,538743050,16456995725,-5127,,
15052420789,527.05544,16457050952,538793145,16457045820,-5132,,
15052471508,527.10616,16457101675,538843861,16457096537,-5138,,
15052522066,527.15671,16457152235,538894417,16457147092,-5143,,
15052572690,527.20734,16457202873,538945051,16457197726,-5147,,
15052623235,527.25788,16457253409,538995580,16457248256,-5153,,
15052674321,527.30897,16457304496,539046663,16457299339,-5157,,
15052725150,527.35980,16457355327,539097490,16457350165,-5162,,
15052775920,527.41057,16457406101,539148257,16457400933,-5168,,
15052826530,527.46118,16457456712,539198864,16457451539,-5173,,
15052877135,527.51178,16457507330,539249478,16457502154,-5176,,
15052927940,527.56259,16457558128,539300269,16457552945,-5183,,
15052978962,527.61361,16457609151,539351288,16457603963,-5188,,
15053029977,527.66463,16457660169,539402300,16457654975,-5194,,
15053081059,527.71571,16457711253,539453380,16457706055,-5198,,
15053132088,527.76674,16457762285,539504407,16457757093,-5192,,
15053183157,527.81781,16457813356,539555472,16457808147,-5209,,
15053233719,527.86837,16457863921,539606033,16457858708,-5213,,
15053284253,527.91890,16457914456,539656563,16457909239,-5217,,
15053334802,527.96945,16457965008,539707109,16457959784,-5224,,
15053385822,528.02047,16458016031,539758126,16458010802,-5229,,
15053436430,528.07108,16458066641,539808732,16458061408,-5233,,
15053487479,528.12213,16458117693,539859778,16458112454,-5239,,
15053538530,528.17318,16458168745,539910826,16458163501,-5244,,
15053589093,528.22374,16458219312,539961387,16458214062,-5250,,
15053639185,528.27383,16458269406,540011477,16458264152,-5254,,
15053689618,528.32427,16458319841,540061906,16458314582,-5259,,
15053740515,528.37516,16458370741,540112800,16458365476,-5265,,
15053791092,528.42574,16458421320,540163375,16458416051,-5269,,
15053841309,528.47596,16458471539,540213590,16458466265,-5274,,
15053892360,528.52701,16458522593,540264637,16458517313,-5280,,
15053943392,528.57804,16458573627,540315667,16458568343,-5284,,
15053994429,528.62908,16458624666,540366702,16458619377,-5289,,
15054045465,528.68011,16458675705,540417735,16458670410,-5295,,
15054096511,528.73116,16458726753,540468777,16458721453,-5300,,
15054147321,528.78197,16458777565,540519584,16458772260,-5305,,
15054198393,528.83304,16458828640,540570654,16458823329,-5311,,
15054249038,528.88369,16458879286,540621296,16458873971,-5315,,
15054299642,528.93429,16458929894,540671898,16458924573,-5321,,
15054350224,528.98487,16458980478,540722487,16458975163,-5315,,
15054400806,529.03545,16459031061,540773056,16459025731,-5330,,
15054450857,529.08551,16459081116,540823104,16459075780,-5336,,
15054500971,529.13562,16459131232,540873217,16459125892,-5340,,
15054551877,529.18652,16459182140,540924119,16459176794,-5346,,
15054602922,529.23757,16459233188,540975161,16459227837,-5351,,
15054653538,529.28819,16459283805,541025775,16459278450,-5355,,
15054704151,529.33880,16459334421,541076386,16459329061,-5360,,
15054754785,529.38943,16459385058,541127017,16459379692,-5366,,
15054805882,529.44053,16459436156,541178109,16459430785,-5371,,
15054856431,529.49108,16459486708,541228658,16459481333,-5375,,
15054906997,529.54165,16459537276,541279220,16459531896,-5380,,
15054958044,529.59269,16459588326,541330264,16459582940,-5386,,
15055009091,529.64374,16459639376,541381310,16459633985,-5391,,
15055060107,529.69475,16459690394,541432323,16459684998,-5396,,
15055110683,529.74533,16459740972,541482896,16459735571,-5401,,
15055161234,529.79588,16459791526,541533443,16459786118,-5408,,
15055212306,529.84695,16459842599,541584513,16459837188,-5411,,
15055263349,529.89800,16459893645,541635554,16459888229,-5416,,
15055313895,529.94854,16459944194,541686097,16459938772,-5422,,
15055363969,529.99862,16459994270,541736168,16459988844,-5426,,
15055414516,530.04916,16460044819,541786712,16460039388,-5431,,
15055465093,530.09974,16460095399,541837287,16460089962,-5437,,
15055515648,530.15030,16460145955,541887838,16460140513,-5442,,
15055565899,530.20055,16460196209,541938087,16460190763,-5446,,
15055616476,530.25112,16460246789,541988662,16460241337,-5452,,
15055667413,530.30206,16460297728,542039596,16460292271,-5457,,
15055718020,530.35267,16460348338,542090201,16460342876,-5462,,
15055768166,530.40281,16460398486,542140343,16460393018,-5468,,
15055819241,530.45389,16460449562,542191415,16460444090,-5472,,
15055870300,530.50495,16460500625,542242472,16460495147,-5478,,
15055921293,530.55594,16460551620,542293463,16460546138,-5482,,
15055972259,530.60691,16460602587,542344425,16460597100,-5487,,
15056022821,530.65747,16460653153,542394985,16460647660,-5493,,
15056073230,530.70788,16460703564,542445391,16460698067,-5497,,
15056123481,530.75813,16460753827,542495650,16460748325,-5502,,
15056174061,530.80871,16460804411,542546228,16460798903,-5508,,
15056225099,530.85975,16460855439,542597251,16460849927,-5512,,
15056276046,530.91069,16460906389,542648197,16460900872,-5517,,
15056326543,530.96119,16460956888,542698690,16460951365,-5523,,
15056377099,531.01175,16461007447,542749243,16461001918,-5529,,
15056427171,531.06182,16461057522,542799313,16461051989,-5533,,
15056477707,531.11235,16461108060,542849846,16461102522,-5538,,
15056528249,531.16290,16461158603,542900385,16461153060,-5543,,
15056578851,531.21350,16461209208,542950985,16461203661,-5547,,
15056629206,531.26385,16461259565,543001337,16461254012,-5553,,
15056679774,531.31442,16461310136,543051903,16461304578,-5558,,
15056730300,531.36495,16461360664,543102425,16461355100,-5564,,
15056780907,531.41556,16461411273,543153030,16461405705,-5568,,
15056831950,531.46660,16461462319,543204070,16461456746,-5573,,
15056882974,531.51762,16461513346,543255091,16461507767,-5579,,
15056933547,531.56819,16461563921,543305662,16461558337,-5584,,
15056984100,531.61875,16461614476,543356213,16461608888,-5588,,
15057035131,531.66978,16461665510,543407241,16461659916,-5594,,
15057085726,531.72037,16461716107,543457832,16461710508,-5599,,
15057136527,531.77117,16461766911,543508631,16461761307,-5604,,
15057186637,531.82128,16461817023,543558738,16461811414,-5609,,
15057236919,531.87157,16461867307,543609017,16461861693,-5614,,
15057287098,531.92175,16461917489,543659195,16461911870,-5619,,
15057338110,531.97276,16461968503,543710204,16461962879,-5624,,
15057388744,532.02339,16462019139,543760834,16462013509,-5630,,
15057439693,532.07434,16462070091,543811781,16462064457,-5634,,
15057490263,532.12491,16462120663,543862348,16462115024,-5639,,
15057540825,532.17547,16462171227,543912907,16462165583,-5644,,
15057591371,532.22602,16462221776,543963451,16462216126,-5650,,
15057642421,532.27707,16462272828,544014498,16462267174,-5654,,
15057692968,532.32762,16462323377,544065043,16462317718,-5659,,
15057743501,532.37815,16462373913,544115573,16462368248,-5665,,
15057794329,532.42898,16462424743,544166398,16462419074,-5669,,
15057844869,532.47952,16462475285,544216935,16462469611,-5674,,
15057895440,532.53009,16462525869,544267514,16462520189,-5680,,
15057946481,532.58113,16462576902,544318541,16462571216,-5686,,
15057997529,532.63218,16462627953,544369588,16462622263,-5690,,
15058047727,532.68237,16462678152,544419782,16462672457,-5695,,
15058098745,532.73339,16462729173,544470808,16462723484,-5689,,
15058149410,532.78406,16462779840,544521460,16462774135,-5705,,
15058200088,532.83474,16462830521,544572135,16462824811,-5710,,
15058250662,532.88531,16462881108,544622718,16462875393,-5715,,
15058301699,532.93635,16462932136,544673740,16462926415,-5721,,
15058352235,532.98688,16462982675,544724275,16462976950,-5725,,
15058402798,533.03745,16463033253,544774847,16463027522,-5731,,
15058453838,533.08849,16463084283,544825871,16463078546,-5737,,
15058503902,533.13855,16463134349,544875934,16463128609,-5740,,
15058554472,533.18912,16463184921,544926501,16463179176,-5745,,
15058605321,533.23997,16463235773,544977347,16463230022,-5751,,
15058655833,533.29048,16463286298,545027867,16463280542,-5756,,
15058706907,533.34155,16463337364,545078928,16463331603,-5761,,
15058757544,533.39219,16463388002,545129561,16463382236,-5766,,
15058808352,533.44300,16463438813,545180367,16463433042,-5771,,
15058858954,533.49360,16463489418,545230967,16463483643,-5775,,
15058909621,533.54427,16463540087,545281630,16463534306,-5781,,
15058960160,533.59481,16463590628,545332166,16463584842,-5786,,
15059010270,533.64492,16463640741,545382273,16463634949,-5792,,
15059060855,533.69550,16463691328,545432856,16463685532,-5796,,
15059111392,533.74604,16463741867,545483401,16463736076,-5791,,
15059162404,533.79705,16463792882,545534399,16463787075,-5807,,
15059213008,533.84766,16463843488,545585001,16463837677,-5811,,
15059263562,533.89821,16463894044,545635553,16463888228,-5816,,
15059314577,533.94922,16463945061,545686564,16463939239,-5822,,
15059365656,534.00030,16463996142,545737640,16463990316,-5826,,
15059416706,534.05135,16464047196,545788688,16464041363,-5833,,
15059467700,534.10235,16464098192,545839679,16464092355,-5837,,
15059517818,534.15247,16464148312,545889795,16464142471,-5841,,
15059568321,534.20297,16464198817,545940295,16464192970,-5847,,
15059618881,534.25353,16464249380,545990852,16464243528,-5852,,
15059669495,534.30414,16464299995,546041463,16464294139,-5856,,
15059720545,534.35519,16464351049,546092510,16464345186,-5863,,
15059771094,534.40574,16464401600,546143057,16464395733,-5867,,
15059822103,534.45675,16464452610,546194063,16464446738,-5872,,
15059872690,534.50734,16464503201,546244648,16464497323,-5878,,
15059923698,534.55835,16464554211,546295653,16464548329,-5882,,
15059974346,534.60899,16464604860,546346298,16464598974,-5886,,
15060025369,534.66002,16464655899,546397330,16464650006,-5893,,
15060076419,534.71107,16464706938,546448376,16464701051,-5887,,
15060127516,534.76216,16464758039,546499460,16464752136,-5903,,
15060178056,534.81270,16464808580,546549997,16464802672,-5908,,
15060229091,534.86374,16464859629,546601041,16464853717,-5912,,
15060280175,534.91482,16464910705,546652112,16464904787,-5918,,
15060330701,534.96535,16464961233,546702635,16464955310,-5923,,
15060381750,535.01640,16465012284,546753680,16465006356,-5928,,
15060432746,535.06739,16465063283,546804674,16465057349,-5934,,
15060482847,535.11749,16465113385,546854772,16465107447,-5938,,
15060533895,535.16854,16465164435,546905817,16465158492,-5943,,
15060584454,535.21910,16465214998,546956373,16465209049,-5949,,
15060635467,535.27012,16465266013,547007384,16465260060,-5953,,
15060685571,535.32022,16465316120,547057485,16465310161,-5959,,
15060736597,535.37125,16465367148,547108508,16465361184,-5964,,
15060787668,535.42232,16465418221,547159576,16465412252,-5969,,
15060838690,535.47334,16465469246,547210597,16465463272,-5974,,
15060889263,535.52391,16465519820,547261166,16465513841,-5979,,
15060940281,535.57493,16465570841,547312181,16465564857,-5984,,
15060990840,535.62549,16465621413,547362748,16465615424,-5989,,
15061041877,535.67652,16465672442,547413773,16465666448,-5994,,
15061092628,535.72728,16465723194,547464520,16465717195,-5999,,
15061143696,535.77834,16465774266,547515585,16465768261,-6005,,
15061194246,535.82889,16465824817,547566133,16465818808,-6009,,
15061245298,535.87995,16465875873,547617182,16465869858,-6015,,
15061295869,535.93052,16465926446,547667750,16465920426,-6020,,
15061346939,535.98159,16465977518,547718817,16465971492,-6026,,
15061397188,536.03184,16466027769,547769064,16466021739,-6030,,
15061447799,536.08245,16466078382,547819672,16466072348,-6034,,
15061497924,536.13257,16466128510,547869795,16466122470,-6040,,
15061548969,536.18362,16466179557,547920837,16466173512,-6045,,
15061599488,536.23414,16466230079,547971353,16466224029,-6050,,
15061650533,536.28518,16466281126,548022395,16466275071,-6055,,
15061701573,536.33622,16466332169,548073433,16466326109,-6060,,
15061752164,536.38681,16466382762,548124021,16466376697,-6065,,
15061802764,536.43741,16466433364,548174618,16466427294,-6070,,
15061853385,536.48803,16466483987,548225235,16466477911,-6076,,
15061903950,536.53860,16466534555,548275799,16466528475,-6080,,
15061954988,536.58964,16466585596,548326835,16466579510,-6086,,
15062006025,536.64067,16466636635,548377868,16466630544,-6091,,
15062057097,536.69174,16466687709,548428938,16466681613,-6096,,
15062107645,536.74229,16466738259,548479483,16466732158,-6101,,
15062158684,536.79333,16466789301,548530519,16466783195,-6106,,
15062209748,536.84440,16466840367,548581581,16466834256,-6111,,
15062260302,536.89495,16466890935,548632143,16466884819,-6116,,
15062311335,536.94598,16466941959,548683162,16466935838,-6121,,
15062361941,536.99659,16466992567,548733766,16466986441,-6126,,
15062412457,537.04710,16467043086,548784278,16467036953,-6133,,
15062463001,537.09765,16467093632,548834821,16467087496,-6136,,
15062514050,537.14870,16467144684,548885867,16467138542,-6142,,
15062565102,537.19975,16467195738,548936916,16467189591,-6147,,
15062616212,537.25086,16467246850,548988023,16467240698,-6152,,
15062667126,537.30177,16467297767,549038934,16467291610,-6157,,
15062718166,537.35281,16467348809,549089972,16467342647,-6162,,
15062768740,537.40339,16467399384,549140542,16467393217,-6167,,
15062819800,537.45445,16467450448,549191601,16467444276,-6172,,
15062870362,537.50501,16467501012,549242160,16467494835,-6177,,
15062920440,537.55509,16467551091,549292234,16467544910,-6181,,
15062971467,537.60612,16467602122,549343260,16467595935,-6187,,
15063022029,537.65668,16467652686,549393819,16467646494,-6192,,
15063072585,537.70723,16467703245,549444372,16467697047,-6198,,
15063123673,537.75832,16467754335,549495457,16467748132,-6203,,
15063174685,537.80933,16467805348,549546466,16467799142,-6206,,
15063225725,537.86037,16467856392,549597503,16467850179,-6213,,
15063276282,537.91093,16467906950,549648057,16467900732,-6218,,
15063326847,537.96150,16467957518,549698621,16467951296,-6222,,
15063377873,538.01252,16468008547,549749644,16468002319,-6228,,
15063428562,538.06321,16468059238,549800329,16468053005,-6233,,
15063479537,538.11419,16468110214,549851301,16468103976,-6238,,
15063530579,538.16523,16468161260,549902341,16468155017,-6243,,
15063580640,538.21529,16468211322,549952399,16468205074,-6248,,
15063631180,538.26583,16468261866,550002937,16468255612,-6254,,
15063681965,538.31661,16468312662,550053729,16468306404,-6258,,
15063732487,538.36713,16468363177,550104239,16468356915,-6262,,
15063783019,538.41767,16468413722,550154778,16468407453,-6269,,
15063834043,538.46869,16468464738,550205789,16468458464,-6274,,
15063884569,538.51922,16468515265,550256312,16468508987,-6278,,
15063935143,538.56979,16468565843,550306883,16468559559,-6284,,
15063985691,538.62034,16468616404,550357439,16468610115,-6289,,
15064036215,538.67086,16468666918,550407950,16468660626,-6292,,
15064087278,538.72193,16468717984,550459010,16468711685,-6299,,
15064137836,538.77248,16468768545,550509575,16468762251,-6294,,
15064188388,538.82304,16468819098,550560125,16468812800,-6298,,
15064239421,538.87407,16468870134,550611145,16468863820,-6314,,
15064290483,538.92513,16468921199,550662205,16468914881,-6318,,
15064341018,538.97567,16468971737,550712736,16468965412,-6325,,
15064392069,539.02672,16469022789,550763785,16469016461,-6328,,
15064443109,539.07776,16469073831,550814822,16469067497,-6334,,
15064493664,539.12831,16469124390,550865375,16469118050,-6340,,
15064544298,539.17895,16469175026,550916005,16469168681,-6345,,
15064595353,539.23000,16469226083,550967059,16469219734,-6349,,
15064646131,539.28078,16469276863,551017833,16469270509,-6354,,
15064696661,539.33131,16469327396,551068361,16469321036,-6360,,
15064747233,539.38188,16469377969,551118930,16469371605,-6364,,
15064797782,539.43243,16469428522,551169487,16469422162,-6360,,
15064848336,539.48298,16469479078,551220028,16469472703,-6375,,
15064898924,539.53357,16469529668,551270613,16469523288,-6380,,
15064949462,539.58411,16469580209,551321148,16469573823,-6386,,
15065000018,539.63467,16469630767,551371701,16469624377,-6390,,
15065050559,539.68521,16469681310,551422239,16469674914,-6396,,
15065101122,539.73577,16469731876,551472801,16469725476,-6400,,
15065151682,539.78633,16469782437,551523356,16469776043,-6394,,
15065202246,539.83689,16469833005,551573919,16469826594,-6411,,
15065253266,539.88791,16469884027,551624936,16469877611,-6416,,
15065304328,539.93898,16469935091,551675996,16469928671,-6420,,
15065354877,539.98952,16469985643,551726541,16469979217,-6426,,
15065405970,540.04062,16470036738,551777631,16470030307,-6431,,
15065456543,540.09119,16470087313,551828202,16470080878,-6435,,
15065507077,540.14172,16470137851,551878734,16470131410,-6441,,
15065558122,540.19277,16470188896,551929775,16470182450,-6446,,
15065609139,540.24379,16470239916,551980790,16470233465,-6451,,
15065659744,540.29439,16470290524,552031392,16470284067,-6457,,
15065710234,540.34488,16470341016,552081879,16470334554,-6462,,
15065761268,540.39592,16470392053,552132910,16470385586,-6467,,
15065811354,540.44600,16470442140,552182994,16470435669,-6471,,
15065861928,540.49658,16470492716,552233565,16470486240,-6476,,
15065912478,540.54713,16470543270,552284113,16470536788,-6482,,
15065963027,540.59767,16470593821,552334659,16470587335,-6486,,
15066013598,540.64825,16470644394,552385228,16470637903,-6491,,
15066064127,540.69877,16470694927,552435755,16470688430,-6497,,
15066115446,540.75009,16470746247,552487069,16470739745,-6502,,
15066165710,540.80036,16470796513,552537332,16470790007,-6506,,
15066223511,540.85816,16470854316,552595129,16470847804,-6512,,
15066274333,540.90898,16470905141,552645948,16470898624,-6517,,
15066327366,540.96201,16470958177,552698979,16470951654,-6523,,
15066377412,541.01206,16471008225,552749022,16471001698,-6527,,
15066427507,541.06215,16471058324,552799115,16471051790,-6534,,
15066478534,541.11318,16471109352,552850139,16471102814,-6538,,
15066529572,541.16422,16471160391,552901173,16471153848,-6543,,
15066586147,541.22079,16471216969,552957745,16471210420,-6549,,
15066637178,541.27183,16471268002,553008773,16471261448,-6554,,
15066687707,541.32236,16471318535,553059301,16471311976,-6559,,
15066738432,541.37308,16471369263,553110024,16471362699,-6564,,
15066789359,541.42401,16471420191,553160947,16471413622,-6569,,
15066839433,541.47408,16471470267,553211018,16471463693,-6574,,
15066889791,541.52444,16471520627,553261373,16471514048,-6579,,
15066940083,541.57473,16471570921,553311662,16471564337,-6584,,
15066990455,541.62510,16471621297,553362033,16471614709,-6588,,
15067041021,541.67567,16471671864,553412607,16471665282,-6582,,
15067091746,541.72639,16471722591,553463317,16471715993,-6598,,
15067142129,541.77678,16471772989,553513709,16471766385,-6604,,
15067192344,541.82699,16471823195,553563910,16471816586,-6609,,
15067242610,541.87726,16471873462,553614173,16471866849,-6613,,
15067293192,541.92784,16471924048,553664752,16471917428,-6620,,
15067344244,541.97889,16471975102,553715802,16471968477,-6625,,
15067394851,542.02950,16472025712,553766406,16472019082,-6630,,
15067445087,542.07974,16472075950,553816639,16472069315,-6635,,
15067495803,542.13045,16472126679,553867365,16472120041,-6638,,
15067546154,542.18080,16472177022,553917701,16472170377,-6645,,
15067806246,542.44089,16472437125,554177779,16472430454,-6671,16472436315,
15067831358,542.46601,16472462239,554202890,16472455594,-6645,,
15067881918,542.51657,16472512801,554253447,16472506211,-6590,,
15067932064,542.56671,16472562949,554303591,16472556412,-6537,,
15067982682,542.61733,16472613570,554354215,16472607096,-6474,,
15068033762,542.66841,16472664652,554405284,16472658225,-6427,,
15068084347,542.71899,16472715250,554455876,16472708876,-6374,,
15068135332,542.76998,16472766226,554506847,16472759907,-6319,,
15068186302,542.82095,16472817199,554557815,16472810935,-6264,,
15068237351,542.87200,16472868251,554608861,16472862041,-6210,,
15068288414,542.92306,16472919316,554659921,16472913161,-6155,,
15068339460,542.97411,16472970364,554710965,16472964264,-6100,,
15068390531,543.02518,16473021438,554762033,16473015393,-6045,,
15068441554,543.07620,16473072462,554813053,16473066472,-5990,,
15068492601,543.12725,16473123513,554864098,16473117577,-5936,,
15068543155,543.17780,16473174080,554914660,16473168198,-5882,,
15068594225,543.22887,16473225141,554965716,16473219315,-5826,,
15068645274,543.27992,16473276192,555016762,16473270420,-5772,,
15068696301,543.33095,16473327221,555067786,16473321503,-5718,,
15068747403,543.38205,16473378326,555118886,16473372664,-5662,,
15068798198,543.43285,16473429135,555169690,16473423528,-5607,,
15068848963,543.48361,16473479891,555220440,16473474337,-5554,,
15068900009,543.53466,16473530940,555271483,16473525440,-5500,,
15068950954,543.58560,16473581887,555322426,16473576443,-5444,,
15069001518,543.63617,16473632452,555372987,16473627063,-5389,,
15069052581,543.68723,16473683529,555424058,16473678194,-5335,,
15069103637,543.73829,16473734576,555475100,16473729295,-5281,,
15069154681,543.78933,16473785623,555526142,16473780397,-5226,,
15069204854,543.83950,16473835798,555576311,16473830626,-5172,,
15069254944,543.88959,16473885890,555626399,16473880772,-5118,,
15069305504,543.94015,16473936453,555676957,16473931390,-5063,,
15069356049,543.99070,16473987001,555727500,16473981991,-5010,,
15069407052,544.04170,16474038005,555778499,16474033051,-4954,,
15069457406,544.09205,16474088362,555828851,16474083462,-4900,,
15069507996,544.14264,16474138955,555879438,16474134108,-4847,,
15069558634,544.19328,16474189595,555930074,16474184803,-4792,,
15069609244,544.24389,16474240207,555980680,16474235469,-4738,,
15069659786,544.29443,16474290752,556031221,16474286068,-4684,,
15069710308,544.34496,16474341276,556081739,16474336646,-4630,,
15069761393,544.39604,16474392363,556132821,16474387787,-4576,,
15069812042,544.44669,16474443015,556183469,16474438495,-4520,,
15069862678,544.49733,16474493653,556234101,16474489187,-4466,,
15069913278,544.54793,16474544265,556284708,16474539852,-4413,,
15069964300,544.59895,16474595280,556335718,16474590922,-4358,,
15070014875,544.64952,16474645867,556386300,16474641565,-4302,,
15070065923,544.70057,16474696908,556437335,16474692659,-4249,,
15070116957,544.75161,16474747944,556488366,16474743749,-4195,,
15070168021,544.80267,16474799020,556539439,16474794882,-4138,,
15070218663,544.85331,16474849654,556590067,16474845570,-4084,,
15070269283,544.90393,16474900277,556640684,16474896246,-4031,,
15070319398,544.95405,16474950394,556690796,16474946417,-3977,,
15070370020,545.00467,16475001018,556741416,16474997096,-3922,,
15070421039,545.05569,16475052040,556792432,16475048172,-3868,,
15070472056,545.10670,16475103060,556843446,16475099247,-3813,,
15070522125,545.15677,16475153131,556893513,16475149372,-3759,,
15070573110,545.20776,16475204118,556944496,16475200414,-3704,,
15070623219,545.25787,16475254230,556994601,16475250579,-3651,,
15070673876,545.30852,16475304889,557045255,16475301291,-3598,,
15070724021,545.35867,16475355036,557095398,16475351494,-3542,,
15070775091,545.40974,16475406109,557146465,16475402621,-3488,,
15070825723,545.46037,16475456743,557197094,16475453309,-3434,,
15070875908,545.51056,16475506930,557247278,16475503551,-3379,,
15070926502,545.56115,16475557527,557297869,16475554201,-3326,,
15070977123,545.61177,16475608150,557348487,16475604879,-3271,,
15071028146,545.66279,16475659174,557399507,16475655959,-3215,,
15071078306,545.71295,16475709338,557449665,16475706175,-3163,,
15071129239,545.76389,16475760272,557500594,16475757164,-3108,,
15071179863,545.81451,16475810900,557551215,16475807845,-3055,,
15071230840,545.86549,16475861879,557602190,16475858880,-2999,,
15071281253,545.91590,16475912293,557652600,16475909348,-2945,,
15071331860,545.96651,16475962903,557703204,16475960012,-2891,,
15071382874,546.01752,16476013920,557754216,16476011084,-2836,,
15071433066,546.06771,16476064114,557804405,16476061332,-2782,,
15071483681,546.11833,16476114731,557855017,16476112003,-2728,,
15071534689,546.16934,16476165742,557906022,16476163069,-2673,,
15071585058,546.21971,16476216112,557956389,16476213495,-2617,,
15071636144,546.27079,16476267201,558007472,16476264637,-2564,,
15071687192,546.32184,16476318252,558058517,16476315742,-2510,,
15071737768,546.37242,16476368840,558109101,16476366386,-2454,,
15071788378,546.42303,16476419443,558159698,16476417042,-2401,,
15071838506,546.47315,16476469573,558209823,16476467226,-2347,,
15071889528,546.52418,16476520597,558260842,16476518304,-2293,,
15071940118,546.57477,16476571190,558311430,16476568952,-2238,,
15071991128,546.62578,16476622212,558362448,16476620029,-2183,,
15072042160,546.67681,16476673237,558413466,16476671107,-2130,,
15072092771,546.72742,16476723850,558464075,16476721776,-2074,,
15072143405,546.77805,16476774486,558514706,16476772465,-2021,,
15072193521,546.82817,16476824604,558564819,16476822637,-1967,,
15072244088,546.87874,16476875174,558615384,16476873261,-1913,,
15072295180,546.92983,16476926268,558666474,16476924411,-1857,,
15072346229,546.98088,16476977320,558717519,16476975517,-1803,,
15072397278,547.03193,16477028371,558768566,16477026623,-1748,,
15072447761,547.08241,16477078855,558819046,16477077162,-1693,,
15072498376,547.13302,16477129474,558869658,16477127835,-1639,,
15072548971,547.18362,16477180070,558920250,16477178485,-1585,,
15072599556,547.23420,16477230658,558970832,16477229127,-1531,,
15072650568,547.28522,16477281672,559021842,16477280196,-1476,,
15072700756,547.33540,16477331863,559072027,16477330440,-1423,,
15072751293,547.38594,16477382413,559122572,16477381044,-1369,,
15072802389,547.43704,16477433501,559173656,16477432188,-1313,,
15072853346,547.48799,16477484460,559224609,16477483146,-1314,,
15072904070,547.53872,16477535186,559275330,16477533867,-1319,,
15072954655,547.58930,16477585773,559325912,16477584449,-1324,,
15073005201,547.63985,16477636322,559376457,16477634994,-1328,,
15073056232,547.69088,16477687356,559427495,16477686033,-1323,,
15073106825,547.74147,16477737951,559478074,16477736612,-1339,,
15073157867,547.79251,16477788994,559529114,16477787651,-1343,,
15073208915,547.84356,16477840046,559580159,16477838697,-1349,,
15073259432,547.89408,16477890565,559630673,16477889211,-1354,,
15073309978,547.94463,16477941114,559681217,16477939754,-1360,,
15073360532,547.99518,16477991669,559731768,16477990315,-1354,,
15073411130,548.04578,16478042269,559782363,16478040900,-1369,,
15073462220,548.09687,16478093363,559833450,16478091987,-1376,,
15073512808,548.14746,16478143952,559884036,16478142573,-1379,,
15073563325,548.19797,16478194471,559934550,16478193087,-1384,,
15073613903,548.24855,16478245052,559985125,16478243662,-1390,,
15073664090,548.29874,16478295242,560035310,16478293848,-1394,,
15073714223,548.34887,16478345377,560085440,16478343978,-1399,,
15073764831,548.39948,16478395988,560136045,16478394583,-1405,,
15073815885,548.45053,16478447043,560187096,16478445633,-1410,,
15073866952,548.50160,16478498113,560238162,16478496699,-1414,,
15073917561,548.55221,16478548724,560288767,16478547305,-1419,,
15073968609,548.60326,16478599775,560339812,16478598350,-1425,,
15074019184,548.65383,16478650353,560390386,16478648923,-1430,,
15074069937,548.70458,16478701108,560441136,16478699673,-1435,,
15074120982,548.75563,16478752155,560492178,16478750715,-1440,,
15074172033,548.80668,16478803209,560543225,16478801762,-1447,,
15074223080,548.85773,16478854257,560594270,16478852807,-1450,,
15074274103,548.90875,16478905283,560645290,16478903828,-1455,,
15074325147,548.95979,16478956330,560696342,16478954880,-1450,,
15074376226,549.01087,16479007411,560747408,16479005945,-1466,,
15074427276,549.06192,16479058464,560798456,16479056993,-1471,,
15074478347,549.11299,16479109537,560849523,16479108060,-1477,,
15074528984,549.16363,16479160175,560900157,16479158694,-1481,,
15074579473,549.21412,16479210668,560950644,16479209182,-1486,,
15074629560,549.26421,16479260757,561000729,16479259266,-1491,,
15074680152,549.31480,16479311351,561051318,16479309855,-1496,,
15074731224,549.36587,16479362425,561102386,16479360923,-1502,,
15074781407,549.41606,16479412611,561152567,16479411105,-1506,,
15074832431,549.46708,16479463637,561203589,16479462126,-1511,,
15074883434,549.51808,16479514643,561254589,16479513126,-1517,,
15074934475,549.56912,16479565686,561305627,16479564165,-1521,,
15074984881,549.61953,16479616094,561356031,16479614568,-1526,,
15075035070,549.66972,16479666285,561406216,16479664753,-1532,,
15075086086,549.72073,16479717304,561457230,16479715767,-1537,,
15075137103,549.77175,16479768323,561508244,16479766781,-1542,,
15075187697,549.82235,16479818920,561558835,16479817373,-1547,,
15075238746,549.87339,16479869970,561609881,16479868418,-1552,,
15075289329,549.92398,16479920557,561660462,16479918999,-1558,,
15075340354,549.97500,16479971584,561711485,16479970022,-1562,,
15075391403,550.02605,16480022635,561762530,16480021067,-1568,,
15075442480,550.07713,16480073715,561813604,16480072141,-1574,,
15075493529,550.12818,16480124766,561864651,16480123188,-1578,,
15075544578,550.17923,16480175817,561915697,16480174235,-1582,,
15075595589,550.23024,16480226831,561966705,16480225243,-1588,,
15075646672,550.28132,16480277916,562017786,16480276323,-1593,,
15075697763,550.33241,16480329009,562068874,16480327411,-1598,,
15075748365,550.38301,16480379613,562119473,16480378010,-1603,,
15075798993,550.43364,16480430244,562170098,16480428636,-1608,,
15075849545,550.48419,16480480798,562220648,16480479185,-1613,,
15075900561,550.53521,16480531817,562271672,16480530209,-1608,,
15075951611,550.58626,16480582869,562322708,16480581246,-1623,,
15076002082,550.63673,16480633342,562373176,16480631713,-1629,,
15076052545,550.68719,16480683807,562423637,16480682174,-1633,,
15076103138,550.73779,16480734403,562474227,16480732765,-1638,,
15076153685,550.78833,16480784953,562524772,16480783309,-1644,,
15076204734,550.83938,16480836004,562575818,16480834355,-1649,,
15076255782,550.89043,16480887055,562626863,16480885401,-1654,,
15076306363,550.94101,16480937638,562677442,16480935979,-1659,,
15076356980,550.99163,16480988257,562728055,16480986592,-1665,,
15076407553,551.04220,16481038833,562778626,16481037163,-1670,,
15076458046,551.09269,16481089328,562829116,16481087653,-1675,,
15076508359,551.14301,16481139653,562879436,16481137974,-1679,,
15076558949,551.19360,16481190236,562930014,16481188552,-1684,,
15076608997,551.24365,16481240286,562980060,16481238597,-1689,,
15076659581,551.29423,16481290872,563030640,16481289178,-1694,,
15076710184,551.34483,16481341477,563081241,16481339778,-1699,,
15076760826,551.39547,16481392121,563131880,16481390417,-1704,,
15076811874,551.44652,16481443172,563182925,16481441463,-1709,,
15076862924,551.49757,16481494225,563233972,16481492510,-1715,,
15076913972,551.54862,16481545275,563285019,16481543556,-1719,,
15076965014,551.59966,16481596320,563336057,16481594595,-1725,,
15077015604,551.65025,16481646912,563386645,16481645182,-1730,,
15077066188,551.70084,16481697509,563437236,16481695774,-1735,,
15077117258,551.75191,16481748571,563488293,16481746831,-1740,,
15077168297,551.80295,16481799611,563539329,16481797866,-1745,,
15077219354,551.85400,16481850670,563590383,16481848920,-1750,,
15077270403,551.90505,16481901722,563641430,16481899967,-1755,,
15077321423,551.95607,16481952745,563692448,16481950985,-1760,,
15077371969,552.00662,16482003293,563742991,16482001528,-1765,,
15077423052,552.05770,16482054379,563794070,16482052608,-1771,,
15077473906,552.10855,16482105235,563844923,16482103460,-1775,,
15077524031,552.15868,16482155362,563895043,16482153581,-1781,,
15077574452,552.20910,16482205786,563945463,16482204000,-1786,,
15077625056,552.25970,16482256392,563996064,16482254601,-1791,,
15077675372,552.31002,16482306711,564046377,16482304915,-1796,,
15077725884,552.36053,16482357224,564096886,16482355423,-1801,,
15077776307,552.41095,16482407650,564147317,16482405855,-1795,,
15077827125,552.46177,16482458471,564198122,16482456660,-1811,,
15077878196,552.51284,16482509544,564249190,16482507728,-1816,,
15077928764,552.56341,16482560114,564299755,16482558292,-1822,,
15077979867,552.61451,16482611220,564350857,16482609394,-1826,,
15078030551,552.66520,16482661905,564401547,16482660084,-1821,,
15078081600,552.71625,16482712967,564452593,16482711131,-1836,,
15078132683,552.76733,16482764043,564503663,16482762201,-1842,,
15078183733,552.81838,16482815094,564554711,16482813248,-1846,,
15078234294,552.86894,16482865659,564605269,16482863807,-1852,,
15078285297,552.91994,16482916664,564656269,16482914807,-1857,,
15078335860,552.97051,16482967229,564706830,16482965368,-1861,,
15078386940,553.02159,16483018311,564757906,16483016444,-1867,,
15078437958,553.07261,16483069331,564808921,16483067459,-1872,,
15078489041,553.12369,16483120417,564860002,16483118539,-1878,,
15078540060,553.17471,16483171439,564911019,16483169557,-1882,,
15078591094,553.22574,16483222475,564962050,16483220587,-1888,,
15078641644,553.27629,16483273032,565012602,16483271139,-1893,,
15078692205,553.32685,16483323590,565063156,16483321693,-1897,,
15078743284,553.37793,16483374672,565114233,16483372770,-1902,,
15078793906,553.42855,16483425297,565164851,16483423389,-1908,,
15078844507,553.47915,16483475899,565215449,16483473987,-1912,,
15078895127,553.52977,16483526521,565266067,16483524605,-1916,,
15078945306,553.57995,16483576704,565316243,16483574781,-1923,,
15078995436,553.63008,16483626836,565366371,16483624908,-1928,,
15079046316,553.68096,16483677717,565417248,16483675785,-1932,,
15079096944,553.73159,16483728349,565467874,16483726411,-1938,,
15079147980,553.78263,16483779387,565518907,16483777444,-1943,,
15079198762,553.83341,16483830182,565569697,16483828235,-1947,,
15079248919,553.88357,16483880331,565619840,16483878389,-1942,,
15079299295,553.93394,16483930709,565670213,16483928762,-1947,,
15079349415,553.98406,16483980830,565720329,16483978878,-1952,,
15079400045,554.03469,16484031463,565770958,16484029495,-1968,,
15079450637,554.08528,16484082057,565821547,16484080084,-1973,,
15079500770,554.13542,16484132192,565871676,16484130214,-1978,,
15079551369,554.18602,16484182795,565922275,16484180812,-1983,,
15079601952,554.23660,16484233380,565972854,16484231392,-1988,,
15079652521,554.28717,16484283950,566023420,16484281957,-1993,,
15079703189,554.33784,16484334622,566074085,16484332623,-1999,,
15079754086,554.38873,16484385521,566124980,16484383518,-2003,,
15079804712,554.43936,16484436150,566175613,16484434151,-1999,,
15079855400,554.49005,16484486839,566226288,16484484825,-2014,,
15079906079,554.54073,16484537520,566276965,16484535502,-2018,,
15079957097,554.59174,16484588542,566327981,16484586518,-2024,,
15080007689,554.64234,16484639136,566378569,16484637107,-2029,,
15080058696,554.69334,16484690144,566429573,16484688110,-2034,,
15080108802,554.74345,16484740254,566479677,16484738215,-2039,,
15080159415,554.79406,16484790868,566530287,16484788824,-2044,,
15080210433,554.84508,16484841889,566581303,16484839840,-2049,,
15080261434,554.89608,16484892893,566632301,16484890839,-2054,,
15080311722,554.94637,16484943183,566682586,16484941124,-2059,,
15080362562,554.99721,16484994036,566733433,16484991971,-2065,,
15080412927,555.04758,16485044393,566783785,16485042322,-2071,,
15080463859,555.09851,16485095326,566834715,16485093252,-2074,,
15080513961,555.14861,16485145432,566884814,16485143351,-2081,,
15080564945,555.19959,16485196418,566935795,16485194333,-2085,,
15080615490,555.25014,16485246965,566986339,16485244876,-2089,,
15080666071,555.30072,16485297549,567036916,16485295454,-2095,,
15080716210,555.35086,16485347690,567087052,16485345590,-2100,,
15080766324,555.40097,16485397806,567137164,16485395702,-2104,,
15080817390,555.45204,16485448875,567188227,16485446765,-2110,,
15080867991,555.50264,16485499478,567238826,16485497363,-2115,,
15080919040,555.55369,16485550529,567289871,16485548409,-2120,,
15080970112,555.60476,16485601605,567340943,16485599480,-2125,,
15081020676,555.65532,16485652170,567391503,16485650040,-2130,,
15081071739,555.70639,16485703235,567442563,16485701100,-2135,,
15081122345,555.75699,16485753856,567493178,16485751715,-2141,,
15081172968,555.80762,16485804468,567543786,16485802323,-2145,,
15081223599,555.85825,16485855103,567594415,16485852952,-2151,,
15081274247,555.90890,16485905753,567645059,16485903596,-2157,,
15081324848,555.95950,16485956356,567695658,16485954195,-2161,,
15081375757,556.01040,16486007268,567746574,16486005112,-2156,,
15081425857,556.06051,16486057370,567796662,16486055199,-2171,,
15081476326,556.11097,16486107840,567847128,16486105665,-2175,,
15081527349,556.16200,16486158867,567898148,16486156685,-2182,,
15081577793,556.21244,16486209313,567948589,16486207127,-2186,,
15081628380,556.26303,16486259902,567999173,16486257711,-2191,,
15081679406,556.31405,16486310931,568050197,16486308735,-2196,,
15081729753,556.36440,16486361280,568100542,16486359079,-2201,,
15081780358,556.41501,16486411886,568151143,16486409680,-2206,,
15081831432,556.46608,16486462964,568202215,16486460753,-2211,,
15081882083,556.51673,16486513617,568252863,16486511401,-2216,,
15081932646,556.56729,16486564183,568303423,16486561961,-2222,,
15081983266,556.61791,16486614805,568354040,16486612578,-2227,,
15082033862,556.66851,16486665403,568404634,16486663172,-2231,,
15082084909,556.71956,16486716453,568455678,16486714216,-2237,,
15082135929,556.77058,16486767474,568506695,16486765232,-2242,,
15082186562,556.82121,16486818110,568557326,16486815863,-2247,,
15082237568,556.87222,16486869119,568608330,16486866868,-2251,,
15082288617,556.92327,16486920170,568659375,16486917912,-2258,,
15082339200,556.97385,16486970755,568709956,16486968493,-2262,,
15082389809,557.02446,16487021367,568760574,16487019111,-2256,,
15082440381,557.07503,16487071941,568811132,16487069669,-2272,,
15082490584,557.12523,16487122145,568861331,16487119868,-2277,,
15082540748,557.17540,16487172313,568911493,16487170031,-2282,,
15082591778,557.22643,16487223344,568962530,16487221067,-2277,,
15082642312,557.27696,16487273882,569013052,16487271589,-2293,,
15082692819,557.32747,16487324391,569063555,16487322093,-2298,,
15082743896,557.37854,16487375469,569114630,16487373167,-2302,,
15082794945,557.42959,16487426522,569165676,16487424213,-2309,,
15082845500,557.48015,16487477079,569216228,16487474776,-2303,,
15082896110,557.53076,16487527702,569266848,16487525385,-2317,,
15082946735,557.58138,16487578330,569317470,16487576008,-2322,,
15082996798,557.63145,16487628384,569367518,16487626056,-2328,,
15083047409,557.68206,16487678996,569418127,16487676665,-2331,,
15083098440,557.73309,16487730030,569469155,16487727692,-2338,,
15083148982,557.78363,16487780586,569519706,16487778244,-2342,,
15083200066,557.83471,16487831661,569570776,16487829313,-2348,,
15083251055,557.88570,16487882653,569621762,16487880300,-2353,,
15083301628,557.93628,16487933228,569672332,16487930870,-2358,,
15083352676,557.98732,16487984279,569723377,16487981915,-2364,,
15083403060,558.03771,16488034665,569773758,16488032295,-2370,,
15083453624,558.08827,16488085230,569824320,16488082857,-2373,,
15083504236,558.13888,16488135846,569874930,16488133467,-2379,,
15083555322,558.18997,16488186933,569926012,16488184549,-2384,,
15083606292,558.24094,16488237906,569976980,16488235518,-2388,,
15083656862,558.29151,16488288478,570027547,16488286084,-2394,,
15083707536,558.34218,16488339155,570078219,16488336756,-2399,,
15083758122,558.39277,16488389742,570128801,16488387338,-2404,,
15083808369,558.44302,16488439993,570179047,16488437584,-2409,,
15083859371,558.49402,16488490997,570230045,16488488583,-2414,,
15083910421,558.54507,16488542049,570281092,16488539630,-2419,,
15083960962,558.59561,16488592593,570331632,16488590169,-2424,,
15084011509,558.64616,16488643142,570382175,16488640712,-2430,,
15084062510,558.69716,16488694146,570433173,16488691711,-2435,,
15084112660,558.74731,16488744298,570483322,16488741859,-2439,,
15084163230,558.79788,16488794881,570533899,16488792437,-2444,,
15084213823,558.84847,16488845465,570584478,16488843015,-2450,,
15084264889,558.89954,16488896533,570635541,16488894078,-2455,,
15084315897,558.95055,16488947544,570686548,16488945085,-2459,,
15084366988,559.00164,16488998637,570737635,16488996172,-2465,,
15084417534,559.05218,16489049198,570788190,16489046728,-2470,,
15084468612,559.10326,16489100266,570839254,16489097792,-2474,,
15084519660,559.15431,16489151317,570890299,16489148837,-2480,,
15084570737,559.20538,16489202395,570941373,16489199911,-2484,,
15084621759,559.25641,16489253421,570992392,16489250930,-2491,,
15084672271,559.30692,16489303934,571042902,16489301439,-2495,,
15084722819,559.35747,16489354485,571093447,16489351985,-2500,,
15084773377,559.40802,16489405046,571144003,16489402540,-2506,,
15084824196,559.45884,16489455867,571194819,16489453356,-2511,,
15084874786,559.50943,16489506459,571245407,16489503944,-2515,,
15084924974,559.55962,16489556650,571295591,16489554128,-2522,,
15084976020,559.61067,16489607698,571346635,16489605172,-2526,,
15085026580,559.66123,16489658259,571397192,16489655729,-2530,,
15085076896,559.71154,16489708580,571447506,16489706044,-2536,,
15085127470,559.76212,16489759155,571498076,16489756614,-2541,,
15085178027,559.81268,16489809713,571548631,16489807168,-2545,,
15085228627,559.86328,16489860317,571599228,16489857766,-2551,,
15085279630,559.91428,16489911322,571650229,16489908766,-2556,,
15085330215,559.96486,16489961910,571700810,16489959347,-2563,,
15085381165,560.01581,16490012861,571751758,16490010295,-2566,,
15085431754,560.06640,16490063453,571802344,16490060882,-2571,,
15085482789,560.11744,16490114491,571853376,16490111914,-2577,,
15085533837,560.16849,16490165541,571904422,16490162959,-2582,,
15085584876,560.21952,16490216581,571955458,16490213995,-2586,,
15085635891,560.27054,16490267600,572006470,16490265008,-2592,,
15085686487,560.32114,16490318199,572057065,16490315603,-2596,,
15085737070,560.37172,16490368782,572107644,16490366182,-2600,,
15085787698,560.42235,16490419425,572158281,16490416819,-2606,,
15085838738,560.47339,16490470456,572209306,16490467844,-2612,,
15085889344,560.52399,16490521065,572259910,16490518447,-2618,,
15085940379,560.57503,16490572101,572310942,16490569480,-2621,,
15085990935,560.62558,16490622660,572361495,16490620033,-2627,,
15086041480,560.67613,16490673208,572412037,16490670575,-2633,,
15086092057,560.72671,16490723787,572462612,16490721150,-2637,,
15086142446,560.77709,16490774178,572512998,16490771536,-2642,,
15086193002,560.82765,16490824737,572563552,16490822090,-2647,,
15086243934,560.87858,16490875671,572614481,16490873018,-2653,,
15086294982,560.92963,16490926720,572665526,16490924064,-2656,,
15086345597,560.98024,16490977339,572716139,16490974676,-2663,,
15086396634,561.03128,16491028378,572767172,16491025710,-2668,,
15086447258,561.08191,16491079004,572817794,16491076332,-2672,,
15086497853,561.13250,16491129602,572868386,16491126924,-2678,,
15086548256,561.18290,16491180007,572918786,16491177324,-2683,,
15086598390,561.23304,16491230143,572968918,16491227456,-2687,,
15086648988,561.28364,16491280744,573019513,16491278051,-2693,,
15086699558,561.33421,16491331316,573070081,16491328619,-2697,,
15086750319,561.38497,16491382080,573120838,16491379376,-2704,,
15086800439,561.43509,16491432202,573170957,16491429494,-2708,,
15086851477,561.48613,16491483241,573221991,16491480529,-2712,,
15086901621,561.53627,16491533389,573272133,16491530670,-2719,,
15086952274,561.58692,16491584044,573322783,16491581321,-2723,,
15087003325,561.63797,16491635097,573373831,16491632369,-2728,,
15087053827,561.68848,16491685602,573424330,16491682868,-2734,,
15087103878,561.73853,16491735655,573474379,16491732916,-2739,,
15087153961,561.78861,16491785740,573524460,16491782997,-2743,,
15087204530,561.83918,16491836312,573575026,16491833563,-2749,,
15087255070,561.88972,16491886853,573625562,16491884100,-2753,,
15087306010,561.94066,16491937796,573676500,16491935038,-2758,,
15087356611,561.99126,16491988400,573727098,16491985636,-2764,,
15087407184,562.04183,16492038975,573777668,16492036205,-2770,,
15087458230,562.09288,16492090023,573828712,16492087249,-2774,,
15087508867,562.14351,16492140662,573879346,16492137883,-2779,,
15087559909,562.19456,16492191706,573930385,16492188922,-2784,,
15087610494,562.24514,16492242294,573980967,16492239504,-2790,,
15087661548,562.29620,16492293351,574032019,16492290557,-2794,,
15087712085,562.34673,16492343890,574082553,16492341090,-2800,,
15087762644,562.39729,16492394452,574133110,16492391648,-2804,,
15087813672,562.44832,16492445481,574184135,16492442672,-2809,,
15087864283,562.49893,16492496095,574234744,16492493281,-2814,,
15087915240,562.54989,16492547055,574285698,16492544235,-2820,,
15087965335,562.59998,16492597151,574335789,16492594326,-2825,,
15088015906,562.65055,16492647725,574386359,16492644897,-2828,,
15088066480,562.70113,16492698301,574436929,16492695467,-2834,,
15088117078,562.75173,16492748912,574487535,16492746073,-2839,,
15088167616,562.80226,16492799441,574538060,16492796597,-2844,,
15088218645,562.85329,16492850473,574589086,16492847623,-2850,,
15088268733,562.90338,16492900564,574639171,16492897709,-2855,,
15088319788,562.95444,16492951622,574690224,16492948761,-2861,,
15088370823,563.00547,16493002659,574741257,16492999795,-2864,,
15088421872,563.05652,16493053711,574792304,16493050841,-2870,,
15088472535,563.10718,16493104375,574842962,16493101499,-2876,,
15088523556,563.15820,16493155399,574893982,16493152520,-2879,,
15088574568,563.20922,16493206413,574944991,16493203528,-2885,,
15088625188,563.25984,16493257036,574995607,16493254145,-2891,,
15088675732,563.31038,16493307582,575046149,16493304686,-2896,,
15088726763,563.36141,16493358614,575097177,16493355714,-2900,,
15088777333,563.41198,16493409187,575147744,16493406292,-2895,,
15088828396,563.46304,16493460253,575198804,16493457341,-2912,,
15088878504,563.51315,16493510363,575248910,16493507447,-2916,,
15088928995,563.56364,16493560857,575299399,16493557936,-2921,,
15088979157,563.61380,16493611020,575349557,16493608094,-2926,,
15089029966,563.66461,16493661833,575400363,16493658900,-2933,,
15089080552,563.71520,16493712420,575450947,16493709484,-2936,,
15089131118,563.76577,16493762989,575501521,16493760059,-2930,,
15089181755,563.81640,16493813628,575552144,16493810681,-2947,,
15089232378,563.86703,16493864254,575602765,16493861303,-2951,,
15089282505,563.91715,16493914383,575652890,16493911427,-2956,,
15089333138,563.96779,16493965019,575703519,16493962057,-2962,,
15089384177,564.01882,16494016059,575754555,16494013092,-2967,,
15089434752,564.06940,16494066637,575805128,16494063666,-2971,,
15089485005,564.11965,16494116893,575855378,16494113916,-2977,,
15089535157,564.16980,16494167047,575905528,16494164065,-2982,,
15089585843,564.22049,16494217734,575956211,16494214748,-2986,,
15089636036,564.27068,16494267931,576006401,16494264939,-2992,,
15089686577,564.32123,16494318473,576056939,16494315477,-2996,,
15089737133,564.37178,16494369031,576107493,16494366030,-3001,,
15089788200,564.42285,16494420101,576158557,16494417094,-3007,,
15089839166,564.47381,16494471070,576209521,16494468058,-3012,,
15089889795,564.52444,16494521702,576260147,16494518684,-3018,,
15089940391,564.57504,16494572299,576310740,16494569278,-3021,,
15089991041,564.62569,16494622952,576361388,16494619925,-3027,,
15090041598,564.67625,16494673511,576411941,16494670478,-3033,,
15090092133,564.72678,16494724048,576462474,16494721011,-3037,,
15090142264,564.77691,16494774182,576512602,16494771140,-3042,,
15090192452,564.82710,16494824373,576562788,16494821326,-3047,,
15090243498,564.87815,16494875421,576613832,16494872369,-3052,,
15090294085,564.92873,16494926010,576664415,16494922952,-3058,,
15090344240,564.97889,16494976167,576714567,16494973104,-3063,,
15090394867,565.02951,16495026797,576765192,16495023729,-3068,,
15090445930,565.08058,16495077862,576816253,16495074790,-3072,,
15090496469,565.13112,16495128404,576866800,16495125337,-3067,,
15090547516,565.18216,16495179463,576917843,16495176381,-3082,,
15090598555,565.23320,16495230494,576968869,16495227406,-3088,,
15090649581,565.28423,16495281522,577019892,16495278429,-3093,,
15090700119,565.33477,16495332062,577070427,16495328964,-3098,,
15090750677,565.38532,16495382624,577120982,16495379529,-3095,,
15090801246,565.43589,16495433195,577171549,16495430087,-3108,,
15090852224,565.48687,16495484175,577222524,16495481062,-3113,,
15090902843,565.53749,16495534797,577273140,16495531677,-3120,,
15090953870,565.58852,16495585826,577324165,16495582703,-3123,,
15091004473,565.63912,16495636431,577374765,16495633302,-3129,,
15091055563,565.69021,16495687523,577425852,16495684389,-3134,,
15091106193,565.74084,16495738166,577476489,16495735027,-3139,,
15091157226,565.79187,16495789190,577527510,16495786047,-3143,,
15091207405,565.84205,16495839373,577577687,16495836224,-3149,,
15091258454,565.89310,16495890423,577628732,16495887269,-3154,,
15091309482,565.94413,16495941455,577679767,16495938304,-3151,,
15091360550,565.99520,16495992525,577730823,16495989360,-3165,,
15091411579,566.04623,16496043556,577781860,16496040397,-3159,,
15091462648,566.09730,16496094628,577832915,16496091452,-3176,,
15091513695,566.14834,16496145677,577883960,16496142498,-3179,,
15091564713,566.19936,16496196697,577934975,16496193513,-3184,,
15091615794,566.25044,16496247781,577986053,16496244591,-3190,,
15091666845,566.30149,16496298834,578037101,16496295639,-3195,,
15091717874,566.35252,16496349866,578088139,16496346676,-3190,,
15091768942,566.40359,16496400935,578139193,16496397730,-3205,,
15091819990,566.45464,16496451986,578190239,16496448776,-3210,,
15091870542,566.50519,16496502540,578240787,16496499324,-3216,,
15091920866,566.55551,16496552867,578291109,16496549646,-3221,,
15091971244,566.60589,16496603247,578341484,16496600021,-3226,,
15092021796,566.65644,16496653802,578392033,16496650571,-3231,,
15092072308,566.70696,16496704316,578442543,16496701081,-3235,,
15092123386,566.75803,16496755396,578493618,16496752156,-3240,,
15092174431,566.80908,16496806455,578544671,16496803209,-3246,,
15092225494,566.86014,16496857508,578595720,16496854257,-3251,,
15092276542,566.91119,16496908560,578646766,16496905304,-3256,,
15092327561,566.96221,16496959580,578697782,16496956319,-3261,,
15092378610,567.01326,16497010632,578748828,16497007365,-3267,,
15092429157,567.06381,16497061181,578799373,16497057910,-3271,,
15092480165,567.11481,16497112192,578850379,16497108916,-3276,,
15092530277,567.16493,16497162305,578900487,16497159024,-3281,,
15092580815,567.21546,16497212857,578951032,16497209570,-3287,,
15092631392,567.26604,16497263426,579001597,16497260135,-3291,,
15092681994,567.31664,16497314029,579052196,16497310733,-3296,,
15092732547,567.36720,16497364585,579102746,16497361283,-3302,,
15092783170,567.41782,16497415210,579153367,16497411904,-3306,,
15092834217,567.46887,16497466260,579204412,16497462949,-3311,,
15092884830,567.51948,16497516876,579255021,16497513559,-3317,,
15092935879,567.57053,16497567927,579306067,16497564605,-3322,,
15092986450,567.62110,16497618500,579356636,16497615173,-3327,,
15093037244,567.67189,16497669297,579407427,16497665965,-3332,,
15093088038,567.72269,16497720093,579458218,16497716756,-3337,,
15093138629,567.77328,16497770687,579508807,16497767354,-3333,,
15093189197,567.82385,16497821256,579559372,16497817909,-3347,,
15093240246,567.87489,16497872307,579610418,16497868955,-3352,,
15093291294,567.92594,16497923359,579661463,16497920001,-3358,,
15093342343,567.97699,16497974410,579712510,16497971048,-3362,,
15093393393,568.02804,16498025461,579763557,16498022094,-3367,,
15093444443,568.07909,16498076514,579814604,16498073142,-3372,,
15093495471,568.13012,16498127545,579865630,16498124168,-3377,,
15093546042,568.18069,16498178119,579916198,16498174736,-3383,,
15093596584,568.23123,16498228663,579966738,16498225275,-3388,,
15093647167,568.28182,16498279247,580017317,16498275854,-3393,,
15093698213,568.33286,16498330296,580068361,16498326898,-3398,,
15093748748,568.38340,16498380834,580118894,16498377431,-3403,,
15093799333,568.43398,16498431420,580169475,16498428012,-3408,,
15093849891,568.48454,16498481993,580220043,16498478580,-3413,,
15093900440,568.53509,16498532533,580270577,16498529115,-3418,,
15093951346,568.58599,16498583441,580321480,16498580018,-3423,,
15094002373,568.63702,16498634470,580372504,16498631042,-3428,,
15094052897,568.68755,16498684997,580423026,16498681564,-3433,,
15094103489,568.73814,16498735591,580473615,16498732153,-3438,,
15094154094,568.78874,16498786199,580524217,16498782755,-3444,,
15094205434,568.84008,16498837541,580575555,16498834093,-3448,,
15094256028,568.89068,16498888138,580626147,16498884685,-3453,,
15094306630,568.94128,16498938742,580676746,16498935283,-3459,,
15094357173,568.99182,16498989286,580727285,16498985822,-3464,,
15094408203,569.04285,16499040320,580778313,16499036851,-3469,,
15094458750,569.09340,16499090869,580828858,16499087395,-3474,,
15094509292,569.14394,16499141412,580879396,16499137933,-3479,,
15094559864,569.19451,16499191993,580929972,16499188509,-3484,,
15094610909,569.24556,16499243035,580981008,16499239546,-3489,,
15094661487,569.29614,16499293615,581031583,16499290121,-3494,,
15094712516,569.34716,16499344646,581082609,16499341146,-3500,,
15094763056,569.39770,16499395189,581133147,16499391685,-3504,,
15094813713,569.44836,16499445848,581183802,16499442339,-3509,,
15094864288,569.49894,16499496426,581234373,16499492911,-3515,,
15094914862,569.54951,16499547002,581284945,16499543483,-3519,,
15094965899,569.60055,16499598042,581335980,16499594517,-3525,,
15095016924,569.65157,16499649068,581387001,16499645538,-3530,,
15095067413,569.70206,16499699560,581437487,16499696024,-3536,,
15095117995,569.75264,16499750144,581488067,16499746604,-3540,,
15095168091,569.80274,16499800243,581538160,16499796698,-3545,,
15095218763,569.85341,16499850917,581588829,16499847367,-3550,,
15095269311,569.90396,16499901467,581639375,16499897912,-3555,,
15095320321,569.95497,16499952480,581690382,16499948920,-3560,,
15095370642,570.00529,16500002803,581740710,16499999248,-3555,,
15095420954,570.05560,16500053118,581791010,16500049548,-3570,,
15095471653,570.10630,16500103818,581841706,16500100243,-3575,,
15095522154,570.15680,16500154322,581892205,16500150742,-3580,,
15095573159,570.20781,16500205330,581943206,16500201744,-3586,,
15095623752,570.25840,16500255925,581993797,16500252335,-3590,,
15095674270,570.30892,16500306446,582044312,16500302850,-3596,,
15095724848,570.35950,16500357025,582094887,16500353424,-3601,,
15095775924,570.41057,16500408104,582145961,16500404498,-3606,,
15095826454,570.46110,16500458647,582196499,16500455036,-3611,,
15095877491,570.51214,16500509676,582247522,16500506060,-3616,,
15095928499,570.56315,16500560685,582298527,16500557064,-3621,,
15095978635,570.61328,16500610825,582348661,16500607199,-3626,,
15096029280,570.66393,16500661471,582399303,16500657840,-3631,,
15096079467,570.71411,16500711660,582449487,16500708024,-3636,,
15096130091,570.76474,16500762287,582500109,16500758646,-3641,,
15096181139,570.81579,16500813337,582551154,16500809691,-3646,,
15096231690,570.86634,16500863891,582601703,16500860240,-3651,,
15096282721,570.91737,16500914925,582652730,16500911268,-3657,,
15096333769,570.96842,16500965975,582703776,16500962314,-3661,,
15096384830,571.01948,16501017038,582754833,16501013371,-3667,,
15096435369,571.07002,16501067579,582805370,16501063907,-3672,,
15096486448,571.12110,16501118661,582856448,16501114985,-3676,,
15096536986,571.17163,16501169202,582906983,16501165521,-3681,,
15096588014,571.22266,16501220232,582958008,16501216545,-3687,,
15096638583,571.27323,16501270802,583008573,16501267111,-3691,,
15096689252,571.32390,16501321474,583059240,16501317777,-3697,,
15096739783,571.37443,16501372007,583109768,16501368305,-3702,,
15096790390,571.42504,16501422616,583160372,16501418909,-3707,,
15096840884,571.47553,16501473114,583210864,16501469401,-3713,,
15096891033,571.52568,16501523265,583261010,16501519547,-3718,,
15096942082,571.57673,16501574316,583312057,16501570594,-3722,,
15096992647,571.62730,16501624884,583362618,16501621156,-3728,,
15097043647,571.67830,16501675886,583413616,16501672154,-3732,,
15097094164,571.72881,16501726406,583464130,16501722668,-3738,,
15097145245,571.77989,16501777488,583515208,16501773745,-3743,,
15097195802,571.83045,16501828048,583565763,16501824301,-3747,,
15097246851,571.88150,16501879099,583616809,16501875346,-3753,,
15097297899,571.93255,16501930150,583667855,16501926392,-3758,,
15097348496,571.98314,16501980748,583718448,16501976985,-3763,,
15097399503,572.03415,16502031758,583769453,16502027990,-3768,,
15097450093,572.08474,16502082351,583820041,16502078578,-3773,,
15097500648,572.13530,16502132908,583870593,16502129130,-3778,,
15097551711,572.18636,16502183974,583921653,16502180190,-3784,,
15097602291,572.23694,16502234555,583972230,16502230767,-3788,,
15097652896,572.28754,16502285164,584022832,16502281370,-3794,,
15097703423,572.33807,16502335693,584073356,16502331894,-3799,,
15097754005,572.38865,16502386276,584123936,16502382473,-3803,,
15097804156,572.43880,16502436431,584174085,16502432622,-3809,,
15097854743,572.48939,16502487020,584224669,16502483206,-3814,,
15097905155,572.53980,16502537433,584275088,16502533625,-3808,,
15097955329,572.58998,16502587610,584325248,16502583786,-3824,,
15098006145,572.64079,16502638429,584376063,16502634600,-3829,,
15098057140,572.69179,16502689426,584427055,16502685592,-3834,,
15098107231,572.74188,16502739520,584477144,16502735681,-3839,,
15098158240,572.79289,16502790531,584528149,16502786687,-3844,,
15098208831,572.84348,16502841124,584578738,16502837275,-3849,,
15098259391,572.89404,16502891687,584629296,16502887833,-3854,,
15098310429,572.94508,16502942737,584680341,16502938879,-3858,,
15098361500,572.99615,16502993799,584731397,16502989935,-3864,,
15098412516,573.04716,16503044819,584782411,16503040949,-3870,,
15098463595,573.09824,16503095900,584833489,16503092026,-3874,,
15098514645,573.14929,16503146952,584884535,16503143072,-3880,,
15098565229,573.19988,16503197538,584935116,16503193653,-3885,,
15098615825,573.25047,16503248137,584985710,16503244248,-3889,,
15098666344,573.30099,16503298659,585036227,16503294764,-3895,,
15098716866,573.35151,16503349182,585086745,16503345283,-3899,,
15098766937,573.40158,16503399255,585136814,16503395351,-3904,,
15098817453,573.45210,16503449774,585187327,16503445864,-3910,,
15098868027,573.50267,16503500351,585237899,16503496436,-3915,,
15098919045,573.55369,16503551370,585288913,16503547450,-3920,,
15098969160,573.60381,16503601489,585339027,16503597564,-3925,,
15099019265,573.65391,16503651596,585389129,16503647667,-3929,,
15099069854,573.70450,16503702186,585439714,16503698251,-3935,,
15099119977,573.75463,16503752313,585489836,16503748373,-3940,,
15099170578,573.80523,16503802916,585540434,16503798971,-3945,,
15099221590,573.85624,16503853930,585591443,16503849980,-3950,,
15099271679,573.90633,16503904022,585641530,16503900067,-3955,,
15099322258,573.95691,16503954603,585692106,16503950643,-3960,,
15099373316,574.00796,16504005664,585743161,16504001698,-3966,,
15099423963,574.05861,16504056313,585793804,16504052342,-3971,,
15099474520,574.10917,16504106872,585844359,16504102897,-3975,,
15099524637,574.15928,16504156992,585894473,16504153021,-3971,,
15099575649,574.21030,16504208005,585945482,16504204019,-3986,,
15099626682,574.26133,16504259041,585996514,16504255051,-3990,,
15099677704,574.31235,16504310066,586047532,16504306070,-3996,,
15099727851,574.36250,16504360215,586097677,16504356214,-4001,,
15099778419,574.41307,16504410786,586148243,16504406780,-4006,,
15099828797,574.46344,16504461165,586198617,16504457165,-4000,,
15099879563,574.51421,16504511933,586249380,16504507917,-4016,,
15099929693,574.56434,16504562065,586299507,16504558044,-4021,,
15099980291,574.61494,16504612667,586350103,16504608641,-4026,,
15100031313,574.66596,16504663691,586401122,16504659660,-4031,,
15100082389,574.71704,16504714769,586452195,16504710733,-4036,,
15100133440,574.76809,16504765823,586503243,16504761781,-4042,,
15100184531,574.81918,16504816916,586554332,16504812870,-4046,,
15100235571,574.87022,16504867958,586605369,16504863907,-4051,,
15100286587,574.92124,16504918977,586656383,16504914920,-4057,,
15100337142,574.97179,16504969534,586706935,16504965472,-4062,,
15100387696,575.02234,16505020091,586757497,16505016034,-4057,,
15100438766,575.07341,16505071162,586808553,16505067090,-4072,,
15100489771,575.12442,16505122170,586859556,16505118093,-4077,,
15100540856,575.17550,16505173258,586910639,16505169176,-4082,,
15100591858,575.22651,16505224262,586961637,16505220175,-4087,,
15100642406,575.27705,16505274813,587012182,16505270720,-4093,,
15100692999,575.32765,16505325408,587062773,16505321310,-4098,,
15100744026,575.37867,16505376437,587113809,16505372346,-4091,,
15100794564,575.42921,16505426977,587164332,16505422869,-4108,,
15100845621,575.48027,16505478036,587215386,16505473923,-4113,,
15100896655,575.53130,16505529073,587266419,16505524956,-4117,,
15100946787,575.58144,16505579208,587316547,16505575085,-4123,,
15100996895,575.63154,16505629318,587366652,16505625190,-4128,,
15101047946,575.68259,16505680371,587417701,16505676239,-4132,,
15101098515,575.73316,16505730942,587468267,16505726805,-4137,,
15101149182,575.78383,16505781611,587518931,16505777468,-4143,,
15101200266,575.83491,16505832697,587570012,16505828549,-4148,,
15101251314,575.88596,16505883749,587621059,16505879596,-4153,,
15101302345,575.93699,16505934792,587672097,16505930634,-4158,,
15101353414,575.98806,16505985854,587723153,16505981690,-4164,,
15101404495,576.03914,16506036936,587774230,16506032768,-4168,,
15101455501,576.09015,16506087944,587825234,16506083771,-4173,,
15101506092,576.14074,16506138538,587875821,16506134359,-4179,,
15101557098,576.19175,16506189547,587926825,16506185363,-4184,,
15101607667,576.24231,16506240117,587977392,16506235929,-4188,,
15101658727,576.29337,16506291180,588028449,16506286986,-4194,,
15101709590,576.34424,16506342046,588079309,16506337846,-4200,,
15101760120,576.39477,16506392579,588129836,16506388374,-4205,,
15101810243,576.44489,16506442703,588179957,16506438494,-4209,,
15101860786,576.49543,16506493249,588230509,16506489046,-4203,,
15101911481,576.54613,16506543947,588281190,16506539727,-4220,,
15101962155,576.59680,16506594623,588331872,16506590410,-4213,,
15102012865,576.64751,16506645335,588382568,16506641106,-4229,,
15102063485,576.69813,16506695957,588433185,16506691722,-4235,,
15102114549,576.74920,16506747023,588484246,16506742784,-4239,,
15102165587,576.80024,16506798064,588535282,16506793820,-4244,,
15102216136,576.85078,16506848616,588585828,16506844366,-4250,,
15102267188,576.90184,16506899669,588636877,16506895414,-4255,,
15102318237,576.95289,16506950720,588687924,16506946462,-4258,,
15102369291,577.00394,16507001778,588738975,16506997512,-4266,,
15102420372,577.05502,16507052861,588790054,16507048591,-4270,,
15102471293,577.10594,16507103785,588840972,16507099509,-4276,,
15102522324,577.15697,16507154818,588892001,16507150538,-4280,,
15102572880,577.20753,16507205376,588942554,16507201091,-4285,,
15102623457,577.25811,16507255956,588993128,16507251665,-4291,,
15102674043,577.30869,16507306544,589043712,16507302249,-4295,,
15102725058,577.35971,16507357561,589094724,16507353261,-4300,,
15102775623,577.41027,16507408129,589145286,16507403823,-4306,,
15102826175,577.46082,16507458694,589195846,16507454384,-4310,,
15102876812,577.51146,16507509322,589246469,16507505007,-4315,,
15102927860,577.56251,16507560372,589297514,16507556051,-4321,,
15102978428,577.61308,16507610955,589348091,16507606629,-4326,,
15103029524,577.66417,16507662041,589399172,16507657709,-4332,,
15103080561,577.71521,16507713080,589450207,16507708744,-4336,,
15103130642,577.76529,16507763163,589500295,16507758833,-4330,,
15103181665,577.81631,16507814189,589551305,16507809842,-4347,,
15103232739,577.86739,16507865265,589602387,16507860924,-4341,,
15103283806,577.91845,16507916335,589653441,16507911979,-4356,,
15103334810,577.96946,16507967341,589704442,16507962991,-4350,,
15103385390,578.02004,16508017935,589755030,16508013568,-4367,,
15103436405,578.07105,16508068941,589806032,16508064570,-4371,,
15103486487,578.12113,16508119026,589856111,16508114649,-4377,,
15103537556,578.17220,16508170096,589907177,16508165715,-4381,,
15103588604,578.22325,16508221148,589958224,16508216761,-4387,,
15103639649,578.27430,16508272194,590009265,16508267802,-4392,,
15103690261,578.32491,16508322808,590059874,16508318411,-4397,,
15103740970,578.37562,16508373520,590110580,16508369117,-4403,,
15103791560,578.42621,16508424113,590161168,16508419706,-4407,,
15103842124,578.47677,16508474689,590211740,16508470278,-4411,,
15103893197,578.52784,16508525755,590262799,16508521337,-4418,,
15103944247,578.57889,16508576807,590313847,16508572385,-4422,,
15103995255,578.62990,16508627816,590364852,16508623389,-4427,,
15104045829,578.68048,16508678393,590415423,16508673960,-4433,,
15104096893,578.73154,16508729460,590466485,16508725022,-4438,,
15104147721,578.78237,16508780291,590517311,16508775848,-4443,,
15104198770,578.83342,16508831342,590568356,16508826894,-4448,,
15104249838,578.88449,16508882412,590619422,16508877959,-4453,,
15104300844,578.93549,16508933421,590670424,16508928961,-4460,,
15104351400,578.98605,16508983979,590720978,16508979516,-4463,,
15104402484,579.03713,16509035065,590772060,16509030597,-4468,,
15104453103,579.08775,16509085687,590822676,16509081213,-4474,,
15104504151,579.13880,16509136737,590873722,16509132260,-4477,,
15104554515,579.18916,16509187103,590924082,16509182620,-4483,,
15104605059,579.23971,16509237650,590974624,16509233161,-4489,,
15104655574,579.29022,16509288166,591025135,16509283672,-4494,,
15104706153,579.34080,16509338747,591075712,16509334249,-4498,,
15104756733,579.39138,16509389332,591126290,16509384828,-4504,,
15104807257,579.44191,16509439857,591176810,16509435348,-4509,,
15104858302,579.49295,16509490904,591227853,16509486390,-4514,,
15104908414,579.54306,16509541018,591277962,16509536509,-4509,,
15104959029,579.59368,16509591635,591328574,16509587111,-4524,,
15105009194,579.64384,16509641803,591378737,16509637274,-4529,,
15105059800,579.69445,16509692412,591429341,16509687878,-4534,,
15105110090,579.74474,16509742704,591479628,16509738166,-4538,,
15105161154,579.79580,16509793770,591530688,16509789225,-4545,,
15105212222,579.84687,16509844841,591581755,16509840292,-4549,,
15105263270,579.89792,16509895891,591632799,16509891337,-4554,,
15105313816,579.94846,16509946440,591683343,16509941880,-4560,,
15105364284,579.99893,16509996910,591733808,16509992345,-4565,,
15105415334,580.04998,16510047962,591784855,16510043393,-4569,,
15105466297,580.10095,16510098928,591835815,16510094352,-4576,,
15105516905,580.15155,16510149538,591886420,16510144958,-4580,,
15105567869,580.20252,16510200505,591937383,16510195920,-4585,,
15105618461,580.25311,16510251099,591987972,16510246519,-4580,,
15105668860,580.30351,16510301499,592038367,16510296904,-4595,,
15105719414,580.35406,16510352057,592088919,16510347457,-4600,,
15105770167,580.40481,16510402823,592139681,16510398219,-4604,,
15105820767,580.45542,16510453426,592190278,16510448816,-4610,,
15105871413,580.50606,16510504063,592240909,16510499447,-4616,,
15105922036,580.55668,16510554688,592291530,16510550068,-4620,,
15105972606,580.60725,16510605260,592342109,16510600647,-4613,,
15106023233,580.65788,16510655890,592392721,16510651259,-4631,,
15106074271,580.70892,16510706930,592443758,16510702295,-4635,,
15106124833,580.75948,16510757494,592494316,16510752853,-4641,,
15106175485,580.81013,16510808149,592544965,16510803503,-4646,,
15106226126,580.86077,16510858792,592595604,16510854141,-4651,,
15106276636,580.91128,16510909305,592646112,16510904650,-4655,,
15106327559,580.96221,16510960230,592697032,16510955569,-4661,,
15106378608,581.01326,16511011281,592748077,16511006615,-4666,,
15106429654,581.06430,16511062330,592799122,16511057659,-4671,,
15106480682,581.11533,16511113360,592850146,16511108684,-4676,,
15106531312,581.16596,16511163991,592900773,16511159311,-4680,,
15106581854,581.21650,16511214537,592951313,16511209850,-4687,,
15106632435,581.26708,16511265120,593001891,16511260429,-4691,,
15106682963,581.31761,16511315649,593052416,16511310953,-4696,,
15106733543,581.36819,16511366233,593102994,16511361531,-4702,,
15106784558,581.41921,16511417253,593154010,16511412547,-4706,,
15106835093,581.46974,16511467786,593204538,16511463075,-4711,,
15106885631,581.52028,16511518328,593255073,16511513611,-4717,,
15106936204,581.57085,16511568903,593305643,16511564181,-4722,,
15106986967,581.62162,16511619669,593356405,16511614942,-4727,,
15107037993,581.67264,16511670697,593407427,16511665965,-4732,,
15107088451,581.72310,16511721157,593457883,16511716421,-4736,,
15107139478,581.77413,16511772187,593508907,16511767445,-4742,,
15107189602,581.82425,16511822313,593559029,16511817566,-4747,,
15107239761,581.87441,16511872474,593609184,16511867722,-4752,,
15107290800,581.92545,16511923515,593660221,16511918758,-4757,,
15107340967,581.97561,16511973684,593710385,16511968922,-4762,,
15107391987,582.02664,16512024707,593761403,16512019940,-4767,,
15107442487,582.07713,16512075210,593811900,16512070438,-4772,,
15107493063,582.12771,16512125788,593862474,16512121011,-4777,,
15107544110,582.17876,16512176837,593913517,16512172055,-4782,,
15107595146,582.22979,16512227876,593964551,16512223088,-4788,,
15107645701,582.28035,16512278432,594015102,16512273639,-4793,,
15107696783,582.33143,16512329518,594066183,16512324720,-4798,,
15107747285,582.38193,16512380021,594116681,16512375218,-4803,,
15107797830,582.43248,16512430569,594167223,16512425761,-4808,,
15107847924,582.48257,16512480666,594217315,16512475853,-4813,,
15107898979,582.53363,16512531723,594268367,16512526905,-4818,,
15107949991,582.58464,16512582748,594319387,16512577925,-4823,,
15108001021,582.63567,16512633769,594370403,16512628940,-4829,,
15108051161,582.68581,16512683911,594420541,16512679078,-4833,,
15108101698,582.73635,16512734450,594471075,16512729612,-4838,,
15108151956,582.78660,16512784712,594521330,16512779868,-4844,,
15108202487,582.83713,16512835256,594571870,16512830408,-4848,,
15108253546,582.88819,16512886306,594622916,16512881453,-4853,,
15108303689,582.93834,16512936452,594673056,16512931593,-4859,,
15108354332,582.98898,16512987097,594723696,16512982234,-4863,,
15108405004,583.03965,16513037770,594774365,16513032902,-4868,,
15108455565,583.09021,16513088345,594824933,16513083471,-4874,,
15108506163,583.14081,16513138935,594875519,16513134056,-4879,,
15108556643,583.19129,16513189418,594925997,16513184534,-4884,,
15108607689,583.24234,16513240466,594977040,16513235577,-4889,,
15108658247,583.29290,16513291025,595027595,16513286132,-4893,,
15108709030,583.34368,16513341812,595078376,16513336914,-4898,,
15108759634,583.39428,16513392417,595128976,16513387513,-4904,,
15108809697,583.44434,16513442482,595179036,16513437574,-4908,,
15108860793,583.49544,16513493582,595230130,16513488667,-4915,,
15108911796,583.54644,16513544587,595281131,16513539668,-4919,,
15108962364,583.59701,16513595157,595331695,16513590233,-4924,,
15109012516,583.64716,16513645311,595381844,16513640381,-4930,,
15109063122,583.69777,16513695920,595432449,16513690986,-4934,,
15109113265,583.74791,16513746064,595482588,16513741125,-4939,,
15109163847,583.79850,16513796650,595533167,16513791705,-4945,,
15109214397,583.84905,16513847202,595583715,16513842253,-4949,,
15109265051,583.89970,16513897857,595634366,16513892904,-4953,,
15109316071,583.95072,16513948881,595685384,16513943921,-4960,,
15109367116,584.00176,16513999938,595736435,16513994973,-4965,,
15109418177,584.05282,16514050992,595787485,16514046022,-4970,,
15109469233,584.10388,16514102050,595838538,16514097075,-4975,,
15109519757,584.15440,16514152575,595889058,16514147595,-4980,,
15109570444,584.20509,16514203266,595939743,16514198281,-4985,,
15109621027,584.25567,16514253850,595990323,16514248860,-4990,,
15109671543,584.30619,16514304369,596040837,16514299374,-4995,,
15109722578,584.35723,16514355406,596091868,16514350406,-5000,,
15109772800,584.40745,16514405631,596142088,16514400626,-5005,,
15109823435,584.45808,16514456268,596192721,16514451258,-5010,,
15109874025,584.50867,16514506861,596243307,16514501845,-5016,,
15109924523,584.55917,16514557361,596293803,16514552341,-5020,,
15109975153,584.60980,16514607992,596344430,16514602967,-5025,,
15110026197,584.66084,16514659040,596395471,16514654009,-5031,,
15110076689,584.71134,16514709534,596445961,16514704498,-5036,,
15110127315,584.76196,16514760163,596496585,16514755122,-5041,,
15110178372,584.81302,16514811222,596547638,16514806176,-5046,,
15110229447,584.86410,16514862299,596598710,16514857248,-5051,,
15110280459,584.91511,16514913314,596649720,16514908268,-5046,,
15110331500,584.96615,16514964357,596700759,16514959296,-5061,,
15110382065,585.01671,16515014924,596751321,16515009858,-5066,,
15110432694,585.06734,16515065556,596801947,16515060485,-5071,,
15110483538,585.11819,16515116402,596852788,16515111326,-5076,,
15110534098,585.16875,16515166974,596903356,16515161893,-5081,,
15110585110,585.21976,16515217979,596954355,16515212892,-5087,,
15110635733,585.27038,16515268604,597004975,16515263512,-5092,,
15110686731,585.32138,16515319605,597055970,16515314508,-5097,,
15110737479,585.37213,16515370355,597106715,16515365253,-5102,,
15110788519,585.42317,16515421396,597157752,16515416289,-5107,,
15110839271,585.47392,16515472151,597208502,16515467040,-5111,,
15110889844,585.52449,16515522727,597259073,16515517611,-5116,,
15110940857,585.57551,16515573741,597310082,16515568620,-5121,,
15110991932,585.62658,16515624819,597361154,16515619691,-5128,,
15111042410,585.67706,16515675300,597411631,16515670168,-5132,,
15111093284,585.72793,16515726175,597462501,16515721038,-5137,,
15111143378,585.77803,16515776273,597512592,16515771130,-5143,,
15111193863,585.82851,16515826760,597563076,16515821613,-5147,,
15111244809,585.87946,16515877709,597614019,16515872556,-5153,,
15111295888,585.93054,16515928790,597665094,16515923632,-5158,,
15111346917,585.98157,16515979832,597716131,16515974669,-5163,,
15111397511,586.03216,16516030417,597766712,16516025250,-5167,,
15111447929,586.08258,16516080837,597817127,16516075665,-5172,,
15111498942,586.13359,16516131853,597868137,16516126675,-5178,,
15111549525,586.18417,16516182439,597918718,16516177256,-5183,,
15111600574,586.23522,16516233500,597969774,16516228311,-5189,,
15111651145,586.28579,16516284063,598020332,16516278870,-5193,,
15111702194,586.33684,16516335115,598071379,16516329916,-5199,,
15111753198,586.38785,16516386121,598122380,16516380918,-5203,,
15111803790,586.43844,16516436716,598172969,16516431506,-5210,,
15111854318,586.48897,16516487246,598223495,16516482032,-5214,,
15111904885,586.53953,16516537815,598274059,16516532597,-5218,,
15111955936,586.59058,16516588869,598325108,16516583645,-5224,,
15112006553,586.64120,16516639488,598375721,16516634270,-5218,,
15112057144,586.69179,16516690081,598426310,16516684847,-5234,,
15112108233,586.74288,16516741173,598477397,16516735934,-5239,,
15112158750,586.79340,16516791691,598527910,16516786447,-5244,,
15112209376,586.84402,16516842319,598578533,16516837071,-5248,,
15112260279,586.89493,16516893226,598629434,16516887972,-5254,,
15112311330,586.94598,16516944279,598680482,16516939020,-5259,,
15112362378,586.99703,16516995330,598731528,16516990065,-5265,,
15112412919,587.04757,16517045873,598782066,16517040603,-5270,,
15112462974,587.09762,16517095930,598832118,16517090656,-5274,,
15112513506,587.14815,16517146465,598882648,16517141185,-5280,,
15112564070,587.19872,16517197032,598933210,16517191748,-5284,,
15112615124,587.24977,16517248087,598984260,16517242798,-5289,,
15112665671,587.30032,16517298637,599034804,16517293342,-5295,,
15112716205,587.35085,16517349173,599085335,16517343873,-5300,,
15112766514,587.40116,16517399484,599135642,16517394180,-5304,,
15112817295,587.45194,16517450268,599186420,16517444958,-5310,,
15112867833,587.50248,16517500808,599236956,16517495493,-5315,,
15112918345,587.55299,16517551322,599287465,16517546002,-5320,,
15112969393,587.60404,16517602372,599338510,16517597047,-5325,,
15113019914,587.65456,16517652895,599389028,16517647565,-5330,,
15113070518,587.70517,16517703503,599439630,16517698168,-5335,,
15113121561,587.75621,16517754548,599490670,16517749208,-5340,,
15113172459,587.80711,16517805459,599541576,16517800114,-5345,,
15113223253,587.85790,16517856245,599592356,16517850894,-5351,,
15113273875,587.90852,16517906868,599642975,16517901512,-5356,,
15113324935,587.95958,16517957931,599694034,16517952571,-5360,,
15113375542,588.01019,16518008540,599744637,16518003175,-5365,,
15113426137,588.06079,16518059137,599795229,16518053766,-5371,,
15113477171,588.11182,16518110174,599846262,16518104799,-5375,,
15113527749,588.16240,16518160755,599896837,16518155374,-5381,,
15113578366,588.21301,16518211374,599947450,16518205988,-5386,,
15113628927,588.26357,16518261937,599998008,16518256546,-5391,,
15113680016,588.31466,16518313029,600049096,16518307633,-5396,,
15113730529,588.36518,16518363544,600099606,16518358143,-5401,,
15113780775,588.41542,16518413792,600149849,16518408386,-5406,,
15113831839,588.46649,16518464859,600200910,16518459448,-5411,,
15113882444,588.51709,16518515466,600251513,16518510050,-5416,,
15113933495,588.56814,16518566519,600302560,16518561097,-5422,,
15113984537,588.61919,16518617563,600353599,16518612136,-5427,,
15114035069,588.66972,16518668098,600404130,16518662667,-5431,,
15114086128,588.72078,16518719160,600455185,16518713722,-5438,,
15114136650,588.77130,16518769683,600505704,16518764241,-5442,,
15114187219,588.82187,16518820254,600556271,16518814808,-5446,,
15114237844,588.87249,16518870883,600606894,16518865431,-5452,,
15114288446,588.92309,16518921487,600657492,16518916030,-5457,,
15114339419,588.97407,16518972462,600708463,16518967000,-5462,,
15114389965,589.02461,16519023010,600759006,16519017543,-5467,,
15114440505,589.07515,16519073552,600809543,16519068081,-5471,,
15114490809,589.12546,16519123859,600859845,16519118382,-5477,,
15114540896,589.17554,16519173949,600909929,16519168467,-5482,,
15114591362,589.22601,16519224417,600960392,16519218930,-5487,,
15114642229,589.27688,16519275286,601011256,16519269794,-5492,,
15114692781,589.32743,16519325841,601061806,16519320343,-5498,,
15114743830,589.37848,16519376892,601112852,16519371390,-5502,,
15114794411,589.42906,16519427476,601163431,16519421968,-5508,,
15114845427,589.48008,16519478494,601214443,16519472981,-5513,,
15114895971,589.53062,16519529040,601264986,16519523523,-5517,,
15114946524,589.58117,16519579596,601315536,16519574073,-5523,,
15114997072,589.63172,16519630145,601366080,16519624618,-5527,,
15115048120,589.68277,16519681196,601417125,16519675663,-5533,,
15115099169,589.73382,16519732248,601468173,16519726710,-5538,,
15115150218,589.78487,16519783299,601519219,16519777756,-5543,,
15115201299,589.83595,16519834383,601570296,16519828834,-5549,,
15115252189,589.88684,16519885274,601621184,16519879721,-5553,,
15115303219,589.93787,16519936307,601672211,16519930749,-5558,,
15115354242,589.98889,16519987332,601723231,16519981768,-5564,,
15115405341,590.03999,16520038434,601774328,16520032865,-5569,,
15115455874,590.09052,16520088969,601824859,16520083396,-5573,,
15115506905,590.14155,16520140002,601875886,16520134423,-5579,,
15115557953,590.19260,16520191052,601926931,16520185468,-5584,,
15115609002,590.24365,16520242103,601977977,16520236514,-5589,,
15115660084,590.29473,16520293189,602029057,16520287594,-5595,,
15115710868,590.34552,16520343975,602079839,16520338376,-5599,,
15115761397,590.39604,16520394507,602130365,16520388902,-5605,,
15115812029,590.44668,16520445141,602180995,16520439532,-5609,,
15115862159,590.49681,16520495283,602231131,16520489669,-5614,,
15115912696,590.54734,16520545812,602281655,16520540192,-5620,,
15115963780,590.59843,16520596898,602332736,16520591274,-5624,,
15116014675,590.64932,16520647796,602383630,16520642167,-5629,,
15116065250,590.69990,16520698374,602434202,16520692739,-5635,,
15116115818,590.75047,16520748943,602484766,16520743303,-5640,,
15116166393,590.80104,16520799520,602535339,16520793876,-5644,,
15116217013,590.85166,16520850144,602585956,16520844494,-5650,,
15116267209,590.90186,16520900342,602636150,16520894687,-5655,,
15116318275,590.95292,16520951409,602687212,16520945750,-5659,,
15116368860,591.00351,16521001998,602737795,16520996332,-5666,,
15116419913,591.05456,16521053052,602788845,16521047383,-5669,,
15116470932,591.10558,16521104075,602839862,16521098399,-5676,,
15116521984,591.15663,16521155140,602890922,16521149460,-5680,,
15116573054,591.20770,16521206201,602941979,16521200516,-5685,,
15116624093,591.25874,16521257243,602993014,16521251552,-5691,,
15116675152,591.30980,16521308303,603044070,16521302608,-5695,,
15116726201,591.36085,16521359355,603095117,16521353655,-5700,,
15116777211,591.41186,16521410367,603146124,16521404661,-5706,,
15116827799,591.46245,16521460957,603196709,16521455247,-5710,,
15116878846,591.51349,16521512008,603247755,16521506292,-5716,,
15116929370,591.56402,16521562534,603298275,16521556812,-5722,,
15116980395,591.61504,16521613561,603349298,16521607836,-5725,,
15117030997,591.66565,16521664165,603399896,16521658434,-5731,,
15117081998,591.71665,16521715168,603450895,16521709432,-5736,,
15117132533,591.76718,16521765706,603501428,16521759965,-5741,,
15117182600,591.81725,16521815776,603551492,16521810029,-5747,,
15117233475,591.86812,16521866653,603602365,16521860902,-5751,,
15117283769,591.91842,16521916949,603652656,16521911193,-5756,,
15117334326,591.96897,16521967509,603703209,16521961746,-5763,,
15117384958,592.01961,16522018143,603753839,16522012376,-5767,,
15117435455,592.07010,16522068641,603804333,16522062871,-5770,,
15117486498,592.12115,16522119688,603855374,16522113911,-5777,,
15117537041,592.17169,16522170233,603905914,16522164451,-5782,,
15117588079,592.22273,16522221273,603956949,16522215486,-5787,,
15117639143,592.27379,16522272339,604008010,16522266547,-5792,,
15117689277,592.32393,16522322476,604058141,16522316679,-5797,,
15117739877,592.37452,16522373079,604108738,16522367276,-5803,,
15117790474,592.42512,16522423678,604159333,16522417871,-5807,,
15117841075,592.47572,16522474293,604209943,16522468481,-5812,,
15117892133,592.52678,16522525341,604260986,16522519523,-5818,,
15117942746,592.57739,16522575957,604311597,16522570135,-5822,,
15117993287,592.62793,16522626500,604362135,16522620673,-5827,,
15118043864,592.67851,16522677080,604412709,16522671247,-5833,,
15118093973,592.72862,16522727194,604462820,16522721357,-5837,,
15118144962,592.77961,16522778182,604513802,16522772340,-5842,,
15118195570,592.83022,16522828792,604564407,16522822944,-5848,,
15118246612,592.88126,16522879838,604615448,16522873986,-5852,,
15118297184,592.93183,16522930410,604666016,16522924553,-5857,,
15118347776,592.98242,16522981006,604716605,16522975143,-5863,,
15118398319,593.03297,16523031550,604767144,16523025682,-5868,,
15118448906,593.08355,16523082140,604817730,16523076267,-5873,,
15118499488,593.13414,16523132724,604868309,16523126846,-5878,,
15118550038,593.18469,16523183277,604918856,16523177393,-5884,,
15118600694,593.23534,16523233936,604969510,16523228048,-5888,,
15118651717,593.28637,16523284961,605020530,16523279068,-5893,,
15118702732,593.33738,16523335977,605071542,16523330079,-5898,,
15118753310,593.38796,16523386559,605122117,16523380655,-5904,,
15118804358,593.43901,16523437609,605173163,16523431701,-5908,,
15118854517,593.48916,16523487770,605223319,16523481857,-5913,,
15118905310,593.53996,16523538565,605274109,16523532646,-5919,,
15118955895,593.59054,16523589153,605324692,16523583229,-5924,,
15119006913,593.64156,16523640172,605375707,16523634245,-5927,,
15119057532,593.69218,16523690795,605426323,16523684861,-5934,,
15119108189,593.74284,16523741453,605476977,16523735515,-5938,,
15119158734,593.79338,16523792002,605527520,16523786057,-5945,,
15119209818,593.84447,16523843087,605578601,16523837138,-5949,,
15119260448,593.89510,16523893720,605629229,16523887766,-5954,,
15119310569,593.94522,16523943844,605679348,16523937885,-5959,,
15119361598,593.99625,16523994875,605730374,16523988911,-5964,,
15119412188,594.04684,16524045467,605780961,16524039499,-5968,,
15119462814,594.09746,16524096096,605831584,16524090122,-5974,,
15119513440,594.14809,16524146723,605882207,16524140744,-5979,,
15119564434,594.19908,16524197720,605933199,16524191736,-5984,,
15119614976,594.24962,16524248265,605983737,16524242275,-5990,,
15119665541,594.30019,16524298832,606034299,16524292836,-5996,,
15119716361,594.35101,16524349654,606085117,16524343655,-5999,,
15119766961,594.40161,16524400257,606135714,16524394252,-6005,,
15119817107,594.45176,16524450405,606185858,16524444395,-6010,,
15119867621,594.50227,16524500921,606236369,16524494907,-6014,,
15119918625,594.55327,16524551928,606287370,16524545908,-6020,,
15119969219,594.60387,16524602523,606337961,16524596499,-6024,,
15120020296,594.65494,16524653604,606389035,16524647573,-6031,,
15120070875,594.70552,16524704185,606439612,16524698149,-6036,,
15120121435,594.75608,16524754747,606490169,16524748707,-6040,,
15120172116,594.80676,16524805431,606540848,16524799385,-6046,,
15120222709,594.85736,16524856026,606591439,16524849976,-6050,,
15120273744,594.90839,16524907063,606642471,16524901008,-6055,,
15120324306,594.95895,16524957627,606693029,16524951566,-6061,,
15120374830,595.00948,16525008154,606743551,16525002088,-6066,,
15120425420,595.06007,16525058745,606794138,16525052675,-6070,,
15120475574,595.11022,16525108909,606844299,16525102837,-6072,,
15120526122,595.16077,16525159453,606894834,16525153372,-6081,,
15120576744,595.21139,16525210077,606945455,16525203992,-6085,,
15120627763,595.26241,16525261099,606996470,16525255008,-6091,,
15120678295,595.31294,16525311633,607047000,16525305537,-6096,,
15120728857,595.36351,16525362198,607097560,16525356097,-6101,,
15120779640,595.41429,16525412982,607148339,16525406876,-6106,,
15120830163,595.46481,16525463508,607198859,16525457396,-6112,,
15120880736,595.51538,16525514084,607249429,16525507966,-6118,,
15120931730,595.56638,16525565080,607300421,16525558958,-6122,,
15120982283,595.61693,16525615635,607350971,16525609508,-6127,,
15121033365,595.66801,16525666719,607402050,16525660587,-6132,,
15121083910,595.71856,16525717267,607452593,16525711131,-6136,,
15121134500,595.76915,16525767859,607503181,16525761718,-6141,,
15121185093,595.81974,16525818454,607553770,16525812307,-6147,,
15121235702,595.87035,16525869065,607604376,16525862913,-6152,,
15121286751,595.92140,16525920117,607655424,16525913961,-6156,,
15121337755,595.97240,16525971123,607706424,16525964961,-6162,,
15121388350,596.02300,16526021721,607757016,16526015554,-6167,,
15121439397,596.07404,16526072771,607808062,16526066599,-6172,,
15121490433,596.12508,16526123809,607859094,16526117632,-6177,,
15121541491,596.17614,16526174869,607910150,16526168687,-6182,,
15121592542,596.22719,16526225923,607961197,16526219734,-6189,,
15121643552,596.27820,16526276935,608012217,16526270754,-6181,,
15121694641,596.32929,16526328026,608063292,16526321829,-6197,,
15121745151,596.37980,16526378539,608113798,16526372336,-6203,,
15121795241,596.42989,16526428631,608163885,16526422423,-6208,,
15121846248,596.48090,16526479641,608214890,16526473428,-6213,,
15121896816,596.53146,16526530211,608265456,16526523993,-6218,,
15121947134,596.58178,16526580530,608315770,16526574307,-6223,,
15121997665,596.63231,16526631064,608366299,16526624837,-6227,,
15122048251,596.68290,16526681653,608416882,16526675420,-6233,,
15122098776,596.73342,16526732179,608467404,16526725941,-6238,,
15122149374,596.78402,16526782781,608518001,16526776538,-6243,,
15122200404,596.83505,16526833813,608569027,16526827565,-6248,,
15122250993,596.88564,16526884404,608619614,16526878151,-6253,,
15122301178,596.93583,16526934591,608669795,16526928332,-6259,,
15122351954,596.98660,16526985370,608720570,16526979107,-6263,,
15122402602,597.03725,16527036020,608771214,16527029752,-6268,,
15122453144,597.08779,16527086564,608821753,16527080291,-6273,,
15122503292,597.13794,16527136715,608871900,16527130437,-6278,,
15122553918,597.18857,16527187343,608922522,16527181060,-6283,,
15122604104,597.23875,16527237532,608972706,16527231243,-6289,,
15122655120,597.28977,16527288550,609023718,16527282255,-6295,,
15122705258,597.33991,16527338689,609073854,16527332391,-6298,,
15122756345,597.39099,16527389780,609124939,16527383476,-6304,,
15122806863,597.44151,16527440299,609175453,16527433990,-6309,,
15122857443,597.49209,16527490883,609226032,16527484569,-6314,,
15122908351,597.54300,16527541793,609276937,16527535474,-6319,,
15122958866,597.59351,16527592309,609327448,16527585985,-6324,,
15123009580,597.64423,16527643026,609378160,16527636697,-6329,,
15123059695,597.69434,16527693155,609428283,16527686821,-6334,,
15123110458,597.74511,16527743909,609479032,16527737570,-6339,,
15123161093,597.79574,16527794547,609529664,16527788201,-6346,,
15123211731,597.84638,16527845187,609580301,16527838838,-6349,,
15123262330,597.89698,16527895788,609630896,16527889434,-6354,,
15123313231,597.94788,16527946691,609681794,16527940331,-6360,,
15123363820,597.99847,16527997283,609732382,16527990919,-6364,,
15123414861,598.04951,16528048326,609783419,16528041957,-6369,,
15123465420,598.10007,16528098898,609833985,16528092523,-6375,,
15123516489,598.15114,16528149959,609885042,16528143579,-6380,,
15123567538,598.20219,16528201010,609936088,16528194625,-6385,,
15123618555,598.25320,16528252030,609987102,16528245640,-6390,,
15123669616,598.30426,16528303092,610038160,16528296697,-6395,,
15123720653,598.35530,16528354132,610089194,16528347732,-6400,,
15123771240,598.40589,16528404722,610139779,16528398317,-6405,,
15123822302,598.45695,16528455786,610190838,16528449376,-6410,,
15123872831,598.50748,16528506329,610241375,16528499912,-6417,,
15123923893,598.55854,16528557382,610292424,16528550962,-6420,,
15123974918,598.60957,16528608408,610343446,16528601983,-6425,,
15124025775,598.66042,16528659279,610394311,16528652848,-6431,,
15124075924,598.71057,16528709419,610444446,16528702983,-6436,,
15124126561,598.76121,16528760060,610495081,16528753619,-6441,,
15124177299,598.81195,16528810800,610545816,16528804353,-6447,,
15124227853,598.86250,16528861355,610596367,16528854904,-6451,,
15124278898,598.91355,16528912404,610647411,16528905948,-6456,,
15124329910,598.96456,16528963418,610698419,16528956957,-6461,,
15124380472,599.01512,16529013982,610748979,16529007526,-6456,,
15124430656,599.06530,16529064169,610799159,16529057697,-6472,,
15124481003,599.11565,16529114518,610849505,16529108042,-6476,,
15124532014,599.16666,16529165531,610900512,16529159050,-6481,,
15124582451,599.21710,16529215970,610950956,16529209494,-6476,,
15124633004,599.26765,16529266526,611001497,16529260035,-6491,,
15124683134,599.31778,16529316658,611051625,16529310162,-6496,,
15124734161,599.36881,16529367688,611102649,16529361187,-6501,,
15124784708,599.41936,16529418237,611153194,16529411731,-6506,,
15124835755,599.47040,16529469287,611204237,16529462775,-6512,,
15124886641,599.52129,16529520174,611255120,16529513657,-6517,,
15124937250,599.57190,16529570786,611305726,16529564263,-6523,,
15124987806,599.62245,16529621356,611356291,16529614829,-6527,,
15125038369,599.67302,16529671910,611406841,16529665378,-6532,,
15125089398,599.72405,16529722940,611457866,16529716403,-6537,,
15125140007,599.77466,16529773552,611508473,16529767010,-6542,,
15125190582,599.82523,16529824130,611559045,16529817583,-6547,,
15125241631,599.87628,16529875181,611610092,16529868629,-6552,,
15125291709,599.92636,16529925262,611660166,16529918704,-6558,,
15125342751,599.97740,16529976306,611711207,16529969744,-6562,,
15125393320,600.02797,16530026877,611761773,16530020310,-6567,,
15125444298,600.07895,16530077858,611812748,16530071285,-6573,,
15125495017,600.12967,16530128578,611863464,16530122001,-6577,,
15125546076,600.18072,16530179641,611914521,16530173058,-6583,,
15125596155,600.23080,16530229721,611964596,16530223133,-6588,,
15125646704,600.28135,16530280273,612015142,16530273680,-6593,,
15125697738,600.33239,16530331310,612066175,16530324712,-6598,,
15125747849,600.38250,16530381423,612116282,16530374819,-6604,,
15125797931,600.43258,16530431506,612166361,16530424898,-6608,,
15125848449,600.48310,16530482028,612216878,16530475415,-6613,,
15125899491,600.53414,16530533072,612267916,16530526453,-6619,,
15125950546,600.58519,16530584129,612318968,16530577506,-6623,,
15126001096,600.63574,16530634682,612369515,16530628053,-6629,,
15126052144,600.68679,16530685732,612420561,16530679099,-6633,,
15126103194,600.73784,16530736784,612471608,16530730146,-6638,,
15126153748,600.78840,16530787340,612522159,16530780696,-6644,,
15126204787,600.83943,16530838382,612573196,16530831733,-6649,,
15126255008,600.88966,16530888605,612623414,16530881952,-6653,,
15126305599,600.94025,16530939199,612674002,16530932540,-6659,,
15126356222,600.99087,16530989823,612724622,16530983159,-6664,,
15126406741,601.04139,16531040346,612775139,16531033676,-6670,,
15126457800,601.09245,16531091407,612826195,16531084733,-6674,,
15126508394,601.14304,16531142003,612876786,16531135324,-6679,,
15126559387,601.19403,16531192998,612927777,16531186314,-6684,,
15126609973,601.24462,16531243596,612978370,16531236907,-6689,,
15126661011,601.29566,16531294626,613029395,16531287932,-6694,,
15126711864,601.34651,16531345482,613080245,16531338782,-6700,,
15126762456,601.39710,16531396077,613130835,16531389373,-6704,,
15126813002,601.44765,16531446624,613181378,16531439915,-6709,,
15126863616,601.49826,16531497242,613232000,16531490538,-6704,,
15126914683,601.54933,16531548311,613283055,16531541592,-6719,,
15126965726,601.60037,16531599356,613334094,16531592631,-6725,,
15127016278,601.65093,16531649910,613384643,16531643180,-6730,,
15127067289,601.70194,16531700923,613435651,16531694188,-6735,,
15127118285,601.75293,16531751923,613486645,16531745183,-6740,,
15127169214,601.80386,16531802864,613537581,16531796119,-6745,,
15127219392,601.85404,16531853034,613587746,16531846295,-6739,,
15127269980,601.90463,16531903625,613638333,16531896870,-6755,,
15127321026,601.95567,16531954673,613689375,16531947913,-6760,,
15127371402,602.00605,16532005061,613739759,16531998296,-6765,,
15127422470,602.05712,16532056122,613790813,16532049351,-6771,,
15127473489,602.10814,16532107143,613841830,16532100368,-6775,,
15127524568,602.15922,16532158225,613892907,16532151444,-6781,,
15127575117,602.20976,16532208775,613943452,16532201989,-6786,,
15127625691,602.26034,16532259352,613994024,16532252573,-6779,,
15127676324,602.31097,16532309987,614044654,16532303191,-6796,,
15127727399,602.36205,16532361064,614095726,16532354263,-6801,,
15127777995,602.41264,16532411673,614146330,16532404867,-6806,,
15127829063,602.46371,16532462734,614197386,16532455923,-6811,,
15128064014,602.69866,16532697695,614432323,16532690860,-6835,16532696983,
15128089479,602.72413,16532723161,614457787,16532716354,-6807,,
15128140107,602.77476,16532773792,614508413,16532767042,-6750,,
15128191171,602.82582,16532824859,614559474,16532818165,-6694,,
15128242221,602.87687,16532875911,614610521,16532869276,-6635,,
15128292765,602.92741,16532926457,614661062,16532919878,-6579,,
15128343405,602.97805,16532977100,614711699,16532970578,-6522,,
15128394399,603.02905,16533028096,614762690,16533021631,-6465,,
15128445051,603.07970,16533078749,614813340,16533072342,-6407,,
15128495627,603.13027,16533129338,614863923,16533122987,-6351,,
15128546257,603.18091,16533179961,614914540,16533173666,-6295,,
15128596848,603.23150,16533230554,614965129,16533224318,-6236,,
15128647433,603.28208,16533281142,615015711,16533274962,-6180,,
15128698025,603.33267,16533331736,615066300,16533325613,-6123,,
15128748648,603.38330,16533382361,615116923,16533376297,-6064,,
15128799404,603.43405,16533433120,615167674,16533427111,-6009,,
15128850429,603.48508,16533484147,615218696,16533478206,-5941,,
15128901406,603.53605,16533535127,615269670,16533529232,-5895,,
15128952031,603.58668,16533585754,615320293,16533579917,-5837,,
15129002547,603.63720,16533636272,615370806,16533630492,-5780,,
15129053128,603.68778,16533686855,615421384,16533681132,-5723,,
15129104180,603.73883,16533737919,615472443,16533732254,-5665,,
15129154716,603.78936,16533788448,615522967,16533782840,-5608,,
15129205772,603.84042,16533839506,615574020,16533833954,-5552,,
15129256389,603.89104,16533890125,615624634,16533884630,-5495,,
15129307435,603.94208,16533941173,615675678,16533935737,-5436,,
15129358480,603.99313,16533992222,615726721,16533986842,-5380,,
15129409560,604.04421,16534043303,615777797,16534037981,-5322,,
15129460107,604.09475,16534093854,615828341,16534088588,-5266,,
15129510293,604.14494,16534144042,615878525,16534138832,-5210,,
15129561343,604.19599,16534195094,615929573,16534189943,-5151,,
15129611889,604.24654,16534245643,615980115,16534240548,-5095,,
15129662938,604.29759,16534296694,616031162,16534291656,-5038,,
15129713450,604.34810,16534347208,616081671,16534342228,-4980,,
15129764404,604.39905,16534398165,616132622,16534393241,-4924,,
15129815467,604.45011,16534449240,616183692,16534444374,-4866,,
15129866478,604.50113,16534500242,616234691,16534495434,-4808,,
15129916550,604.55120,16534550317,616284760,16534545565,-4752,,
15129967117,604.60177,16534600887,616335324,16534596192,-4695,,
15130017692,604.65234,16534651464,616385897,16534646827,-4637,,
15130068299,604.70295,16534702074,616436501,16534697492,-4582,,
15130118738,604.75339,16534752515,616486937,16534747990,-4525,,
15130169704,604.80435,16534803484,616537900,16534799015,-4469,,
15130220751,604.85540,16534854532,616588945,16534850122,-4410,,
15130271226,604.90587,16534905010,616639428,16534900667,-4343,,
15130321809,604.95646,16534955606,616690008,16534951309,-4297,,
15130372350,605.00700,16535006138,616740536,16535001899,-4239,,
15130423021,605.05767,16535056811,616791204,16535052629,-4182,,
15130473630,605.10828,16535107424,616841810,16535103298,-4126,,
15130524672,605.15932,16535158468,616892849,16535154400,-4068,,
15130575293,605.20994,16535209101,616943479,16535205091,-4010,,
15130625799,605.26045,16535259600,616993971,16535255646,-3954,,
15130676806,605.31145,16535310609,617044975,16535306712,-3897,,
15130727412,605.36206,16535361216,617095579,16535357377,-3839,,
15130778458,605.41311,16535412266,617146623,16535408484,-3782,,
15130829041,605.46369,16535462851,617197203,16535459126,-3725,,
15130879793,605.51444,16535513606,617247951,16535509936,-3670,,
15130930336,605.56498,16535564151,617298493,16535560541,-3610,,
15130980983,605.61563,16535614800,617349136,16535611246,-3554,,
15131031493,605.66614,16535665313,617399643,16535661815,-3498,,
15131082077,605.71672,16535715898,617450225,16535712458,-3440,,
15131133034,605.76768,16535766858,617501179,16535763474,-3384,,
15131183779,605.81843,16535817606,617551922,16535814279,-3327,,
15131234781,605.86943,16535868610,617602920,16535865341,-3269,,
15131285351,605.92000,16535919182,617653489,16535915971,-3211,,
15131335960,605.97061,16535969793,617704094,16535966638,-3155,,
15131386947,606.02160,16536020794,617755090,16536017697,-3097,,
15131437508,606.07216,16536071346,617805637,16536068306,-3040,,
15131488510,606.12316,16536122351,617856637,16536119367,-2984,,
15131539084,606.17373,16536172927,617907207,16536170000,-2927,,
15131590133,606.22478,16536223978,617958253,16536221108,-2870,,
15131641169,606.27582,16536275016,618009287,16536272205,-2811,,
15131691735,606.32638,16536325585,618059850,16536322830,-2755,,
15131742278,606.37693,16536376130,618110390,16536373432,-2698,,
15131793023,606.42767,16536426877,618161133,16536424236,-2641,,
15131843582,606.47823,16536477438,618211689,16536474854,-2584,,
15131894196,606.52884,16536528056,618262300,16536525528,-2528,,
15131945187,606.57984,16536579048,618313298,16536576588,-2460,,
15131996187,606.63084,16536630050,618364286,16536627638,-2412,,
15132046893,606.68154,16536680760,618414989,16536678403,-2357,,
15132097411,606.73206,16536731279,618465504,16536728980,-2299,,
15132147958,606.78261,16536781829,618516049,16536779587,-2242,,
15132198018,606.83267,16536831892,618566106,16536829706,-2186,,
15132248112,606.88276,16536881988,618616197,16536879859,-2129,,
15132298752,606.93340,16536932630,618666835,16536930558,-2072,,
15132349368,606.98402,16536983249,618717449,16536981234,-2015,,
15132400256,607.03490,16537034139,618768333,16537032181,-1958,,
15132451321,607.08597,16537085207,618819395,16537083305,-1902,,
15132501819,607.13647,16537135707,618869892,16537133864,-1843,,
15132552462,607.18711,16537186351,618920531,16537184565,-1786,,
15132603035,607.23768,16537236927,618971101,16537235197,-1730,,
15132653582,607.28823,16537287476,619021646,16537285804,-1672,,
15132704182,607.33883,16537338078,619072243,16537336462,-1616,,
15132754729,607.38938,16537388629,619122788,16537387069,-1560,,
15132805748,607.44040,16537439650,619173804,16537438148,-1502,,
15132856828,607.49148,16537490731,619224881,16537489287,-1444,,
15132907903,607.54255,16537541809,619275953,16537540422,-1387,,
15132958951,607.59360,16537592860,619326998,16537591530,-1330,,
15133009965,607.64461,16537643877,619378010,16537642605,-1272,,
15133060049,607.69470,16537693963,619428092,16537692747,-1216,,
15133111100,607.74575,16537745016,619479139,16537743800,-1216,,
15133161649,607.79630,16537795568,619529685,16537794347,-1221,,
15133212702,607.84735,16537846623,619580737,16537845398,-1225,,
15133263264,607.89791,16537897187,619631296,16537895957,-1230,,
15133313857,607.94850,16537947782,619681885,16537946546,-1236,,
15133364489,607.99914,16537998417,619732515,16537997177,-1240,,
15133415536,608.05018,16538049465,619783559,16538048220,-1245,,
15133466146,608.10079,16538100079,619834167,16538098828,-1251,,
15133516664,608.15131,16538150599,619884681,16538149343,-1256,,
15133567714,608.20236,16538201651,619935729,16538200390,-1261,,
15133618295,608.25294,16538252235,619986307,16538250968,-1267,,
15133668828,608.30348,16538302769,620036847,16538301508,-1261,,
15133719825,608.35447,16538353770,620087832,16538352494,-1276,,
15133770394,608.40504,16538404340,620138398,16538403070,-1270,,
15133820980,608.45563,16538454929,620188982,16538453643,-1286,,
15133871977,608.50662,16538505929,620239976,16538504637,-1292,,
15133922536,608.55718,16538556490,620290532,16538555194,-1296,,
15133973152,608.60780,16538607107,620341145,16538605806,-1301,,
15134024207,608.65886,16538658165,620392197,16538656858,-1307,,
15134074795,608.70944,16538708756,620442783,16538707445,-1311,,
15134125743,608.76039,16538759706,620493728,16538758389,-1317,,
15134176803,608.81145,16538810769,620544785,16538809447,-1322,,
15134227852,608.86250,16538861820,620595831,16538860492,-1328,,
15134277975,608.91262,16538911946,620645952,16538910613,-1333,,
15134328777,608.96343,16538962750,620696752,16538961413,-1337,,
15134378991,609.01364,16539012966,620746962,16539011624,-1342,,
15134430028,609.06468,16539064005,620798008,16539062670,-1335,,
15134481094,609.11574,16539115074,620849061,16539113722,-1352,,
15134532138,609.16679,16539166119,620900101,16539164762,-1357,,
15134582674,609.21732,16539216670,620950646,16539215307,-1363,,
15134633241,609.26789,16539267228,621001200,16539265861,-1367,,
15134684303,609.31895,16539318291,621052258,16539316919,-1372,,
15134735339,609.36999,16539369331,621103292,16539367953,-1378,,
15134786386,609.42103,16539420380,621154335,16539418997,-1383,,
15134836991,609.47164,16539470988,621204938,16539469599,-1389,,
15134887554,609.52220,16539521552,621255498,16539520159,-1393,,
15134937693,609.57234,16539571694,621305634,16539570296,-1398,,
15134988098,609.62275,16539622102,621356037,16539620709,-1393,,
15135039130,609.67378,16539673136,621407066,16539671728,-1408,,
15135089214,609.72386,16539723222,621457148,16539721809,-1413,,
15135139358,609.77401,16539773369,621507290,16539771951,-1418,,
15135189939,609.82459,16539823952,621557868,16539822529,-1423,,
15135240131,609.87478,16539874145,621608056,16539872717,-1428,,
15135291207,609.92585,16539925225,621659129,16539923790,-1435,,
15135341792,609.97644,16539975811,621709712,16539974373,-1438,,
15135392421,610.02707,16540026443,621760349,16540025011,-1432,,
15135442985,610.07763,16540077010,621810899,16540075561,-1449,,
15135493551,610.12820,16540127578,621861463,16540126124,-1454,,
15135544621,610.17927,16540178649,621912530,16540177191,-1458,,
15135595208,610.22986,16540229240,621963114,16540227776,-1464,,
15135645383,610.28003,16540279416,622013287,16540277948,-1468,,
15135695930,610.33058,16540329966,622063831,16540328492,-1474,,
15135746488,610.38114,16540380527,622114386,16540379048,-1479,,
15135797112,610.43176,16540431153,622165007,16540429669,-1484,,
15135847695,610.48234,16540481739,622215589,16540480250,-1489,,
15135898343,610.53299,16540532389,622266233,16540530895,-1494,,
15135948409,610.58306,16540582457,622316297,16540580958,-1499,,
15135999488,610.63414,16540633539,622367374,16540632035,-1504,,
15136049620,610.68427,16540683683,622417513,16540682174,-1509,,
15136100699,610.73535,16540734763,622468587,16540733249,-1514,,
15136151338,610.78599,16540785396,622519215,16540783876,-1520,,
15136201952,610.83660,16540836012,622569826,16540834488,-1524,,
15136252570,610.88722,16540886632,622620441,16540885103,-1529,,
15136303575,610.93822,16540937640,622671443,16540936105,-1535,,
15136354579,610.98923,16540988645,622722445,16540987106,-1539,,
15136405126,611.03977,16541039195,622772989,16541037651,-1544,,
15136456175,611.09082,16541090247,622824035,16541088697,-1550,,
15136507218,611.14187,16541141292,622875075,16541139737,-1555,,
15136557773,611.19242,16541191850,622925629,16541190290,-1560,,
15136608851,611.24350,16541242930,622976703,16541241364,-1566,,
15136659855,611.29450,16541293935,623027704,16541292365,-1570,,
15136710426,611.34507,16541344510,623078273,16541342935,-1575,,
15136761465,611.39611,16541395550,623129309,16541393970,-1580,,
15136812544,611.44719,16541446632,623180386,16541445047,-1585,,
15136863531,611.49818,16541497622,623231369,16541496031,-1591,,
15136913723,611.54837,16541547816,623281559,16541546220,-1596,,
15136964330,611.59898,16541598425,623332173,16541596835,-1590,,
15137015323,611.64997,16541649420,623383153,16541647814,-1606,,
15137065868,611.70052,16541699968,623433696,16541698358,-1610,,
15137115941,611.75059,16541750044,623483766,16541748428,-1616,,
15137166110,611.80076,16541800215,623533933,16541798594,-1621,,
15137217159,611.85181,16541851266,623584979,16541849640,-1626,,
15137267789,611.90244,16541901899,623635606,16541900268,-1631,,
15137318814,611.95346,16541952926,623686628,16541951289,-1637,,
15137369456,612.00410,16542003580,623737278,16542001940,-1640,,
15137420555,612.05520,16542054671,623788364,16542053025,-1646,,
15137471195,612.10584,16542105314,623839001,16542103662,-1652,,
15137521836,612.15648,16542155956,623889638,16542154300,-1656,,
15137572437,612.20709,16542206560,623940237,16542204898,-1662,,
15137623460,612.25811,16542257598,623991271,16542255933,-1665,,
15137674498,612.30915,16542308627,624042293,16542306954,-1673,,
15137725581,612.36023,16542359712,624093373,16542358035,-1677,,
15137776630,612.41128,16542410762,624144419,16542409080,-1682,,
15137827644,612.46229,16542461780,624195431,16542460092,-1688,,
15137878228,612.51288,16542512366,624246012,16542510673,-1693,,
15137929245,612.56389,16542563385,624297026,16542561688,-1697,,
15137979781,612.61443,16542613924,624347561,16542612222,-1702,,
15138030374,612.66502,16542664518,624398150,16542662811,-1707,,
15138080892,612.71554,16542715050,624448676,16542713338,-1712,,
15138131940,612.76659,16542766090,624499711,16542764372,-1718,,
15138183020,612.81767,16542817172,624550789,16542815450,-1722,,
15138234068,612.86872,16542868223,624601833,16542866494,-1729,,
15138284806,612.91945,16542918963,624652569,16542917230,-1733,,
15138334898,612.96955,16542969057,624702658,16542967319,-1738,,
15138385461,613.02011,16543019623,624753218,16543017880,-1743,,
15138435780,613.07043,16543069944,624803544,16543068206,-1738,,
15138486407,613.12105,16543120573,624854160,16543118821,-1752,,
15138537435,613.17208,16543171604,624905184,16543169846,-1758,,
15138588505,613.22315,16543222676,624956251,16543220913,-1763,,
15138639537,613.27418,16543273720,625007290,16543271952,-1768,,
15138690105,613.32475,16543324281,625057847,16543322508,-1773,,
15138740680,613.37533,16543374857,625108418,16543373079,-1778,,
15138791757,613.42641,16543425936,625159492,16543424153,-1783,,
15138842249,613.47690,16543476432,625209981,16543474643,-1789,,
15138892842,613.52749,16543527026,625260572,16543525233,-1793,,
15138943907,613.57856,16543578095,625311635,16543576296,-1799,,
15138994075,613.62872,16543628264,625361799,16543626460,-1804,,
15139045044,613.67969,16543679236,625412767,16543677428,-1808,,
15139095367,613.73001,16543729563,625463087,16543727749,-1814,,
15139145966,613.78061,16543780173,625513693,16543778354,-1819,,
15139197032,613.83168,16543831231,625564755,16543829417,-1814,,
15139247187,613.88184,16543881389,625614899,16543879560,-1829,,
15139297799,613.93245,16543932002,625665507,16543930168,-1834,,
15139348394,613.98304,16543982600,625716100,16543980761,-1839,,
15139398557,614.03320,16544032766,625766260,16544030922,-1844,,
15139449601,614.08425,16544083812,625817301,16544081963,-1849,,
15139500085,614.13473,16544134298,625867782,16544132444,-1854,,
15139550276,614.18492,16544184491,625917970,16544182632,-1859,,
15139601300,614.23595,16544235517,625968992,16544233653,-1864,,
15139652349,614.28700,16544286569,626020039,16544284700,-1869,,
15139703423,614.33807,16544337646,626071109,16544335771,-1875,,
15139754473,614.38912,16544388697,626122157,16544386818,-1879,,
15139805522,614.44017,16544439749,626173203,16544437864,-1885,,
15139856093,614.49074,16544490334,626223782,16544488444,-1890,,
15139906694,614.54134,16544540926,626274370,16544539032,-1894,,
15139957181,614.59183,16544591415,626324854,16544589515,-1900,,
15140007253,614.64190,16544641501,626374934,16544639596,-1905,,
15140057884,614.69253,16544692123,626425552,16544690213,-1910,,
15140108955,614.74360,16544743196,626476620,16544741281,-1915,,
15140159999,614.79465,16544794242,626527661,16544792322,-1920,,
15140210603,614.84525,16544844848,626578262,16544842923,-1925,,
15140261185,614.89583,16544895434,626628843,16544893504,-1930,,
15140311837,614.94649,16544946088,626679492,16544944153,-1935,,
15140362386,614.99703,16544996639,626730037,16544994698,-1941,,
15140412957,615.04760,16545047213,626780605,16545045266,-1947,,
15140463569,615.09822,16545097827,626831215,16545095877,-1950,,
15140514655,615.14930,16545148916,626882298,16545146960,-1956,,
15140564966,615.19961,16545199229,626932606,16545197268,-1961,,
15140615851,615.25050,16545250115,626983489,16545248150,-1965,,
15140666575,615.30122,16545300843,627034211,16545298872,-1971,,
15140717188,615.35184,16545351457,627084820,16545349481,-1976,,
15140767353,615.40200,16545401625,627134982,16545399644,-1981,,
15140817450,615.45210,16545451724,627185077,16545449738,-1986,,
15140868361,615.50301,16545502638,627235986,16545500647,-1991,,
15140918879,615.55353,16545553157,627286500,16545551161,-1996,,
15140969470,615.60412,16545603752,627337089,16545601750,-2002,,
15141020419,615.65507,16545654703,627388035,16545652696,-2007,,
15141071455,615.70610,16545705741,627439069,16545703730,-2011,,
15141121515,615.75616,16545755804,627489126,16545753788,-2016,,
15141172152,615.80680,16545806443,627539760,16545804422,-2021,,
15141222252,615.85690,16545856556,627589868,16545854530,-2026,,
15141272789,615.90744,16545907084,627640391,16545905052,-2032,,
15141323421,615.95807,16545957719,627691022,16545955683,-2036,,
15141374405,616.00905,16546008705,627742002,16546006663,-2042,,
15141424921,616.05957,16546059224,627792516,16546057177,-2047,,
15141475497,616.11014,16546109802,627843089,16546107750,-2052,,
15141526555,616.16120,16546160863,627894144,16546158805,-2058,,
15141577605,616.21225,16546211914,627945191,16546209853,-2061,,
15141628654,616.26330,16546262965,627996237,16546260898,-2067,,
15141679202,616.31385,16546313517,628046783,16546311444,-2073,,
15141730251,616.36490,16546364568,628097829,16546362491,-2077,,
15141780800,616.41545,16546415119,628148375,16546413036,-2083,,
15141831848,616.46650,16546466170,628199421,16546464083,-2087,,
15141882897,616.51755,16546517221,628250467,16546515129,-2092,,
15141933456,616.56810,16546567793,628301033,16546565695,-2098,,
15141984098,616.61875,16546618427,628351662,16546616324,-2103,,
15142034502,616.66915,16546668833,628402064,16546666726,-2107,,
15142085143,616.71979,16546719476,628452702,16546717363,-2113,,
15142135783,616.77043,16546770128,628503349,16546768010,-2118,,
15142186806,616.82145,16546821143,628554360,16546819021,-2122,,
15142237367,616.87202,16546871708,628604919,16546869580,-2128,,
15142287911,616.92256,16546922264,628655469,16546920131,-2133,,
15142338567,616.97321,16546972912,628706112,16546970774,-2138,,
15142389122,617.02377,16547023469,628756665,16547021326,-2143,,
15142439682,617.07433,16547074041,628807232,16547071893,-2148,,
15142490751,617.12540,16547125102,628858288,16547122949,-2153,,
15142540863,617.17551,16547175227,628908408,16547173069,-2158,,
15142591141,617.22579,16547225498,628958674,16547223335,-2163,,
15142641703,617.27635,16547276062,629009232,16547273894,-2168,,
15142692781,617.32743,16547327143,629060307,16547324969,-2174,,
15142743831,617.37848,16547378195,629111355,16547376017,-2178,,
15142794859,617.42951,16547429226,629162380,16547427042,-2184,,
15142845410,617.48006,16547479778,629212928,16547477589,-2189,,
15142895508,617.53016,16547529878,629263024,16547527685,-2193,,
15142946122,617.58077,16547580496,629313635,16547578297,-2199,,
15142996259,617.63091,16547630635,629363769,16547628431,-2204,,
15143046993,617.68164,16547681371,629414501,16547679163,-2208,,
15143097543,617.73219,16547731924,629465049,16547729710,-2214,,
15143148575,617.78322,16547782958,629516077,16547780739,-2219,,
15143198851,617.83350,16547833236,629566351,16547831012,-2224,,
15143249439,617.88409,16547883827,629616937,16547881598,-2229,,
15143299831,617.93448,16547934221,629667326,16547931987,-2234,,
15143350858,617.98551,16547985250,629718349,16547983011,-2239,,
15143401933,618.03658,16548036328,629769422,16548034084,-2244,,
15143452982,618.08763,16548087379,629820469,16548085130,-2249,,
15143503437,618.13809,16548137837,629870921,16548135582,-2255,,
15143553991,618.18864,16548188392,629921471,16548186133,-2259,,
15143604576,618.23922,16548238980,629972055,16548236716,-2264,,
15143655093,618.28974,16548289500,630022568,16548287230,-2270,,
15143706129,618.34078,16548340537,630073601,16548338262,-2275,,
15143756674,618.39132,16548391085,630124144,16548388806,-2279,,
15143807609,618.44226,16548442023,630175077,16548439738,-2285,,
15143858148,618.49280,16548492564,630225613,16548490275,-2289,,
15143909194,618.54384,16548543611,630276655,16548541316,-2295,,
15143959750,618.59440,16548594171,630327210,16548591871,-2300,,
15144010306,618.64495,16548644729,630377763,16548642424,-2305,,
15144060844,618.69549,16548695278,630428307,16548692969,-2309,,
15144111840,618.74649,16548746268,630479291,16548743953,-2315,,
15144161992,618.79664,16548796422,630529440,16548794102,-2320,,
15144213019,618.84767,16548847452,630580464,16548845126,-2326,,
15144264086,618.89873,16548898521,630631528,16548896190,-2331,,
15144314629,618.94928,16548949077,630682080,16548946741,-2336,,
15144365446,619.00009,16548999885,630732883,16548997545,-2340,,
15144416289,619.05094,16549050730,630783723,16549048384,-2346,,
15144467339,619.10199,16549101783,630834771,16549099433,-2350,,
15144518346,619.15299,16549152793,630885776,16549150437,-2356,,
15144568910,619.20356,16549203358,630936336,16549200997,-2361,,
15144619937,619.25459,16549254388,630987360,16549252022,-2366,,
15144670530,619.30518,16549304984,631037951,16549302613,-2371,,
15144721536,619.35618,16549355992,631088954,16549353616,-2376,,
15144772128,619.40678,16549406587,631139543,16549404205,-2382,,
15144822619,619.45727,16549457080,631190032,16549454694,-2386,,
15144873194,619.50784,16549507657,631240604,16549505266,-2391,,
15144923776,619.55842,16549558242,631291183,16549555845,-2397,,
15144974813,619.60946,16549609281,631342218,16549606880,-2401,,
15145025355,619.66000,16549659824,631392757,16549657418,-2406,,
15145075966,619.71061,16549710438,631443365,16549708026,-2412,,
15145127013,619.76166,16549761488,631494410,16549759071,-2417,,
15145177379,619.81203,16549811856,631544774,16549809436,-2420,,
15145227920,619.86257,16549862399,631595311,16549859972,-2427,,
15145277972,619.91262,16549912454,631645361,16549910022,-2432,,
15145328518,619.96317,16549963001,631695903,16549960565,-2436,,
15145379137,620.01378,16550013623,631746520,16550011181,-2442,,
15145430157,620.06480,16550064646,631797538,16550062199,-2447,,
15145481200,620.11585,16550115692,631848578,16550113239,-2453,,
15145531816,620.16646,16550166310,631899191,16550163853,-2457,,
15145581929,620.21658,16550216434,631949311,16550213972,-2462,,
15145632997,620.26765,16550267496,632000367,16550265028,-2468,,
15145683992,620.31864,16550318493,632051358,16550316020,-2473,,
15145734281,620.36893,16550368784,632101645,16550366306,-2478,,
15145785308,620.41996,16550419813,632152669,16550417330,-2483,,
15145836357,620.47100,16550470864,632203726,16550468387,-2477,,
15145886957,620.52161,16550521466,632254313,16550518974,-2492,,
15145937803,620.57245,16550572315,632305156,16550569817,-2498,,
15145988849,620.62350,16550623363,632356199,16550620860,-2503,,
15146039613,620.67426,16550674130,632406960,16550671621,-2509,,
15146090144,620.72479,16550724674,632457499,16550722161,-2513,,
15146141190,620.77584,16550775723,632508544,16550773205,-2518,,
15146192261,620.82691,16550826785,632559600,16550824262,-2523,,
15146242810,620.87746,16550877336,632610147,16550874808,-2528,,
15146293821,620.92847,16550928349,632661155,16550925816,-2533,,
15146344462,620.97911,16550978994,632711794,16550976455,-2539,,
15146395514,621.03016,16551030048,632762843,16551027504,-2544,,
15146446562,621.08121,16551081098,632813888,16551078550,-2548,,
15146497578,621.13223,16551132117,632864902,16551129563,-2554,,
15146548651,621.18330,16551183193,632915972,16551180633,-2560,,
15146599707,621.23436,16551234251,632967025,16551231686,-2565,,
15146650758,621.28541,16551285304,633018074,16551282735,-2569,,
15146701309,621.33596,16551335856,633068621,16551333282,-2574,,
15146752368,621.38702,16551386919,633119678,16551384339,-2580,,
15146803429,621.43808,16551437981,633170736,16551435397,-2584,,
15146854003,621.48865,16551488558,633221307,16551485969,-2589,,
15146905095,621.53974,16551539653,633272397,16551537058,-2595,,
15146955951,621.59060,16551590511,633323250,16551587911,-2600,,
15147006955,621.64160,16551641516,633374251,16551638912,-2604,,
15147057603,621.69225,16551692168,633424896,16551689558,-2610,,
15147108614,621.74326,16551743181,633475905,16551740566,-2615,,
15147159152,621.79380,16551793721,633526440,16551791101,-2620,,
15147209708,621.84436,16551844280,633576993,16551841654,-2626,,
15147259798,621.89445,16551894372,633627080,16551891741,-2631,,
15147310613,621.94526,16551945190,633677892,16551942554,-2636,,
15147361459,621.99611,16551996038,633728737,16551993398,-2640,,
15147412197,622.04684,16552046778,633779483,16552044145,-2633,,
15147463280,622.09793,16552097875,633830563,16552095225,-2650,,
15147513812,622.14846,16552148398,633881081,16552145743,-2655,,
15147564901,622.19955,16552199488,633932167,16552196828,-2660,,
15147615511,622.25016,16552250102,633982785,16552247446,-2656,,
15147666581,622.30123,16552301173,634033841,16552298502,-2671,,
15147717627,622.35227,16552352223,634084886,16552349548,-2675,,
15147768676,622.40332,16552403274,634135931,16552400593,-2681,,
15147819703,622.45435,16552454302,634186955,16552451616,-2686,,
15147870736,622.50538,16552505338,634237985,16552502646,-2692,,
15147921777,622.55642,16552556382,634289024,16552553686,-2696,,
15147972840,622.60749,16552607446,634340084,16552604745,-2701,,
15148023022,622.65767,16552657632,634390263,16552654925,-2707,,
15148073615,622.70826,16552708227,634440855,16552705516,-2711,,
15148124195,622.75884,16552758809,634491431,16552756092,-2717,,
15148174864,622.80951,16552809480,634542097,16552806758,-2722,,
15148225911,622.86056,16552860530,634593141,16552857803,-2727,,
15148276463,622.91111,16552911085,634643691,16552908353,-2732,,
15148326631,622.96128,16552961255,634693856,16552958517,-2738,,
15148377195,623.01184,16553011821,634744418,16553009079,-2742,,
15148427803,623.06245,16553062432,634795023,16553059685,-2747,,
15148478204,623.11285,16553112835,634845421,16553110082,-2753,,
15148528724,623.16337,16553163368,634895949,16553160611,-2757,,
15148578896,623.21354,16553213532,634946109,16553210770,-2762,,
15148629794,623.26444,16553264432,634997004,16553261665,-2767,,
15148680834,623.31548,16553315484,635048050,16553312712,-2772,,
15148731907,623.36655,16553366549,635099110,16553363771,-2778,,
15148782965,623.41761,16553417609,635150166,16553414828,-2781,,
15148833511,623.46816,16553468157,635200709,16553465370,-2787,,
15148884514,623.51916,16553519164,635251709,16553516371,-2793,,
15148935113,623.56976,16553569765,635302307,16553566968,-2797,,
15148986162,623.62081,16553620817,635353352,16553618014,-2803,,
15149037209,623.67186,16553671866,635404396,16553669058,-2808,,
15149087826,623.72247,16553722484,635455010,16553719672,-2812,,
15149138389,623.77304,16553773050,635505570,16553770232,-2818,,
15149188920,623.82357,16553823584,635556099,16553820761,-2823,,
15149239497,623.87414,16553874162,635606672,16553871345,-2817,,
15149290115,623.92476,16553924784,635657289,16553921951,-2833,,
15149340721,623.97537,16553975391,635707892,16553972553,-2838,,
15149391778,624.02643,16554026451,635758946,16554023607,-2844,,
15149442576,624.07722,16554077252,635809741,16554074403,-2849,,
15149493193,624.12784,16554127871,635860356,16554125018,-2853,,
15149543793,624.17844,16554178473,635910954,16554175615,-2858,,
15149594403,624.22905,16554229086,635961560,16554226221,-2865,,
15149645411,624.28006,16554280096,636012567,16554277228,-2868,,
15149695977,624.33063,16554330665,636063130,16554327792,-2873,,
15149746514,624.38116,16554381204,636113664,16554378336,-2868,,
15149796911,624.43156,16554431602,636164057,16554428718,-2884,,
15149847526,624.48217,16554482221,636214670,16554479332,-2889,,
15149898154,624.53280,16554532851,636265295,16554529957,-2894,,
15149948745,624.58339,16554583444,636315884,16554580545,-2899,,
15149998913,624.63356,16554633615,636366049,16554630711,-2904,,
15150049508,624.68416,16554684212,636416642,16554681303,-2909,,
15150100586,624.73523,16554735292,636467717,16554732378,-2914,,
15150151635,624.78628,16554786344,636518763,16554783424,-2920,,
15150202263,624.83691,16554836973,636569388,16554834049,-2924,,
15150253273,624.88792,16554887985,636620395,16554885057,-2928,,
15150303895,624.93854,16554938611,636671014,16554935676,-2935,,
15150354940,624.98959,16554989657,636722057,16554986718,-2939,,
15150405501,625.04015,16555040232,636772626,16555037287,-2945,,
15150456123,625.09077,16555090846,636823234,16555087896,-2950,,
15150506660,625.14131,16555141385,636873768,16555138430,-2955,,
15150557261,625.19191,16555191989,636924368,16555189029,-2960,,
15150607862,625.24251,16555242591,636974965,16555239626,-2965,,
15150658848,625.29350,16555293580,637025948,16555290610,-2970,,
15150709398,625.34405,16555344143,637076507,16555341168,-2975,,
15150760471,625.39512,16555395208,637127566,16555392237,-2971,,
15150811003,625.44565,16555445741,637178095,16555442756,-2985,,
15150861535,625.49618,16555496277,637228624,16555493286,-2991,,
15150912579,625.54723,16555547322,637279666,16555544328,-2994,,
15150963640,625.59829,16555598385,637330724,16555595385,-3000,,
15151013992,625.64864,16555648741,637381074,16555645735,-3006,,
15151065048,625.69970,16555699798,637432127,16555696788,-3010,,
15151115566,625.75021,16555750319,637482642,16555747304,-3015,,
15151166131,625.80078,16555800887,637533204,16555797866,-3021,,
15151216697,625.85135,16555851467,637583780,16555848441,-3026,,
15151267758,625.90241,16555902519,637634827,16555899488,-3031,,
15151318335,625.95298,16555953097,637685400,16555950062,-3035,,
15151368551,626.00320,16556003316,637735614,16556000275,-3041,,
15151419503,626.05415,16556054270,637786563,16556051224,-3046,,
15151470120,626.10477,16556104889,637837177,16556101839,-3050,,
15151520750,626.15540,16556155522,637887804,16556152466,-3056,,
15151571791,626.20644,16556206578,637938855,16556203516,-3062,,
15151622796,626.25744,16556257573,637989845,16556254507,-3066,,
15151673343,626.30799,16556308133,638040401,16556305062,-3071,,
15151724416,626.35906,16556359197,638091459,16556356120,-3077,,
15151775463,626.41011,16556410247,638142505,16556407166,-3081,,
15151826496,626.46114,16556461283,638193534,16556458196,-3087,,
15151876609,626.51126,16556511397,638243644,16556508305,-3092,,
15151927356,626.56200,16556562147,638294388,16556559050,-3097,,
15151977997,626.61265,16556612791,638345038,16556609699,-3092,,
15152028564,626.66321,16556663359,638395591,16556660252,-3107,,
15152079632,626.71428,16556714430,638446656,16556711317,-3113,,
15152129862,626.76451,16556764662,638496884,16556761545,-3117,,
15152180906,626.81555,16556815709,638547925,16556812587,-3122,,
15152231059,626.86571,16556865863,638598075,16556862736,-3127,,
15152282055,626.91670,16556916862,638649068,16556913730,-3132,,
15152333141,626.96779,16556967951,638700152,16556964814,-3137,,
15152383291,627.01794,16557018103,638750300,16557014961,-3142,,
15152434340,627.06899,16557069155,638801345,16557066007,-3148,,
15152485388,627.12004,16557120205,638852391,16557117053,-3152,,
15152535988,627.17064,16557170808,638903000,16557167662,-3146,,
15152587035,627.22168,16557221856,638954032,16557218693,-3163,,
15152638088,627.27274,16557272911,639005082,16557269743,-3168,,
15152689133,627.32378,16557323960,639056125,16557320787,-3173,,
15152740185,627.37483,16557375014,639107174,16557371836,-3178,,
15152790764,627.42541,16557425595,639157761,16557422422,-3173,,
15152841837,627.47649,16557476670,639208820,16557473481,-3189,,
15152892886,627.52753,16557527721,639259867,16557524528,-3193,,
15152943411,627.57806,16557578262,639310401,16557575063,-3199,,
15152994484,627.62913,16557629325,639361459,16557626121,-3204,,
15153044646,627.67929,16557679489,639411619,16557676281,-3208,,
15153095249,627.72990,16557730095,639462230,16557726892,-3203,,
15153146316,627.78096,16557781163,639513283,16557777944,-3219,,
15153196836,627.83148,16557831686,639563801,16557828463,-3223,,
15153247405,627.88205,16557882258,639614367,16557879029,-3229,,
15153298454,627.93310,16557933309,639665414,16557930075,-3234,,
15153349462,627.98411,16557984318,639716418,16557981079,-3239,,
15153400525,628.03517,16558035396,639767490,16558032152,-3244,,
15153451124,628.08577,16558085986,639818076,16558082737,-3249,,
15153501867,628.13652,16558136731,639868816,16558133477,-3254,,
15153552436,628.18708,16558187303,639919381,16558184043,-3260,,
15153603498,628.23815,16558238367,639970441,16558235103,-3264,,
15153654558,628.28921,16558289430,640021498,16558286160,-3270,,
15153704658,628.33931,16558339531,640071595,16558336256,-3275,,
15153755235,628.38988,16558390110,640122170,16558386831,-3279,,
15153805836,628.44048,16558440714,640172768,16558437429,-3285,,
15153856556,628.49120,16558491437,640223485,16558488146,-3291,,
15153907545,628.54219,16558542428,640274471,16558539133,-3295,,
15153958153,628.59280,16558593039,640325078,16558589739,-3300,,
15154009202,628.64385,16558644090,640376124,16558640785,-3305,,
15154060233,628.69488,16558695122,640427151,16558691813,-3309,,
15154111164,628.74581,16558746056,640478080,16558742741,-3315,,
15154162167,628.79682,16558797062,640529081,16558793742,-3320,,
15154212699,628.84735,16558847597,640579610,16558844271,-3326,,
15154263781,628.89843,16558898681,640630688,16558895349,-3332,,
15154314788,628.94944,16558949690,640681693,16558946355,-3335,,
15154365741,629.00039,16559000646,640732644,16558997305,-3341,,
15154416311,629.05096,16559051217,640783210,16559047872,-3345,,
15154466949,629.10160,16559101858,640833846,16559098508,-3350,,
15154517343,629.15199,16559152255,640884237,16559148899,-3356,,
15154567895,629.20254,16559202809,640934787,16559199448,-3361,,
15154618470,629.25312,16559253386,640985359,16559250020,-3366,,
15154669088,629.30374,16559304007,641035974,16559300636,-3371,,
15154719138,629.35379,16559354059,641086021,16559350683,-3376,,
15154769274,629.40392,16559404197,641136154,16559400816,-3381,,
15154820295,629.45494,16559455221,641187173,16559451835,-3386,,
15154871347,629.50599,16559506275,641238222,16559502884,-3391,,
15154921945,629.55659,16559556875,641288817,16559553478,-3397,,
15154972597,629.60725,16559607530,641339468,16559604129,-3401,,
15155023614,629.65826,16559658549,641390482,16559655143,-3406,,
15155074240,629.70889,16559709178,641441116,16559705777,-3401,,
15155124848,629.75950,16559759788,641491710,16559756371,-3417,,
15155175716,629.81036,16559810658,641542575,16559807237,-3421,,
15155226219,629.86087,16559861164,641593075,16559857737,-3427,,
15155277254,629.91190,16559912200,641644107,16559908768,-3432,,
15155327848,629.96250,16559962797,641694698,16559959360,-3437,,
15155378896,630.01354,16560013848,641745745,16560010406,-3442,,
15155429875,630.06452,16560064828,641796720,16560061381,-3447,,
15155480068,630.11472,16560115024,641846911,16560111572,-3452,,
15155531115,630.16576,16560166074,641897956,16560162617,-3457,,
15155581747,630.21640,16560216707,641948584,16560213245,-3462,,
15155632316,630.26696,16560267279,641999150,16560263811,-3468,,
15155683359,630.31801,16560318324,642050190,16560314851,-3473,,
15155733423,630.36807,16560368390,642100252,16560364913,-3477,,
15155784001,630.41865,16560418971,642150827,16560415488,-3483,,
15155834996,630.46964,16560469969,642201819,16560466480,-3489,,
15155885120,630.51977,16560520095,642251942,16560516603,-3492,,
15155935715,630.57036,16560570692,642302533,16560567194,-3498,,
15155986305,630.62095,16560621285,642353120,16560617782,-3503,,
15156037381,630.67203,16560672363,642404195,16560668856,-3507,,
15156088102,630.72275,16560723087,642454912,16560719574,-3513,,
15156139111,630.77376,16560774098,642505918,16560770580,-3518,,
15156189844,630.82449,16560824833,642556648,16560821310,-3523,,
15156240857,630.87550,16560875849,642607660,16560872321,-3528,,
15156290968,630.92562,16560925962,642657767,16560922439,-3523,,
15156341979,630.97663,16560976975,642708775,16560973436,-3539,,
15156392896,631.02754,16561027895,642759690,16561024351,-3544,,
15156443530,631.07818,16561078531,642810321,16561074983,-3548,,
15156494092,631.12874,16561129096,642860881,16561125542,-3554,,
15156544724,631.17937,16561179730,642911516,16561176178,-3552,,
15156595261,631.22991,16561230269,642962044,16561226706,-3563,,
15156646317,631.28097,16561281328,643013098,16561277759,-3569,,
15156697405,631.33205,16561332418,643064183,16561328844,-3574,,
15156747919,631.38257,16561382933,643114694,16561379355,-3578,,
15156798967,631.43362,16561433985,643165739,16561430401,-3584,,
15156850047,631.48469,16561485067,643216816,16561481478,-3589,,
15156901060,631.53571,16561536083,643267827,16561532488,-3595,,
15156952109,631.58676,16561587134,643318873,16561583535,-3599,,
15157002678,631.63733,16561637705,643369439,16561634101,-3604,,
15157053247,631.68790,16561688277,643420005,16561684667,-3610,,
15157104251,631.73890,16561739283,643471006,16561735668,-3615,,
15157154798,631.78945,16561789832,643521552,16561786213,-3619,,
15157204941,631.83959,16561839978,643571692,16561836353,-3625,,
15157255444,631.89009,16561890482,643622191,16561886852,-3630,,
15157305783,631.94043,16561940824,643672529,16561937191,-3633,,
15157356215,631.99086,16561991259,643722957,16561987630,-3629,,
15157407173,632.04182,16562042219,643773913,16562038574,-3645,,
15157457304,632.09195,16562092352,643824041,16562088703,-3649,,
15157507527,632.14217,16562142578,643874261,16562138923,-3655,,
15157558555,632.19320,16562193608,643925287,16562189948,-3660,,
15157609635,632.24428,16562244690,643976363,16562241024,-3666,,
15157660653,632.29530,16562295711,644027380,16562292041,-3670,,
15157711699,632.34635,16562346759,644078422,16562343084,-3675,,
15157762290,632.39694,16562397353,644129011,16562393672,-3681,,
15157813339,632.44799,16562448404,644180057,16562444719,-3685,,
15157864355,632.49900,16562499422,644231071,16562495732,-3690,,
15157915435,632.55008,16562550505,644282147,16562546809,-3696,,
15157966440,632.60109,16562601511,644333149,16562597810,-3701,,
15158017001,632.65165,16562652085,644383719,16562648380,-3705,,
15158067580,632.70223,16562702657,644434284,16562698946,-3711,,
15158118499,632.75315,16562753577,644485200,16562749861,-3716,,
15158168668,632.80332,16562803749,644535367,16562800029,-3720,,
15158219666,632.85431,16562854750,644586362,16562851024,-3726,,
15158270104,632.90475,16562905189,644636797,16562901459,-3730,,
15158321153,632.95580,16562956242,644687843,16562952505,-3737,,
15158372158,633.00681,16563007248,644738846,16563003507,-3741,,
15158422244,633.05689,16563057337,644788930,16563053592,-3745,,
15158472678,633.10733,16563107774,644839372,16563104033,-3741,,
15158523291,633.15794,16563158388,644889971,16563154632,-3756,,
15158573466,633.20811,16563208566,644940143,16563204805,-3761,,
15158623996,633.25864,16563259099,644990670,16563255332,-3767,,
15158674957,633.30961,16563310062,645041629,16563306290,-3772,,
15158725514,633.36016,16563360621,645092184,16563356845,-3776,,
15158776119,633.41077,16563411229,645142786,16563407447,-3782,,
15158826657,633.46131,16563461768,645193320,16563457981,-3787,,
15158877706,633.51235,16563512831,645244379,16563509041,-3790,,
15158928286,633.56293,16563563403,645294944,16563559606,-3797,,
15158978772,633.61342,16563613891,645345427,16563610089,-3802,,
15159029367,633.66401,16563664489,645396019,16563660681,-3808,,
15159080388,633.71504,16563715511,645447038,16563711700,-3811,,
15159130716,633.76536,16563765841,645497363,16563762025,-3816,,
15159181081,633.81573,16563816210,645547725,16563812387,-3823,,
15159231643,633.86629,16563866774,645598286,16563862947,-3827,,
15159282695,633.91734,16563917827,645649334,16563913995,-3832,,
15159333264,633.96791,16563968400,645699900,16563964562,-3838,,
15159383447,634.01810,16564018585,645750082,16564014743,-3842,,
15159434413,634.06906,16564069553,645801044,16564065706,-3847,,
15159485208,634.11986,16564120350,645851836,16564116497,-3853,,
15159535795,634.17044,16564170939,645902420,16564167082,-3857,,
15159586368,634.22102,16564221514,645952991,16564217652,-3862,,
15159637016,634.27166,16564272165,646003636,16564268297,-3868,,
15159688051,634.32270,16564323203,646054668,16564319330,-3873,,
15159739078,634.37373,16564374233,646105693,16564370354,-3879,,
15159790151,634.42480,16564425308,646156763,16564421425,-3883,,
15159840678,634.47533,16564475847,646207298,16564471959,-3888,,
15159891755,634.52640,16564526917,646258361,16564523023,-3894,,
15159942796,634.57744,16564577960,646309400,16564574062,-3898,,
15159993845,634.62849,16564629010,646360446,16564625107,-3903,,
15160044898,634.67955,16564680066,646411496,16564676157,-3909,,
15160095946,634.73059,16564731117,646462541,16564727203,-3914,,
15160146964,634.78161,16564782136,646513557,16564778218,-3918,,
15160197522,634.83217,16564832698,646564123,16564828784,-3914,,
15160248115,634.88276,16564883292,646614702,16564879364,-3928,,
15160299094,634.93374,16564934275,646665680,16564930341,-3934,,
15160349715,634.98436,16564984897,646716297,16564980959,-3938,,
15160400267,635.03491,16565035452,646766846,16565031508,-3944,,
15160450903,635.08555,16565086091,646817479,16565082141,-3950,,
15160501868,635.13652,16565137058,646868453,16565133115,-3943,,
15160552917,635.18756,16565188108,646919488,16565184149,-3959,,
15160603990,635.23864,16565239185,646970558,16565235219,-3966,,
15160654994,635.28964,16565290190,647021559,16565286220,-3970,,
15160705193,635.33984,16565340391,647071756,16565336417,-3974,,
15160755836,635.39048,16565391038,647122397,16565387059,-3979,,
15160806449,635.44110,16565441653,647173007,16565437668,-3985,,
15160856990,635.49164,16565492206,647223555,16565488217,-3989,,
15160907297,635.54195,16565542506,647273850,16565538511,-3995,,
15160957871,635.59252,16565593081,647324420,16565589081,-4000,,
15161008820,635.64347,16565644033,647375367,16565640028,-4005,,
15161059403,635.69405,16565694619,647425947,16565690609,-4010,,
15161110458,635.74511,16565745675,647476999,16565741661,-4014,,
15161161267,635.79592,16565796488,647527805,16565792467,-4021,,
15161211906,635.84655,16565847129,647578442,16565843103,-4026,,
15161262350,635.89700,16565897575,647628883,16565893545,-4030,,
15161312400,635.94705,16565947628,647678930,16565943592,-4036,,
15161362538,635.99719,16565997768,647729066,16565993728,-4040,,
15161413161,636.04781,16566048392,647779686,16566044347,-4045,,
15161463776,636.09842,16566099010,647830297,16566094959,-4051,,
15161514826,636.14947,16566150062,647881345,16566146006,-4056,,
15161565367,636.20002,16566200605,647931884,16566196545,-4060,,
15161615967,636.25062,16566251209,647982481,16566247143,-4066,,
15161667022,636.30167,16566302266,648033533,16566298195,-4071,,
15161717809,636.35246,16566353056,648084318,16566348980,-4076,,
15161767952,636.40260,16566403200,648134458,16566399119,-4081,,
15161818062,636.45271,16566453313,648184565,16566449227,-4086,,
15161868187,636.50284,16566503441,648234699,16566499360,-4081,,
15161918814,636.55346,16566554069,648285312,16566549974,-4095,,
15161968962,636.60361,16566604220,648335457,16566600130,-4090,,
15162019552,636.65420,16566654824,648386056,16566650717,-4107,,
15162070428,636.70508,16566705690,648436918,16566701579,-4111,,
15162121431,636.75608,16566756696,648487918,16566752580,-4116,,
15162171994,636.80664,16566807262,648538479,16566803140,-4122,,
15162222542,636.85719,16566857812,648589024,16566853685,-4127,,
15162273116,636.90776,16566908388,648639595,16566904256,-4132,,
15162324200,636.95885,16566959474,648690676,16566955337,-4137,,
15162374810,637.00946,16567010087,648741283,16567005945,-4142,,
15162424936,637.05958,16567060224,648791417,16567056079,-4145,,
15162475542,637.11019,16567110823,648842020,16567106682,-4141,,
15162526131,637.16078,16567161414,648892596,16567157257,-4157,,
15162576800,637.21145,16567212086,648943263,16567207925,-4161,,
15162627787,637.26243,16567263076,648994257,16567258919,-4157,,
15162678393,637.31304,16567313695,649044861,16567309523,-4172,,
15162729474,637.36412,16567364768,649095929,16567360591,-4177,,
15162779597,637.41425,16567414893,649146050,16567410711,-4182,,
15162830191,637.46484,16567465488,649196640,16567461301,-4187,,
15162881153,637.51580,16567516454,649247599,16567512260,-4194,,
15162932193,637.56684,16567567496,649298637,16567563299,-4197,,
15162983249,637.61790,16567618554,649349690,16567614352,-4202,,
15163034295,637.66894,16567669603,649400733,16567665395,-4208,,
15163084896,637.71954,16567720206,649451331,16567715993,-4213,,
15163135469,637.77012,16567770781,649501902,16567766563,-4218,,
15163185581,637.82023,16567820895,649552011,16567816673,-4222,,
15163235692,637.87034,16567871009,649602119,16567866781,-4228,,
15163286210,637.92086,16567921529,649652636,16567917297,-4232,,
15163337130,637.97178,16567972452,649703552,16567968213,-4239,,
15163387771,638.02242,16568023095,649754191,16568018852,-4243,,
15163438130,638.07278,16568073457,649804548,16568069210,-4247,,
15163488716,638.12336,16568124045,649855130,16568119792,-4253,,
15163539354,638.17400,16568174685,649905765,16568170427,-4258,,
15163589963,638.22461,16568225297,649956372,16568221033,-4264,,
15163640550,638.27520,16568275886,650006956,16568271618,-4268,,
15163691169,638.32582,16568326507,650057573,16568322235,-4272,,
15163741796,638.37644,16568377137,650108197,16568372858,-4279,,
15163792845,638.42749,16568428188,650159243,16568423905,-4283,,
15163843426,638.47807,16568478782,650209832,16568474494,-4288,,
15163894031,638.52868,16568529378,650260423,16568525084,-4294,,
15163944692,638.57934,16568580042,650311093,16568575755,-4287,,
15163995551,638.63020,16568630903,650361938,16568626600,-4303,,
15164045652,638.68030,16568681007,650412036,16568676698,-4309,,
15164095880,638.73053,16568731236,650462278,16568726939,-4297,,
15164146950,638.78160,16568782308,650513328,16568777990,-4318,,
15164197595,638.83224,16568832957,650563971,16568828632,-4325,,
15164248658,638.88331,16568884022,650615032,16568879693,-4329,,
15164299737,638.93439,16568935103,650666107,16568930769,-4334,,
15164350299,638.98495,16568985668,650716667,16568981329,-4339,,
15164400494,639.03514,16569035865,650766869,16569031530,-4335,,
15164451560,639.08621,16569086934,650817922,16569082584,-4350,,
15164502172,639.13682,16569137548,650868532,16569133194,-4354,,
15164552742,639.18739,16569188120,650919099,16569183760,-4360,,
15164603344,639.23799,16569238725,650969698,16569234360,-4365,,
15164653989,639.28864,16569289372,651020342,16569285003,-4369,,
15164704605,639.33925,16569339989,651070954,16569335615,-4374,,
15164755209,639.38986,16569390597,651121555,16569386217,-4380,,
15164806002,639.44065,16569441392,651172346,16569437007,-4385,,
15164856997,639.49164,16569492389,651223338,16569488000,-4389,,
15164907179,639.54183,16569542574,651273517,16569538179,-4395,,
15164958259,639.59291,16569593656,651324594,16569589256,-4400,,
15165009323,639.64397,16569644723,651375657,16569640318,-4405,,
15165059913,639.69456,16569695315,651426243,16569690905,-4410,,
15165110438,639.74509,16569745842,651476765,16569741427,-4415,,
15165161446,639.79609,16569796853,651527770,16569792432,-4421,,
15165212068,639.84672,16569847476,651578390,16569843051,-4425,,
15165262656,639.89730,16569898066,651628975,16569893636,-4430,,
15165312703,639.94735,16569948117,651679020,16569943681,-4436,,
15165363314,639.99796,16569998730,651729628,16569994290,-4440,,
15165414299,640.04895,16570049717,651780610,16570045271,-4446,,
15165464873,640.09952,16570100294,651831191,16570095853,-4441,,
15165515039,640.14969,16570150462,651881344,16570146006,-4456,,
15165565237,640.19988,16570200662,651931540,16570196202,-4460,,
15165616284,640.25093,16570251712,651982584,16570247246,-4466,,
15165666869,640.30152,16570302299,652033167,16570297828,-4471,,
15165717886,640.35253,16570353329,652084192,16570348853,-4476,,
15165768510,640.40316,16570403945,652134802,16570399464,-4481,,
15165819523,640.45417,16570454960,652185813,16570450474,-4486,,
15165869732,640.50438,16570505172,652236020,16570500681,-4491,,
15165920676,640.55532,16570556118,652286960,16570551622,-4496,,
15165971186,640.60583,16570606630,652337468,16570602129,-4501,,
15166021693,640.65634,16570657139,652387971,16570652632,-4507,,
15166072242,640.70689,16570707691,652438518,16570703180,-4511,,
15166122802,640.75745,16570758252,652489075,16570753736,-4516,,
15166173411,640.80806,16570808865,652539681,16570804343,-4522,,
15166224415,640.85906,16570859871,652590683,16570855345,-4526,,
15166275040,640.90969,16570910498,652641305,16570905967,-4531,,
15166326087,640.96073,16570961547,652692349,16570957010,-4537,,
15166376659,641.01131,16571012122,652742918,16571007580,-4542,,
15166427214,641.06186,16571062679,652793471,16571058132,-4547,,
15166477845,641.11249,16571113313,652844099,16571108761,-4552,,
15166528364,641.16301,16571163833,652894615,16571159277,-4556,,
15166578953,641.21360,16571214426,652945202,16571209863,-4563,,
15166629615,641.26426,16571265089,652995861,16571260522,-4567,,
15166680674,641.31532,16571316151,653046918,16571311579,-4572,,
15166730751,641.36540,16571366230,653097002,16571361663,-4567,,
15166781262,641.41591,16571416744,653147501,16571412162,-4582,,
15166831809,641.46646,16571467292,653198044,16571462705,-4587,,
15166881925,641.51657,16571517412,653248157,16571512819,-4593,,
15166932462,641.56711,16571567950,653298692,16571563354,-4596,,
15166983021,641.61767,16571618512,653349249,16571613910,-4602,,
15167033578,641.66823,16571669072,653399803,16571664464,-4608,,
15167084613,641.71926,16571720109,653450836,16571715497,-4612,,
15167135695,641.77034,16571771193,653501914,16571766576,-4617,,
15167186210,641.82086,16571821711,653552427,16571817088,-4623,,
15167237289,641.87194,16571872791,653603502,16571868163,-4628,,
15167288305,641.92295,16571923811,653654517,16571919178,-4633,,
15167338890,641.97354,16571974398,653705098,16571969760,-4638,,
15167389424,642.02407,16572024933,653755629,16572020290,-4643,,
15167440092,642.07474,16572075605,653806294,16572070956,-4649,,
15167490603,642.12525,16572126117,653856803,16572121464,-4653,,
15167541251,642.17590,16572176768,653907449,16572172110,-4658,,
15167592298,642.22695,16572227818,653958493,16572223154,-4664,,
15167643302,642.27795,16572278823,654009494,16572274156,-4667,,
15167693896,642.32854,16572329420,654060086,16572324747,-4673,,
15167744946,642.37959,16572380473,654111133,16572375794,-4679,,
15167795970,642.43062,16572431499,654162154,16572426815,-4684,,
15167846545,642.48119,16572482077,654212726,16572477388,-4689,,
15167897097,642.53175,16572532630,654263275,16572527936,-4694,,
15167948179,642.58283,16572583715,654314354,16572579016,-4699,,
15167999226,642.63387,16572634764,654365399,16572630061,-4703,,
15168050301,642.68495,16572685842,654416472,16572681134,-4708,,
15168100896,642.73554,16572736439,654467063,16572731725,-4714,,
15168151521,642.78617,16572787067,654517686,16572782347,-4720,,
15168202570,642.83722,16572838117,654568732,16572833394,-4723,,
15168252814,642.88746,16572888364,654618973,16572883634,-4730,,
15168303423,642.93807,16572938976,654669590,16572934252,-4724,,
15168354462,642.98911,16572990016,654720616,16572985277,-4739,,
15168404527,643.03918,16573040083,654770678,16573035339,-4744,,
15168455109,643.08976,16573090669,654821257,16573085919,-4750,,
15168505720,643.14037,16573141282,654871865,16573136527,-4755,,
15168556336,643.19098,16573191901,654922479,16573187141,-4760,,
15168607206,643.24185,16573242773,654973346,16573238008,-4765,,
15168657680,643.29233,16573293249,655023829,16573288490,-4759,,
15168708252,643.34290,16573343824,655074387,16573339048,-4776,,
15168758854,643.39350,16573394428,655124986,16573389647,-4781,,
15168809681,643.44433,16573445257,655175810,16573440471,-4786,,
15168860690,643.49534,16573496268,655226816,16573491477,-4791,,
15168911249,643.54590,16573546830,655277373,16573542035,-4795,,
15168962222,643.59687,16573597816,655328354,16573593016,-4800,,
15169012788,643.64744,16573648374,655378907,16573643568,-4806,,
15169063366,643.69801,16573698953,655429482,16573694143,-4810,,
15169113925,643.74857,16573749515,655480038,16573744700,-4815,,
15169164519,643.79917,16573800112,655530629,16573795291,-4821,,
15169215556,643.85020,16573851150,655581664,16573846325,-4825,,
15169266226,643.90087,16573901824,655632331,16573896993,-4831,,
15169316798,643.95145,16573952397,655682900,16573947561,-4836,,
15169367338,644.00199,16574002940,655733438,16573998099,-4841,,
15169418381,644.05303,16574053985,655784478,16574049139,-4846,,
15169468813,644.10346,16574104420,655834908,16574099570,-4850,,
15169519828,644.15448,16574155437,655885919,16574150580,-4857,,
15169570088,644.20474,16574205699,655936177,16574200838,-4861,,
15169620735,644.25538,16574256349,655986821,16574251483,-4866,,
15169671325,644.30597,16574306941,656037409,16574302070,-4871,,
15169722380,644.35703,16574357999,656088461,16574353122,-4877,,
15169772958,644.40761,16574408578,656139036,16574403697,-4881,,
15169823904,644.45855,16574459527,656189979,16574454641,-4886,,
15169874661,644.50931,16574510298,656240745,16574505407,-4891,,
15169925233,644.55988,16574560872,656291315,16574555976,-4896,,
15169975818,644.61047,16574611449,656341885,16574606547,-4902,,
15170025967,644.66062,16574661599,656392031,16574656692,-4907,,
15170076989,644.71164,16574712623,656443050,16574707711,-4912,,
15170127573,644.76222,16574763222,656493643,16574758305,-4917,,
15170178233,644.81288,16574813873,656544289,16574808951,-4922,,
15170228850,644.86350,16574864492,656594904,16574859565,-4927,,
15170279017,644.91367,16574914662,656645068,16574909741,-4921,,
15170329591,644.96424,16574965237,656695639,16574960300,-4937,,
15170380177,645.01482,16575015826,656746222,16575010884,-4942,,
15170430747,645.06539,16575066409,656796800,16575061461,-4948,,
15170481787,645.11644,16575117441,656847827,16575112489,-4952,,
15170532435,645.16708,16575168091,656898473,16575163134,-4957,,
15170583026,645.21767,16575218685,656949061,16575213722,-4963,,
15170633641,645.26829,16575269302,656999674,16575264335,-4967,,
15170684746,645.31939,16575320409,657050776,16575315437,-4972,,
15170735795,645.37044,16575371461,657101822,16575366483,-4978,,
15170786340,645.42099,16575422008,657152364,16575417025,-4983,,
15170837345,645.47199,16575473016,657203367,16575468028,-4988,,
15170887938,645.52259,16575523610,657253956,16575518617,-4993,,
15170938486,645.57313,16575574161,657304501,16575569163,-4998,,
15170989004,645.62365,16575624681,657355017,16575619678,-5003,,
15171040038,645.67469,16575675718,657406048,16575670710,-5008,,
15171090631,645.72528,16575726312,657456637,16575721309,-5003,,
15171141201,645.77585,16575776886,657507205,16575771866,-5020,,
15171192251,645.82690,16575827937,657558253,16575822914,-5023,,
15171243309,645.87796,16575878997,657609307,16575873969,-5028,,
15171293878,645.92853,16575929569,657659874,16575924535,-5034,,
15171344402,645.97905,16575980096,657710396,16575975058,-5038,,
15171394970,646.02962,16576030667,657760962,16576025623,-5044,,
15171445823,646.08047,16576081522,657811812,16576076473,-5049,,
15171496433,646.13108,16576132134,657862418,16576127080,-5054,,
15171547042,646.18169,16576182746,657913026,16576177687,-5059,,
15171598061,646.23271,16576233767,657964042,16576228703,-5064,,
15171648627,646.28328,16576284335,658014604,16576279266,-5069,,
15171699163,646.33381,16576334873,658065138,16576329799,-5074,,
15171749756,646.38440,16576385469,658115729,16576380390,-5079,,
15171800805,646.43545,16576436520,658166775,16576431436,-5084,,
15171851390,646.48604,16576487107,658217356,16576482018,-5089,,
15171902480,646.53713,16576538200,658268445,16576533106,-5094,,
15171953529,646.58818,16576589250,658319490,16576584151,-5099,,
15172003712,646.63836,16576639436,658369670,16576634331,-5105,,
15172054397,646.68904,16576690124,658420354,16576685015,-5109,,
15172104575,646.73922,16576740305,658470528,16576735190,-5115,,
15172155587,646.79024,16576791319,658521537,16576786198,-5121,,
15172206648,646.84130,16576842382,658572607,16576837268,-5114,,
15172257363,646.89201,16576893099,658623308,16576887969,-5130,,
15172307913,646.94256,16576943651,658673855,16576938516,-5135,,
15172358931,646.99358,16576994672,658724871,16576989532,-5140,,
15172409034,647.04368,16577044789,658774983,16577039644,-5145,,
15172459199,647.09385,16577094945,658825134,16577089795,-5150,,
15172509826,647.14447,16577145574,658875757,16577140419,-5155,,
15172560685,647.19533,16577196436,658926615,16577191276,-5160,,
15172611269,647.24592,16577247022,658977196,16577241857,-5165,,
15172662304,647.29695,16577298070,659028239,16577292900,-5170,,
15172713353,647.34800,16577349123,659079285,16577343947,-5176,,
15172763925,647.39857,16577399685,659129844,16577394505,-5180,,
15172814463,647.44911,16577450226,659180378,16577445039,-5187,,
15172865148,647.49980,16577500913,659231061,16577495722,-5191,,
15172916197,647.55084,16577551963,659282107,16577546769,-5194,,
15172967246,647.60189,16577603016,659333154,16577597815,-5201,,
15173018293,647.65294,16577654065,659384198,16577648859,-5206,,
15173069345,647.70399,16577705119,659435247,16577699908,-5211,,
15173120361,647.75501,16577756138,659486260,16577750922,-5216,,
15173171437,647.80609,16577807215,659537333,16577801994,-5221,,
15173222485,647.85713,16577858267,659588378,16577853039,-5228,,
15173273491,647.90814,16577909275,659639381,16577904043,-5232,,
15173324090,647.95874,16577959875,659689978,16577954639,-5236,,
15173374588,648.00924,16578010377,659740474,16578005135,-5242,,
15173425074,648.05972,16578060865,659790956,16578055617,-5248,,
15173475997,648.11064,16578111790,659841877,16578106539,-5251,,
15173527049,648.16170,16578162844,659892926,16578157587,-5257,,
15173577652,648.21230,16578213450,659943527,16578208188,-5262,,
15173628221,648.26287,16578264021,659994093,16578258755,-5266,,
15173679281,648.31393,16578315083,660045150,16578309811,-5272,,
15173730241,648.36489,16578366046,660096108,16578360769,-5277,,
15173780830,648.41548,16578416637,660146693,16578411355,-5282,,
15173831363,648.46601,16578467173,660197224,16578461886,-5287,,
15173882434,648.51708,16578518245,660248292,16578512953,-5292,,
15173933075,648.56772,16578568890,660298930,16578563592,-5298,,
15173984131,648.61878,16578619948,660349983,16578614645,-5303,,
15174035172,648.66982,16578670991,660401023,16578665684,-5307,,
15174086162,648.72081,16578721983,660452009,16578716671,-5312,,
15174136307,648.77095,16578772131,660502152,16578766813,-5318,,
15174187353,648.82200,16578823178,660553195,16578817856,-5322,,
15174237915,648.87256,16578873743,660603754,16578868415,-5328,,
15174288965,648.92361,16578924795,660654801,16578919462,-5333,,
15174340014,648.97466,16578975847,660705847,16578970509,-5338,,
15174391061,649.02571,16579026896,660756892,16579021553,-5343,,
15174442084,649.07673,16579077921,660807912,16579072573,-5348,,
15174493106,649.12775,16579128946,660858931,16579123592,-5354,,
15174543709,649.17836,16579179552,660909531,16579174193,-5359,,
15174594781,649.22943,16579230625,660960601,16579225262,-5363,,
15174645335,649.27998,16579281183,661011152,16579275814,-5369,,
15174696387,649.33104,16579332237,661062201,16579326863,-5374,,
15174746901,649.38155,16579382753,661112714,16579377375,-5378,,
15174797462,649.43211,16579433317,661163271,16579427933,-5384,,
15174848034,649.48268,16579483891,661213841,16579478502,-5389,,
15174899089,649.53374,16579534948,661264893,16579529554,-5394,,
15174949679,649.58433,16579585550,661315490,16579580151,-5399,,
15175000271,649.63492,16579636135,661366069,16579630730,-5405,,
15175050926,649.68557,16579686792,661416721,16579681382,-5410,,
15175101559,649.73621,16579737428,661467353,16579732025,-5403,,
15175152179,649.78683,16579788050,661517969,16579782631,-5419,,
15175202937,649.83758,16579838810,661568724,16579833386,-5424,,
15175253761,649.88841,16579889647,661619556,16579884217,-5430,,
15175304451,649.93910,16579940329,661670233,16579934895,-5434,,
15175355010,649.98966,16579990890,661720789,16579985450,-5440,,
15175405597,650.04025,16580041480,661771384,16580036045,-5435,,
15175456598,650.09125,16580092483,661822372,16580087034,-5449,,
15175507209,650.14186,16580143097,661872980,16580137641,-5456,,
15175557751,650.19240,16580193641,661923520,16580188181,-5460,,
15175607915,650.24256,16580243816,661973691,16580238353,-5463,,
15175658986,650.29363,16580294881,662024750,16580289412,-5469,,
15175709285,650.34393,16580345182,662075045,16580339706,-5476,,
15175759418,650.39407,16580395328,662125186,16580389848,-5480,,
15175810288,650.44494,16580446189,662176043,16580440704,-5485,,
15175860803,650.49545,16580496707,662226555,16580491217,-5490,,
15175911848,650.54650,16580547755,662277597,16580542259,-5496,,
15175962468,650.59712,16580598377,662328215,16580592877,-5500,,
15176013025,650.64767,16580648936,662378769,16580643431,-5505,,
15176064105,650.69875,16580700018,662429846,16580694507,-5511,,
15176115025,650.74967,16580750941,662480763,16580745425,-5516,,
15176165668,650.80032,16580801586,662531405,16580796066,-5520,,
15176215865,650.85051,16580851786,662581599,16580846260,-5526,,
15176266405,650.90105,16580902327,662632135,16580896796,-5531,,
15176316939,650.95159,16580952864,662682667,16580947329,-5535,,
15176367126,651.00177,16581003054,662732852,16580997513,-5541,,
15176417235,651.05188,16581053165,662782958,16581047619,-5546,,
15176467359,651.10201,16581103290,662833079,16581097740,-5550,,
15176518410,651.15306,16581154345,662884127,16581148789,-5556,,
15176568977,651.20362,16581204914,662934692,16581199353,-5561,,
15176620013,651.25466,16581255952,662985725,16581250386,-5566,,
15176670586,651.30523,16581306527,663036295,16581300956,-5571,,
15176721110,651.35576,16581357054,663086817,16581351478,-5576,,
15176771704,651.40635,16581407651,663137408,16581402069,-5582,,
15176822657,651.45731,16581458605,663188358,16581453020,-5585,,
15176873201,651.50785,16581509152,663238900,16581503561,-5591,,
15176923807,651.55845,16581559760,663289502,16581554163,-5597,,
15176974388,651.60904,16581610343,663340080,16581604742,-5601,,
15177024918,651.65957,16581660886,663390619,16581655280,-5606,,
15177075954,651.71060,16581711915,663441641,16581706303,-5612,,
15177126515,651.76116,16581762478,663492199,16581756861,-5617,,
15177177054,651.81170,16581813018,663542736,16581807397,-5621,,
15177227104,651.86175,16581863072,663592784,16581857445,-5627,,
15177278190,651.91284,16581914160,663643867,16581908529,-5631,,
15177329239,651.96389,16581965211,663694912,16581959574,-5637,,
15177379750,652.01440,16582015725,663745422,16582010083,-5642,,
15177430835,652.06548,16582066812,663796504,16582061165,-5647,,
15177481784,652.11643,16582117763,663847449,16582112110,-5653,,
15177532288,652.16694,16582168270,663897952,16582162613,-5657,,
15177582466,652.21711,16582218449,663948126,16582212787,-5662,,
15177633022,652.26767,16582269009,663998680,16582263341,-5668,,
15177683187,652.31783,16582319176,664048841,16582313503,-5673,,
15177733768,652.36842,16582369758,664099420,16582364082,-5676,,
15177784319,652.41897,16582420312,664149968,16582414629,-5683,,
15177834912,652.46956,16582470908,664200558,16582465220,-5688,,
15177885993,652.52064,16582521990,664251637,16582516298,-5692,,
15177937040,652.57169,16582573041,664302681,16582567343,-5698,,
15177988059,652.62271,16582624061,664353697,16582618358,-5703,,
15178038148,652.67280,16582674152,664403783,16582668444,-5708,,
15178088302,652.72295,16582724309,664453935,16582718596,-5713,,
15178139200,652.77385,16582775210,664504831,16582769492,-5718,,
15178189844,652.82449,16582825856,664555472,16582820133,-5723,,
15178240880,652.87553,16582876895,664606505,16582871167,-5728,,
15178291263,652.92591,16582927283,664656890,16582921552,-5731,,
15178341899,652.97655,16582977919,664707519,16582972180,-5739,,
15178392903,653.02755,16583028925,664758521,16583023182,-5743,,
15178443820,653.07847,16583079844,664809434,16583074096,-5748,,
15178494463,653.12911,16583130490,664860074,16583124736,-5754,,
15178544550,653.17920,16583180579,664910158,16583174820,-5759,,
15178595297,653.22995,16583231327,664960903,16583225565,-5762,,
15178645893,653.28054,16583281926,665011496,16583276157,-5769,,
15178696416,653.33106,16583332452,665062016,16583326678,-5774,,
15178746987,653.38163,16583383025,665112585,16583377247,-5778,,
15178797462,653.43211,16583433513,665163068,16583427730,-5783,,
15178848513,653.48316,16583484555,665214105,16583478767,-5788,,
15178899534,653.53418,16583535579,665265124,16583529785,-5794,,
15178950126,653.58477,16583586174,665315714,16583580375,-5799,,
15179001191,653.63584,16583637240,665366775,16583631437,-5803,,
15179052184,653.68683,16583688237,665417765,16583682426,-5811,,
15179102751,653.73740,16583738805,665468330,16583732992,-5813,,
15179153799,653.78845,16583789856,665519376,16583784037,-5819,,
15179204350,653.83900,16583840410,665569924,16583834585,-5825,,
15179255384,653.89003,16583891446,665620954,16583885616,-5830,,
15179305958,653.94061,16583942032,665671537,16583936198,-5834,,
15179356988,653.99164,16583993055,665722553,16583987215,-5840,,
15179407543,654.04219,16584043612,665773105,16584037766,-5846,,
15179458519,654.09317,16584094590,665824080,16584088741,-5849,,
15179508632,654.14328,16584144706,665874189,16584138851,-5855,,
15179559127,654.19377,16584195203,665924682,16584189343,-5860,,
15179609575,654.24422,16584245653,665975126,16584239787,-5866,,
15179660093,654.29474,16584296174,666025642,16584290303,-5871,,
15179711127,654.34578,16584347209,666076673,16584341334,-5875,,
15179761684,654.39633,16584397781,666127239,16584391900,-5881,,
15179812246,654.44689,16584448334,666177788,16584442449,-5885,,
15179863200,654.49785,16584499289,666228738,16584493399,-5890,,
15179913739,654.54839,16584549832,666279274,16584543936,-5896,,
15179964786,654.59943,16584600880,666330318,16584594980,-5900,,
15180015843,654.65049,16584651939,666381373,16584646034,-5905,,
15180066360,654.70101,16584702460,666431888,16584696549,-5911,,
15180117081,654.75173,16584753183,666482606,16584747267,-5916,,
15180167630,654.80228,16584803733,666533152,16584797813,-5920,,
15180218178,654.85283,16584854285,666583697,16584848359,-5926,,
15180269224,654.90387,16584905333,666634741,16584899402,-5931,,
15180319635,654.95428,16584955747,666685148,16584949810,-5937,,
15180370673,655.00532,16585006787,666736184,16585000846,-5941,,
15180421593,655.05624,16585057708,666787101,16585051762,-5946,,
15180472053,655.10670,16585108172,666837558,16585102220,-5952,,
15180523089,655.15774,16585159210,666888592,16585153254,-5956,,
15180574123,655.20877,16585210246,666939624,16585204285,-5961,,
15180625037,655.25968,16585261163,666990535,16585255196,-5967,,
15180675126,655.30977,16585311253,667040620,16585305281,-5972,,
15180726102,655.36075,16585362232,667091594,16585356256,-5976,,
15180776567,655.41121,16585412700,667142056,16585406718,-5982,,
15180827616,655.46226,16585463750,667193102,16585457763,-5987,,
15180878369,655.51302,16585514506,667243854,16585508515,-5991,,
15180929389,655.56404,16585565529,667294870,16585559532,-5997,,
15180979928,655.61458,16585616070,667345407,16585610068,-6002,,
15181030977,655.66562,16585667122,667396452,16585661114,-6008,,
15181082013,655.71666,16585718160,667447487,16585712148,-6012,,
15181132575,655.76722,16585768723,667498045,16585762706,-6017,,
15181183123,655.81777,16585819275,667548590,16585813252,-6023,,
15181234157,655.86880,16585870311,667599623,16585864284,-6027,,
15181284709,655.91936,16585920865,667650172,16585914833,-6032,,
15181335331,655.96998,16585971490,667700790,16585965451,-6039,,
15181386326,656.02097,16586022490,667751786,16586016448,-6042,,
15181436392,656.07104,16586072555,667801846,16586066508,-6047,,
15181486978,656.12163,16586123143,667852429,16586117090,-6053,,
15181537528,656.17218,16586173696,667902976,16586167638,-6058,,
15181588084,656.22273,16586224255,667953530,16586218192,-6063,,
15181639169,656.27382,16586275342,668004613,16586269274,-6068,,
15181689741,656.32439,16586325927,668055192,16586319854,-6073,,
15181740363,656.37501,16586376541,668105800,16586370462,-6079,,
15181791383,656.42603,16586427563,668156818,16586421479,-6084,,
15181841965,656.47661,16586478147,668207398,16586472059,-6088,,
15181892542,656.52719,16586528727,668257972,16586522633,-6094,,
15181943567,656.57822,16586579754,668308994,16586573656,-6098,,
15181993641,656.62829,16586629829,668359065,16586623726,-6103,,
15182044688,656.67934,16586680880,668410109,16586674771,-6109,,
15182095723,656.73037,16586731917,668461141,16586725803,-6114,,
15182146197,656.78084,16586782392,668511613,16586776274,-6118,,
15182196750,656.83140,16586832949,668562164,16586826825,-6124,,
15182247333,656.88198,16586883534,668612744,16586877405,-6129,,
15182298159,656.93281,16586934363,668663568,16586928229,-6134,,
15182348728,656.98338,16586984933,668714133,16586978794,-6139,,
15182399322,657.03397,16587035530,668764724,16587029386,-6144,,
15182449826,657.08447,16587086037,668815225,16587079886,-6151,,
15182499869,657.13452,16587136082,668865267,16587129928,-6154,,
15182550448,657.18510,16587186662,668915842,16587180504,-6158,,
15182601509,657.23616,16587237727,668966900,16587231562,-6165,,
15182652106,657.28675,16587288326,669017496,16587282157,-6169,,
15182702205,657.33685,16587338427,669067592,16587332253,-6174,,
15182752774,657.38742,16587388999,669118158,16587382819,-6180,,
15182803817,657.43846,16587440044,669169198,16587433860,-6184,,
15182854660,657.48931,16587490888,669220038,16587484699,-6189,,
15182904995,657.53964,16587541227,669270371,16587535032,-6195,,
15182955067,657.58971,16587591300,669320439,16587585100,-6200,,
15183005337,657.63999,16587641573,669370708,16587635369,-6204,,
15183055884,657.69053,16587692123,669421251,16587685913,-6210,,
15183105980,657.74063,16587742221,669471344,16587736006,-6215,,
15183156529,657.79118,16587792772,669521891,16587786553,-6219,,
15183207532,657.84218,16587843778,669572892,16587837553,-6225,,
15183258589,657.89324,16587894837,669623946,16587888607,-6230,,
15183309142,657.94379,16587945393,669674495,16587939157,-6236,,
15183359677,657.99433,16587995930,669725029,16587989690,-6240,,
15183410726,658.04537,16588046980,669776074,16588040735,-6245,,
15183461271,658.09592,16588097529,669826616,16588091278,-6251,,
15183512321,658.14697,16588148581,669877664,16588142326,-6255,,
15183565982,658.20063,16588202243,669931322,16588195983,-6260,,
15183616915,658.25156,16588253180,669982252,16588246914,-6266,,
15183671488,658.30614,16588307755,670036822,16588301483,-6272,,
15183729914,658.36456,16588366183,670095245,16588359906,-6277,,
15183782824,658.41747,16588419097,670148152,16588412814,-6283,,
15183834384,658.46903,16588470658,670199709,16588464370,-6288,,
15183885172,658.51982,16588521448,670250495,16588515156,-6292,,
15183936228,658.57088,16588572507,670301548,16588566209,-6298,,
15183986784,658.62143,16588623065,670352101,16588616762,-6303,,
15184037319,658.67197,16588673602,670402634,16588667296,-6306,,
15184087870,658.72252,16588724157,670453182,16588717844,-6313,,
15184138428,658.77308,16588774717,670503737,16588768399,-6318,,
15184188966,658.82361,16588825256,670554272,16588818933,-6323,,
15184239012,658.87366,16588875306,670604317,16588868978,-6328,,
15184290059,658.92471,16588926355,670655361,16588920022,-6333,,
15184340648,658.97530,16588976945,670705946,16588970607,-6338,,
15184391726,659.02637,16589028026,670757022,16589021683,-6343,,
15184442721,659.07737,16589079023,670808014,16589072675,-6348,,
15184493780,659.12843,16589130085,670859069,16589123731,-6354,,
15184544314,659.17896,16589180622,670909601,16589174263,-6359,,
15184594856,659.22950,16589231165,670960141,16589224802,-6363,,
15184645460,659.28011,16589281772,671010742,16589275403,-6369,,
15184696464,659.33111,16589332778,671061743,16589326404,-6374,,
15184747045,659.38169,16589383361,671112322,16589376983,-6378,,
15184798097,659.43274,16589434417,671163372,16589428033,-6384,,
15184848663,659.48331,16589484995,671213944,16589478606,-6389,,
15184899710,659.53436,16589536045,671264990,16589529652,-6393,,
15184950778,659.58543,16589587105,671316044,16589580706,-6399,,
15185001324,659.63597,16589637653,671366587,16589631249,-6404,,
15185051862,659.68651,16589688194,671417122,16589681784,-6410,,
15185102420,659.73707,16589738753,671467678,16589732340,-6413,,
15185152980,659.78763,16589789316,671518235,16589782896,-6420,,
15185203572,659.83822,16589839911,671568825,16589833486,-6425,,
15185253761,659.88841,16589890101,671619010,16589883671,-6430,,
15185304747,659.93939,16589941090,671669994,16589934655,-6435,,
15185355801,659.99045,16589992147,671721046,16589985707,-6440,,
15185406426,660.04107,16590042773,671771667,16590036328,-6445,,
15185457461,660.09211,16590093811,671822700,16590087362,-6449,,
15185508497,660.14315,16590144849,671873733,16590138394,-6455,,
15185559525,660.19417,16590195879,671924758,16590189419,-6460,,
15185609637,660.24428,16590245994,671974867,16590239529,-6465,,
15185660651,660.29530,16590297011,672025880,16590290541,-6470,,
15185711283,660.34593,16590347644,672076508,16590341169,-6475,,
15185761839,660.39649,16590398203,672127061,16590391723,-6480,,
15185812767,660.44741,16590449133,672177987,16590442649,-6484,,
15185863364,660.49801,16590499733,672228581,16590493242,-6491,,
15185914400,660.54905,16590550772,672279614,16590544276,-6496,,
15185964989,660.59964,16590601363,672330201,16590594862,-6501,,
15186016031,660.65068,16590652406,672381240,16590645901,-6505,,
15186067073,660.70172,16590703452,672432279,16590696941,-6511,,
15186117615,660.75226,16590753995,672482818,16590747479,-6516,,
15186168393,660.80304,16590804776,672533594,16590798256,-6520,,
15186218984,660.85363,16590855370,672584182,16590848844,-6526,,
15186269763,660.90441,16590906150,672634958,16590899619,-6531,,
15186320632,660.95528,16590957023,672685825,16590950486,-6537,,
15186371652,661.00630,16591008044,672736842,16591001503,-6541,,
15186422700,661.05735,16591059095,672787887,16591052549,-6546,,
15186473742,661.10839,16591110140,672838927,16591103588,-6552,,
15186524783,661.15943,16591161183,672889965,16591154626,-6557,,
15186575332,661.20998,16591211733,672940511,16591205172,-6561,,
15186625890,661.26054,16591262294,672991066,16591255727,-6567,,
15186676314,661.31096,16591312721,673041487,16591306149,-6572,,
15186726408,661.36106,16591362816,673091579,16591356240,-6576,,
15186777444,661.41209,16591413855,673142612,16591407273,-6582,,
15186828064,661.46271,16591464478,673193230,16591457891,-6587,,
15186879096,661.51374,16591515513,673244259,16591508921,-6592,,
15186930174,661.56482,16591566592,673295334,16591559995,-6597,,
15186980732,661.61538,16591617152,673345889,16591610551,-6601,,
15187030806,661.66545,16591667229,673395960,16591660621,-6608,,
15187081395,661.71604,16591717821,673446547,16591711209,-6612,,
15187131969,661.76662,16591768407,673497129,16591761790,-6617,,
15187183020,661.81767,16591819450,673548166,16591812828,-6622,,
15187233577,661.86823,16591870010,673598721,16591863383,-6627,,
15187283763,661.91841,16591920198,673648905,16591913566,-6632,,
15187334814,661.96946,16591971251,673699951,16591964613,-6638,,
15187385847,662.02049,16592022287,673750983,16592015644,-6643,,
15187436409,662.07106,16592072851,673801543,16592066204,-6647,,
15187487004,662.12165,16592123449,673852135,16592116796,-6653,,
15187538019,662.17267,16592174466,673903146,16592167808,-6658,,
15187589067,662.22371,16592225517,673954193,16592218854,-6663,,
15187639616,662.27426,16592276068,674004738,16592269400,-6668,,
15187690165,662.32481,16592326619,674055284,16592319946,-6673,,
15187740701,662.37535,16592377157,674105817,16592370478,-6679,,
15187791288,662.42594,16592427747,674156403,16592421065,-6682,,
15187841844,662.47649,16592478305,674206956,16592471617,-6688,,
15187892852,662.52750,16592529316,674257961,16592522622,-6694,,
15187943907,662.57856,16592580373,674309013,16592573675,-6698,,
15187994401,662.62905,16592630869,674359505,16592624166,-6703,,
15188044962,662.67961,16592681433,674410063,16592674724,-6709,,
15188305783,662.94043,16592942266,674670869,16592935530,-6736,16592941313,
15188331216,662.96586,16592967700,674696302,16592960992,-6708,,
15188382273,663.01692,16593018758,674747355,16593012105,-6653,,
15188432817,663.06746,16593069305,674797896,16593062703,-6602,,
15188482969,663.11762,16593119460,674848046,16593112912,-6548,,
15188533617,663.16827,16593170109,674898691,16593163615,-6494,,
15188584289,663.21894,16593220784,674949359,16593214342,-6442,,
15188634776,663.26942,16593271273,674999845,16593264886,-6387,,
15188685361,663.32001,16593321862,675050428,16593315527,-6335,,
15188736424,663.37107,16593372927,675101487,16593366646,-6281,,
15188786987,663.42164,16593423492,675152047,16593417265,-6227,,
15188837556,663.47220,16593474064,675202615,16593467890,-6174,,
15188888584,663.52323,16593525093,675253639,16593518973,-6120,,
15188939620,663.57427,16593576131,675304672,16593570066,-6065,,
15188990181,663.62483,16593626696,675355232,16593620684,-6012,,
15189040730,663.67538,16593677247,675405777,16593671288,-5959,,
15189091778,663.72643,16593728297,675456822,16593722393,-5904,,
15189142326,663.77697,16593778848,675507367,16593772996,-5852,,
15189192860,663.82751,16593829383,675557899,16593823585,-5798,,
15189243420,663.87807,16593879945,675608456,16593874201,-5744,,
15189293958,663.92861,16593930486,675658991,16593924794,-5692,,
15189344493,663.97914,16593981024,675709524,16593975387,-5637,,
15189394569,664.02922,16594031103,675759597,16594025518,-5585,,
15189445615,664.08026,16594082151,675810640,16594076620,-5531,,
15189496162,664.13081,16594132699,675861184,16594127221,-5478,,
15189546744,664.18139,16594183285,675911764,16594177861,-5424,,
15189597761,664.23241,16594234304,675962779,16594228934,-5370,,
15189648310,664.28296,16594284855,676013325,16594279538,-5317,,
15189698883,664.33353,16594335430,676063895,16594330167,-5263,,
15189749937,664.38459,16594386487,676114946,16594381278,-5209,,
15189800987,664.43564,16594437538,676165993,16594432383,-5155,,
15189851505,664.48615,16594488059,676216508,16594482956,-5103,,
15189902039,664.53669,16594538596,676267041,16594533548,-5048,,
15189953097,664.58775,16594589655,676318095,16594584661,-4994,,
15190003657,664.63830,16594640218,676368652,16594635277,-4941,,
15190054199,664.68885,16594690763,676419193,16594685876,-4887,,
15190105237,664.73988,16594741803,676470227,16594736969,-4834,,
15190155794,664.79044,16594792363,676520781,16594787583,-4780,,
15190206344,664.84099,16594842915,676571329,16594838188,-4727,,
15190257643,664.89229,16594894217,676622626,16594889544,-4673,,
15190307947,664.94259,16594944523,676672926,16594939904,-4619,,
15190358648,664.99330,16594995226,676723624,16594990660,-4566,,
15190409198,665.04385,16595045779,676774172,16595041267,-4512,,
15190462793,665.09744,16595099376,676827764,16595094921,-4455,,
15190513265,665.14791,16595149851,676878233,16595145448,-4403,,
15190563822,665.19847,16595200409,676928787,16595196060,-4349,,
15190620291,665.25494,16595256880,676985253,16595252591,-4289,,
15190671469,665.30612,16595308062,677036429,16595303827,-4235,,
15190725473,665.36012,16595362068,677090431,16595357891,-4177,,
15190776019,665.41067,16595412616,677140972,16595408491,-4125,,
15190826171,665.46082,16595462770,677191122,16595458698,-4072,,
15190876229,665.51088,16595512830,677241178,16595508812,-4018,,
15190927278,665.56193,16595563883,677292224,16595559918,-3965,,
15190982337,665.61698,16595618943,677347280,16595615037,-3906,,
15191033365,665.66801,16595669975,677398306,16595666122,-3853,,
15191083435,665.71808,16595720047,677448373,16595716248,-3799,,
15191134460,665.76911,16595771074,677499395,16595767329,-3745,,
15191185517,665.82016,16595822134,677550449,16595818442,-3692,,
15191236066,665.87071,16595872684,677600995,16595869045,-3639,,
15191286619,665.92127,16595923239,677651546,16595919655,-3584,,
15191337707,665.97235,16595974331,677702631,16595970800,-3531,,
15191388320,666.02297,16596024946,677753241,16596021469,-3477,,
15191439338,666.07399,16596075967,677804257,16596072544,-3423,,
15191489885,666.12453,16596126516,677854801,16596123146,-3370,,
15191540702,666.17535,16596177335,677905625,16596174029,-3306,,
15191591757,666.22640,16596228393,677956668,16596225130,-3263,,
15191641933,666.27658,16596278571,678006841,16596275362,-3209,,
15191692944,666.32759,16596329584,678057849,16596326429,-3155,,
15191743515,666.37816,16596380158,678108418,16596377055,-3103,,
15191794432,666.42908,16596431076,678159332,16596428028,-3048,,
15191844541,666.47919,16596481188,678209438,16596478193,-2995,,
15191894938,666.52959,16596531598,678259842,16596528656,-2942,,
15191945509,666.58016,16596582161,678310400,16596579272,-2889,,
15191996560,666.63121,16596633214,678361450,16596630380,-2834,,
15192047211,666.68186,16596683868,678412097,16596681087,-2781,,
15192098238,666.73289,16596734907,678463132,16596732180,-2727,,
15192148821,666.78347,16596785483,678513702,16596782809,-2674,,
15192199849,666.83450,16596836513,678564727,16596833892,-2621,,
15192249896,666.88454,16596886562,678614772,16596883995,-2567,,
15192300293,666.93494,16596936962,678665166,16596934448,-2514,,
15192350907,666.98555,16596987578,678715777,16596985118,-2460,,
15192401773,667.03642,16597038446,678766640,16597036040,-2406,,
15192452375,667.08702,16597089051,678817239,16597086698,-2353,,
15192502935,667.13758,16597139613,678867807,16597137324,-2289,,
15192553500,667.18815,16597190180,678918359,16597187935,-2245,,
15192603689,667.23834,16597240372,678968546,16597238179,-2193,,
15192654239,667.28889,16597290923,679019104,16597288795,-2128,,
15192705307,667.33996,16597341994,679070159,16597339909,-2085,,
15192756321,667.39097,16597393011,679121170,16597390979,-2032,,
15192807385,667.44203,16597444088,679172242,16597442110,-1978,,
15192858454,667.49310,16597495148,679223297,16597493224,-1924,,
15192909502,667.54415,16597546199,679274342,16597544328,-1871,,
15192960506,667.59515,16597597205,679325343,16597595389,-1816,,
15193011099,667.64575,16597647800,679375933,16597646037,-1763,,
15193062147,667.69679,16597698851,679426980,16597697143,-1708,,
15193113196,667.74784,16597749901,679478025,16597748247,-1654,,
15193164215,667.79886,16597800924,679529042,16597799323,-1601,,
15193214842,667.84949,16597851553,679579667,16597850007,-1546,,
15193265456,667.90010,16597902168,679630277,16597900675,-1493,,
15193316325,667.95097,16597953041,679681144,16597951589,-1452,,
15193366855,668.00150,16598003583,679731681,16598002126,-1457,,
15193417789,668.05244,16598054510,679782602,16598053048,-1462,,
15193467959,668.10261,16598104682,679832770,16598103215,-1467,,
15193518532,668.15318,16598155257,679883339,16598153784,-1473,,
15193569044,668.20369,16598205772,679933849,16598204295,-1477,,
15193620015,668.25466,16598256745,679984828,16598255274,-1471,,
15193670963,668.30561,16598307695,680035762,16598306208,-1487,,
15193721734,668.35638,16598358469,680086530,16598356976,-1493,,
15193772314,668.40696,16598409051,680137109,16598407554,-1497,,
15193823352,668.45800,16598460091,680188144,16598458590,-1501,,
15193874415,668.50906,16598511157,680239203,16598509649,-1508,,
15193925450,668.56010,16598562194,680290236,16598560682,-1512,,
15193976081,668.61073,16598612828,680340865,16598611310,-1518,,
15194026628,668.66128,16598663376,680391408,16598661853,-1523,,
15194077180,668.71183,16598713931,680441958,16598712403,-1528,,
15194128213,668.76286,16598764967,680492989,16598763445,-1522,,
15194178776,668.81342,16598815531,680543548,16598813993,-1538,,
15194229771,668.86442,16598866529,680594541,16598864986,-1543,,
15194280340,668.91499,16598917112,680645119,16598915564,-1548,,
15194330925,668.96557,16598967688,680695690,16598966135,-1553,,
15194381483,669.01613,16599018247,680746244,16599016689,-1558,,
15194432150,669.06680,16599068918,680796908,16599067354,-1564,,
15194483152,669.11780,16599119922,680847908,16599118354,-1568,,
15194533747,669.16840,16599170519,680898500,16599168946,-1573,,
15194584247,669.21889,16599221022,680948997,16599219442,-1580,,
15194634375,669.26902,16599271151,680999123,16599269568,-1583,,
15194684960,669.31961,16599321739,681049705,16599320150,-1589,,
15194735573,669.37022,16599372354,681100315,16599370760,-1594,,
15194785774,669.42042,16599422558,681150513,16599420959,-1599,,
15194836450,669.47110,16599473247,681201197,16599471642,-1605,,
15194886726,669.52137,16599523515,681251461,16599521918,-1597,,
15194937769,669.57242,16599574559,681302500,16599572946,-1613,,
15194988283,669.62293,16599625077,681353012,16599623458,-1619,,
15195038380,669.67303,16599675176,681403106,16599673552,-1624,,
15195089007,669.72366,16599725805,681453730,16599724176,-1629,,
15195140040,669.77469,16599776841,681504761,16599775206,-1635,,
15195191099,669.82575,16599827901,681555817,16599826262,-1639,,
15195241405,669.87605,16599878209,681606120,16599876565,-1644,,
15195291971,669.92662,16599928779,681656684,16599927129,-1650,,
15195342447,669.97709,16599979257,681707157,16599977603,-1654,,
15195393035,670.02768,16600029847,681757742,16600028188,-1659,,
15195444060,670.07871,16600080874,681808764,16600079209,-1665,,
15195495103,670.12975,16600131920,681859805,16600130251,-1669,,
15195545653,670.18030,16600182473,681910352,16600180798,-1675,,
15195596220,670.23087,16600233052,681960927,16600231372,-1680,,
15195647287,670.28193,16600284110,682011980,16600282425,-1685,,
15195698336,670.33298,16600335163,682063027,16600333472,-1691,,
15195749384,670.38403,16600386212,682114072,16600384517,-1695,,
15195800434,670.43508,16600437264,682165119,16600435564,-1700,,
15195850953,670.48560,16600487786,682215636,16600486081,-1705,,
15195901509,670.53616,16600538345,682266190,16600536635,-1710,,
15195951865,670.58651,16600588703,682316543,16600586998,-1705,,
15196002937,670.63758,16600639777,682367611,16600638056,-1721,,
15196053462,670.68811,16600690305,682418145,16600688590,-1715,,
15196104515,670.73916,16600741360,682469184,16600739630,-1730,,
15196155560,670.79021,16600792417,682520236,16600790681,-1736,,
15196206207,670.84086,16600843057,682570872,16600841317,-1740,,
15196256786,670.89143,16600893639,682621448,16600891893,-1746,,
15196307348,670.94200,16600944203,682672006,16600942452,-1751,,
15196357927,670.99257,16600994784,682722582,16600993028,-1756,,
15196408112,671.04276,16601044972,682772765,16601043210,-1762,,
15196458603,671.09325,16601095465,682823254,16601093699,-1766,,
15196509181,671.14383,16601146045,682873828,16601144274,-1771,,
15196559723,671.19437,16601196590,682924369,16601194814,-1776,,
15196610759,671.24541,16601247638,682975412,16601245858,-1780,,
15196661857,671.29651,16601298728,683026496,16601296942,-1786,,
15196712371,671.34702,16601349245,683077008,16601347453,-1792,,
15196763406,671.39805,16601400282,683128040,16601398486,-1796,,
15196813968,671.44862,16601450846,683178599,16601449044,-1802,,
15196865002,671.49965,16601501883,683229630,16601500076,-1807,,
15196915599,671.55025,16601552482,683280226,16601550671,-1811,,
15196966621,671.60127,16601603507,683331244,16601601690,-1817,,
15197017698,671.65235,16601654586,683382318,16601652764,-1822,,
15197068725,671.70337,16601705614,683433342,16601703787,-1827,,
15197119750,671.75440,16601756643,683484366,16601754811,-1832,,
15197170302,671.80495,16601807197,683534914,16601805360,-1837,,
15197220866,671.85551,16601857763,683585476,16601855922,-1841,,
15197271879,671.90653,16601908778,683636485,16601906931,-1847,,
15197321973,671.95662,16601958875,683686578,16601957023,-1852,,
15197373027,672.00767,16602009932,683737628,16602008074,-1858,,
15197424062,672.05871,16602060968,683788660,16602059105,-1863,,
15197474625,672.10927,16602111534,683839221,16602109667,-1867,,
15197525164,672.15981,16602162076,683889758,16602160203,-1873,,
15197576111,672.21076,16602213025,683940702,16602211147,-1878,,
15197626349,672.26100,16602263265,683990938,16602261383,-1882,,
15197677347,672.31200,16602314266,684041932,16602312378,-1888,,
15197728402,672.36305,16602365323,684092985,16602363430,-1893,,
15197779231,672.41388,16602416153,684143810,16602414256,-1897,,
15197829570,672.46422,16602466496,684194147,16602464592,-1904,,
15197880088,672.51474,16602517028,684244675,16602515120,-1908,,
15197931124,672.56577,16602568054,684295695,16602566141,-1913,,
15197981692,672.61634,16602618624,684346261,16602616706,-1918,,
15198032734,672.66738,16602669669,684397301,16602667746,-1923,,
15198083789,672.71844,16602720726,684448352,16602718797,-1929,,
15198134331,672.76898,16602771271,684498892,16602769337,-1934,,
15198185381,672.82003,16602822323,684549939,16602820385,-1938,,
15198236463,672.87111,16602873408,684601018,16602871464,-1944,,
15198287472,672.92212,16602924419,684652024,16602922470,-1949,,
15198338300,672.97295,16602975248,684702849,16602973294,-1954,,
15198389366,673.02401,16603026318,684753914,16603024359,-1959,,
15198440443,673.07509,16603077397,684804988,16603075433,-1964,,
15198490983,673.12563,16603127939,684855525,16603125970,-1969,,
15198541567,673.17621,16603178526,684906106,16603176552,-1974,,
15198592073,673.22672,16603229033,684956609,16603227054,-1979,,
15198642215,673.27686,16603279179,685006748,16603277194,-1985,,
15198692689,673.32734,16603329655,685057219,16603327665,-1990,,
15198743737,673.37838,16603380715,685108275,16603378721,-1994,,
15198794347,673.42899,16603431318,685158872,16603429318,-2000,,
15198844495,673.47914,16603481468,685209017,16603479463,-2005,,
15198895529,673.53018,16603532504,685260049,16603530495,-2009,,
15198946079,673.58073,16603583056,685310596,16603581041,-2015,,
15198996663,673.63131,16603633643,685361178,16603631624,-2019,,
15199047620,673.68227,16603684602,685412131,16603682588,-2014,,
15199098677,673.73333,16603735662,685463186,16603733632,-2030,,
15199149704,673.78435,16603786691,685514210,16603784656,-2035,,
15199200269,673.83492,16603837258,685564772,16603835218,-2040,,
15199250821,673.88547,16603887813,685615333,16603885778,-2035,,
15199301860,673.93651,16603938853,685666358,16603936803,-2050,,
15199352908,673.98756,16603989905,685717403,16603987849,-2056,,
15199404002,674.03865,16604041001,685768495,16604038940,-2061,,
15199454507,674.08916,16604091507,685818997,16604089442,-2065,,
15199504969,674.13962,16604141972,685869456,16604139902,-2070,,
15199555989,674.19064,16604192995,685920474,16604190919,-2076,,
15199606542,674.24119,16604243550,685971024,16604241470,-2080,,
15199656815,674.29146,16604293836,686021304,16604291750,-2086,,
15199707279,674.34193,16604344292,686071756,16604342201,-2091,,
15199758268,674.39292,16604395292,686122751,16604393197,-2095,,
15199813248,674.44790,16604450265,686177719,16604448164,-2101,,
15199863934,674.49858,16604500953,686228402,16604498847,-2106,,
15199914466,674.54911,16604551488,686278931,16604549376,-2112,,
15199965027,674.59968,16604602052,686329490,16604599935,-2117,,
15200016062,674.65071,16604653089,686380522,16604650968,-2121,,
15200067124,674.70177,16604704164,686431592,16604702038,-2126,,
15200118158,674.75281,16604755190,686482613,16604753058,-2132,,
15200168290,674.80294,16604805324,686532743,16604803188,-2136,,
15200219337,674.85398,16604856374,686583787,16604854232,-2142,,
15200270393,674.90504,16604907432,686634839,16604905285,-2147,,
15200320965,674.95561,16604958007,686685408,16604955854,-2153,,
15200371742,675.00639,16605008786,686736184,16605006629,-2157,,
15200422615,675.05726,16605059660,686787053,16605057498,-2162,,
15200473677,675.10833,16605110725,686838112,16605108557,-2168,,
15200524791,675.15944,16605161842,686889224,16605159669,-2173,,
15200575265,675.20991,16605212318,686939695,16605210145,-2173,,
15200625338,675.25999,16605262393,686989765,16605260210,-2183,,
15200675804,675.31045,16605312862,687040229,16605310674,-2188,,
15200726472,675.36112,16605363531,687090894,16605361339,-2192,,
15200777519,675.41217,16605414581,687141938,16605412383,-2198,,
15200827893,675.46254,16605464958,687192310,16605462755,-2203,,
15200878488,675.51314,16605515555,687242902,16605513347,-2208,,
15200929522,675.56417,16605566592,687293933,16605564379,-2213,,
15200980566,675.61521,16605617637,687344974,16605615420,-2217,,
15201032351,675.66700,16605669426,687396756,16605667202,-2224,,
15201083384,675.71803,16605720461,687447787,16605718232,-2229,,
15201133779,675.76843,16605770857,687498179,16605768624,-2233,,
15201184569,675.81922,16605821651,687548967,16605819412,-2239,,
15201238709,675.87336,16605875792,687603103,16605873548,-2244,,
15201288764,675.92341,16605925851,687653156,16605923602,-2249,,
15201339311,675.97396,16605976400,687703701,16605974146,-2254,,
15201389612,676.02426,16606026704,687753999,16606024445,-2259,,
15201440278,676.07493,16606077372,687804662,16606075107,-2265,,
15201496536,676.13118,16606133632,687860917,16606131362,-2270,,
15201546724,676.18137,16606183823,687911103,16606181548,-2275,,
15201596769,676.23142,16606233870,687961144,16606231589,-2281,,
15201646830,676.28148,16606283933,688011203,16606281648,-2285,,
15201697385,676.33203,16606334490,688061755,16606332201,-2289,,
15201747931,676.38258,16606385039,688112298,16606382744,-2295,,
15201798474,676.43312,16606435584,688162839,16606433284,-2300,,
15201848526,676.48317,16606485639,688212889,16606483334,-2305,,
15201898575,676.53322,16606535689,688262934,16606533380,-2309,,
15201948895,676.58354,16606586011,688313251,16606583696,-2315,,
15201999485,676.63413,16606636605,688363840,16606634285,-2320,,
15202050076,676.68472,16606687198,688414427,16606684873,-2325,,
15202100622,676.73527,16606737746,688464971,16606735416,-2330,,
15202151685,676.78633,16606788811,688516030,16606786475,-2336,,
15202202318,676.83697,16606839447,688566661,16606837107,-2340,,
15202253359,676.88801,16606890489,688617699,16606888144,-2345,,
15202303910,676.93856,16606941044,688668247,16606938693,-2351,,
15202354024,676.98867,16606991161,688718360,16606988806,-2355,,
15202404547,677.03919,16607041695,688768890,16607039336,-2359,,
15202455085,677.08973,16607092226,688819414,16607089860,-2366,,
15202506141,677.14079,16607143284,688870467,16607140913,-2371,,
15202556768,677.19142,16607193914,688921093,16607191538,-2376,,
15202607415,677.24206,16607244563,688971736,16607242181,-2382,,
15202658019,677.29267,16607295169,689022338,16607292783,-2386,,
15202708838,677.34349,16607345990,689073154,16607343599,-2391,,
15202759919,677.39457,16607397073,689124232,16607394677,-2396,,
15202810477,677.44512,16607447633,689174787,16607445232,-2401,,
15202861092,677.49574,16607498252,689225399,16607495845,-2407,,
15202911957,677.54660,16607549119,689276262,16607546708,-2411,,
15202962573,677.59722,16607599737,689326876,16607597321,-2416,,
15203013210,677.64786,16607650377,689377510,16607647955,-2422,,
15203063347,677.69799,16607700515,689427644,16607698090,-2425,,
15203114438,677.74909,16607751609,689478732,16607749178,-2431,,
15203165054,677.79970,16607802228,689529345,16607799791,-2437,,
15203216123,677.85077,16607853298,689580411,16607850856,-2442,,
15203267167,677.90182,16607904346,689631455,16607901900,-2446,,
15203318207,677.95285,16607955388,689682491,16607952936,-2452,,
15203368789,678.00344,16608005972,689733069,16608003514,-2458,,
15203419365,678.05401,16608056550,689783643,16608054088,-2462,,
15203470194,678.10484,16608107381,689834469,16608104915,-2466,,
15203520805,678.15545,16608157994,689885077,16608155522,-2472,,
15203571825,678.20647,16608209017,689936094,16608206540,-2477,,
15203622406,678.25705,16608259601,689986674,16608257120,-2481,,
15203673432,678.30808,16608310629,690037697,16608308142,-2487,,
15203724248,678.35890,16608361447,690088509,16608358954,-2493,,
15203774835,678.40948,16608412037,690139095,16608409540,-2497,,
15203825867,678.46051,16608463072,690190124,16608460569,-2503,,
15203876418,678.51107,16608513625,690240671,16608511117,-2508,,
15203926954,678.56160,16608564163,690291204,16608561650,-2513,,
15203977295,678.61194,16608614507,690341544,16608611989,-2518,,
15204027809,678.66246,16608665023,690392054,16608662499,-2524,,
15204078415,678.71306,16608715630,690442657,16608713102,-2528,,
15204128994,678.76364,16608766213,690493235,16608763680,-2533,,
15204180070,678.81472,16608817290,690544307,16608814752,-2538,,
15204230591,678.86524,16608867814,690594826,16608865271,-2543,,
15204281629,678.91628,16608918855,690645860,16608916306,-2549,,
15204332354,678.96700,16608969581,690696583,16608967029,-2552,,
15204383404,679.01805,16609020634,690747630,16609018076,-2558,,
15204434459,679.06911,16609071692,690798682,16609069128,-2564,,
15204484609,679.11926,16609121844,690848831,16609119276,-2568,,
15204535634,679.17028,16609172872,690899852,16609170297,-2575,,
15204586711,679.22136,16609223952,690950928,16609221374,-2578,,
15204637749,679.27240,16609274990,691001961,16609272407,-2583,,
15204688780,679.32343,16609326024,691052990,16609323435,-2589,,
15204738899,679.37355,16609376146,691103106,16609373552,-2594,,
15204789943,679.42459,16609427192,691154147,16609424593,-2599,,
15204840970,679.47562,16609478221,691205172,16609475617,-2604,,
15204891550,679.52620,16609528804,691255750,16609526196,-2608,,
15204942104,679.57675,16609579360,691306300,16609576746,-2614,,
15204992664,679.62731,16609629922,691356857,16609627302,-2620,,
15205043698,679.67835,16609680959,691407889,16609678335,-2624,,
15205094286,679.72893,16609731550,691458474,16609728920,-2630,,
15205144823,679.77947,16609782089,691509009,16609779454,-2635,,
15205195850,679.83050,16609833122,691560038,16609830484,-2638,,
15205246920,679.88157,16609884191,691611101,16609881546,-2645,,
15205297456,679.93210,16609934729,691661633,16609932079,-2650,,
15205348037,679.98268,16609985312,691712212,16609982657,-2655,,
15205398577,680.03323,16610035855,691762749,16610033195,-2660,,
15205449612,680.08426,16610086891,691813780,16610084226,-2665,,
15205500171,680.13482,16610137453,691864338,16610134783,-2670,,
15205551207,680.18585,16610188491,691915371,16610185817,-2674,,
15205602253,680.23690,16610239540,691966415,16610236860,-2680,,
15205652793,680.28744,16610290083,692016951,16610287397,-2686,,
15205703384,680.33803,16610340675,692067539,16610337984,-2691,,
15205754336,680.38898,16610391630,692118489,16610388935,-2695,,
15205805395,680.44004,16610442692,692169545,16610439991,-2701,,
15205855907,680.49055,16610493206,692220054,16610490500,-2706,,
15205906034,680.54068,16610543335,692270180,16610540625,-2710,,
15205957079,680.59173,16610594383,692321221,16610591667,-2716,,
15206008107,680.64275,16610645413,692372246,16610642692,-2721,,
15206058664,680.69331,16610695972,692422801,16610693246,-2726,,
15206109242,680.74389,16610746553,692473377,16610743822,-2731,,
15206160285,680.79493,16610797597,692524416,16610794861,-2736,,
15206211319,680.84597,16610848633,692575447,16610845892,-2741,,
15206261869,680.89652,16610899186,692625995,16610896441,-2745,,
15206312710,680.94736,16610950030,692676833,16610947279,-2751,,
15206363643,680.99829,16611000965,692727763,16610998209,-2756,,
15206414268,681.04892,16611051593,692778385,16611048830,-2763,,
15206464837,681.09948,16611102164,692828953,16611099398,-2766,,
15206515884,681.15053,16611153224,692880006,16611150452,-2772,,
15206566536,681.20118,16611203868,692930646,16611201091,-2777,,
15206617086,681.25173,16611254420,692981193,16611251639,-2781,,
15206667467,681.30211,16611304804,693031571,16611302017,-2787,,
15206717677,681.35232,16611355016,693081778,16611352224,-2792,,
15206768245,681.40289,16611405586,693132344,16611402789,-2797,,
15206818822,681.45347,16611456166,693182918,16611453364,-2802,,
15206869206,681.50385,16611506552,693233299,16611503745,-2807,,
15206920193,681.55484,16611557540,693284283,16611554728,-2812,,
15206970305,681.60495,16611607656,693334394,16611604839,-2817,,
15207021353,681.65600,16611658705,693385438,16611655883,-2822,,
15207071415,681.70606,16611708769,693435497,16611705942,-2827,,
15207122471,681.75712,16611759829,693486551,16611756996,-2833,,
15207173519,681.80817,16611810878,693537596,16611808041,-2837,,
15207224053,681.85870,16611861416,693588127,16611858572,-2844,,
15207274640,681.90929,16611912005,693638712,16611909158,-2847,,
15207325700,681.96035,16611963067,693689770,16611960215,-2852,,
15207376722,682.01137,16612014092,693740789,16612011234,-2858,,
15207427798,682.06245,16612065170,693791861,16612062307,-2863,,
15207478820,682.11347,16612116194,693842881,16612113327,-2867,,
15207529369,682.16402,16612166745,693893427,16612163873,-2872,,
15207579915,682.21456,16612217294,693943971,16612214416,-2878,,
15207630453,682.26510,16612267833,693994505,16612264950,-2883,,
15207681031,682.31568,16612318415,694045082,16612315527,-2888,,
15207731583,682.36623,16612368969,694095630,16612366076,-2893,,
15207782619,682.41727,16612420007,694146663,16612417109,-2898,,
15207833504,682.46815,16612470895,694197545,16612467991,-2904,,
15207884045,682.51869,16612521437,694248084,16612518529,-2908,,
15207935063,682.56971,16612572458,694299099,16612569544,-2914,,
15207986127,682.62077,16612623525,694350160,16612620606,-2919,,
15208036666,682.67131,16612674066,694400698,16612671143,-2923,,
15208088205,682.72285,16612725608,694452234,16612722679,-2929,,
15208139257,682.77391,16612776663,694503284,16612773729,-2934,,
15208190662,682.82531,16612828069,694554684,16612825129,-2940,,
15208243466,682.87811,16612880875,694607486,16612877931,-2944,,
15208297811,682.93246,16612935223,694661828,16612932273,-2950,,
15208348455,682.98310,16612985870,694712469,16612982915,-2955,,
15208398518,683.03317,16613035934,694762529,16613032974,-2960,,
15208449049,683.08370,16613086469,694813064,16613083510,-2959,,
15208499094,683.13374,16613136516,694863100,16613133546,-2970,,
15208549657,683.18430,16613187080,694913660,16613184105,-2975,,
15208599708,683.23436,16613237136,694963709,16613234155,-2981,,
15208654003,683.28865,16613291433,695018003,16613288448,-2985,,
15208705296,683.33994,16613342727,695069292,16613339738,-2989,,
15208755342,683.38999,16613392775,695119334,16613389780,-2995,,
15208805403,683.44005,16613442839,695169393,16613439838,-3001,,
15208856210,683.49086,16613493649,695220198,16613490644,-3005,,
15208906305,683.54095,16613543745,695270289,16613540734,-3011,,
15208956834,683.59148,16613594277,695320815,16613591261,-3016,,
15209007387,683.64203,16613644832,695371367,16613641812,-3020,,
15209058000,683.69265,16613695448,695421976,16613692422,-3026,,
15209108497,683.74315,16613745947,695472470,16613742915,-3032,,
15209159205,683.79385,16613796657,695523176,16613793621,-3036,,
15209209622,683.84427,16613847077,695573591,16613844036,-3041,,
15209260133,683.89478,16613897589,695624098,16613894543,-3046,,
15209310351,683.94500,16613947810,695674313,16613944759,-3051,,
15209361400,683.99605,16613998861,695725360,16613995805,-3056,,
15209411982,684.04663,16614049445,695775939,16614046384,-3061,,
15209462561,684.09721,16614100028,695826516,16614096961,-3067,,
15209513120,684.14777,16614150589,695877072,16614147518,-3071,,
15209563603,684.19825,16614201073,695927552,16614197997,-3076,,
15209613693,684.24834,16614251167,695977639,16614248085,-3082,,
15209664734,684.29938,16614302209,696028677,16614299122,-3087,,
15209714930,684.34958,16614352407,696078871,16614349316,-3091,,
15209765481,684.40013,16614402961,696129419,16614399864,-3097,,
15209816508,684.45116,16614453991,696180443,16614450888,-3103,,
15209866681,684.50133,16614504166,696230615,16614501060,-3106,,
15209916970,684.55162,16614554458,696280900,16614551346,-3112,,
15209967969,684.60262,16614605459,696331896,16614602342,-3117,,
15210018575,684.65322,16614656067,696382500,16614652945,-3122,,
15210069593,684.70424,16614707089,696433517,16614703962,-3127,,
15210120638,684.75529,16614758134,696484557,16614755003,-3131,,
15210171703,684.80635,16614809203,696535620,16614806065,-3138,,
15210222268,684.85692,16614859769,696586182,16614856627,-3142,,
15210273302,684.90795,16614910806,696637214,16614907659,-3147,,
15210323841,684.95849,16614961347,696687749,16614958194,-3153,,
15210374908,685.00956,16615012416,696738813,16615009269,-3147,,
15210425525,685.06017,16615063036,696789428,16615059874,-3162,,
15210476302,685.11095,16615113816,696840202,16615110648,-3168,,
15210527168,685.16182,16615164684,696891066,16615161511,-3173,,
15210578217,685.21286,16615215736,696942113,16615212559,-3177,,
15210629259,685.26391,16615266780,696993151,16615263596,-3184,,
15210680294,685.31494,16615317816,697044183,16615314628,-3188,,
15210731385,685.36603,16615368911,697095271,16615365717,-3194,,
15210782181,685.41683,16615419709,697146066,16615416511,-3198,,
15210832810,685.46746,16615470340,697196691,16615467136,-3204,,
15210883420,685.51807,16615520952,697247297,16615517743,-3209,,
15210934437,685.56908,16615571972,697298313,16615568758,-3214,,
15210985518,685.62017,16615623054,697349390,16615619836,-3218,,
15211036067,685.67071,16615673606,697399937,16615670382,-3224,,
15211086708,685.72136,16615724250,697450575,16615721021,-3229,,
15211137303,685.77195,16615774848,697501169,16615771614,-3234,,
15211188352,685.82300,16615825898,697552214,16615822660,-3238,,
15211238899,685.87355,16615876447,697602758,16615873204,-3243,,
15211289956,685.92460,16615927507,697653813,16615924258,-3249,,
15211340997,685.97564,16615978551,697704852,16615975297,-3254,,
15211392043,686.02669,16616029599,697755894,16616026339,-3260,,
15211442572,686.07722,16616080130,697806430,16616076875,-3255,,
15211493594,686.12824,16616131155,697857441,16616127886,-3269,,
15211544193,686.17884,16616181756,697908037,16616178482,-3274,,
15211595241,686.22989,16616232807,697959081,16616229527,-3280,,
15211646248,686.28090,16616283816,698010085,16616280530,-3286,,
15211696803,686.33145,16616334374,698060638,16616331084,-3290,,
15211747419,686.38207,16616384992,698111251,16616381697,-3295,,
15211797980,686.43263,16616435555,698161810,16616432255,-3300,,
15211848191,686.48284,16616485769,698212018,16616482464,-3305,,
15211898770,686.53342,16616536361,698262606,16616533051,-3310,,
15211949368,686.58402,16616586951,698313191,16616583636,-3315,,
15212000336,686.63498,16616637921,698364155,16616634601,-3320,,
15212050935,686.68558,16616688522,698414751,16616685197,-3325,,
15212101061,686.73571,16616738650,698464874,16616735320,-3330,,
15212152131,686.78678,16616789723,698515941,16616786387,-3336,,
15212202897,686.83754,16616840490,698566705,16616837151,-3339,,
15212253457,686.88810,16616891053,698617262,16616887708,-3345,,
15212304090,686.93874,16616941688,698667892,16616938338,-3350,,
15212354640,686.98929,16616992241,698718440,16616988885,-3356,,
15212405239,687.03989,16617042842,698769036,16617039481,-3361,,
15212456246,687.09089,16617093851,698820040,16617090485,-3366,,
15212507300,687.14195,16617144918,698871102,16617141547,-3371,,
15212558364,687.19301,16617195975,698922153,16617192599,-3376,,
15212608936,687.24358,16617246549,698972723,16617243168,-3381,,
15212659025,687.29367,16617296639,699022808,16617293253,-3386,,
15212709583,687.34423,16617347200,699073364,16617343810,-3390,,
15212760631,687.39528,16617398251,699124409,16617394855,-3396,,
15212811205,687.44585,16617448827,699174980,16617445426,-3401,,
15212862236,687.49688,16617499861,699226009,16617496454,-3407,,
15212912809,687.54746,16617550436,699276579,16617547025,-3411,,
15212963611,687.59826,16617601240,699327378,16617597823,-3417,,
15213014654,687.64930,16617652286,699378419,16617648864,-3422,,
15213064759,687.69941,16617702393,699428521,16617698966,-3427,,
15213115614,687.75026,16617753250,699479373,16617749818,-3432,,
15213166228,687.80088,16617803867,699529984,16617800430,-3437,,
15213216729,687.85138,16617854369,699580482,16617850927,-3442,,
15213267291,687.90194,16617904934,699631042,16617901488,-3446,,
15213317891,687.95254,16617955536,699681639,16617952084,-3452,,
15213368169,688.00282,16618005817,699731914,16618002360,-3457,,
15213418728,688.05338,16618056379,699782472,16618052917,-3462,,
15213469283,688.10393,16618106936,699833023,16618103469,-3467,,
15213519825,688.15447,16618157480,699883562,16618154007,-3473,,
15213569914,688.20456,16618207572,699933649,16618204095,-3477,,
15213620029,688.25468,16618257688,699983761,16618254206,-3482,,
15213670781,688.30543,16618308443,700034511,16618304956,-3487,,
15213721331,688.35598,16618358996,700085058,16618355503,-3493,,
15213771966,688.40661,16618409632,700135690,16618406135,-3497,,
15213822528,688.45718,16618460196,700186248,16618456694,-3502,,
15213873079,688.50773,16618510750,700236797,16618507242,-3508,,
15213923625,688.55827,16618561298,700287341,16618557787,-3511,,
15213974651,688.60930,16618612327,700338364,16618608810,-3517,,
15214025225,688.65987,16618662904,700388936,16618659381,-3523,,
15214076261,688.71091,16618713942,700439969,16618710414,-3528,,
15214126355,688.76100,16618764039,700490061,16618760506,-3533,,
15214177388,688.81204,16618815074,700541091,16618811536,-3538,,
15214227533,688.86218,16618865220,700591232,16618861677,-3543,,
15214278067,688.91272,16618915758,700641764,16618912210,-3548,,
15214329120,688.96377,16618966813,700692814,16618963260,-3553,,
15214379928,689.01458,16619017623,700743619,16619014065,-3558,,
15214430494,689.06514,16619068192,700794183,16619064629,-3563,,
15214481035,689.11568,16619118735,700844721,16619115167,-3568,,
15214532078,689.16673,16619169779,700895761,16619166206,-3573,,
15214582656,689.21730,16619220361,700946336,16619216782,-3579,,
15214633302,689.26795,16619271009,700996980,16619267426,-3583,,
15214683820,689.31847,16619321529,701047495,16619317941,-3588,,
15214734453,689.36910,16619372165,701098125,16619368570,-3595,,
15214785316,689.41996,16619423029,701148986,16619419431,-3598,,
15214835855,689.47050,16619473571,701199522,16619469967,-3604,,
15214886426,689.52107,16619524144,701250090,16619520535,-3609,,
15214937045,689.57169,16619574766,701300707,16619571152,-3614,,
15214987602,689.62225,16619625326,701351261,16619621707,-3619,,
15215037660,689.67231,16619675385,701401316,16619671761,-3624,,
15215088698,689.72335,16619726426,701452351,16619722797,-3629,,
15215139754,689.77440,16619777485,701503405,16619773851,-3634,,
15215190303,689.82495,16619828036,701553951,16619824397,-3639,,
15215240852,689.87550,16619878586,701604497,16619874942,-3644,,
15215291404,689.92605,16619929142,701655046,16619925492,-3650,,
15215341940,689.97659,16619979680,701705580,16619976026,-3654,,
15215392107,690.02675,16620029849,701755744,16620026190,-3659,,
15215442844,690.07749,16620080589,701806478,16620076924,-3665,,
15215493151,690.12780,16620130898,701856783,16620127229,-3669,,
15215543776,690.17842,16620181524,701907405,16620177850,-3674,,
15215594326,690.22897,16620232077,701957952,16620228397,-3680,,
15215645342,690.27999,16620283096,702008966,16620279412,-3684,,
15215696375,690.33102,16620334131,702059996,16620330441,-3690,,
15215746438,690.38109,16620384197,702110056,16620380502,-3695,,
15215797005,690.43165,16620434766,702160631,16620431076,-3690,,
15215847579,690.48223,16620485343,702211192,16620481638,-3705,,
15215898131,690.53278,16620535897,702261741,16620532187,-3710,,
15215949183,690.58383,16620586951,702312791,16620583236,-3715,,
15215999719,690.63437,16620637490,702363325,16620633770,-3720,,
15216050262,690.68491,16620688035,702413865,16620684310,-3725,,
15216100349,690.73500,16620738124,702463949,16620734394,-3730,,
15216151146,690.78579,16620788924,702514742,16620785188,-3736,,
15216201782,690.83643,16620839561,702565376,16620835821,-3740,,
15216252332,690.88698,16620890114,702615923,16620886369,-3745,,
15216303372,690.93802,16620941157,702666960,16620937406,-3751,,
15216354406,690.98905,16620992193,702717992,16620988438,-3755,,
15216404978,691.03963,16621042767,702768562,16621039007,-3760,,
15216455860,691.09051,16621093652,702819440,16621089886,-3766,,
15216506677,691.14133,16621144471,702870254,16621140700,-3771,,
15216557271,691.19192,16621195068,702920846,16621191291,-3777,,
15216607773,691.24242,16621245572,702971345,16621241791,-3781,,
15216658808,691.29346,16621296608,703022377,16621292823,-3785,,
15216709401,691.34405,16621347205,703072968,16621343414,-3791,,
15216759994,691.39464,16621397800,703123559,16621394004,-3796,,
15216810159,691.44481,16621447967,703173720,16621444166,-3801,,
15216861079,691.49573,16621498889,703224637,16621495082,-3807,,
15216911617,691.54626,16621549429,703275173,16621545618,-3811,,
15216961801,691.59645,16621599616,703325354,16621595800,-3816,,
15217012429,691.64708,16621650247,703375979,16621646425,-3822,,
15217062987,691.69763,16621700807,703426535,16621696981,-3826,,
15217113549,691.74820,16621751370,703477094,16621747540,-3830,,
15217164185,691.79883,16621802009,703527727,16621798172,-3837,,
15217214914,691.84956,16621852741,703578455,16621848900,-3841,,
15217266926,691.90157,16621904755,703630463,16621900908,-3847,,
15217317025,691.95167,16621954857,703680559,16621951004,-3853,,
15217368078,692.00273,16622005912,703731609,16622002055,-3857,,
15217418613,692.05326,16622056449,703782142,16622052587,-3862,,
15217469157,692.10380,16622106995,703832683,16622103128,-3867,,
15217519896,692.15454,16622157737,703883419,16622153865,-3872,,
15217570442,692.20509,16622208286,703933964,16622204409,-3877,,
15217621015,692.25566,16622258860,703984532,16622254978,-3882,,
15217672057,692.30670,16622309905,704035572,16622306018,-3887,,
15217722597,692.35725,16622360447,704086109,16622356554,-3893,,
15217773133,692.40778,16622410986,704136643,16622407088,-3898,,
15217823696,692.45834,16622461550,704187203,16622457648,-3902,,
15217873833,692.50848,16622511690,704237337,16622507782,-3908,,
15217924890,692.55954,16622562749,704288392,16622558837,-3912,,
15217975382,692.61003,16622613245,704338881,16622609327,-3918,,
15218025941,692.66059,16622663806,704389438,16622659883,-3923,,
15218076017,692.71066,16622713884,704439511,16622709957,-3927,,
15218127043,692.76169,16622764912,704490534,16622760979,-3933,,
15218177201,692.81185,16622815073,704540690,16622811135,-3938,,
15218228270,692.86292,16622866144,704591755,16622862201,-3943,,
15218279328,692.91398,16622917204,704642811,16622913256,-3948,,
15218330334,692.96498,16622968212,704693814,16622964259,-3953,,
15218382381,693.01703,16623020262,704745858,16623016304,-3958,,
15218433421,693.06807,16623071305,704796895,16623067341,-3964,,
15218484230,693.11888,16623122116,704847702,16623118148,-3968,,
15218536803,693.17145,16623174692,704900273,16623170718,-3974,,
15218591659,693.22631,16623229550,704955125,16623225571,-3979,,
15218642662,693.27731,16623280555,705006124,16623276570,-3985,,
15218693670,693.32832,16623331565,705057130,16623327575,-3990,,
15218743726,693.37837,16623381623,705107184,16623377629,-3994,,
15218794270,693.42892,16623432171,705157725,16623428171,-4000,,
15218844320,693.47897,16623482223,705207772,16623478218,-4005,,
15218895370,693.53002,16623533275,705258820,16623529266,-4009,,
15218953959,693.58861,16623591866,705317404,16623587850,-4016,,
15219005019,693.63967,16623642928,705368463,16623638908,-4020,,
15219056052,693.69070,16623693965,705419493,16623689939,-4026,,
15219106570,693.74122,16623744485,705470008,16623740453,-4032,,
15219157608,693.79226,16623795525,705521044,16623791490,-4035,,
15219208177,693.84282,16623846097,705571611,16623842056,-4041,,
15219258714,693.89336,16623896636,705622145,16623892590,-4046,,
15219308763,693.94341,16623946687,705672191,16623942637,-4050,,
15219359331,693.99398,16623997257,705722756,16623993201,-4056,,
15219410371,694.04502,16624048300,705773794,16624044239,-4061,,
15219460918,694.09557,16624098850,705824337,16624094783,-4067,,
15219511482,694.14613,16624149416,705874899,16624145345,-4071,,
15219562530,694.19718,16624200465,705925954,16624196400,-4065,,
15219613595,694.24824,16624251533,705977006,16624247451,-4082,,
15219664653,694.29930,16624302594,706028062,16624298507,-4087,,
15219715660,694.35031,16624353602,706079066,16624349511,-4091,,
15219765726,694.40037,16624403681,706129139,16624399585,-4096,,
15219816111,694.45076,16624454058,706179511,16624449956,-4102,,
15219866681,694.50133,16624504630,706230079,16624500524,-4106,,
15219917284,694.55193,16624555237,706280679,16624551125,-4112,,
15219968294,694.60294,16624606260,706331698,16624602143,-4117,,
15220019183,694.65383,16624657141,706382573,16624653019,-4122,,
15220069702,694.70435,16624707662,706433089,16624703535,-4127,,
15220120261,694.75491,16624758234,706483656,16624754102,-4132,,
15220170885,694.80553,16624808850,706534266,16624804712,-4138,,
15220221487,694.85613,16624859454,706584866,16624855312,-4142,,
15220272524,694.90717,16624910493,706635900,16624906346,-4147,,
15220322831,694.95748,16624960803,706686204,16624956650,-4153,,
15220373882,695.00853,16625011856,706737254,16625007699,-4157,,
15220424895,695.05954,16625062870,706788263,16625058708,-4162,,
15220475490,695.11014,16625113469,706838856,16625109301,-4168,,
15220526095,695.16074,16625164075,706889457,16625159902,-4173,,
15220576642,695.21129,16625214625,706940003,16625210448,-4177,,
15220627159,695.26181,16625265144,706990516,16625260961,-4183,,
15220677991,695.31264,16625315979,707041345,16625311790,-4189,,
15220729053,695.36370,16625367043,707092405,16625362850,-4193,,
15220779141,695.41379,16625417134,707142490,16625412936,-4198,,
15220830198,695.46485,16625468193,707193544,16625463989,-4204,,
15220880765,695.51541,16625518763,707244108,16625514554,-4209,,
15220931312,695.56596,16625569312,707294653,16625565099,-4213,,
15220982354,695.61700,16625620355,707345692,16625616137,-4218,,
15221033397,695.66805,16625671402,707396732,16625667177,-4225,,
15221084483,695.71913,16625722490,707447816,16625718262,-4228,,
15221135533,695.77018,16625773542,707498864,16625769310,-4232,,
15221186526,695.82117,16625824537,707549853,16625820298,-4239,,
15221237123,695.87177,16625875138,707600448,16625870894,-4244,,
15221288171,695.92282,16625926188,707651494,16625921940,-4248,,
15221339228,695.97388,16625977247,707702547,16625972993,-4254,,
15221390786,696.02543,16626028806,707754101,16626024547,-4259,,
15221441320,696.07597,16626079344,707804634,16626075079,-4265,,
15221491798,696.12645,16626129834,707855120,16626125565,-4269,,
15221542879,696.17753,16626180907,707906187,16626176633,-4274,,
15221593422,696.22807,16626231453,707956728,16626227173,-4280,,
15221643960,696.27861,16626281992,708007262,16626277708,-4284,,
15221694507,696.32916,16626332542,708057807,16626328253,-4289,,
15221745071,696.37972,16626383108,708108368,16626378813,-4295,,
15221796026,696.43067,16626434066,708159320,16626429765,-4301,,
15221846584,696.48123,16626484627,708209876,16626480322,-4305,,
15221897631,696.53228,16626535676,708260920,16626531366,-4310,,
15221948175,696.58282,16626586222,708311461,16626581907,-4315,,
15221999229,696.63388,16626637279,708362514,16626632959,-4320,,
15222050278,696.68493,16626688330,708413560,16626684006,-4324,,
15222101328,696.73598,16626739382,708464607,16626735052,-4330,,
15222151887,696.78653,16626789943,708515162,16626785607,-4336,,
15222202904,696.83755,16626840963,708566178,16626836623,-4340,,
15222252952,696.88760,16626891013,708616222,16626886667,-4346,,
15222303488,696.93814,16626941551,708666755,16626937200,-4351,,
15222353607,696.98825,16626991673,708716872,16626987317,-4356,,
15222404621,697.03927,16627042700,708767895,16627038341,-4359,,
15222455645,697.09029,16627093716,708818904,16627089349,-4367,,
15222506215,697.14086,16627144288,708869472,16627139917,-4371,,
15222557260,697.19191,16627195335,708920514,16627190960,-4375,,
15222608301,697.24295,16627246379,708971552,16627241997,-4382,,
15222658860,697.29351,16627296939,709022108,16627292553,-4386,,
15222709929,697.34458,16627348012,709073176,16627343621,-4391,,
15222760983,697.39563,16627399068,709124226,16627394672,-4396,,
15222812011,697.44666,16627450098,709175251,16627445697,-4401,,
15222862585,697.49723,16627500686,709225834,16627496280,-4406,,
15222913636,697.54828,16627551728,709276872,16627547318,-4410,,
15222964186,697.59883,16627602279,709327418,16627597864,-4415,,
15223014759,697.64941,16627652856,709377989,16627648435,-4421,,
15223065302,697.69995,16627703401,709428529,16627698974,-4427,,
15223116347,697.75099,16627754449,709479571,16627750017,-4432,,
15223167376,697.80202,16627805480,709530597,16627801043,-4437,,
15223217936,697.85258,16627856042,709581155,16627851600,-4442,,
15223268985,697.90363,16627907094,709632201,16627902647,-4447,,
15223319870,697.95452,16627957980,709683083,16627953528,-4452,,
15223370925,698.00557,16628009047,709734145,16628004591,-4456,,
15223421961,698.05661,16628060077,709785169,16628055614,-4463,,
15223472410,698.10706,16628110528,709835616,16628106061,-4467,,
15223523425,698.15807,16628161544,709886627,16628157073,-4471,,
15223573514,698.20816,16628211637,709936713,16628207159,-4478,,
15223624081,698.25873,16628262206,709987279,16628257724,-4482,,
15223675081,698.30973,16628313209,710038275,16628308720,-4489,,
15223726115,698.36076,16628364245,710089307,16628359752,-4493,,
15223776725,698.41137,16628414856,710139913,16628410359,-4497,,
15223827726,698.46237,16628465861,710190913,16628461358,-4503,,
15223878303,698.51295,16628516440,710241486,16628511932,-4508,,
15223929353,698.56400,16628567492,710292533,16628562979,-4513,,
15223980204,698.61485,16628618345,710343382,16628613827,-4518,,
15224030959,698.66561,16628669103,710394134,16628664580,-4523,,
15224082008,698.71666,16628720154,710445181,16628715627,-4527,,
15224133030,698.76768,16628771179,710496199,16628766645,-4534,,
15224184100,698.81875,16628822251,710547268,16628817713,-4538,,
15224235149,698.86980,16628873303,710598313,16628868759,-4544,,
15224285342,698.91999,16628923498,710648504,16628918949,-4549,,
15224336409,698.97106,16628974567,710699569,16628970014,-4553,,
15224386957,699.02161,16629025117,710750113,16629020559,-4558,,
15224437014,699.07166,16629075177,710800167,16629070613,-4564,,
15224488089,699.12274,16629126253,710851239,16629121685,-4568,,
15224538669,699.17332,16629176837,710901817,16629172263,-4574,,
15224589056,699.22370,16629227226,710952202,16629222647,-4579,,
15224640092,699.27474,16629278263,711003234,16629273679,-4584,,
15224690670,699.32532,16629328845,711053810,16629324256,-4589,,
15224740732,699.37538,16629378909,711103870,16629374315,-4594,,
15224791782,699.42643,16629429960,711154916,16629425362,-4598,,
15224842460,699.47711,16629480642,711205591,16629476037,-4605,,
15224893157,699.52780,16629531341,711256286,16629526732,-4609,,
15224944198,699.57885,16629582385,711307325,16629577770,-4615,,
15224995111,699.62976,16629633299,711358234,16629628680,-4619,,
15225045399,699.68005,16629683590,711408520,16629678966,-4624,,
15225096488,699.73114,16629734681,711459606,16629730051,-4630,,
15225146567,699.78121,16629784763,711509683,16629780128,-4635,,
15225197362,699.83201,16629835560,711560475,16629830920,-4640,,
15225248446,699.88309,16629886647,711611557,16629882002,-4645,,
15225299098,699.93375,16629937301,711662206,16629932652,-4649,,
15225350047,699.98469,16629988252,711713152,16629983597,-4655,,
15225400612,700.03526,16630038820,711763714,16630034160,-4660,,
15225450765,700.08541,16630088975,711813864,16630084310,-4665,,
15225500833,700.13548,16630139045,711863929,16630134375,-4670,,
15225551397,700.18605,16630189612,711914492,16630184937,-4675,,
15225601919,700.23657,16630240135,711965010,16630235455,-4680,,
15225652065,700.28671,16630290284,712015153,16630285599,-4685,,
15225702599,700.33725,16630340821,712065684,16630336130,-4691,,
15225753639,700.38829,16630391863,712116723,16630387168,-4695,,
15225803865,700.43851,16630442092,712166945,16630437390,-4702,,
15225854107,700.48875,16630492336,712217185,16630487630,-4706,,
15225905123,700.53977,16630543354,712268199,16630538644,-4710,,
15225955690,700.59034,16630593924,712318762,16630589208,-4716,,
15226006279,700.64093,16630644515,712369349,16630639794,-4721,,
15226056915,700.69156,16630695153,712419981,16630690427,-4726,,
15226107945,700.74259,16630746185,712471009,16630741455,-4730,,
15226158969,700.79362,16630797211,712522029,16630792475,-4736,,
15226209517,700.84416,16630847761,712572575,16630843020,-4741,,
15226260600,700.89525,16630898848,712623656,16630894102,-4746,,
15226310800,700.94545,16630949050,712673853,16630944299,-4751,,
15226361792,700.99644,16631000044,712724842,16630995287,-4757,,
15226412026,701.04667,16631050281,712775073,16631045518,-4763,,
15226462976,701.09762,16631101233,712826022,16631096467,-4766,,
15226513515,701.14816,16631151775,712876558,16631147003,-4772,,
15226564109,701.19876,16631202371,712927148,16631197594,-4777,,
15226614886,701.24953,16631253149,712977923,16631248368,-4781,,
15226665416,701.30006,16631303683,713028451,16631298896,-4787,,
15226716480,701.35113,16631354749,713079511,16631349957,-4792,,
15226767477,701.40212,16631405748,713130505,16631400951,-4797,,
15226818017,701.45267,16631456290,713181043,16631451489,-4801,,
15226869082,701.50373,16631507358,713232106,16631502551,-4807,,
15226919672,701.55432,16631557950,713282696,16631553145,-4805,,
15226970669,701.60532,16631608950,713333687,16631604133,-4817,,
15227021261,701.65591,16631659544,713384276,16631654722,-4822,,
15227071900,701.70655,16631710185,713434913,16631705358,-4827,,
15227122921,701.75757,16631761208,713485930,16631756376,-4832,,
15227173513,701.80816,16631811803,713536520,16631806965,-4838,,
15227225850,701.86050,16631864143,713588854,16631859300,-4843,,
15227276720,701.91137,16631915014,713639721,16631910167,-4847,,
15227327763,701.96241,16631966059,713690762,16631961207,-4852,,
15227378975,702.01362,16632017275,713741971,16632012416,-4859,,
15227442535,702.07718,16632080837,713805527,16632075972,-4865,,
15227502778,702.13743,16632141084,713865767,16632136213,-4871,,
15227553095,702.18774,16632191402,713916081,16632186527,-4875,,
15227604021,702.23867,16632242331,713967005,16632237451,-4880,,
15227654402,702.28905,16632292714,714017383,16632287828,-4886,,
15227704606,702.33925,16632342920,714067584,16632338029,-4891,,
15227755191,702.38984,16632393508,714118167,16632388613,-4895,,
15227814084,702.44873,16632452403,714177056,16632447501,-4902,,
15227864996,702.49964,16632503317,714227966,16632498411,-4906,,
15227915192,702.54984,16632553516,714278159,16632548605,-4911,,
15227965493,702.60014,16632603819,714328457,16632598902,-4917,,
15228016016,702.65066,16632654344,714378978,16632649423,-4921,,
15228066324,702.70097,16632704655,714429283,16632699728,-4927,,
15228117128,702.75178,16632755461,714480084,16632750529,-4932,,
15228167612,702.80226,16632805948,714530566,16632801012,-4936,,
15228217906,702.85255,16632856244,714580857,16632851302,-4942,,
15228268431,702.90308,16632906771,714631379,16632901825,-4946,,
15228318899,702.95355,16632957241,714681843,16632952289,-4952,,
15228369333,703.00398,16633007678,714732276,16633002721,-4957,,
15228419526,703.05417,16633057873,714782466,16633052911,-4962,,
15228469868,703.10452,16633108219,714832805,16633103251,-4968,,
15228520602,703.15525,16633158954,714883537,16633153982,-4972,,
15228570962,703.20561,16633209316,714933894,16633204339,-4977,,
15228621426,703.25607,16633259783,714984355,16633254800,-4983,,
15228672145,703.30679,16633310504,715035072,16633305517,-4987,,
15228722449,703.35710,16633360811,715085373,16633355818,-4993,,
15228772872,703.40752,16633411236,715135793,16633406238,-4998,,
15228823192,703.45784,16633461559,715186110,16633456556,-5003,,
15228873644,703.50829,16633512013,715236561,16633507006,-5007,,
15228924157,703.55881,16633562529,715287071,16633557516,-5013,,
15228974947,703.60960,16633613320,715337857,16633608302,-5018,,
15229025662,703.66031,16633664038,715388570,16633659016,-5022,,
15229076572,703.71122,16633714950,715439477,16633709922,-5028,,
15229127110,703.76176,16633765491,715490012,16633760458,-5033,,
15229177570,703.81222,16633815952,715540470,16633810915,-5037,,
15229228012,703.86266,16633866399,715590911,16633861356,-5043,,
15229278758,703.91341,16633917146,715641652,16633912098,-5048,,
15229329796,703.96444,16633968187,715692688,16633963134,-5053,,
15229380409,704.01506,16634018801,715743298,16634013743,-5058,,
15229431017,704.06566,16634069412,715793903,16634064349,-5063,,
15229481800,704.11645,16634120197,715844683,16634115128,-5069,,
15229532780,704.16743,16634171179,715895661,16634166106,-5073,,
15229583344,704.21799,16634221745,715946222,16634216667,-5078,,
15229634395,704.26904,16634272799,715997270,16634267716,-5083,,
15229684951,704.31960,16634323358,716047823,16634318269,-5089,,
15229736002,704.37065,16634374411,716098872,16634369318,-5093,,
15229787021,704.42167,16634425433,716149888,16634420334,-5099,,
15229837092,704.47174,16634475505,716199956,16634470401,-5104,,
15229888131,704.52278,16634526547,716250994,16634521439,-5108,,
15229938674,704.57332,16634577093,716301533,16634571979,-5114,,
15229989223,704.62387,16634627644,716352080,16634622525,-5119,,
15230039806,704.67445,16634678230,716402659,16634673105,-5125,,
15230090376,704.72502,16634728801,716453227,16634723673,-5128,,
15230141226,704.77587,16634779654,716504075,16634774520,-5134,,
15230192252,704.82690,16634830682,716555097,16634825542,-5140,,
15230242825,704.87747,16634881257,716605668,16634876113,-5144,,
15230292933,704.92758,16634931368,716655773,16634926219,-5149,,
15230343496,704.97814,16634981933,716706332,16634976778,-5155,,
15230393660,705.02831,16635032100,716756494,16635026939,-5161,,
15230444195,705.07884,16635082647,716807038,16635077484,-5163,,
15230495283,705.12993,16635133728,716858112,16635128558,-5170,,
15230545996,705.18064,16635184442,716908822,16635179267,-5175,,
15230596677,705.23132,16635235125,716959501,16635229946,-5179,,
15230646919,705.28157,16635285371,717009740,16635280186,-5185,,
15230697973,705.33262,16635336427,717060792,16635331237,-5190,,
15230748990,705.38364,16635387445,717111805,16635382250,-5195,,
15230799567,705.43421,16635438026,717162381,16635432827,-5199,,
15230850603,705.48525,16635489063,717213413,16635483858,-5205,,
15230900981,705.53563,16635539445,717263788,16635534234,-5211,,
15230952033,705.58668,16635590499,717314838,16635585284,-5215,,
15231002408,705.63706,16635640875,717365210,16635635655,-5220,,
15231053057,705.68771,16635691528,717415856,16635686302,-5226,,
15231103596,705.73824,16635742069,717466393,16635736838,-5231,,
15231154148,705.78880,16635792622,717516942,16635787387,-5235,,
15231205155,705.83980,16635843633,717567947,16635838392,-5241,,
15231256175,705.89082,16635894655,717618964,16635889409,-5246,,
15231306598,705.94125,16635945079,717669384,16635939829,-5250,,
15231357667,705.99231,16635996152,717720450,16635990896,-5256,,
15231408708,706.04336,16636047195,717771488,16636041933,-5262,,
15231459748,706.09440,16636098237,717822525,16636092970,-5267,,
15231510787,706.14544,16636149279,717873562,16636144007,-5272,,
15231561350,706.19600,16636199844,717924123,16636194568,-5276,,
15231612364,706.24701,16636250861,717975133,16636245579,-5282,,
15231662928,706.29758,16636301426,718025695,16636296140,-5286,,
15231713497,706.34815,16636351998,718076262,16636346707,-5291,,
15231764517,706.39917,16636403021,718127278,16636397723,-5298,,
15231815068,706.44972,16636453573,718177826,16636448271,-5302,,
15231865641,706.50029,16636504149,718228397,16636498843,-5306,,
15231916696,706.55134,16636555206,718279448,16636549894,-5312,,
15231967716,706.60236,16636606229,718330467,16636600912,-5317,,
15232018293,706.65294,16636656809,718381042,16636651487,-5322,,
15232068887,706.70353,16636707404,718431632,16636702077,-5327,,
15232119159,706.75381,16636757679,718481902,16636752347,-5332,,
15232169712,706.80436,16636808235,718532451,16636802897,-5338,,
15232220779,706.85543,16636859304,718583517,16636853962,-5342,,
15232271348,706.90600,16636909875,718634082,16636904528,-5347,,
15232321555,706.95620,16636960084,718684286,16636954731,-5353,,
15232372583,707.00723,16637011115,718735313,16637005758,-5357,,
15232422667,707.05732,16637061201,718785393,16637055839,-5362,,
15232473717,707.10837,16637112254,718836440,16637106886,-5368,,
15232524374,707.15902,16637162913,718887095,16637157541,-5372,,
15232574997,707.20965,16637213538,718937716,16637208161,-5377,,
15232625901,707.26055,16637264445,718988616,16637259062,-5383,,
15232676165,707.31081,16637314711,719038877,16637309322,-5389,,
15232727037,707.36168,16637365585,719089747,16637360193,-5392,,
15232777100,707.41175,16637415651,719139808,16637410253,-5398,,
15232827807,707.46245,16637466360,719190512,16637460958,-5402,,
15232878753,707.51340,16637517309,719241456,16637511901,-5408,,
15232928941,707.56359,16637567499,719291641,16637562086,-5413,,
15232979556,707.61420,16637618116,719342253,16637612698,-5418,,
15233030590,707.66524,16637669153,719393283,16637663729,-5424,,
15233081430,707.71608,16637719994,719444121,16637714566,-5428,,
15233132450,707.76710,16637771017,719495138,16637765584,-5433,,
15233182996,707.81764,16637821566,719545682,16637816127,-5439,,
15233233593,707.86824,16637872165,719596276,16637866721,-5444,,
15233284623,707.91927,16637923197,719647303,16637917749,-5448,,
15233335173,707.96982,16637973749,719697850,16637968296,-5453,,
15233385758,708.02041,16638024337,719748433,16638018878,-5459,,
15233436869,708.07152,16638075450,719799541,16638069987,-5463,,
15233487429,708.12208,16638126023,719850108,16638120554,-5469,,
15233538456,708.17310,16638177042,719901123,16638171568,-5474,,
15233588815,708.22346,16638227404,719951479,16638221925,-5479,,
15233639588,708.27424,16638278179,720002259,16638272705,-5474,,
15233690639,708.32529,16638329232,720053298,16638323743,-5489,,
15233741162,708.37581,16638379758,720103817,16638374262,-5496,,
15233791711,708.42636,16638430309,720154365,16638424810,-5499,,
15233842235,708.47688,16638480835,720204885,16638475331,-5504,,
15233892831,708.52748,16638531434,720255479,16638525924,-5510,,
15233943344,708.57799,16638581948,720305999,16638576445,-5503,,
15233994414,708.62906,16638633021,720357057,16638627502,-5519,,
15234045390,708.68004,16638684000,720408030,16638678475,-5525,,
15234096315,708.73096,16638734927,720458951,16638729397,-5530,,
15234146885,708.78153,16638785499,720509519,16638779965,-5534,,
15234197425,708.83207,16638836042,720560056,16638830502,-5540,,
15234248464,708.88311,16638887093,720611104,16638881549,-5544,,
15234299537,708.93418,16638938158,720662163,16638932609,-5549,,
15234350573,708.98522,16638989196,720713196,16638983642,-5554,,
15234401632,709.03628,16639040258,720764253,16639034698,-5560,,
15234452659,709.08731,16639091288,720815276,16639085722,-5566,,
15234503701,709.13835,16639142332,720866317,16639136762,-5570,,
15234554734,709.18938,16639193366,720917346,16639187792,-5574,,
15234605315,709.23996,16639243951,720967925,16639238370,-5581,,
15234656337,709.29098,16639294975,721018943,16639289389,-5586,,
15234706896,709.34154,16639345537,721069500,16639339958,-5579,,
15234757454,709.39210,16639396097,721120055,16639390501,-5596,,
15234808507,709.44316,16639447152,721171105,16639441551,-5601,,
15234859366,709.49401,16639498014,721221962,16639492408,-5606,,
15234909537,709.54418,16639548186,721272130,16639542575,-5611,,
15234959605,709.59425,16639598256,721322195,16639592640,-5616,,
15235010163,709.64481,16639648829,721372762,16639643207,-5622,,
15235061239,709.69589,16639699895,721423824,16639694270,-5625,,
15235111483,709.74613,16639750142,721474066,16639744511,-5631,,
15235161866,709.79651,16639800528,721524446,16639794891,-5637,,
15235212813,709.84746,16639851476,721575390,16639845835,-5641,,
15235263388,709.89804,16639902055,721625964,16639896409,-5646,,
15235314416,709.94906,16639953084,721676987,16639947433,-5651,,
15235364984,709.99963,16640003655,721727554,16639997999,-5656,,
15235415549,710.05020,16640054221,721778115,16640048560,-5661,,
15235466103,710.10075,16640104778,721828666,16640099111,-5667,,
15235516941,710.15159,16640155619,721879502,16640149948,-5671,,
15235567481,710.20213,16640206162,721930040,16640200485,-5677,,
15235618528,710.25318,16640257211,721981083,16640251529,-5682,,
15235669578,710.30423,16640308274,722032142,16640302587,-5687,,
15235720652,710.35530,16640359340,722083202,16640353647,-5693,,
15235771701,710.40635,16640410391,722134248,16640404694,-5697,,
15235822288,710.45694,16640460980,722184833,16640455279,-5701,,
15235873333,710.50798,16640512027,722235874,16640506319,-5708,,
15235923826,710.55847,16640562533,722286376,16640556822,-5711,,
15235974914,710.60956,16640613613,722337450,16640607896,-5717,,
15236025923,710.66057,16640664625,722388457,16640658902,-5723,,
15236076564,710.71121,16640715267,722439094,16640709539,-5728,,
15236127602,710.76225,16640766309,722490130,16640760576,-5733,,
15236178685,710.81333,16640817394,722541211,16640811656,-5738,,
15236228768,710.86342,16640867478,722591290,16640861735,-5743,,
15236279908,710.91456,16640918622,722642428,16640912874,-5748,,
15236330958,710.96561,16640969674,722693475,16640963920,-5754,,
15236381694,711.01634,16641020423,722744220,16641014666,-5757,,
15236432731,711.06738,16641071452,722795242,16641065687,-5765,,
15236483790,711.11844,16641122513,722846299,16641116745,-5768,,
15236534378,711.16903,16641173104,722896885,16641167330,-5774,,
15236585439,711.22009,16641224166,722947943,16641218388,-5778,,
15236635937,711.27058,16641274666,722998438,16641268883,-5783,,
15236686499,711.32115,16641325232,723049005,16641319450,-5782,,
15236737555,711.37220,16641376290,723100050,16641370496,-5794,,
15236788131,711.42278,16641426868,723150623,16641421069,-5799,,
15236839143,711.47379,16641477883,723201633,16641472079,-5804,,
15236889700,711.52435,16641528442,723252187,16641522633,-5809,,
15236940349,711.57500,16641579093,723302834,16641573279,-5814,,
15236990702,711.62535,16641629448,723353184,16641623629,-5819,,
15237041344,711.67599,16641680092,723403823,16641674269,-5823,,
15237091903,711.72655,16641730654,723454389,16641724835,-5819,,
15237142140,711.77679,16641780894,723504614,16641775059,-5835,,
15237193154,711.82780,16641831910,723555625,16641826071,-5839,,
15237243203,711.87785,16641881961,723605672,16641876117,-5844,,
15237293750,711.92840,16641932511,723656215,16641926661,-5850,,
15237344813,711.97946,16641983586,723707287,16641977732,-5854,,
15237395847,712.03049,16642034612,723758307,16642028752,-5860,,
15237446889,712.08154,16642085656,723809346,16642079792,-5864,,
15237497940,712.13259,16642136709,723860394,16642130839,-5870,,
15237548890,712.18354,16642187663,723911342,16642181788,-5875,,
15237599433,712.23408,16642238207,723961882,16642232328,-5879,,
15237649994,712.28464,16642288771,724012441,16642282886,-5885,,
15237700598,712.33525,16642339378,724063042,16642333488,-5890,,
15237751169,712.38582,16642389950,724113610,16642384055,-5895,,
15237801775,712.43642,16642440559,724164214,16642434659,-5900,,
15237852214,712.48686,16642491000,724214649,16642485094,-5906,,
15237902864,712.53751,16642541653,724265297,16642535743,-5910,,
15237953912,712.58856,16642592703,724316342,16642586788,-5915,,
15238004961,712.63961,16642643754,724367388,16642637834,-5920,,
15238055975,712.69062,16642694771,724418400,16642688846,-5925,,
15238106587,712.74123,16642745386,724469010,16642739455,-5931,,
15238157179,712.79183,16642795980,724519598,16642790044,-5936,,
15238207714,712.84236,16642846517,724570130,16642840576,-5941,,
15238258295,712.89294,16642897101,724620710,16642891155,-5946,,
15238308943,712.94359,16642947751,724671354,16642941800,-5951,,
15238359885,712.99453,16642998694,724722293,16642992738,-5956,,
15238410049,713.04470,16643048873,724772466,16643042912,-5961,,
15238460731,713.09538,16643099545,724823134,16643093579,-5966,,
15238511481,713.14613,16643150310,724873894,16643144340,-5970,,
15238562375,713.19702,16643201195,724924773,16643195218,-5977,,
15238613417,713.24806,16643252239,724975812,16643246258,-5981,,
15238664008,713.29866,16643302833,725026400,16643296846,-5987,,
15238715039,713.34969,16643353866,725077440,16643347885,-5981,,
15238765617,713.40026,16643404446,725128004,16643398450,-5996,,
15238816629,713.45128,16643455461,725179013,16643449459,-6002,,
15238867207,713.50185,16643506041,725229589,16643500034,-6007,,
15238918220,713.55287,16643557056,725280598,16643551044,-6012,,
15238968605,713.60325,16643607443,725330981,16643601426,-6017,,
15239018741,713.65339,16643657581,725381114,16643651559,-6022,,
15239069338,713.70399,16643708181,725431709,16643702154,-6027,,
15239119456,713.75410,16643758301,725481824,16643752270,-6031,,
15239170014,713.80466,16643808862,725532380,16643802825,-6037,,
15239220836,713.85548,16643859686,725583198,16643853644,-6042,,
15239271381,713.90603,16643910234,725633741,16643904187,-6047,,
15239321921,713.95657,16643960776,725684278,16643954724,-6052,,
15239372318,714.00697,16644011175,725734672,16644005118,-6057,,
15239423061,714.05771,16644061921,725785412,16644055858,-6063,,
15239473623,714.10827,16644112484,725835972,16644106417,-6067,,
15239524638,714.15929,16644163503,725886984,16644157429,-6074,,
15239575186,714.20983,16644214052,725937529,16644207974,-6078,,
15239625677,714.26032,16644264546,725988019,16644258464,-6082,,
15239676781,714.31143,16644315653,726039119,16644309565,-6088,,
15239727781,714.36243,16644366655,726090117,16644360562,-6093,,
15239778293,714.41294,16644417168,726140625,16644411070,-6098,,
15239828744,714.46339,16644467622,726191074,16644461520,-6102,,
15239879293,714.51394,16644518174,726241620,16644512066,-6108,,
15239929864,714.56451,16644568747,726292189,16644562634,-6113,,
15239980262,714.61491,16644619148,726342585,16644613030,-6118,,
15240030570,714.66522,16644669458,726392889,16644663335,-6123,,
15240080737,714.71538,16644719626,726443053,16644713498,-6128,,
15240131344,714.76599,16644770237,726493658,16644764104,-6133,,
15240182249,714.81690,16644821144,726544561,16644815007,-6137,,
15240232790,714.86744,16644871687,726595099,16644865544,-6143,,
15240283347,714.91800,16644922246,726645651,16644916097,-6149,,
15240333900,714.96855,16644972801,726696203,16644966648,-6153,,
15240384559,715.01921,16645023464,726746859,16645017305,-6159,,
15240435280,715.06993,16645074186,726797577,16645068023,-6163,,
15240485919,715.12057,16645124828,726848215,16645118660,-6168,,
15240536400,715.17105,16645175312,726898693,16645169138,-6174,,
15240586980,715.22163,16645225893,726949268,16645219714,-6179,,
15240638022,715.27267,16645276938,727000308,16645270754,-6184,,
15240688764,715.32341,16645327683,727051048,16645321494,-6189,,
15240739304,715.37395,16645378225,727101585,16645372031,-6194,,
15240789862,715.42451,16645428785,727152141,16645422586,-6199,,
15240840428,715.47508,16645479354,727202704,16645473150,-6204,,
15240891453,715.52610,16645530381,727253727,16645524172,-6209,,
15240942077,715.57673,16645581006,727304347,16645574792,-6214,,
15240993118,715.62777,16645632051,727355386,16645625831,-6220,,
15241043653,715.67830,16645682587,727405918,16645676363,-6224,,
15241094193,715.72884,16645733131,727456456,16645726902,-6229,,
15241144977,715.77963,16645783916,727507236,16645777682,-6234,,
15241195538,715.83019,16645834492,727557807,16645828253,-6239,,
15241246063,715.88071,16645885008,727608318,16645878764,-6244,,
15241296156,715.93080,16645935103,727658408,16645928854,-6249,,
15241347164,715.98181,16645986113,727709412,16645979858,-6255,,
15241397721,716.03237,16646036673,727759967,16646030413,-6260,,
15241450311,716.08496,16646089265,727812555,16646083000,-6265,,
15241501269,716.13592,16646140225,727863510,16646133955,-6270,,
15241552169,716.18682,16646191128,727914406,16646184852,-6276,,
15241602218,716.23687,16646241179,727964454,16646234899,-6280,,
15241652266,716.28691,16646291228,728014498,16646284943,-6285,,
15241702311,716.33696,16646341276,728064539,16646334985,-6291,,
15241752873,716.38752,16646391841,728115101,16646385546,-6295,,
15241804114,716.43876,16646443085,728166339,16646436784,-6301,,
15241854460,716.48911,16646493433,728216681,16646487127,-6306,,
15241904533,716.53918,16646543507,728266752,16646537197,-6310,,
15241961142,716.59579,16646600120,728323358,16646593804,-6316,,
15242030624,716.66527,16646669604,728392836,16646663281,-6323,,
15242081373,716.71602,16646720356,728443582,16646714028,-6328,,
15242132052,716.76670,16646771038,728494259,16646764704,-6334,,
15242182727,716.81737,16646821714,728544931,16646815376,-6338,,
15242233331,716.86798,16646872321,728595532,16646865977,-6344,,
15242283618,716.91827,16646922611,728645816,16646916261,-6350,,
15242333925,716.96857,16646972920,728696121,16646966567,-6353,,
15242388194,717.02284,16647027192,728750387,16647020833,-6359,,
15242438594,717.07324,16647077594,728800784,16647071230,-6364,,
15242489395,717.12404,16647128396,728851582,16647122027,-6369,,
15242539705,717.17435,16647178709,728901890,16647172335,-6374,,
15242590636,717.22528,16647229642,728952818,16647223263,-6379,,
15242641092,717.27574,16647280100,729003271,16647273716,-6384,,
15242691521,717.32617,16647330533,729053698,16647324143,-6390,,
15242741856,717.37650,16647380870,729104031,16647374476,-6394,,
15242792357,717.42701,16647431373,729154528,16647424973,-6400,,
15242842717,717.47736,16647481736,729204886,16647475331,-6405,,
15242893743,717.52839,16647532763,729255909,16647526354,-6409,,
15242944745,717.57939,16647583769,729306908,16647577354,-6415,,
15242995327,717.62997,16647634353,729357487,16647627933,-6420,,
15243046394,717.68104,16647685422,729408553,16647678998,-6424,,
15243098260,717.73291,16647737291,729460415,16647730860,-6431,,
15243148972,717.78362,16647788005,729511125,16647781570,-6435,,
15243208419,717.84307,16647847454,729570568,16647841013,-6441,,
15243259071,717.89372,16647898108,729621217,16647891662,-6446,,
15243317474,717.95212,16647956514,729679617,16647950062,-6452,,
15243370051,718.00470,16648009093,729732190,16648002636,-6457,,
15243431862,718.06651,16648070907,729793999,16648064444,-6463,,
15243500961,718.13561,16648140009,729863094,16648133539,-6470,,
15243551524,718.18617,16648190576,729913655,16648184101,-6475,,
15243604928,718.23958,16648243982,729967057,16648237502,-6480,,
15243655596,718.29024,16648294652,730017721,16648288166,-6486,,
15243706529,718.34118,16648345587,730068651,16648339096,-6491,,
15243756798,718.39145,16648395858,730118918,16648389363,-6495,,
15243807470,718.44212,16648446534,730169587,16648440033,-6501,,
15243868528,718.50318,16648507595,730230643,16648501088,-6507,,
15243919436,718.55408,16648558504,730281547,16648551992,-6512,,
15243970200,718.60485,16648609271,730332309,16648602754,-6517,,
15244020873,718.65552,16648659947,730382979,16648653424,-6523,,
15244071359,718.70601,16648710435,730433462,16648703908,-6527,,
15244122010,718.75666,16648761087,730484110,16648754555,-6532,,
15244172505,718.80715,16648811585,730534602,16648805047,-6538,,
15244222682,718.85733,16648861764,730584777,16648855222,-6542,,
15244272964,718.90761,16648912049,730635057,16648905502,-6547,,
15244323778,718.95843,16648962865,730685867,16648956313,-6552,,
15244374083,719.00873,16649013173,730736170,16649006615,-6558,,
15244424646,719.05929,16649063737,730786730,16649057175,-6562,,
15244475387,719.11004,16649114482,730837469,16649107914,-6568,,
15244525961,719.16061,16649165058,730888040,16649158485,-6573,,
15244576082,719.21073,16649215181,730938158,16649208604,-6577,,
15244626886,719.26153,16649265988,730988959,16649259405,-6583,,
15244677358,719.31201,16649316472,731039439,16649309884,-6588,,
15244727492,719.36214,16649366598,731089561,16649360006,-6592,,
15244777619,719.41227,16649416728,731139684,16649410129,-6599,,
15244828199,719.46285,16649467310,731190262,16649460707,-6603,,
15244878751,719.51340,16649517864,731240811,16649511257,-6607,,
15244929046,719.56369,16649568161,731291103,16649561548,-6613,,
15244979703,719.61435,16649618821,731341758,16649612203,-6618,,
15245030295,719.66494,16649669415,731392346,16649662792,-6623,,
15245080469,719.71512,16649719592,731442530,16649712976,-6616,,
15245131169,719.76582,16649770294,731493216,16649763661,-6633,,
15245181905,719.81655,16649821032,731543948,16649814394,-6638,,
15245232096,719.86674,16649871226,731594138,16649864583,-6643,,
15245282566,719.91721,16649921698,731644604,16649915050,-6648,,
15245333022,719.96767,16649972157,731695058,16649965503,-6654,,
15245383351,720.01800,16650022488,731745384,16650015830,-6658,,
15245433823,720.06847,16650072962,731795853,16650066299,-6663,,
15245484557,720.11920,16650123698,731846584,16650117029,-6669,,
15245534864,720.16951,16650174008,731896888,16650167334,-6674,,
15245585074,720.21972,16650224220,731947096,16650217542,-6678,,
15245635221,720.26987,16650274370,731997240,16650267686,-6684,,
15245685554,720.32020,16650324705,732047571,16650318016,-6689,,
15245736114,720.37076,16650375266,732098128,16650368573,-6693,,
15245786430,720.42108,16650425586,732148441,16650418887,-6699,,
15245836936,720.47158,16650476094,732198945,16650469390,-6704,,
15245887434,720.52208,16650526594,732249440,16650519886,-6708,,
15245937651,720.57230,16650576814,732299654,16650570100,-6714,,
15245988063,720.62271,16650627228,732350064,16650620509,-6719,,
15246038722,720.67337,16650677889,732400720,16650671165,-6724,,
15246089241,720.72389,16650728411,732451236,16650721681,-6730,,
15246139825,720.77447,16650778996,732501817,16650772262,-6734,,
15246190147,720.82479,16650829321,732552137,16650822582,-6739,,
15246240286,720.87493,16650879462,732602273,16650872718,-6744,,
15246290626,720.92527,16650929805,732652610,16650923056,-6749,,
15246341104,720.97575,16650980286,732703085,16650973530,-6756,,
15246391399,721.02605,16651030583,732753379,16651023824,-6759,,
15246441490,721.07614,16651080676,732803466,16651073912,-6764,,
15246492083,721.12673,16651131271,732854056,16651124501,-6770,,
15246542569,721.17722,16651181759,732904540,16651174985,-6774,,
15246593345,721.22799,16651232537,732955313,16651225758,-6779,,
15246643971,721.27862,16651283166,733005936,16651276381,-6785,,
15246694665,721.32931,16651333863,733056627,16651327072,-6791,,
15246745219,721.37987,16651384419,733107180,16651377625,-6794,,
15246795995,721.43064,16651435198,733157953,16651428398,-6800,,
15246846487,721.48113,16651485692,733208441,16651478887,-6805,,
15246897080,721.53173,16651536286,733259032,16651529477,-6809,,
15246947485,721.58213,16651586695,733309434,16651579880,-6815,,
15246998160,721.63281,16651637372,733360106,16651630552,-6820,,
15247048764,721.68341,16651687978,733410708,16651681153,-6825,,
15247098889,721.73354,16651738106,733460831,16651731276,-6830,,
15247149927,721.78458,16651789146,733511866,16651782311,-6835,,
15247200696,721.83534,16651839917,733562631,16651833077,-6840,,
15247251277,721.88593,16651890500,733613210,16651883656,-6844,,
15247301716,721.93636,16651940941,733663646,16651934092,-6849,,
15247352305,721.98695,16651991534,733714233,16651984678,-6856,,
15247403366,722.03801,16652042597,733765291,16652035737,-6860,,
15247453773,722.08842,16652093005,733815695,16652086141,-6864,,
15247504793,722.13944,16652144029,733866713,16652137159,-6870,,
15247554864,722.18951,16652194101,733916780,16652187225,-6876,,
15247605469,722.24012,16652244708,733967383,16652237829,-6879,,
15247655730,722.29038,16652294972,734017641,16652288086,-6886,,
15247706796,722.34144,16652346040,734068704,16652339149,-6891,,
15247757134,722.39178,16652396381,734119040,16652389486,-6895,,
15247807346,722.44199,16652446596,734169249,16652439694,-6902,,
15247857502,722.49215,16652496754,734219403,16652489849,-6905,,
15247907747,722.54240,16652547001,734269644,16652540090,-6911,,
15247958179,722.59283,16652597435,734320074,16652590520,-6915,,
15248008300,722.64295,16652647559,734370192,16652640638,-6921,,
15248058905,722.69355,16652698165,734420794,16652691239,-6926,,
15248109256,722.74390,16652748519,734471143,16652741588,-6931,,
15248159373,722.79402,16652798639,734521258,16652791703,-6936,,
15248209766,722.84441,16652849034,734571647,16652842093,-6941,,
15248259896,722.89454,16652899167,734621775,16652892221,-6946,,
15248310140,722.94479,16652949412,734672016,16652942461,-6951,,
15248545085,723.17973,16653184369,734906948,16653177394,-6975,16653183371,
15248570532,723.20518,16653209817,734932394,16653202870,-6947,,
15248621579,723.25623,16653260867,734983438,16653253975,-6892,,
15248672627,723.30728,16653311917,735034485,16653305082,-6835,,
15248723164,723.35781,16653362455,735085018,16653355676,-6779,,
15248773721,723.40837,16653413015,735135572,16653406291,-6724,,
15248823789,723.45844,16653463086,735185637,16653456416,-6670,,
15248874369,723.50902,16653513668,735236215,16653507053,-6615,,
15248925446,723.56009,16653564748,735287289,16653558190,-6558,,
15248976508,723.61116,16653615812,735338349,16653609310,-6502,,
15249027026,723.66167,16653666332,735388865,16653659887,-6445,,
15249077943,723.71259,16653717252,735439778,16653710861,-6391,,
15249128424,723.76307,16653767734,735490267,16653761410,-6324,,
15249179066,723.81371,16653818379,735540896,16653812100,-6279,,
15249229932,723.86458,16653869248,735591759,16653863024,-6224,,
15249280242,723.91489,16653919560,735642067,16653913391,-6169,,
15249330898,723.96555,16653970219,735692720,16653964104,-6115,,
15249381508,724.01616,16654020830,735743327,16654014772,-6058,,
15249432137,724.06678,16654071462,735793954,16654065459,-6003,,
15249483203,724.11785,16654122531,735845016,16654116583,-5948,,
15249534199,724.16885,16654173529,735896009,16654167636,-5893,,
15249585248,724.21990,16654224580,735947056,16654218744,-5836,,
15249636154,724.27080,16654275489,735997960,16654269709,-5780,,
15249687242,724.32189,16654326579,736049044,16654320855,-5724,,
15249737717,724.37236,16654377056,736099528,16654371399,-5657,,
15249788356,724.42300,16654427698,736150165,16654422096,-5602,,
15249838507,724.47316,16654477850,736200301,16654472292,-5558,,
15249889068,724.52372,16654528414,736250859,16654522912,-5502,,
15249939541,724.57419,16654578890,736301330,16654573443,-5447,,
15249990091,724.62474,16654629441,736351877,16654624050,-5391,,
15250040625,724.67527,16654679979,736402409,16654674642,-5337,,
15250091184,724.72583,16654730540,736452965,16654725259,-5281,,
15250142228,724.77688,16654781586,736504006,16654776360,-5226,,
15250192834,724.82748,16654832195,736554609,16654827025,-5170,,
15250243107,724.87775,16654882470,736604881,16654877356,-5114,,
15250294199,724.92885,16654933563,736655969,16654928506,-5057,,
15250344748,724.97940,16654984116,736706516,16654979113,-5003,,
15250395294,725.02994,16655034664,736757059,16655029716,-4948,,
15250445808,725.08046,16655085190,736807581,16655080300,-4890,,
15250496421,725.13107,16655135796,736858181,16655130959,-4837,,
15250546624,725.18127,16655186001,736908380,16655181219,-4782,,
15250597270,725.23192,16655236649,736959024,16655231923,-4726,,
15250648306,725.28295,16655287688,737010058,16655283018,-4670,,
15250699355,725.33400,16655338739,737061103,16655334125,-4614,,
15250750404,725.38505,16655389790,737112149,16655385231,-4559,,
15250801423,725.43607,16655440812,737163166,16655436310,-4502,,
15250852005,725.48665,16655491395,737213745,16655486948,-4447,,
15250903053,725.53770,16655542447,737264790,16655538054,-4393,,
15250953565,725.58821,16655592961,737315300,16655588626,-4335,,
15251004118,725.63877,16655643516,737365850,16655639236,-4280,,
15251054699,725.68935,16655694099,737416428,16655689875,-4224,,
15251105211,725.73986,16655744614,737466938,16655740444,-4170,,
15251155763,725.79041,16655795167,737517487,16655791053,-4114,,
15251206797,725.84145,16655846204,737568518,16655842145,-4059,,
15251257345,725.89199,16655896755,737619063,16655892752,-4003,,
15251308408,725.94306,16655947820,737670125,16655943874,-3946,,
15251358958,725.99361,16655998373,737720671,16655994480,-3893,,
15251409552,726.04420,16656048968,737771262,16656045132,-3836,,
15251460606,726.09525,16656100026,737822313,16656096245,-3781,,
15251511425,726.14607,16656150847,737873130,16656147123,-3724,,
15251562442,726.19709,16656201866,737924144,16656198198,-3668,,
15251613466,726.24811,16656252892,737975165,16656249279,-3613,,
15251664492,726.29914,16656303922,738026190,16656300365,-3557,,
15251715057,726.34970,16656354488,738076751,16656350987,-3501,,
15251766152,726.40080,16656405586,738127843,16656402140,-3446,,
15251817204,726.45185,16656456640,738178892,16656453250,-3390,,
15251867788,726.50244,16656507227,738229474,16656503892,-3335,,
15251918273,726.55292,16656557713,738279956,16656554434,-3279,,
15251969286,726.60393,16656608729,738330966,16656605506,-3223,,
15252019335,726.65398,16656658781,738381014,16656655613,-3168,,
15252069912,726.70456,16656709360,738431587,16656706247,-3113,,
15252120420,726.75507,16656759870,738482093,16656756813,-3057,,
15252170470,726.80512,16656809923,738532140,16656806920,-3003,,
15252221515,726.85616,16656860969,738583182,16656858023,-2946,,
15252271568,726.90622,16656911025,738633233,16656908134,-2891,,
15252322103,726.95675,16656961562,738683764,16656958725,-2837,,
15252372164,727.00681,16657011626,738733824,16657008845,-2781,,
15252422712,727.05736,16657062176,738784368,16657059450,-2726,,
15252473270,727.10792,16657112737,738834923,16657110066,-2671,,
15252524316,727.15896,16657163785,738885966,16657161170,-2615,,
15252574905,727.20955,16657214376,738936553,16657211817,-2559,,
15252625921,727.26057,16657265394,738987566,16657262890,-2504,,
15252676973,727.31162,16657316449,739038615,16657314001,-2448,,
15252728040,727.36269,16657367518,739089680,16657365126,-2392,,
15252778614,727.41326,16657418094,739140251,16657415759,-2335,,
15252829203,727.46385,16657468686,739190837,16657466405,-2281,,
15252879602,727.51425,16657519087,739241233,16657516862,-2225,,
15252930628,727.56528,16657570116,739292257,16657567947,-2169,,
15252981226,727.61587,16657620716,739342853,16657618602,-2114,,
15253032292,727.66694,16657671784,739393915,16657669725,-2059,,
15253083332,727.71798,16657722827,739444953,16657720825,-2002,,
15253133990,727.76864,16657773487,739495608,16657771540,-1947,,
15253184632,727.81928,16657824131,739546247,16657822239,-1892,,
15253234737,727.86938,16657874239,739596350,16657872403,-1836,,
15253285345,727.91999,16657924849,739646956,16657923069,-1780,,
15253336352,727.97100,16657975859,739697959,16657974133,-1726,,
15253386437,728.02108,16658025946,739748042,16658024276,-1670,,
15253436750,728.07140,16658076261,739798353,16658074647,-1614,,
15253487326,728.12197,16658126840,739848925,16658125279,-1561,,
15253538389,728.17304,16658177906,739899986,16658176402,-1504,,
15253589358,728.22401,16658228877,739950952,16658227377,-1500,,
15253639919,728.27457,16658279439,740001510,16658277935,-1504,,
15253690469,728.32512,16658329991,740052057,16658328481,-1510,,
15253740598,728.37525,16658380124,740102184,16658378609,-1515,,
15253790881,728.42553,16658430409,740152465,16658428889,-1520,,
15253841037,728.47568,16658480567,740202617,16658479042,-1525,,
15253892060,728.52671,16658531593,740253637,16658530062,-1531,,
15253943145,728.57779,16658582680,740304721,16658581145,-1535,,
15253993649,728.62830,16658633185,740355221,16658631645,-1540,,
15254044235,728.67888,16658683775,740405805,16658682230,-1545,,
15254095206,728.72985,16658734748,740456773,16658733198,-1550,,
15254145925,728.78057,16658785468,740507489,16658783913,-1555,,
15254196968,728.83162,16658836515,740558530,16658834954,-1561,,
15254266325,728.90097,16658905874,740627882,16658904306,-1568,,
15254337912,728.97256,16658977465,740699465,16658975890,-1575,,
15254394653,729.02930,16659034208,740756203,16659032627,-1581,,
15254448665,729.08331,16659088223,740810213,16659086637,-1586,,
15254499181,729.13383,16659138742,740860750,16659137174,-1568,,
15254549259,729.18391,16659188823,740910802,16659187227,-1596,,
15254599318,729.23397,16659238884,740960858,16659237282,-1602,,
15254650357,729.28500,16659289925,741011895,16659288319,-1606,,
15254700904,729.33555,16659340474,741062438,16659338863,-1611,,
15254750978,729.38563,16659390551,741112510,16659388934,-1617,,
15254802049,729.43670,16659441625,741163579,16659440004,-1621,,
15254853065,729.48771,16659492642,741214592,16659491016,-1626,,
15254903644,729.53829,16659543223,741265167,16659541591,-1632,,
15254954264,729.58891,16659593846,741315785,16659592209,-1637,,
15255005312,729.63996,16659644895,741366830,16659643255,-1640,,
15255055882,729.69053,16659695469,741417397,16659693822,-1647,,
15255106444,729.74109,16659746033,741467957,16659744381,-1652,,
15255157473,729.79212,16659797063,741518983,16659795407,-1656,,
15255209032,729.84368,16659848625,741570539,16659846963,-1662,,
15255259553,729.89420,16659899149,741621057,16659897482,-1667,,
15255309601,729.94425,16659949199,741671102,16659947526,-1673,,
15255359661,729.99431,16659999261,741721160,16659997584,-1677,,
15255409712,730.04436,16660049314,741771208,16660047632,-1682,,
15255460406,730.09505,16660100012,741821899,16660098323,-1689,,
15255510796,730.14544,16660150404,741872288,16660148713,-1691,,
15255560843,730.19549,16660200453,741922332,16660198756,-1697,,
15255611482,730.24613,16660251095,741972968,16660249392,-1703,,
15255662061,730.29671,16660301676,742023570,16660299995,-1681,,
15255712579,730.34723,16660352196,742074059,16660350484,-1712,,
15255763352,730.39800,16660402972,742124829,16660401254,-1718,,
15255814211,730.44886,16660453833,742175686,16660452110,-1723,,
15255864990,730.49964,16660504614,742226462,16660502887,-1727,,
15255915548,730.55020,16660555175,742277018,16660553442,-1733,,
15255966103,730.60075,16660605731,742327569,16660603993,-1738,,
15256018145,730.65279,16660657776,742379609,16660656034,-1742,,
15256068687,730.70334,16660708321,742430148,16660706573,-1748,,
15256118745,730.75339,16660758381,742480204,16660756628,-1753,,
15256169200,730.80385,16660808839,742530656,16660807080,-1759,,
15256219762,730.85441,16660859403,742581216,16660857640,-1763,,
15256270130,730.90478,16660909773,742631581,16660908005,-1768,,
15256321183,730.95583,16660960839,742682640,16660959065,-1774,,
15256372244,731.00689,16661011892,742733689,16661010114,-1778,,
15256422787,731.05744,16661062437,742784230,16661060654,-1783,,
15256473797,731.10844,16661113451,742835238,16661111662,-1789,,
15256524310,731.15896,16661163965,742885747,16661162171,-1794,,
15256574961,731.20961,16661214618,742936396,16661212820,-1798,,
15256625530,731.26018,16661265189,742986961,16661263385,-1804,,
15256676575,731.31122,16661316237,743038004,16661314429,-1808,,
15256727111,731.36176,16661366775,743088537,16661364962,-1813,,
15256777676,731.41232,16661417343,743139100,16661415524,-1819,,
15256828699,731.46335,16661468368,743190119,16661466544,-1824,,
15256879564,731.51421,16661519236,743240982,16661517406,-1830,,
15256929634,731.56428,16661569309,743291050,16661567474,-1835,,
15256980130,731.61478,16661619805,743341542,16661617966,-1839,,
15257030685,731.66533,16661670363,743392094,16661668518,-1845,,
15257081246,731.71589,16661720927,743442653,16661719078,-1849,,
15257132291,731.76694,16661771974,743493695,16661770120,-1854,,
15257182873,731.81752,16661822558,743544274,16661820698,-1860,,
15257233443,731.86809,16661873130,743594842,16661871266,-1864,,
15257284181,731.91883,16661923871,743645578,16661922002,-1869,,
15257334737,731.96938,16661974430,743696130,16661972555,-1875,,
15257385285,732.01993,16662024980,743746676,16662023100,-1880,,
15257435835,732.07048,16662075532,743797224,16662073648,-1884,,
15257485928,732.12058,16662125627,743847313,16662123738,-1889,,
15257536496,732.17114,16662176198,743897878,16662174303,-1895,,
15257587533,732.22218,16662227237,743948913,16662225338,-1899,,
15257638577,732.27323,16662278284,743999954,16662276379,-1905,,
15257694144,732.32879,16662333852,744055518,16662331942,-1910,,
15257745669,732.38032,16662385381,744107041,16662383465,-1916,,
15257795715,732.43036,16662435430,744157084,16662433509,-1921,,
15257846282,732.48093,16662485999,744207649,16662484073,-1926,,
15257897422,732.53207,16662537141,744258786,16662535210,-1931,,
15257948358,732.58301,16662588079,744309719,16662586143,-1936,,
15257999157,732.63381,16662638881,744360515,16662636940,-1941,,
15258049514,732.68416,16662689239,744410869,16662687293,-1946,,
15258100510,732.73516,16662740237,744461862,16662738286,-1951,,
15258151059,732.78571,16662790789,744512407,16662788832,-1957,,
15258201138,732.83579,16662840871,744562485,16662838910,-1961,,
15258252721,732.88737,16662892455,744614065,16662890489,-1966,,
15258303234,732.93788,16662942972,744664575,16662941000,-1972,,
15258353286,732.98793,16662993025,744714625,16662991049,-1976,,
15258403855,733.03850,16663043597,744765192,16663041616,-1981,,
15258454924,733.08957,16663094669,744816257,16663092682,-1987,,
15258505458,733.14011,16663145205,744866788,16663143212,-1993,,
15258566250,733.20090,16663206000,744927577,16663204002,-1998,,
15258617377,733.25203,16663257128,744978702,16663255126,-2002,,
15258668496,733.30314,16663308251,745029818,16663306243,-2008,,
15258718943,733.35359,16663358701,745080263,16663356687,-2014,,
15258770028,733.40468,16663409786,745131344,16663407768,-2018,,
15258820462,733.45511,16663460223,745181776,16663458200,-2023,,
15258870703,733.50535,16663510466,745232014,16663508439,-2027,,
15258920985,733.55563,16663560751,745282293,16663558718,-2033,,
15258971255,733.60590,16663611024,745332562,16663608986,-2038,,
15259022196,733.65684,16663661967,745383499,16663659924,-2043,,
15259072672,733.70732,16663712446,745433972,16663710397,-2049,,
15259123262,733.75791,16663763048,745484570,16663760995,-2053,,
15259173631,733.80828,16663813409,745534926,16663811351,-2058,,
15259224026,733.85867,16663863806,745585318,16663861742,-2064,,
15259274598,733.90925,16663914381,745635888,16663912312,-2069,,
15259325009,733.95966,16663964794,745686297,16663962722,-2072,,
15259375689,734.01034,16664015476,745736973,16664013397,-2079,,
15259425883,734.06053,16664065673,745787164,16664063589,-2084,,
15259476451,734.11110,16664116242,745837730,16664114154,-2088,,
15259527096,734.16174,16664166891,745888373,16664164797,-2094,,
15259578049,734.21270,16664217846,745939322,16664215747,-2099,,
15259628267,734.26292,16664268065,745989537,16664265961,-2104,,
15259678650,734.31330,16664318452,746039918,16664316343,-2109,,
15259729343,734.36399,16664369147,746090609,16664367033,-2114,,
15259780207,734.41485,16664420012,746141469,16664417893,-2119,,
15259830759,734.46541,16664470567,746192019,16664468443,-2124,,
15259880870,734.51552,16664520680,746242127,16664518551,-2129,,
15259931241,734.56589,16664571054,746292496,16664568920,-2134,,
15259981512,734.61616,16664621328,746342764,16664619189,-2139,,
15260031681,734.66633,16664671498,746392929,16664669354,-2144,,
15260082008,734.71666,16664721828,746443254,16664719679,-2149,,
15260132714,734.76736,16664772537,746493958,16664770382,-2155,,
15260182958,734.81761,16664822782,746544199,16664820624,-2158,,
15260233047,734.86770,16664872874,746594285,16664870710,-2164,,
15260283372,734.91802,16664923201,746644607,16664921031,-2170,,
15260334096,734.96874,16664973928,746695329,16664971754,-2174,,
15260384483,735.01913,16665024318,746745713,16665022138,-2180,,
15260435185,735.06983,16665075021,746796412,16665072836,-2185,,
15260485946,735.12059,16665125784,746847171,16665123595,-2189,,
15260536671,735.17132,16665176513,746897893,16665174318,-2195,,
15260587568,735.22222,16665227412,746948788,16665225212,-2200,,
15260638038,735.27269,16665277884,746999254,16665275679,-2205,,
15260688722,735.32337,16665328570,747049936,16665326361,-2209,,
15260739302,735.37395,16665379152,747100513,16665376937,-2215,,
15260789678,735.42433,16665429531,747150887,16665427311,-2220,,
15260840284,735.47493,16665480140,747201490,16665477915,-2225,,
15260890812,735.52546,16665530670,747252015,16665528440,-2230,,
15260941170,735.57582,16665581029,747302370,16665578794,-2235,,
15260991865,735.62651,16665631727,747353062,16665629486,-2241,,
15261042224,735.67687,16665682088,747403419,16665679843,-2245,,
15261092848,735.72750,16665732715,747454041,16665730465,-2250,,
15261143460,735.77811,16665783329,747504649,16665781073,-2256,,
15261194139,735.82879,16665834010,747555326,16665831750,-2260,,
15261244958,735.87961,16665884832,747606142,16665882566,-2266,,
15261295436,735.93008,16665935313,747656618,16665933042,-2271,,
15261345715,735.98036,16665985593,747706894,16665983318,-2275,,
15261395916,736.03056,16666035797,747757092,16666033516,-2281,,
15261446215,736.08086,16666086099,747807389,16666083813,-2286,,
15261496654,736.13130,16666136540,747857824,16666134249,-2291,,
15261547128,736.18178,16666187017,747908296,16666184721,-2296,,
15261597264,736.23191,16666237155,747958429,16666234854,-2301,,
15261647543,736.28219,16666287435,748008705,16666285129,-2306,,
15261697981,736.33263,16666337877,748059141,16666335566,-2311,,
15261748037,736.38269,16666387935,748109194,16666385619,-2316,,
15261798281,736.43293,16666438181,748159436,16666435860,-2321,,
15261848606,736.48325,16666488509,748209759,16666486183,-2326,,
15261898718,736.53337,16666538623,748259868,16666536292,-2331,,
15261949158,736.58381,16666589066,748310306,16666586730,-2336,,
15261999576,736.63422,16666639490,748360725,16666637149,-2341,,
15262049842,736.68449,16666689754,748410984,16666687408,-2346,,
15262100259,736.73491,16666740173,748461398,16666737822,-2351,,
15262150349,736.78500,16666790266,748511485,16666787909,-2357,,
15262200806,736.83545,16666840725,748561940,16666838364,-2361,,
15262251531,736.88618,16666891452,748612662,16666889087,-2365,,
15262301899,736.93655,16666941824,748663027,16666939452,-2372,,
15262352184,736.98683,16666992111,748713310,16666989735,-2376,,
15262402562,737.03721,16667042490,748763685,16667040110,-2380,,
15262452870,737.08752,16667092801,748813989,16667090414,-2387,,
15262503633,737.13828,16667143566,748864751,16667141176,-2390,,
15262553806,737.18845,16667193741,748914920,16667191345,-2396,,
15262604579,737.23923,16667244517,748965691,16667242115,-2402,,
15262655558,737.29021,16667295498,749016667,16667293092,-2406,,
15262706263,737.34091,16667346205,749067370,16667343794,-2411,,
15262756847,737.39149,16667396792,749117951,16667394376,-2416,,
15262807078,737.44173,16667447025,749168179,16667444603,-2422,,
15262857376,737.49202,16667497327,749218475,16667494900,-2427,,
15262907956,737.54260,16667547908,749269052,16667545476,-2432,,
15262958422,737.59307,16667598375,749319514,16667595939,-2436,,
15263008580,737.64323,16667648537,749369671,16667646095,-2442,,
15263059206,737.69385,16667699165,749420294,16667696719,-2446,,
15263109414,737.74406,16667749375,749470499,16667746924,-2451,,
15263159648,737.79430,16667799612,749520730,16667797154,-2458,,
15263209880,737.84453,16667849845,749570959,16667847383,-2462,,
15263261179,737.89583,16667901147,749622255,16667898680,-2467,,
15263311813,737.94646,16667951783,749672886,16667949310,-2473,,
15263361989,737.99664,16668001962,749723060,16667999485,-2477,,
15263413027,738.04768,16668053002,749774095,16668050520,-2482,,
15263464083,738.09873,16668104061,749825148,16668101573,-2488,,
15263515132,738.14978,16668155112,749876195,16668152619,-2493,,
15263565941,738.20059,16668205923,749927002,16668203426,-2497,,
15263616949,738.25160,16668256934,749978006,16668254431,-2503,,
15263667960,738.30261,16668307946,750029014,16668305438,-2508,,
15263718038,738.35269,16668358038,750079101,16668355526,-2512,,
15263769133,738.40378,16668409125,750130182,16668406607,-2518,,
15263820124,738.45477,16668460117,750181170,16668457594,-2523,,
15263870701,738.50535,16668510698,750231744,16668508169,-2529,,
15263921754,738.55640,16668561753,750282795,16668559220,-2533,,
15263972769,738.60742,16668612770,750333808,16668610232,-2538,,
15264023820,738.65847,16668663824,750384855,16668661280,-2544,,
15264074866,738.70951,16668714872,750435900,16668712324,-2548,,
15264125424,738.76007,16668765432,750486455,16668762879,-2553,,
15264176446,738.81109,16668816457,750537474,16668813898,-2559,,
15264226545,738.86119,16668866558,750587570,16668863994,-2564,,
15264277213,738.91186,16668917228,750638235,16668914659,-2569,,
15264327758,738.96241,16668967776,750688777,16668965202,-2574,,
15264378337,739.01298,16669018357,750739354,16669015778,-2579,,
15264428953,739.06360,16669068975,750789967,16669066391,-2584,,
15264479910,739.11456,16669119935,750840921,16669117346,-2589,,
15264530952,739.16560,16669170979,750891961,16669168385,-2594,,
15264582001,739.21665,16669222031,750943006,16669219431,-2600,,
15264633055,739.26770,16669273086,750994058,16669270482,-2604,,
15264683620,739.31827,16669323654,751044620,16669321045,-2609,,
15264734625,739.36927,16669374662,751095622,16669372047,-2615,,
15264784698,739.41935,16669424736,751145693,16669422117,-2619,,
15264835736,739.47038,16669475778,751196729,16669473153,-2625,,
15264886296,739.52094,16669526340,751247286,16669523710,-2630,,
15264936850,739.57150,16669576896,751297837,16669574261,-2635,,
15264987393,739.62204,16669627442,751348377,16669624801,-2641,,
15265038447,739.67309,16669678497,751399428,16669675853,-2644,,
15265088962,739.72361,16669729015,751449940,16669726365,-2650,,
15265140013,739.77466,16669780068,751500989,16669777413,-2655,,
15265191086,739.82573,16669831144,751552060,16669828484,-2660,,
15265241665,739.87631,16669881725,751602636,16669879060,-2665,,
15265292280,739.92693,16669932343,751653248,16669929672,-2671,,
15265343286,739.97793,16669983351,751704251,16669980676,-2675,,
15265394079,740.02873,16670034145,751755041,16670031465,-2680,,
15265444615,740.07926,16670084684,751805574,16670081998,-2686,,
15265494713,740.12936,16670134796,751855682,16670132106,-2690,,
15265545336,740.17998,16670185422,751906302,16670182726,-2696,,
15265596408,740.23106,16670236485,751957359,16670233784,-2701,,
15265646814,740.28146,16670286893,752007794,16670284218,-2675,,
15265697589,740.33224,16670337671,752058536,16670334960,-2711,,
15265748642,740.38329,16670388736,752109596,16670386020,-2716,,
15265799241,740.43389,16670439338,752160193,16670436618,-2720,,
15265849866,740.48451,16670489954,752210804,16670487228,-2726,,
15265900450,740.53510,16670540540,752261385,16670537809,-2731,,
15265951059,740.58571,16670591151,752311991,16670588415,-2736,,
15266001556,740.63620,16670641652,752362486,16670638910,-2742,,
15266052570,740.68722,16670692667,752413497,16670689922,-2745,,
15266103132,740.73778,16670743232,752464057,16670740481,-2751,,
15266153740,740.78839,16670793842,752514661,16670791086,-2756,,
15266204029,740.83868,16670844133,752564948,16670841372,-2761,,
15266255080,740.88973,16670895188,752615996,16670892421,-2767,,
15266305607,740.94025,16670945717,752666520,16670942945,-2772,,
15266356168,740.99082,16670996280,752717079,16670993503,-2777,,
15266406766,741.04141,16671046881,752767674,16671044099,-2782,,
15266457809,741.09246,16671097926,752818714,16671095139,-2787,,
15266508819,741.14347,16671148937,752869721,16671146145,-2792,,
15266559791,741.19444,16671199913,752920692,16671197116,-2797,,
15266610164,741.24481,16671250287,752971061,16671247485,-2802,,
15266660775,741.29542,16671300900,753021669,16671298094,-2806,,
15266711857,741.34650,16671351985,753072748,16671349172,-2813,,
15266762876,741.39752,16671403007,753123766,16671400190,-2817,,
15266813916,741.44856,16671454050,753174813,16671451238,-2812,,
15266864435,741.49908,16671504571,753225318,16671501743,-2828,,
15266914977,741.54962,16671555115,753275859,16671552283,-2832,,
15266965533,741.60018,16671605674,753326412,16671602836,-2838,,
15267016150,741.65080,16671656292,753377025,16671653450,-2842,,
15267067222,741.70187,16671707366,753428094,16671704518,-2848,,
15267117853,741.75250,16671758001,753478723,16671755148,-2853,,
15267168458,741.80311,16671808607,753529325,16671805749,-2858,,
15267219516,741.85416,16671859668,753580380,16671856805,-2863,,
15267270525,741.90517,16671910680,753631387,16671907812,-2868,,
15267321081,741.95573,16671961238,753681940,16671958365,-2873,,
15267371617,742.00626,16672011776,753732473,16672008898,-2878,,
15267422197,742.05684,16672062359,753783050,16672059475,-2884,,
15267472733,742.10738,16672112898,753833585,16672110009,-2889,,
15267523293,742.15794,16672163459,753884141,16672160566,-2893,,
15267574320,742.20897,16672214488,753935165,16672211589,-2899,,
15267624881,742.25953,16672265052,753985725,16672262149,-2903,,
15267675455,742.31010,16672315640,754036306,16672312731,-2909,,
15267726491,742.36114,16672366667,754087328,16672363753,-2914,,
15267777040,742.41169,16672417218,754137875,16672414299,-2919,,
15267827623,742.46227,16672467804,754188455,16672464880,-2924,,
15267878666,742.51331,16672518848,754239495,16672515919,-2929,,
15267929632,742.56428,16672569817,754290458,16672566882,-2935,,
15267979836,742.61448,16672620024,754340661,16672617085,-2939,,
15268030428,742.66508,16672670618,754391249,16672667673,-2945,,
15268081421,742.71607,16672721613,754442239,16672718664,-2949,,
15268132009,742.76666,16672772204,754492825,16672769249,-2955,,
15268182544,742.81719,16672822741,754543358,16672819783,-2958,,
15268233588,742.86824,16672873788,754594402,16672870827,-2961,,
15268284142,742.91879,16672924344,754644949,16672921374,-2970,,
15268334687,742.96934,16672974891,754695492,16672971917,-2974,,
15268385243,743.01989,16673025449,754746045,16673022470,-2979,,
15268435705,743.07035,16673075913,754796504,16673072929,-2984,,
15268486667,743.12131,16673126877,754847464,16673123888,-2989,,
15268537242,743.17189,16673177455,754898036,16673174460,-2995,,
15268587749,743.22240,16673227965,754948541,16673224965,-3000,,
15268638342,743.27299,16673278560,754999131,16673275555,-3005,,
15268689352,743.32400,16673329573,755050138,16673326563,-3010,,
15268739924,743.37457,16673380147,755100708,16673377132,-3015,,
15268790465,743.42511,16673430690,755151246,16673427670,-3020,,
15268841501,743.47615,16673481729,755202280,16673478704,-3025,,
15268892545,743.52719,16673532774,755253320,16673529744,-3030,,
15268943118,743.57777,16673583350,755303890,16673580315,-3035,,
15268994155,743.62880,16673634401,755354935,16673631360,-3041,,
15269044702,743.67935,16673684938,755405469,16673681893,-3045,,
15269095245,743.72989,16673735485,755456009,16673732434,-3051,,
15269145431,743.78008,16673785685,755506204,16673782629,-3056,,
15269195560,743.83021,16673835815,755556331,16673832755,-3060,,
15269245697,743.88035,16673885943,755606453,16673882878,-3065,,
15269296267,743.93092,16673936517,755657021,16673933446,-3071,,
15269347246,743.98189,16673987497,755707996,16673984421,-3076,,
15269397787,744.03243,16674038041,755758536,16674034960,-3081,,
15269448841,744.08349,16674089096,755809586,16674086011,-3085,,
15269499859,744.13451,16674140117,755860602,16674137026,-3091,,
15269549933,744.18458,16674190194,755910674,16674187098,-3096,,
15269600980,744.23563,16674241243,755961717,16674238142,-3101,,
15269652014,744.28666,16674292279,756012749,16674289173,-3106,,
15269702565,744.33721,16674342832,756063296,16674339720,-3112,,
15269753126,744.38777,16674393396,756113856,16674390280,-3116,,
15269803675,744.43832,16674443947,756164401,16674440826,-3121,,
15269854209,744.48886,16674494484,756214932,16674491357,-3127,,
15269904748,744.53940,16674545025,756265469,16674541894,-3131,,
15269955302,744.58995,16674595582,756316020,16674592445,-3137,,
15270006300,744.64095,16674646588,756367039,16674643464,-3124,,
15270056932,744.69158,16674697216,756417645,16674694069,-3147,,
15270107489,744.74214,16674747775,756468199,16674744623,-3152,,
15270157887,744.79254,16674798175,756518594,16674795018,-3157,,
15270208905,744.84355,16674849196,756569609,16674846033,-3163,,
15270259527,744.89418,16674899820,756620229,16674896653,-3167,,
15270310086,744.94473,16674950382,756670786,16674947210,-3172,,
15270361147,744.99580,16675001444,756721843,16674998267,-3177,,
15270411839,745.04649,16675052140,756772533,16675048958,-3182,,
15270462600,745.09725,16675102903,756823292,16675099716,-3187,,
15270513160,745.14781,16675153465,756873848,16675150272,-3193,,
15270563764,745.19841,16675204072,756924449,16675200874,-3198,,
15270614342,745.24899,16675254651,756975025,16675251449,-3202,,
15270665273,745.29992,16675305586,757025953,16675302378,-3208,,
15270716308,745.35096,16675356622,757076985,16675353409,-3213,,
15270766409,745.40106,16675406726,757127085,16675403509,-3217,,
15270816829,745.45148,16675457149,757177502,16675453926,-3223,,
15270867849,745.50250,16675508171,757228518,16675504943,-3228,,
15270918411,745.55306,16675558735,757279078,16675555502,-3233,,
15270969452,745.60410,16675609779,757330116,16675606541,-3238,,
15271020389,745.65504,16675660717,757381050,16675657474,-3243,,
15271071029,745.70568,16675711359,757431687,16675708112,-3247,,
15271121554,745.75620,16675761888,757482210,16675758635,-3253,,
15271172634,745.80728,16675812969,757533287,16675809712,-3257,,
15271223690,745.85834,16675864029,757584340,16675860765,-3264,,
15271274742,745.90939,16675915082,757635389,16675911813,-3269,,
15271324985,745.95963,16675965328,757685631,16675962055,-3273,,
15271375616,746.01026,16676015962,757736258,16676012683,-3279,,
15271426666,746.06131,16676067013,757787305,16676063729,-3284,,
15271477693,746.11234,16676118042,757838329,16676114754,-3288,,
15271528225,746.16287,16676168578,757888859,16676165284,-3294,,
15271578756,746.21340,16676219110,757939387,16676215811,-3299,,
15271629294,746.26394,16676269651,757989922,16676266347,-3304,,
15271679855,746.31450,16676320215,758040481,16676316905,-3310,,
15271730870,746.36552,16676371232,758091494,16676367918,-3314,,
15271781279,746.41593,16676421643,758141899,16676418324,-3319,,
15271832103,746.46675,16676472470,758192722,16676469146,-3324,,
15271882970,746.51762,16676523339,758243585,16676520010,-3329,,
15271933037,746.56768,16676573409,758293650,16676570074,-3335,,
15271984073,746.61872,16676624447,758344682,16676621107,-3340,,
15272034639,746.66929,16676675015,758395246,16676671671,-3344,,
15272085165,746.71981,16676725544,758445769,16676722194,-3350,,
15272135766,746.77041,16676776146,758496367,16676772791,-3355,,
15272185854,746.82050,16676826237,758546454,16676822878,-3359,,
15272236390,746.87104,16676876775,758596986,16676873410,-3365,,
15272287063,746.92171,16676927451,758647657,16676924081,-3370,,
15272337330,746.97198,16676977719,758697920,16676974344,-3375,,
15272388236,747.02288,16677028629,758748824,16677025249,-3380,,
15272438790,747.07344,16677079185,758799375,16677075800,-3385,,
15272489261,747.12391,16677129658,758849843,16677126268,-3390,,
15272539310,747.17396,16677179710,758899891,16677176315,-3395,,
15272589415,747.22406,16677229820,758949997,16677226421,-3399,,
15272639955,747.27460,16677280358,759000529,16677276954,-3404,,
15272690163,747.32481,16677330570,759050736,16677327160,-3410,,
15272740726,747.37537,16677381135,759101295,16677377720,-3415,,
15272790976,747.42562,16677431387,759151545,16677427970,-3417,,
15272841970,747.47662,16677482384,759202533,16677478958,-3426,,
15272892938,747.52759,16677533354,759253499,16677529924,-3430,,
15272943679,747.57833,16677584097,759304237,16677580661,-3436,,
15272993938,747.62859,16677634359,759354494,16677630918,-3441,,
15273044672,747.67932,16677685095,759405225,16677681650,-3445,,
15273095685,747.73033,16677736111,759456235,16677732660,-3451,,
15273146279,747.78093,16677786707,759506826,16677783251,-3456,,
15273196903,747.83155,16677837332,759557448,16677833873,-3459,,
15273247292,747.88194,16677887725,759607834,16677884258,-3467,,
15273297601,747.93225,16677938036,759658140,16677934565,-3471,,
15273348187,747.98284,16677988624,759708723,16677985148,-3476,,
15273398556,748.03320,16678038996,759759090,16678035515,-3481,,
15273449151,748.08380,16678089593,759809682,16678086107,-3486,,
15273499751,748.13440,16678140195,759860280,16678136705,-3490,,
15273549994,748.18464,16678190452,759910532,16678186957,-3495,,
15273600265,748.23491,16678240714,759960789,16678237213,-3501,,
15273651335,748.28598,16678291786,760011856,16678288280,-3506,,
15273702363,748.33701,16678342817,760062880,16678339304,-3513,,
15273753388,748.38804,16678393844,760113903,16678390328,-3516,,
15273803594,748.43824,16678444053,760164107,16678440531,-3522,,
15273854642,748.48929,16678495103,760215151,16678491576,-3527,,
15273905657,748.54030,16678546119,760266164,16678542588,-3531,,
15273956218,748.59087,16678596684,760316722,16678593147,-3537,,
15274006784,748.64143,16678647252,760367285,16678643710,-3542,,
15274057834,748.69248,16678698304,760418333,16678694757,-3547,,
15274108863,748.74351,16678749336,760469359,16678745784,-3552,,
15274159929,748.79458,16678800403,760520422,16678796846,-3557,,
15274210575,748.84522,16678851052,760571065,16678847490,-3562,,
15274261122,748.89577,16678901602,760621610,16678898035,-3567,,
15274311672,748.94632,16678952153,760672157,16678948581,-3572,,
15274362718,748.99737,16679003202,760723200,16678999624,-3578,,
15274413757,749.04841,16679054243,760774236,16679050660,-3583,,
15274463825,749.09847,16679104314,760824302,16679100727,-3587,,
15274514902,749.14955,16679155394,760875377,16679151802,-3592,,
15274565427,749.20007,16679205931,760925909,16679202333,-3598,,
15274616475,749.25112,16679256971,760976945,16679253369,-3602,,
15274667504,749.30215,16679308003,761027970,16679304395,-3608,,
15274718114,749.35276,16679358614,761078577,16679355002,-3612,,
15274769147,749.40379,16679409649,761129607,16679406031,-3618,,
15274819693,749.45434,16679460199,761180152,16679456576,-3623,,
15274870128,749.50478,16679510636,761230583,16679507008,-3628,,
15274921211,749.55586,16679561720,761281663,16679558088,-3632,,
15274972207,749.60685,16679612720,761332658,16679609082,-3638,,
15275022273,749.65692,16679662787,761382720,16679659145,-3642,,
15275073316,749.70796,16679713834,761433760,16679710185,-3649,,
15275123868,749.75852,16679764387,761484309,16679760734,-3653,,
15275174410,749.80906,16679814932,761534850,16679811275,-3657,,
15275225027,749.85968,16679865552,761585463,16679861888,-3664,,
15275275575,749.91022,16679916102,761636008,16679912433,-3669,,
15275326180,749.96083,16679966709,761686612,16679963036,-3673,,
15275376740,750.01139,16680017272,761737169,16680013593,-3679,,
15275427297,750.06195,16680067831,761787722,16680064147,-3684,,
15275478272,750.11292,16680118807,761838694,16680115118,-3689,,
15275528954,750.16360,16680169503,761889385,16680165809,-3694,,
15275579179,750.21383,16680219719,761939596,16680216020,-3699,,
15275629540,750.26419,16680270082,761989954,16680266379,-3703,,
15275679640,750.31429,16680320185,762040051,16680316476,-3709,,
15275730612,750.36526,16680371159,762091021,16680367445,-3714,,
15275781263,750.41591,16680421812,762141669,16680418094,-3718,,
15275831871,750.46652,16680472424,762192275,16680468699,-3725,,
15275882592,750.51724,16680523146,762242993,16680519417,-3729,,
15275933142,750.56779,16680573700,762293540,16680569965,-3735,,
15275984196,750.61884,16680624755,762344591,16680621015,-3740,,
15276034793,750.66944,16680675354,762395186,16680671610,-3744,,
15276085584,750.72023,16680726149,762445975,16680722399,-3750,,
15276135633,750.77028,16680776200,762496020,16680772445,-3755,,
15276186182,750.82083,16680826755,762546572,16680822996,-3759,,
15276236776,750.87142,16680877348,762597158,16680873583,-3765,,
15276287290,750.92194,16680927864,762647670,16680924094,-3770,,
15276337664,750.97231,16680978240,762698040,16680974464,-3776,,
15276388283,751.02293,16681028861,762748657,16681025081,-3780,,
15276438922,751.07357,16681079502,762799293,16681075717,-3785,,
15276489009,751.12366,16681129591,762849377,16681125801,-3790,,
15276539613,751.17426,16681180199,762899979,16681176404,-3795,,
15276590664,751.22531,16681231251,762951027,16681227452,-3799,,
15276641236,751.27588,16681281826,763001597,16681278021,-3805,,
15276692250,751.32690,16681332842,763052608,16681329033,-3809,,
15276742851,751.37750,16681383445,763103206,16681379630,-3815,,
15276793934,751.42858,16681434532,763154287,16681430711,-3821,,
15276844506,751.47915,16681485106,763204856,16681481280,-3826,,
15276895533,751.53018,16681536135,763255881,16681532305,-3830,,
15276946592,751.58124,16681587197,763306937,16681583361,-3836,,
15276997626,751.63227,16681638233,763357968,16681634392,-3841,,
15277048676,751.68332,16681689285,763409015,16681685439,-3846,,
15277099199,751.73385,16681739811,763459535,16681735960,-3851,,
15277149272,751.78392,16681789885,763509605,16681786029,-3856,,
15277200335,751.83498,16681840952,763560666,16681837091,-3861,,
15277251370,751.88602,16681891988,763611698,16681888122,-3866,,
15277301845,751.93649,16681942466,763662171,16681938595,-3871,,
15277351896,751.98654,16681992520,763712218,16681988643,-3877,,
15277402504,752.03715,16682043129,763762824,16682039248,-3881,,
15277453027,752.08767,16682093664,763813354,16682089779,-3885,,
15277504071,752.13872,16682144702,763864386,16682140810,-3892,,
15277554642,752.18929,16682195275,763914954,16682191378,-3897,,
15277605226,752.23987,16682245861,763965535,16682241960,-3901,,
15277655812,752.29046,16682296450,764016118,16682292543,-3907,,
15277706389,752.34104,16682347029,764066692,16682343128,-3901,,
15277757475,752.39212,16682398116,764117776,16682394200,-3916,,
15277808507,752.44316,16682449152,764168806,16682445230,-3922,,
15277859429,752.49408,16682500076,764219725,16682496149,-3927,,
15277909923,752.54457,16682550572,764270215,16682546640,-3932,,
15277960140,752.59479,16682600791,764320430,16682596854,-3937,,
15278011198,752.64585,16682651852,764371485,16682647910,-3942,,
15278061840,752.69649,16682702496,764422124,16682698548,-3948,,
15278112337,752.74698,16682752995,764472619,16682749043,-3952,,
15278163427,752.79808,16682804087,764523706,16682800130,-3957,,
15278213985,752.84863,16682854660,764574273,16682850698,-3962,,
15278264560,752.89921,16682905226,764624834,16682901258,-3968,,
15278315173,752.94982,16682955840,764675455,16682951879,-3961,,
15278366250,753.00090,16683006921,764726518,16683002942,-3979,,
15278416863,753.05151,16683057535,764777127,16683053552,-3983,,
15278467228,753.10188,16683107902,764827491,16683103915,-3987,,
15278517814,753.15246,16683158492,764878075,16683154499,-3993,,
15278568350,753.20300,16683209030,764928608,16683205032,-3998,,
15278619433,753.25408,16683260115,764979688,16683256112,-4003,,
15278670454,753.30510,16683311139,765030707,16683307131,-4008,,
15278721070,753.35572,16683361757,765081319,16683357744,-4013,,
15278771640,753.40629,16683412330,765131886,16683408311,-4019,,
15278822057,753.45671,16683462749,765182302,16683458726,-4023,,
15278872638,753.50729,16683513332,765232880,16683509304,-4028,,
15278923686,753.55833,16683564383,765283925,16683560349,-4034,,
15278974748,753.60940,16683615447,765334983,16683611408,-4039,,
15279025759,753.66041,16683666460,765385992,16683662417,-4043,,
15279076778,753.71143,16683717481,765437008,16683713432,-4049,,
15279127851,753.76250,16683768556,765488078,16683764503,-4053,,
15279178409,753.81306,16683819116,765538643,16683815068,-4048,,
15279228988,753.86364,16683869709,765589220,16683865645,-4064,,
15279279795,753.91444,16683920517,765640024,16683916448,-4069,,
15279330863,753.96551,16683971579,765691079,16683967504,-4075,,
15279381969,754.01662,16684022686,765742183,16684018607,-4079,,
15279433039,754.06769,16684073759,765793251,16684069675,-4084,,
15279484069,754.11872,16684124802,765844287,16684120712,-4090,,
15279535141,754.16979,16684175866,765895347,16684171771,-4095,,
15279585945,754.22059,16684226672,765946149,16684222573,-4099,,
15279637016,754.27166,16684277746,765997216,16684273641,-4105,,
15279688063,754.32271,16684328795,766048261,16684324685,-4110,,
15279738651,754.37330,16684379386,766098847,16684375281,-4105,,
15279789696,754.42434,16684430433,766149889,16684426313,-4120,,
15279840357,754.47501,16684481095,766200546,16684476971,-4124,,
15279890937,754.52558,16684531679,766251123,16684527548,-4131,,
15279941596,754.57624,16684582339,766301780,16684578204,-4135,,
15279992186,754.62683,16684632932,766352368,16684628792,-4140,,
15280042738,754.67739,16684683486,766402916,16684679340,-4146,,
15280092885,754.72753,16684733636,766453062,16684729487,-4149,,
15280143839,754.77849,16684784592,766504012,16684780437,-4155,,
15280194879,754.82953,16684835635,766555049,16684831473,-4162,,
15280244954,754.87960,16684885723,766605133,16684881557,-4166,,
15280296035,754.93068,16684936794,766656200,16684932625,-4169,,
15280347071,754.98172,16684987833,766707233,16684983657,-4176,,
15280398093,755.03274,16685038858,766758253,16685034677,-4181,,
15280448636,755.08328,16685089403,766808793,16685085217,-4186,,
15280499192,755.13384,16685139962,766859346,16685135771,-4191,,
15280549788,755.18444,16685190559,766909939,16685186363,-4196,,
15280600685,755.23533,16685241459,766960833,16685237257,-4202,,
15280651111,755.28576,16685291887,767011257,16685287682,-4205,,
15280701661,755.33631,16685342440,767061804,16685338229,-4211,,
15280752698,755.38735,16685393480,767112838,16685389263,-4217,,
15280803263,755.43791,16685444047,767163401,16685439826,-4221,,
15280854319,755.48897,16685495105,767214455,16685490879,-4226,,
15280904853,755.53950,16685545642,767264985,16685541410,-4232,,
15280955400,755.59005,16685596191,767315529,16685591954,-4237,,
15281005958,755.64061,16685646751,767366086,16685642510,-4241,,
15281057321,755.69197,16685698117,767417445,16685693870,-4247,,
15281108089,755.74274,16685748886,767468210,16685744634,-4252,,
15281158585,755.79323,16685799386,767518704,16685795129,-4257,,
15281209170,755.84382,16685849974,767569288,16685845712,-4262,,
15281260195,755.89484,16685901000,767620309,16685896733,-4267,,
15281310751,755.94540,16685951559,767670862,16685947286,-4273,,
15281360822,755.99547,16686001631,767720930,16685997354,-4277,,
15281411361,756.04601,16686052173,767771467,16686047891,-4282,,
15281461552,756.09620,16686102367,767821654,16686098079,-4288,,
15281511820,756.14647,16686152637,767871921,16686148345,-4292,,
15281562252,756.19690,16686203071,767922350,16686198774,-4297,,
15281612810,756.24746,16686253632,767972905,16686249329,-4303,,
15281662886,756.29753,16686303710,768022978,16686299403,-4307,,
15281712960,756.34761,16686353785,768073049,16686349473,-4312,,
15281763522,756.39817,16686404350,768123608,16686400032,-4318,,
15281813927,756.44858,16686454758,768174011,16686450435,-4323,,
15281864380,756.49903,16686505223,768224472,16686500896,-4327,,
15281914922,756.54957,16686555758,768275000,16686551424,-4334,,
15281965987,756.60064,16686606825,768326062,16686602487,-4338,,
15282016594,756.65124,16686657434,768376668,16686653092,-4342,,
15282066703,756.70135,16686707546,768426774,16686703198,-4348,,
15282116915,756.75156,16686757760,768476983,16686753407,-4353,,
15282167462,756.80211,16686808309,768527527,16686803951,-4358,,
15282218066,756.85271,16686858916,768578128,16686854553,-4363,,
15282268500,756.90315,16686909352,768628559,16686904984,-4368,,
15282319097,756.95375,16686959951,768679163,16686955587,-4364,,
15282370167,757.00482,16687011024,768730222,16687006646,-4378,,
15282420729,757.05538,16687061588,768780780,16687057205,-4383,,
15282471210,757.10586,16687112071,768831258,16687107683,-4388,,
15282521689,757.15634,16687162552,768881735,16687158160,-4392,,
15282572773,757.20742,16687213639,768932816,16687209241,-4398,,
15282623315,757.25796,16687264184,768983356,16687259780,-4404,,
15282673380,757.30803,16687314251,769033418,16687309843,-4408,,
15282724416,757.35906,16687365289,769084451,16687360876,-4413,,
15282774954,757.40960,16687415830,769134987,16687411411,-4419,,
15282825524,757.46017,16687466402,769185553,16687461978,-4424,,
15282876121,757.51077,16687517001,769236149,16687512573,-4428,,
15282927171,757.56182,16687568053,769287195,16687563620,-4433,,
15282978189,757.61284,16687619074,769338210,16687614635,-4439,,
15283028757,757.66341,16687669644,769388776,16687665200,-4444,,
15283079272,757.71392,16687720162,769439289,16687715713,-4449,,
15283130305,757.76495,16687771197,769490319,16687766743,-4454,,
15283180885,757.81553,16687821780,769540896,16687817321,-4459,,
15283231931,757.86658,16687872829,769591940,16687868366,-4463,,
15283282976,757.91762,16687923886,769642993,16687919418,-4468,,
15283334035,757.96868,16687974937,769694038,16687970463,-4474,,
15283384823,758.01947,16688025726,769744822,16688021247,-4479,,
15283435864,758.07051,16688076770,769795861,16688072286,-4484,,
15283486012,758.12066,16688126921,769846006,16688122431,-4490,,
15283550772,758.18542,16688191684,769910763,16688187188,-4496,,
15283601739,758.23639,16688242653,769961727,16688238151,-4502,,
15283652840,758.28749,16688293757,770012825,16688289250,-4507,,
15283703315,758.33796,16688344234,770063297,16688339722,-4512,,
15283753374,758.38802,16688394294,770113354,16688389778,-4516,,
15283805252,758.43990,16688446175,770165229,16688441653,-4522,,
15283855721,758.49037,16688496647,770215696,16688492120,-4527,,
15283906075,758.54072,16688547003,770266047,16688542472,-4531,,
15283956668,758.59132,16688597598,770316637,16688593061,-4537,,
15284007679,758.64233,16688648612,770367645,16688644069,-4543,,
15284058256,758.69290,16688699190,770418219,16688694643,-4547,,
15284108890,758.74354,16688749828,770468851,16688745276,-4552,,
15284159928,758.79458,16688800867,770519886,16688796311,-4556,,
15284210449,758.84510,16688851390,770570404,16688846829,-4561,,
15284266957,758.90161,16688907902,770626910,16688903334,-4568,,
15284317294,758.95194,16688958241,770677244,16688953669,-4572,,
15284368108,759.00276,16689009058,770728055,16689004479,-4579,,
15284418681,759.05333,16689059632,770778625,16689055049,-4583,,
15284468980,759.10363,16689109933,770828921,16689105346,-4587,,
15284519170,759.15382,16689160127,770879109,16689155534,-4593,,
15284569913,759.20456,16689210872,770929849,16689206274,-4598,,
15284620368,759.25502,16689261330,770980301,16689256726,-4604,,
15284670667,759.30531,16689311631,771030598,16689307023,-4608,,
15284721288,759.35594,16689362254,771081216,16689357640,-4614,,
15284771694,759.40634,16689412662,771131619,16689408043,-4619,,
15284822579,759.45723,16689463549,771182502,16689458927,-4622,,
15284873117,759.50776,16689514090,771233037,16689509461,-4629,,
15284923681,759.55833,16689564657,771283598,16689560023,-4634,,
15284974351,759.60900,16689615329,771334265,16689610690,-4639,,
15285024606,759.65925,16689665586,771384518,16689660942,-4644,,
15285075200,759.70985,16689716182,771435109,16689711534,-4648,,
15285125588,759.76024,16689766572,771485494,16689761932,-4640,,
15285176108,759.81076,16689817095,771536012,16689812437,-4658,,
15285226430,759.86108,16689867419,771586331,16689862755,-4664,,
15285276765,759.91141,16689917757,771636663,16689913088,-4669,,
15285327115,759.96176,16689968108,771687011,16689963435,-4673,,
15285377545,760.01219,16690018541,771737438,16690013862,-4679,,
15285427626,760.06227,16690068625,771787516,16690063941,-4684,,
15285478062,760.11271,16690119063,771837949,16690114374,-4689,,
15285528680,760.16333,16690169684,771888565,16690164990,-4694,,
15285578955,760.21360,16690219961,771938837,16690215262,-4699,,
15285629369,760.26402,16690270376,771989247,16690265672,-4704,,
15285679747,760.31439,16690320758,772039624,16690316049,-4709,,
15285730459,760.36511,16690371471,772090333,16690366758,-4713,,
15285781094,760.41574,16690422109,772140965,16690417389,-4720,,
15285831470,760.46612,16690472488,772191339,16690467764,-4724,,
15285882214,760.51686,16690523233,772242080,16690518504,-4729,,
15285932815,760.56746,16690573838,772292679,16690569103,-4735,,
15285983110,760.61776,16690624134,772342970,16690619394,-4740,,
15286033594,760.66824,16690674620,772393452,16690669876,-4744,,
15286085442,760.72009,16690726472,772445298,16690721722,-4750,,
15286136272,760.77092,16690777304,772496124,16690772548,-4756,,
15286186815,760.82146,16690827849,772546665,16690823089,-4760,,
15286237477,760.87212,16690878513,772597324,16690873748,-4765,,
15286288494,760.92314,16690929532,772648338,16690924762,-4770,,
15286338886,760.97353,16690979927,772698727,16690975152,-4775,,
15286389840,761.02449,16691030883,772749679,16691026104,-4779,,
15286440925,761.07557,16691081971,772800762,16691077186,-4785,,
15286491130,761.12578,16691132189,772850974,16691127399,-4790,,
15286541695,761.17634,16691182746,772901526,16691177951,-4795,,
15286592049,761.22670,16691233102,772951877,16691228302,-4800,,
15286642799,761.27745,16691283865,773002635,16691279059,-4806,,
15286693580,761.32823,16691334638,773053402,16691329827,-4811,,
15286744632,761.37928,16691385692,773104464,16691380888,-4804,,
15286795569,761.43022,16691436643,773155398,16691431823,-4820,,
15286846567,761.48122,16691487632,773206382,16691482806,-4826,,
15286897651,761.53230,16691538718,773257464,16691533888,-4830,,
15286948192,761.58284,16691589261,773308001,16691584425,-4836,,
15287008737,761.64338,16691649809,773368543,16691644967,-4842,,
15287060262,761.69491,16691701337,773420065,16691696490,-4847,,
15287111290,761.74594,16691752367,773471091,16691747515,-4852,,
15287161352,761.79600,16691802431,773521149,16691797573,-4858,,
15287212400,761.84705,16691853481,773572195,16691848619,-4862,,
15287263449,761.89810,16691904533,773623241,16691899666,-4867,,
15287313998,761.94865,16691955084,773673787,16691950211,-4873,,
15287364537,761.99919,16692005626,773724324,16692000749,-4877,,
15287414607,762.04926,16692055697,773774391,16692050816,-4881,,
15287464781,762.09943,16692105875,773824563,16692100988,-4887,,
15287515855,762.15050,16692156951,773875634,16692152058,-4893,,
15287566870,762.20152,16692207968,773926646,16692203070,-4898,,
15287617619,762.25227,16692258720,773977393,16692253817,-4903,,
15287668236,762.30288,16692309339,774028007,16692304431,-4908,,
15287718755,762.35340,16692359861,774078523,16692354948,-4913,,
15287769419,762.40407,16692410527,774129184,16692405609,-4918,,
15287820366,762.45501,16692461475,774180128,16692456552,-4923,,
15287870895,762.50554,16692512008,774230655,16692507079,-4929,,
15287921458,762.55611,16692562573,774281215,16692557640,-4933,,
15287972080,762.60673,16692613197,774331834,16692608259,-4938,,
15288023555,762.65820,16692664674,774383306,16692659730,-4944,,
15288074093,762.70874,16692715215,774433843,16692710267,-4948,,
15288124140,762.75879,16692765264,774483886,16692760311,-4953,,
15288174824,762.80947,16692815951,774534568,16692810992,-4959,,
15288225735,762.86038,16692866864,774585476,16692861900,-4964,,
15288276294,762.91094,16692917426,774636032,16692912456,-4970,,
15288327331,762.96198,16692968464,774687065,16692963490,-4974,,
15288377878,763.01253,16693019014,774737610,16693014035,-4979,,
15288428429,763.06308,16693069574,774788165,16693064590,-4984,,
15288479501,763.11415,16693120642,774839228,16693115653,-4989,,
15288530065,763.16471,16693171207,774889789,16693166214,-4993,,
15288580676,763.21532,16693221822,774940397,16693216822,-5000,,
15288631657,763.26630,16693272805,774991377,16693267801,-5004,,
15288681932,763.31658,16693323082,775041649,16693318073,-5009,,
15288732980,763.36763,16693374133,775092694,16693369118,-5015,,
15288784017,763.41867,16693425172,775143729,16693420153,-5019,,
15288834559,763.46921,16693475715,775194267,16693470691,-5024,,
15288885612,763.52026,16693526772,775245317,16693521742,-5030,,
15288935665,763.57031,16693576827,775295367,16693571792,-5035,,
15288986764,763.62141,16693627929,775346465,16693622889,-5040,,
15289037251,763.67190,16693678417,775396948,16693673373,-5044,,
15289087314,763.72196,16693728482,775447008,16693723432,-5050,,
15289138362,763.77301,16693779534,775498054,16693774479,-5055,,
15289189446,763.82409,16693830620,775549136,16693825560,-5060,,
15289239992,763.87464,16693881167,775599678,16693876102,-5065,,
15289291007,763.92566,16693932185,775650690,16693927125,-5060,,
15289341185,763.97583,16693982365,775700866,16693977290,-5075,,
15289391611,764.02626,16694032793,775751289,16694027713,-5080,,
15289442150,764.07680,16694083336,775801825,16694078250,-5086,,
15289493138,764.12779,16694134326,775852812,16694129236,-5090,,
15289544036,764.17868,16694185225,775903706,16694180130,-5095,,
15289594604,764.22925,16694235797,775954271,16694230696,-5101,,
15289645143,764.27979,16694286338,776004808,16694281233,-5105,,
15289695693,764.33034,16694336890,776055355,16694331779,-5111,,
15289746269,764.38092,16694387469,776105928,16694382353,-5116,,
15289797293,764.43194,16694438494,776156949,16694433373,-5121,,
15289848347,764.48299,16694489552,776208001,16694484426,-5126,,
15289898990,764.53364,16694540197,776258642,16694535066,-5131,,
15289949583,764.58423,16694590791,776309231,16694585655,-5136,,
15290000105,764.63475,16694641317,776359751,16694636176,-5141,,
15290050829,764.68548,16694692043,776410472,16694686896,-5147,,
15290101899,764.73655,16694743115,776461539,16694737964,-5151,,
15290152990,764.78764,16694794208,776512627,16694789051,-5157,,
15290204077,764.83872,16694845298,776563713,16694840137,-5161,,
15290254590,764.88924,16694895813,776614223,16694890647,-5166,,
15290305139,764.93979,16694946365,776664769,16694941193,-5172,,
15290355695,764.99034,16694996923,776715322,16694991746,-5177,,
15290406339,765.04099,16695047569,776765963,16695042387,-5182,,
15290456924,765.09157,16695098157,776816557,16695092981,-5176,,
15290507512,765.14216,16695148758,776867142,16695143567,-5191,,
15290558581,765.19323,16695199819,776918198,16695194623,-5196,,
15290612880,765.24753,16695254119,776972493,16695248917,-5202,,
15290663407,765.29805,16695304649,777023017,16695299441,-5208,,
15290717210,765.35186,16695358454,777076817,16695353241,-5213,,
15290767755,765.40240,16695409001,777127359,16695403783,-5218,,
15290818322,765.45297,16695459571,777177924,16695454348,-5223,,
15290869365,765.50401,16695510617,777228964,16695505388,-5229,,
15290920457,765.55511,16695561710,777280053,16695556477,-5233,,
15290970954,765.60560,16695612211,777330549,16695606973,-5238,,
15291021491,765.65614,16695662750,777381083,16695657507,-5243,,
15291071553,765.70620,16695712815,777431142,16695707567,-5248,,
15291122601,765.75725,16695763864,777482186,16695758610,-5254,,
15291173136,765.80778,16695814401,777532719,16695809144,-5257,,
15291223685,765.85833,16695864954,777583266,16695859690,-5264,,
15291273743,765.90839,16695915014,777633320,16695909745,-5269,,
15291324820,765.95947,16695966093,777684395,16695960820,-5273,,
15291375913,766.01056,16696017188,777735485,16696011909,-5279,,
15291427004,766.06165,16696068282,777786574,16696062998,-5284,,
15291477523,766.11217,16696118803,777837090,16696113514,-5289,,
15291536072,766.17072,16696177354,777895635,16696172059,-5295,,
15291587500,766.22215,16696228786,777947063,16696223487,-5299,,
15291637637,766.27229,16696278925,777997195,16696273620,-5305,,
15291687684,766.32233,16696328973,778047239,16696323663,-5310,,
15291738233,766.37288,16696379525,778097786,16696374211,-5314,,
15291788281,766.42293,16696429575,778147831,16696424256,-5319,,
15291838373,766.47302,16696479670,778197921,16696474345,-5325,,
15291888916,766.52356,16696530215,778248461,16696524885,-5330,,
15291939947,766.57460,16696581249,778299489,16696575914,-5335,,
15291990488,766.62514,16696631792,778350027,16696626452,-5340,,
15292041536,766.67618,16696682843,778401072,16696677497,-5346,,
15292092072,766.72672,16696733381,778451607,16696728031,-5350,,
15292142631,766.77728,16696783942,778502163,16696778587,-5355,,
15292193698,766.82835,16696835011,778553226,16696829650,-5361,,
15292245268,766.87992,16696886584,778604794,16696881218,-5366,,
15292296309,766.93096,16696937626,778655832,16696932257,-5369,,
15292347328,766.98198,16696988648,778706848,16696983272,-5376,,
15292398387,767.03304,16697039709,778757904,16697034328,-5381,,
15292448928,767.08358,16697090254,778808444,16697084868,-5386,,
15292499974,767.13462,16697141302,778859487,16697135912,-5390,,
15292551082,767.18573,16697192411,778910591,16697187015,-5396,,
15292601571,767.23622,16697242904,778961077,16697237502,-5402,,
15292652118,767.28677,16697293452,779011622,16697288046,-5406,,
15292703129,767.33778,16697344465,779062630,16697339055,-5410,,
15292753621,767.38827,16697394960,779113119,16697389543,-5417,,
15292803670,767.43832,16697445012,779163166,16697439591,-5421,,
15292854259,767.48891,16697495603,779213752,16697490177,-5426,,
15292904820,767.53947,16697546166,779264310,16697540734,-5432,,
15292955629,767.59028,16697596977,779315116,16697591541,-5436,,
15293006614,767.64126,16697647965,779366099,16697642524,-5441,,
15293057665,767.69231,16697699019,779417148,16697693572,-5447,,
15293108200,767.74285,16697749556,779467679,16697744103,-5453,,
15293159220,767.79387,16697800579,779518697,16697795122,-5457,,
15293209751,767.84440,16697851112,779569225,16697845650,-5462,,
15293259846,767.89449,16697901208,779619317,16697895741,-5467,,
15293309986,767.94463,16697951352,779669455,16697945879,-5473,,
15293361032,767.99568,16698002399,779720498,16697996922,-5477,,
15293411107,768.04575,16698052477,779770570,16698046995,-5482,,
15293461181,768.09583,16698102553,779820641,16698097065,-5488,,
15293511729,768.14638,16698153104,779871188,16698147612,-5492,,
15293562284,768.19693,16698203661,779921739,16698198164,-5497,,
15293612852,768.24750,16698254232,779972305,16698248729,-5503,,
15293663386,768.29803,16698304768,780022836,16698299261,-5507,,
15293714483,768.34913,16698355867,780073934,16698350358,-5509,,
15293764693,768.39934,16698406080,780124138,16698400562,-5518,,
15293815736,768.45038,16698457125,780175177,16698451602,-5523,,
15293866269,768.50092,16698507660,780225709,16698502133,-5527,,
15293916836,768.55148,16698558229,780276272,16698552696,-5533,,
15293967869,768.60252,16698609265,780327302,16698603727,-5538,,
15294018432,768.65308,16698659831,780377864,16698654288,-5543,,
15294068974,768.70362,16698710375,780428402,16698704827,-5548,,
15294119499,768.75415,16698760901,780478924,16698755348,-5553,,
15294170568,768.80522,16698811974,780529990,16698806415,-5559,,
15294220618,768.85527,16698862025,780580038,16698856462,-5563,,
15294270670,768.90532,16698912080,780630088,16698906512,-5568,,
15294321705,768.95635,16698963118,780681119,16698957544,-5574,,
15294372254,769.00690,16699013668,780731666,16699008090,-5578,,
15294422312,769.05696,16699063729,780781721,16699058146,-5583,,
15294472865,769.10751,16699114285,780832271,16699108695,-5590,,
15294523901,769.15855,16699165323,780883305,16699159730,-5593,,
15294574448,769.20910,16699215872,780933849,16699210273,-5599,,
15294625005,769.25965,16699266431,780984403,16699260827,-5604,,
15294675054,769.30970,16699316483,781034449,16699310874,-5609,,
15294725607,769.36026,16699367037,781085000,16699361424,-5613,,
15294776151,769.41080,16699417585,781135541,16699411966,-5619,,
15294826699,769.46135,16699468134,781186086,16699462510,-5624,,
15294877250,769.51190,16699518688,781236635,16699513059,-5629,,
15294927795,769.56244,16699569236,781287178,16699563602,-5634,,
15294978835,769.61348,16699620277,781338214,16699614638,-5639,,
15295028894,769.66354,16699670339,781388271,16699664695,-5644,,
15295079440,769.71409,16699720887,781438814,16699715238,-5649,,
15295129967,769.76462,16699771416,781489338,16699765762,-5654,,
15295180029,769.81468,16699821481,781539397,16699815822,-5659,,
15295230696,769.86534,16699872152,781590063,16699866488,-5664,,
15295281138,769.91579,16699922595,781640501,16699916926,-5669,,
15295331672,769.96632,16699973132,781691033,16699967457,-5675,,
15295382721,770.01737,16700024183,781742079,16700018504,-5679,,
15295433258,770.06791,16700074722,781792613,16700069038,-5684,,
15295483323,770.11797,16700124790,781842675,16700119100,-5690,,
15295534369,770.16902,16700175837,781893718,16700170142,-5695,,
15295584746,770.21939,16700226216,781944093,16700220518,-5698,,
15295635769,770.27042,16700277243,781995113,16700271538,-5705,,
15295685842,770.32049,16700327317,782045183,16700321607,-5710,,
15295736222,770.37087,16700377700,782095562,16700371986,-5714,,
15295786817,770.42147,16700428298,782146153,16700422578,-5720,,
15295837444,770.47209,16700478927,782196778,16700473202,-5725,,
15295888035,770.52268,16700529520,782247366,16700523791,-5729,,
15295938581,770.57323,16700580069,782297910,16700574334,-5735,,
15295989255,770.62390,16700630745,782348580,16700625005,-5740,,
15296039817,770.67447,16700681310,782399140,16700675564,-5746,,
15296090144,770.72479,16700731639,782449465,16700725889,-5750,,
15296141183,770.77583,16700782680,782500500,16700776924,-5756,,
15296191759,770.82641,16700833259,782551074,16700827498,-5761,,
15296242342,770.87699,16700883843,782601654,16700878079,-5764,,
15296292893,770.92754,16700934397,782652202,16700928626,-5771,,
15296343890,770.97854,16700985397,782703197,16700979621,-5776,,
15296394421,771.02907,16701035929,782753724,16701030148,-5781,,
15296444485,771.07913,16701085996,782803786,16701080211,-5785,,
15296495035,771.12968,16701136548,782854332,16701130757,-5791,,
15296545582,771.18023,16701187098,782904878,16701181302,-5796,,
15296596134,771.23078,16701237652,782955428,16701231852,-5800,,
15296647051,771.28170,16701288571,783006341,16701282765,-5806,,
15296697500,771.33215,16701339022,783056787,16701333212,-5810,,
15296747556,771.38220,16701389081,783106841,16701383266,-5815,,
15296798588,771.43324,16701440115,783157870,16701434294,-5821,,
15296848647,771.48329,16701490176,783207926,16701484350,-5826,,
15296899196,771.53384,16701540728,783258472,16701534897,-5831,,
15296949246,771.58389,16701590780,783308520,16701584945,-5835,,
15296999801,771.63445,16701641337,783359072,16701635497,-5840,,
15297049862,771.68451,16701691401,783409130,16701685554,-5847,,
15297100880,771.73553,16701742421,783460146,16701736571,-5850,,
15297151384,771.78603,16701792928,783510647,16701787072,-5856,,
15297201773,771.83642,16701843320,783561034,16701837458,-5862,,
15297251903,771.88655,16701893452,783611161,16701887586,-5866,,
15297302768,771.93742,16701944330,783662034,16701938459,-5871,,
15297353429,771.98808,16701994983,783712681,16701989106,-5877,,
15297403563,772.03821,16702045118,783762812,16702039236,-5882,,
15297454110,772.08876,16702095668,783813357,16702089782,-5886,,
15297504888,772.13954,16702146449,783864132,16702140557,-5892,,
15297554970,772.18962,16702196532,783914211,16702190635,-5897,,
15297605986,772.24063,16702247550,783965225,16702241649,-5901,,
15297656037,772.29069,16702297605,784015273,16702291698,-5907,,
15297706087,772.34073,16702347656,784065320,16702341744,-5912,,
15297756623,772.39127,16702398195,784115854,16702392279,-5916,,
15297807703,772.44235,16702449277,784166931,16702443355,-5922,,
15297858742,772.49339,16702500319,784217967,16702494392,-5927,,
15297909802,772.54445,16702551381,784269024,16702545448,-5933,,
15297960331,772.59498,16702601912,784319551,16702595975,-5937,,
15298010880,772.64553,16702652463,784370097,16702646521,-5942,,
15298061446,772.69609,16702703033,784420660,16702697085,-5948,,
15298112474,772.74712,16702754063,784471686,16702748111,-5952,,
15298163023,772.79767,16702804614,784522232,16702798656,-5958,,
15298213619,772.84827,16702855213,784572825,16702849250,-5963,,
15298265140,772.89979,16702906736,784624343,16702900768,-5968,,
15298316228,772.95088,16702957826,784675429,16702951854,-5972,,
15298366726,773.00137,16703008327,784725925,16703002349,-5978,,
15298417267,773.05192,16703058870,784776463,16703052887,-5983,,
15298467822,773.10247,16703109427,784827015,16703103440,-5987,,
15298518861,773.15351,16703160469,784878052,16703154476,-5993,,
15298570712,773.20536,16703212322,784929899,16703206324,-5998,,
15298621443,773.25609,16703263056,784980627,16703257052,-6004,,
15298671494,773.30614,16703313109,785030676,16703307100,-6009,,
15298722171,773.35682,16703363787,785081350,16703357774,-6013,,
15298773137,773.40778,16703414756,785132312,16703408737,-6019,,
15298824175,773.45882,16703465797,785183349,16703459773,-6024,,
15298875218,773.50987,16703516842,785234389,16703510814,-6028,,
15298925750,773.56040,16703567377,785284918,16703561343,-6034,,
15298976295,773.61094,16703617924,785335460,16703611885,-6039,,
15299027363,773.66201,16703668994,785386527,16703662952,-6042,,
15299078504,773.71315,16703720138,785437664,16703714089,-6049,,
15299129472,773.76412,16703771108,785488629,16703765054,-6054,,
15299180523,773.81517,16703822161,785539677,16703816101,-6060,,
15299231630,773.86628,16703873271,785590783,16703867207,-6064,,
15299282621,773.91727,16703924263,785641770,16703918194,-6069,,
15299336021,773.97067,16703977667,785695167,16703971592,-6075,,
15299386867,774.02152,16704028515,785746010,16704022435,-6080,,
15299437749,774.07240,16704079399,785796889,16704073314,-6085,,
15299488785,774.12343,16704130438,785847923,16704124348,-6090,,
15299538848,774.17350,16704180503,785897984,16704174408,-6095,,
15299589926,774.22457,16704231583,785949058,16704225482,-6101,,
15299640936,774.27558,16704282595,786000066,16704276490,-6105,,
15299691504,774.32615,16704333166,786050632,16704327056,-6110,,
15299742061,774.37671,16704383726,786101185,16704377610,-6116,,
15299793089,774.42774,16704434755,786152211,16704428635,-6120,,
15299844437,774.47909,16704486105,786203556,16704479981,-6124,,
15299895206,774.52985,16704536878,786254323,16704530747,-6131,,
15299945763,774.58041,16704587437,786304876,16704581300,-6137,,
15299996303,774.63095,16704637979,786355414,16704631839,-6140,,
15300046718,774.68137,16704688397,786405827,16704682251,-6146,,
15300097265,774.73191,16704738945,786456370,16704732794,-6151,,
15300148271,774.78292,16704789955,786507375,16704783799,-6156,,
15300199314,774.83396,16704840999,786558414,16704834838,-6161,,
15300250386,774.88503,16704892074,786609484,16704885908,-6166,,
15300301778,774.93643,16704943469,786660872,16704937297,-6172,,
15300351995,774.98664,16704993688,786711088,16704987513,-6175,,
15300402999,775.03765,16705044693,786762088,16705038512,-6181,,
15300453559,775.08821,16705095256,786812645,16705089070,-6186,,
15300504596,775.13924,16705146295,786863680,16705140104,-6191,,
15300555144,775.18979,16705196845,786914225,16705190650,-6195,,
15300605740,775.24039,16705247445,786964818,16705241243,-6202,,
15300656606,775.29125,16705298313,787015682,16705292106,-6207,,
15300707215,775.34186,16705348935,787066603,16705343029,-5906,,
15300758252,775.39290,16705399963,787117322,16705393746,-6217,,
15300809901,775.44455,16705451614,787168968,16705445393,-6221,,
15300860786,775.49543,16705502502,787219850,16705496274,-6228,,
15300910911,775.54556,16705552630,787269973,16705546398,-6232,,
15300962407,775.59705,16705604128,787321467,16705597891,-6237,,
15301013431,775.64808,16705655155,787372488,16705648912,-6243,,
15301064491,775.69914,16705706217,787423545,16705699969,-6248,,
15301115041,775.74969,16705756769,787474092,16705750517,-6252,,
15301166096,775.80074,16705807826,787525144,16705801568,-6258,,
15301216739,775.85139,16705858472,787575784,16705852229,-6243,,
15301267700,775.90235,16705909436,787626743,16705903168,-6268,,
15301318775,775.95342,16705960513,787677815,16705954240,-6273,,
15301369314,776.00396,16706011054,787728352,16706004776,-6278,,
15301423748,776.05840,16706065491,787782783,16706059207,-6284,,
15301475279,776.10993,16706117023,787834311,16706110735,-6288,,
15301525876,776.16052,16706167623,787884905,16706161329,-6294,,
15301576961,776.21161,16706218710,787935987,16706212411,-6299,,
15301627759,776.26241,16706269510,787986782,16706263207,-6303,,
15301678578,776.31323,16706320332,788037599,16706314023,-6309,,
15301729025,776.36367,16706370782,788088043,16706364468,-6314,,
15301779511,776.41416,16706421270,788138526,16706414950,-6320,,
15301830592,776.46524,16706472353,788189605,16706466029,-6324,,
15301880888,776.51554,16706522651,788239898,16706516322,-6329,,
15301931773,776.56642,16706573539,788290781,16706567205,-6334,,
15301981898,776.61655,16706623667,788340904,16706617328,-6339,,
15302032474,776.66712,16706674245,788391476,16706667901,-6344,,
15302083138,776.71779,16706724912,788442137,16706718562,-6350,,
15302133510,776.76816,16706775285,788492506,16706768930,-6355,,
15302184065,776.81871,16706825842,788543059,16706819484,-6358,,
15302234618,776.86927,16706876399,788593609,16706870034,-6365,,
15302285395,776.92004,16706927177,788644383,16706920807,-6370,,
15302335909,776.97056,16706977694,788694895,16706971319,-6375,,
15302386445,777.02109,16707028233,788745428,16707021853,-6380,,
15302437483,777.07213,16707079273,788796463,16707072888,-6385,,
15302487557,777.12221,16707129349,788846534,16707122958,-6391,,
15302538579,777.17323,16707180373,788897554,16707173978,-6395,,
15302588688,777.22334,16707230485,788947660,16707224085,-6400,,
15302639195,777.27384,16707280994,788998164,16707274589,-6405,,
15302690238,777.32489,16707332040,789049206,16707325630,-6410,,
15302740785,777.37543,16707382588,789099749,16707376173,-6415,,
15302791368,777.42602,16707433174,789150330,16707426755,-6419,,
15302841999,777.47665,16707483808,789200958,16707477382,-6426,,
15302892794,777.52744,16707534604,789251750,16707528174,-6430,,
15302943368,777.57802,16707585182,789302321,16707578745,-6437,,
15302993869,777.62852,16707635685,789352819,16707629244,-6441,,
15303044479,777.67913,16707686297,789403428,16707679852,-6445,,
15303095216,777.72986,16707737036,789454161,16707730585,-6451,,
15303145999,777.78065,16707787822,789504942,16707781366,-6456,,
15303196602,777.83125,16707838427,789555542,16707831966,-6461,,
15303247633,777.88228,16707889461,789606570,16707882995,-6466,,
15303298618,777.93327,16707940448,789657552,16707933977,-6471,,
15303349660,777.98431,16707991492,789708592,16707985016,-6476,,
15303400682,778.03533,16708042516,789759611,16708036035,-6481,,
15303451236,778.08588,16708093073,789810163,16708086587,-6486,,
15303501844,778.13649,16708143682,789860767,16708137191,-6491,,
15303552899,778.18755,16708194740,789911818,16708188243,-6497,,
15303603968,778.23862,16708245811,789962886,16708239310,-6501,,
15303654991,778.28964,16708296837,790013906,16708290330,-6507,,
15303705542,778.34019,16708347391,790064454,16708340879,-6512,,
15303756079,778.39073,16708397930,790114989,16708391414,-6516,,
15303807163,778.44181,16708449017,790166071,16708442495,-6522,,
15303858215,778.49286,16708500071,790217120,16708493544,-6527,,
15303909199,778.54385,16708551057,790268100,16708544525,-6532,,
15303960285,778.59493,16708602157,790319196,16708595620,-6537,,
15304010879,778.64553,16708652742,790369775,16708646200,-6542,,
15304061785,778.69643,16708703650,790420678,16708697102,-6548,,
15304112017,778.74667,16708753885,790470908,16708747333,-6552,,
15304162580,778.79723,16708804450,790521468,16708797892,-6558,,
15304213182,778.84783,16708855054,790572067,16708848491,-6563,,
15304263782,778.89843,16708905656,790622664,16708899088,-6568,,
15304314323,778.94897,16708956200,790673203,16708949628,-6572,,
15304364885,778.99953,16709006764,790723762,16709000186,-6578,,
15304415912,779.05056,16709057793,790774786,16709051211,-6582,,
15304466867,779.10151,16709108751,790825739,16709102164,-6587,,
15304517436,779.15208,16709159323,790876305,16709152729,-6594,,
15304568464,779.20311,16709210352,790927330,16709203754,-6598,,
15304619499,779.25415,16709261389,790978362,16709254786,-6603,,
15304669560,779.30421,16709311454,791028421,16709304846,-6608,,
15304720098,779.35475,16709361994,791078957,16709355381,-6613,,
15304771024,779.40567,16709412922,791129879,16709406303,-6619,,
15304821108,779.45576,16709463009,791179962,16709456386,-6623,,
15304871648,779.50630,16709513551,791230498,16709506923,-6628,,
15304922187,779.55683,16709564093,791281034,16709557459,-6634,,
15304972735,779.60738,16709614643,791331580,16709608004,-6639,,
15305023553,779.65820,16709665463,791382396,16709658820,-6643,,
15305074137,779.70879,16709716049,791432976,16709709400,-6649,,
15305124706,779.75935,16709766620,791483542,16709759966,-6654,,
15305174883,779.80953,16709816799,791533717,16709810141,-6658,,
15305225576,779.86022,16709867495,791584407,16709860831,-6664,,
15305276170,779.91082,16709918092,791634999,16709911423,-6669,,
15305327200,779.96185,16709969123,791686026,16709962451,-6672,,
15305378223,780.01287,16710020150,791737046,16710013470,-6680,,
15305441847,780.07650,16710083776,791800666,16710077090,-6686,,
15305492859,780.12751,16710134790,791851676,16710128100,-6690,,
15305543939,780.17859,16710185872,791902753,16710179177,-6695,,
15305594992,780.22964,16710236928,791953803,16710230227,-6701,,
15305646013,780.28066,16710287951,792004821,16710281245,-6706,,
15305697776,780.33242,16710339718,792056583,16710333007,-6711,,
15305752417,780.38707,16710394360,792111220,16710387645,-6715,,
15305802621,780.43727,16710444566,792161421,16710437845,-6721,,
15305856229,780.49088,16710498177,792215025,16710491450,-6727,,
15305909791,780.54444,16710551741,792268585,16710545010,-6731,,
15305965401,780.60005,16710607355,792324192,16710600617,-6738,,
15306022113,780.65676,16710664070,792380901,16710657326,-6744,,
15306072378,780.70703,16710714336,792431163,16710707588,-6748,,
15306122891,780.75754,16710764852,792481674,16710758098,-6754,,
15306173470,780.80812,16710815433,792532250,16710808675,-6758,,
15306223798,780.85845,16710865764,792582576,16710859001,-6763,,
15306274416,780.90906,16710916384,792633191,16710909616,-6768,,
15306324995,780.95964,16710966965,792683767,16710960191,-6774,,
15306378300,781.01295,16711020272,792737069,16711013493,-6779,,
15306428923,781.06357,16711070898,792787689,16711064114,-6784,,
15306479511,781.11416,16711121489,792838275,16711114700,-6789,,
15306530145,781.16479,16711172124,792888906,16711165331,-6793,,
15306581673,781.21632,16711223655,792940431,16711216856,-6799,,
15306631931,781.26658,16711273915,792990687,16711267111,-6804,,
15306682391,781.31704,16711324377,793041144,16711317569,-6808,,
15306732877,781.36753,16711374866,793091627,16711368051,-6815,,
15306783952,781.41860,16711425943,793142700,16711419124,-6819,,
15306834443,781.46909,16711476436,793193188,16711469612,-6824,,
15306885187,781.51983,16711527183,793243929,16711520353,-6830,,
15306935627,781.57028,16711577626,793294366,16711570791,-6835,,
15306986280,781.62093,16711628281,793345017,16711621442,-6839,,
15307037195,781.67184,16711679198,793395929,16711672354,-6844,,
15307087482,781.72213,16711729487,793446213,16711722638,-6849,,
15307137779,781.77243,16711779787,793496508,16711772932,-6855,,
15307188355,781.82300,16711830366,793547082,16711823506,-6860,,
15307238693,781.87334,16711880705,793597416,16711873840,-6865,,
15307288967,781.92362,16711930983,793647688,16711924113,-6870,,
15307339510,781.97416,16711981527,793698228,16711974652,-6875,,
15307390023,782.02467,16712032042,793748738,16712025163,-6879,,
15307440589,782.07524,16712082611,793799301,16712075725,-6886,,
15307491189,782.12584,16712133214,793849900,16712126324,-6890,,
15307541551,782.17620,16712183578,793900259,16712176683,-6895,,
15307591876,782.22652,16712233906,793950581,16712227005,-6901,,
15307642288,782.27694,16712284320,794000991,16712277415,-6905,,
15307692965,782.32761,16712334998,794051664,16712328089,-6909,,
15307743650,782.37830,16712385686,794102346,16712378770,-6916,,
15307793939,782.42859,16712435978,794152634,16712429058,-6920,,
15307844339,782.47899,16712486379,794203030,16712479455,-6924,,
15307894670,782.52932,16712536714,794253358,16712529783,-6931,,
15307945218,782.57987,16712587264,794303903,16712580328,-6936,,
15307995467,782.63012,16712637514,794354149,16712630574,-6940,,
15308045966,782.68061,16712688017,794404646,16712681070,-6947,,
15308096290,782.73094,16712738342,794454967,16712731391,-6951,,
15308146784,782.78143,16712788839,794505459,16712781884,-6955,,
15308197118,782.83177,16712839175,794555790,16712832214,-6961,,
15308247684,782.88233,16712889743,794606353,16712882777,-6966,,
15308298106,782.93275,16712940168,794656773,16712933197,-6971,,
15308348569,782.98322,16712990634,794707233,16712983658,-6976,,
15308398937,783.03359,16713041003,794757598,16713034023,-6980,,
15308449345,783.08399,16713091414,794808003,16713084427,-6987,,
15308499668,783.13432,16713141740,794858324,16713134749,-6991,,
15308550329,783.18498,16713192402,794908982,16713185407,-6995,,
15308786039,783.42069,16713428124,795144679,16713421103,-7021,16713426794,
15308811608,783.44626,16713453693,795170247,16713446700,-6993,,
15308862588,783.49724,16713504676,795221224,16713497735,-6941,,
15308913129,783.54778,16713555220,795271764,16713548331,-6889,,
15308963699,783.59835,16713605791,795322330,16713598955,-6836,,
15309014257,783.64891,16713656353,795372885,16713649569,-6784,,
15309065303,783.69995,16713707401,795423930,16713700671,-6730,,
15309115825,783.75047,16713757926,795474448,16713751247,-6679,,
15309165898,783.80055,16713808001,795524518,16713801374,-6627,,
15309216948,783.85160,16713859053,795575566,16713852479,-6574,,
15309267960,783.90261,16713910068,795626575,16713903547,-6521,,
15309319008,783.95366,16713961118,795677620,16713954651,-6467,,
15309369986,784.00463,16714012097,795728595,16714005683,-6414,,
15309420068,784.05472,16714062183,795778676,16714055821,-6362,,
15309471095,784.10574,16714113212,795829699,16714106903,-6309,,
15309521254,784.15590,16714163373,795879855,16714157116,-6257,,
15309571778,784.20643,16714213900,795930377,16714207694,-6206,,
15309621887,784.25653,16714264011,795980484,16714257858,-6153,,
15309672373,784.30702,16714314499,796030966,16714308399,-6100,,
15309722494,784.35714,16714364623,796081084,16714358574,-6049,,
15309773282,784.40793,16714415423,796131881,16714409428,-5995,,
15309823958,784.45861,16714466091,796182543,16714460148,-5943,,
15309874883,784.50953,16714517019,796233466,16714511128,-5891,,
15309925909,784.56056,16714568047,796284489,16714562211,-5836,,
15309976854,784.61150,16714618995,796335431,16714613211,-5784,,
15310027924,784.66257,16714670066,796386498,16714664335,-5731,,
15310078444,784.71309,16714720589,796437015,16714714910,-5679,,
15310129320,784.76397,16714771469,796487890,16714765843,-5626,,
15310180353,784.81500,16714822503,796538919,16714816930,-5573,,
15310230918,784.86557,16714873070,796589482,16714867550,-5520,,
15310281466,784.91611,16714923631,796640037,16714918162,-5469,,
15310332054,784.96670,16714974220,796690622,16714968806,-5414,,
15310382589,785.01724,16715024748,796741144,16715019385,-5363,,
15310433612,785.06826,16715075774,796792164,16715070464,-5310,,
15310483718,785.11837,16715125882,796842268,16715120625,-5257,,
15310534330,785.16898,16715176496,796892877,16715171290,-5206,,
15310584916,785.21956,16715227085,796943460,16715221932,-5153,,
15310635468,785.27012,16715277639,796994010,16715272539,-5100,,
15310686018,785.32067,16715328192,797044558,16715323144,-5048,,
15310736675,785.37132,16715378851,797095212,16715373856,-4995,,
15310787674,785.42232,16715429852,797146208,16715424910,-4942,,
15310838214,785.47286,16715480395,797196753,16715475513,-4882,,
15310889249,785.52390,16715531433,797247778,16715526596,-4837,,
15310939297,785.57394,16715581483,797297823,16715576697,-4786,,
15310989847,785.62450,16715632035,797348371,16715627303,-4732,,
15311039893,785.67454,16715682083,797398413,16715677402,-4681,,
15311089941,785.72459,16715732132,797448458,16715727512,-4620,,
15311140489,785.77514,16715782684,797499004,16715778108,-4576,,
15311190561,785.82521,16715832758,797549073,16715828234,-4524,,
15311241142,785.87579,16715883341,797599652,16715878870,-4471,,
15311291638,785.92629,16715933840,797650144,16715929420,-4420,,
15311342208,785.97686,16715984411,797700712,16715980045,-4366,,
15311393243,786.02789,16716035449,797751744,16716031136,-4313,,
15311443833,786.07848,16716086042,797802331,16716081781,-4261,,
15311494551,786.12920,16716136761,797853047,16716132554,-4207,,
15311544931,786.17958,16716187143,797903424,16716182988,-4155,,
15311595701,786.23035,16716237917,797954192,16716233814,-4103,,
15311646246,786.28089,16716288463,798004733,16716284412,-4051,,
15311696305,786.33095,16716338526,798054790,16716334527,-3999,,
15311746857,786.38150,16716389080,798105339,16716385134,-3946,,
15311797403,786.43205,16716439628,798155882,16716435734,-3894,,
15311848441,786.48309,16716490669,798206919,16716486828,-3841,,
15311900004,786.53465,16716542234,798258479,16716538447,-3787,,
15311950538,786.58519,16716592770,798309010,16716589036,-3734,,
15312001096,786.63574,16716643330,798359564,16716639647,-3683,,
15312051648,786.68630,16716693885,798410115,16716690256,-3629,,
15312102185,786.73683,16716744424,798460648,16716740847,-3577,,
15312153244,786.78789,16716795486,798511704,16716791961,-3525,,
15312203794,786.83844,16716846037,798562252,16716842566,-3471,,
15312254844,786.88949,16716897090,798613299,16716893671,-3419,,
15312305816,786.94046,16716948064,798664268,16716944699,-3365,,
15312356364,786.99101,16716998615,798714813,16716995301,-3314,,
15312406781,787.04143,16717049035,798765228,16717045774,-3261,,
15312457329,787.09198,16717099584,798815773,16717096376,-3208,,
15312507878,787.14253,16717150135,798866319,16717146979,-3156,,
15312558486,787.19313,16717200747,798916925,16717197644,-3103,,
15312609084,787.24373,16717251346,798967520,16717248296,-3050,,
15312659646,787.29429,16717301911,799018080,16717298913,-2998,,
15312710631,787.34528,16717352898,799069072,16717349964,-2934,,
15312761240,787.39589,16717403509,799119668,16717400618,-2891,,
15312811772,787.44642,16717454044,799170198,16717451204,-2840,,
15312861820,787.49647,16717504095,799220243,16717501306,-2789,,
15312912369,787.54702,16717554646,799270790,16717551911,-2735,,
15312962922,787.59757,16717605200,799321339,16717602517,-2683,,
15313013481,787.64813,16717655763,799371895,16717653132,-2631,,
15313064514,787.69916,16717706798,799422927,16717704221,-2577,,
15313115065,787.74971,16717757352,799473474,16717754825,-2527,,
15313165626,787.80027,16717807915,799524033,16717805442,-2473,,
15313216175,787.85082,16717858466,799574578,16717856046,-2420,,
15313267222,787.90187,16717909516,799625623,16717907149,-2367,,
15313317920,787.95257,16717960216,799676319,16717957901,-2315,,
15313368216,788.00286,16718010513,799726611,16718008251,-2262,,
15313419252,788.05390,16718061552,799777645,16718059343,-2209,,
15313469814,788.10446,16718112117,799828204,16718109960,-2157,,
15313520202,788.15485,16718162517,799878599,16718160412,-2105,,
15313570821,788.20547,16718213129,799929205,16718211076,-2053,,
15313621834,788.25648,16718264144,799980217,16718262145,-1999,,
15313672432,788.30708,16718314744,800030812,16718312798,-1946,,
15313723031,788.35768,16718365345,800081407,16718363451,-1894,,
15313773630,788.40828,16718415947,800132005,16718414106,-1841,,
15313824654,788.45930,16718466974,800183035,16718465152,-1822,,
15313875746,788.51039,16718518068,800234114,16718516231,-1837,,
15313926825,788.56147,16718569149,800285191,16718567307,-1842,,
15313977890,788.61254,16718620217,800336253,16718618370,-1847,,
15314028993,788.66364,16718671322,800387354,16718669470,-1852,,
15314080070,788.71472,16718722400,800438427,16718720543,-1857,,
15314130658,788.76531,16718772991,800489013,16718771129,-1862,,
15314181697,788.81634,16718824033,800540049,16718822166,-1867,,
15314232756,788.86740,16718875094,800591105,16718873222,-1872,,
15314283594,788.91824,16718925934,800641940,16718924056,-1878,,
15314333756,788.96840,16718976099,800692101,16718974217,-1882,,
15314384325,789.01897,16719026671,800742666,16719024783,-1888,,
15314434866,789.06951,16719077214,800793204,16719075321,-1893,,
15314485542,789.12019,16719127893,800843879,16719125995,-1898,,
15314535947,789.17060,16719178300,800894280,16719176397,-1903,,
15314587007,789.22166,16719229362,800945337,16719227453,-1909,,
15314637542,789.27219,16719279898,800995869,16719277985,-1913,,
15314687792,789.32244,16719330152,801046118,16719328234,-1918,,
15314737912,789.37256,16719380274,801096234,16719378351,-1923,,
15314788909,789.42356,16719431273,801147229,16719429345,-1928,,
15314839937,789.47459,16719482303,801198254,16719480370,-1933,,
15314890965,789.52561,16719533333,801249279,16719531395,-1938,,
15314941554,789.57620,16719583925,801299865,16719581982,-1943,,
15314992107,789.62676,16719634481,801350415,16719632531,-1950,,
15315042651,789.67730,16719685027,801400957,16719683074,-1953,,
15315093161,789.72781,16719735539,801451464,16719733581,-1958,,
15315144358,789.77901,16719786738,801502657,16719784774,-1964,,
15315195289,789.82994,16719837673,801553589,16719835705,-1968,,
15315246299,789.88095,16719888685,801604594,16719886711,-1974,,
15315296853,789.93150,16719939241,801655145,16719937262,-1979,,
15315347901,789.98255,16719990291,801706191,16719988307,-1984,,
15315398800,790.03345,16720041192,801757087,16720039203,-1989,,
15315448872,790.08352,16720091266,801807156,16720089273,-1993,,
15315499409,790.13406,16720141806,801857691,16720139807,-1999,,
15315549851,790.18450,16720192251,801908130,16720190246,-2005,,
15315600231,790.23488,16720242633,801958508,16720240624,-2009,,
15315651118,790.28577,16720293522,802009392,16720291509,-2013,,
15315701628,790.33628,16720344035,802059899,16720342015,-2020,,
15315752069,790.38672,16720394478,802110338,16720392454,-2024,,
15315802784,790.43743,16720445195,802161049,16720443166,-2029,,
15315853845,790.48849,16720496269,802212118,16720494235,-2034,,
15315904894,790.53954,16720547310,802263155,16720545271,-2039,,
15315955500,790.59015,16720597929,802313768,16720595885,-2044,,
15316006510,790.64116,16720648931,802364764,16720646881,-2050,,
15316057103,790.69175,16720699525,802415354,16720697471,-2054,,
15316107768,790.74242,16720750194,802466017,16720748134,-2060,,
15316158361,790.79301,16720800789,802516608,16720798724,-2065,,
15316209385,790.84403,16720851825,802567639,16720849755,-2070,,
15316260430,790.89508,16720902863,802618671,16720900788,-2075,,
15316311451,790.94610,16720953886,802669690,16720951806,-2080,,
15316362015,790.99666,16721004451,802720250,16721002366,-2085,,
15316412555,791.04720,16721054995,802770788,16721052904,-2091,,
15316463111,791.09776,16721105553,802821341,16721103458,-2095,,
15316514139,791.14879,16721156584,802872367,16721154483,-2101,,
15316564192,791.19884,16721206639,802922417,16721204533,-2106,,
15316614808,791.24946,16721257257,802973031,16721255147,-2110,,
15316665348,791.30000,16721307799,803023567,16721305684,-2115,,
15316715500,791.35015,16721357954,803073716,16721355832,-2122,,
15316765975,791.40062,16721408431,803124189,16721406306,-2125,,
15316816550,791.45120,16721459009,803174761,16721456878,-2131,,
15316867617,791.50226,16721510077,803225825,16721507942,-2135,,
15316918624,791.55327,16721561099,803276842,16721558958,-2141,,
15316969253,791.60390,16721611719,803327457,16721609573,-2146,,
15317020294,791.65494,16721662761,803378494,16721660610,-2151,,
15317070833,791.70548,16721713314,803429042,16721711159,-2155,,
15317121411,791.75606,16721763884,803479607,16721761723,-2161,,
15317171949,791.80660,16721814424,803530141,16721812258,-2166,,
15317222998,791.85765,16721865475,803581187,16721863303,-2172,,
15317274054,791.90870,16721916534,803632241,16721914357,-2177,,
15317325130,791.95978,16721967612,803683315,16721965432,-2180,,
15317376169,792.01082,16722018654,803734350,16722016467,-2187,,
15317427192,792.06184,16722069679,803785370,16722067487,-2192,,
15317478048,792.11270,16722120537,803836223,16722118340,-2197,,
15317528941,792.16359,16722171433,803887114,16722169231,-2202,,
15317580073,792.21472,16722222566,803938243,16722220359,-2207,,
15317630272,792.26492,16722272767,803988439,16722270555,-2212,,
15317680414,792.31506,16722322913,804038579,16722320696,-2217,,
15317730472,792.36512,16722372973,804088635,16722370751,-2222,,
15317781026,792.41567,16722423529,804139185,16722421302,-2227,,
15317832371,792.46702,16722474877,804190529,16722472645,-2232,,
15317882633,792.51728,16722525141,804240787,16722522904,-2237,,
15317933182,792.56783,16722575693,804291333,16722573449,-2244,,
15317983705,792.61835,16722626218,804341854,16722623970,-2248,,
15318034264,792.66891,16722676778,804392410,16722674527,-2251,,
15318084337,792.71898,16722726854,804442480,16722724596,-2258,,
15318135393,792.77004,16722777913,804493533,16722775650,-2263,,
15318186412,792.82106,16722828934,804544550,16722826667,-2267,,
15318237448,792.87210,16722879973,804595583,16722877700,-2273,,
15318290158,792.92481,16722932684,804648290,16722930406,-2278,,
15318342751,792.97740,16722985280,804700880,16722982996,-2284,,
15318393099,793.02775,16723035631,804751227,16723033343,-2288,,
15318443165,793.07781,16723085698,804801289,16723083405,-2293,,
15318494222,793.12887,16723136759,804852344,16723134460,-2299,,
15318544739,793.17939,16723187278,804902857,16723184974,-2304,,
15318594803,793.22945,16723237343,804952919,16723235036,-2307,,
15318645350,793.28000,16723287893,805003463,16723285579,-2314,,
15318696408,793.33106,16723338953,805054518,16723336635,-2318,,
15318747461,793.38211,16723390009,805105569,16723387686,-2323,,
15318798500,793.43315,16723441051,805156606,16723438722,-2329,,
15318849535,793.48418,16723492088,805207638,16723489755,-2333,,
15318900104,793.53475,16723542660,805258204,16723540320,-2340,,
15318951146,793.58579,16723593703,805309243,16723591359,-2344,,
15319002179,793.63683,16723644739,805360274,16723642390,-2349,,
15319052732,793.68738,16723695295,805410823,16723692940,-2355,,
15319103280,793.73793,16723745845,805461369,16723743485,-2360,,
15319154387,793.78904,16723796954,805512474,16723794590,-2364,,
15319204906,793.83955,16723847475,805562989,16723845105,-2370,,
15319255947,793.89059,16723898518,805614027,16723896143,-2375,,
15319306498,793.94115,16723949072,805664576,16723946693,-2379,,
15319356549,793.99120,16723999126,805714624,16723996741,-2385,,
15319407101,794.04175,16724049679,805765173,16724047290,-2389,,
15319457641,794.09229,16724100222,805815712,16724097829,-2393,,
15319508177,794.14283,16724150761,805866244,16724148361,-2400,,
15319558792,794.19344,16724201378,805916857,16724198973,-2405,,
15319609793,794.24444,16724252382,805967854,16724249971,-2411,,
15319660389,794.29504,16724302980,806018448,16724300565,-2415,,
15319710941,794.34559,16724353534,806068997,16724351114,-2420,,
15319761522,794.39617,16724404118,806119575,16724401692,-2426,,
15319812055,794.44670,16724454653,806170107,16724452223,-2430,,
15319862947,794.49760,16724505546,806220995,16724503111,-2435,,
15319913531,794.54818,16724556134,806271577,16724553693,-2441,,
15319964089,794.59874,16724606694,806322132,16724604248,-2446,,
15320015170,794.64982,16724657777,806373211,16724655327,-2450,,
15320066187,794.70083,16724708797,806424224,16724706341,-2456,,
15320117175,794.75182,16724759787,806475220,16724757336,-2451,,
15320167921,794.80257,16724810535,806525953,16724808070,-2465,,
15320218502,794.85315,16724861119,806576531,16724858648,-2471,,
15320269557,794.90421,16724912186,806627594,16724909710,-2476,,
15320320102,794.95475,16724962734,806678135,16724960252,-2482,,
15320371139,795.00579,16725013763,806729160,16725011277,-2486,,
15320421719,795.05637,16725064344,806779737,16725061853,-2491,,
15320472221,795.10687,16725114850,806830236,16725112353,-2497,,
15320522282,795.15693,16725164913,806880296,16725162412,-2501,,
15320572830,795.20748,16725215463,806930841,16725212957,-2506,,
15320623428,795.25808,16725266063,806981435,16725263551,-2512,,
15320674471,795.30912,16725317109,807032475,16725314592,-2517,,
15320724820,795.35947,16725367460,807082822,16725364939,-2521,,
15320775868,795.41052,16725418511,807133868,16725415984,-2527,,
15320826403,795.46105,16725469048,807184410,16725466527,-2521,,
15320877475,795.51212,16725520122,807235469,16725517585,-2537,,
15320928060,795.56271,16725570710,807286051,16725568168,-2542,,
15320978658,795.61331,16725621310,807336647,16725618764,-2546,,
15321029696,795.66434,16725672351,807387693,16725669810,-2541,,
15321080262,795.71491,16725722919,807438245,16725720361,-2558,,
15321131311,795.76596,16725773970,807489291,16725771408,-2562,,
15321181881,795.81653,16725824543,807539858,16725821975,-2568,,
15321232927,795.86757,16725875591,807590902,16725873019,-2572,,
15321283958,795.91861,16725926623,807641940,16725924056,-2567,,
15321334517,795.96916,16725977186,807692486,16725974602,-2584,,
15321385562,796.02021,16726028233,807743528,16726025656,-2577,,
15321436144,796.07079,16726078817,807794109,16726076225,-2592,,
15321486963,796.12161,16726129639,807844925,16726127041,-2598,,
15321537562,796.17221,16726180239,807895531,16726177647,-2592,,
15321588674,796.22332,16726231355,807946630,16726228747,-2608,,
15321639256,796.27390,16726281938,807997219,16726279336,-2602,,
15321689368,796.32402,16726332053,808047318,16726329446,-2607,,
15321740424,796.37507,16726383112,808098371,16726380488,-2624,,
15321791474,796.42612,16726434164,808149419,16726431536,-2628,,
15321842048,796.47670,16726484740,808199991,16726482107,-2633,,
15321893026,796.52767,16726535721,808250965,16726533082,-2639,,
15321943926,796.57857,16726586623,808301863,16726583980,-2643,,
15321994502,796.62915,16726637201,808352437,16726634553,-2648,,
15322045551,796.68020,16726688252,808403482,16726685598,-2654,,
15322096563,796.73121,16726739267,808454492,16726736608,-2659,,
15322147567,796.78221,16726790273,808505493,16726787620,-2653,,
15322198165,796.83281,16726840874,808556088,16726838205,-2669,,
15322248765,796.88341,16726891476,808606686,16726888802,-2674,,
15322299785,796.93443,16726942498,808657702,16726939818,-2680,,
15322350049,796.98470,16726992764,808707964,16726990080,-2684,,
15322400188,797.03484,16727042906,808758100,16727040216,-2690,,
15322451183,797.08583,16727093903,808809092,16727091208,-2695,,
15322501246,797.13589,16727143969,808859153,16727141269,-2700,,
15322551820,797.18647,16727194545,808909725,16727191841,-2704,,
15322602813,797.23746,16727245541,808960714,16727242830,-2711,,
15322653405,797.28805,16727296134,809011304,16727293421,-2713,,
15322704025,797.33867,16727346756,809061921,16727344037,-2719,,
15322754636,797.38928,16727397371,809112529,16727394645,-2726,,
15322804828,797.43948,16727447565,809162719,16727444835,-2730,,
15322855411,797.49006,16727498149,809213299,16727495416,-2733,,
15322906256,797.54090,16727548997,809264141,16727546257,-2740,,
15322957327,797.59198,16727600070,809315209,16727597325,-2745,,
15323008023,797.64267,16727650770,809365903,16727648020,-2750,,
15323059074,797.69372,16727701823,809416951,16727699067,-2756,,
15323109624,797.74427,16727752385,809467509,16727749625,-2760,,
15323160193,797.79484,16727802946,809518064,16727800180,-2766,,
15323211257,797.84591,16727854012,809569126,16727851242,-2770,,
15323262263,797.89691,16727905021,809620129,16727902246,-2775,,
15323312856,797.94750,16727955617,809670720,16727952836,-2781,,
15323363435,797.99808,16728006198,809721296,16728003412,-2786,,
15323413593,798.04824,16728056358,809771452,16728053568,-2790,,
15323464110,798.09876,16728106878,809821966,16728104082,-2796,,
15323514669,798.14932,16728157449,809872532,16728154649,-2800,,
15323565341,798.19999,16728208113,809923191,16728205308,-2805,,
15323616395,798.25104,16728259179,809974252,16728256368,-2811,,
15323667012,798.30166,16728309788,810024856,16728306972,-2816,,
15323717590,798.35224,16728360369,810075432,16728357548,-2821,,
15323767705,798.40235,16728410487,810125555,16728407672,-2815,,
15323818760,798.45341,16728461544,810176596,16728458713,-2831,,
15323868896,798.50354,16728511682,810226740,16728508856,-2826,,
15323919977,798.55462,16728562765,810277808,16728559924,-2841,,
15323970706,798.60535,16728613496,810328534,16728610650,-2846,,
15324021732,798.65638,16728664536,810379567,16728661684,-2852,,
15324072299,798.70695,16728715095,810430122,16728712239,-2856,,
15324122933,798.75758,16728765731,810480753,16728762870,-2861,,
15324173515,798.80816,16728816316,810531332,16728813449,-2867,,
15324223913,798.85856,16728866716,810581728,16728863845,-2871,,
15324274462,798.90911,16728917266,810632274,16728914390,-2876,,
15324324964,798.95961,16728967771,810682773,16728964889,-2882,,
15324375867,799.01052,16729018676,810733672,16729015789,-2887,,
15324426466,799.06111,16729069277,810784270,16729066386,-2891,,
15324477134,799.11178,16729119948,810834935,16729117051,-2897,,
15324527228,799.16188,16729170044,810885026,16729167142,-2902,,
15324578257,799.21290,16729221077,810936063,16729218180,-2897,,
15324629294,799.26394,16729272116,810987087,16729269204,-2912,,
15324679901,799.31455,16729322725,811037691,16729319807,-2918,,
15324730489,799.36514,16729373316,811088276,16729370393,-2923,,
15324780814,799.41546,16729423642,811138599,16729420715,-2927,,
15324831366,799.46601,16729474197,811189148,16729471265,-2932,,
15324882152,799.51680,16729524986,811239931,16729522047,-2939,,
15324932539,799.56719,16729575375,811290317,16729572433,-2942,,
15324983150,799.61780,16729625988,811340925,16729623041,-2947,,
15325033654,799.66830,16729676495,811391426,16729673542,-2953,,
15325084048,799.71870,16729726902,811441829,16729723946,-2956,,
15325134596,799.76924,16729777441,811492373,16729774490,-2951,,
15325185646,799.82029,16729828494,811543409,16729825526,-2968,,
15325236244,799.87089,16729879093,811594004,16729876120,-2973,,
15325286363,799.92101,16729929216,811644123,16729926240,-2976,,
15325336993,799.97164,16729979847,811694748,16729976865,-2982,,
15325388064,800.02271,16730030920,811745816,16730027932,-2988,,
15325439156,800.07380,16730082016,811796907,16730079023,-2993,,
15325489732,800.12438,16730132594,811847479,16730129596,-2998,,
15325540807,800.17546,16730183671,811898551,16730180668,-3003,,
15325591855,800.22650,16730234722,811949596,16730231713,-3009,,
15325642905,800.27755,16730285774,812000644,16730282761,-3013,,
15325693462,800.32811,16730336333,812051198,16730333315,-3018,,
15325744048,800.37870,16730386922,812101782,16730383898,-3024,,
15325795104,800.42975,16730437980,812152834,16730434951,-3029,,
15325845171,800.47982,16730488049,812202900,16730485016,-3033,,
15325896112,800.53076,16730538994,812253838,16730535955,-3039,,
15325946734,800.58138,16730589617,812304456,16730586573,-3044,,
15325996855,800.63150,16730639740,812354575,16730636691,-3049,,
15326047900,800.68255,16730690788,812405617,16730687734,-3054,,
15326098953,800.73360,16730741842,812456667,16730738783,-3059,,
15326149997,800.78464,16730792890,812507710,16730789826,-3064,,
15326201047,800.83569,16730843941,812558756,16730840872,-3069,,
15326252098,800.88675,16730894995,812609804,16730891921,-3074,,
15326303144,800.93779,16730946043,812660847,16730942963,-3080,,
15326354162,800.98881,16730997063,812711874,16730993990,-3073,,
15326405244,801.03989,16731048148,812762942,16731045059,-3089,,
15326456260,801.09091,16731099167,812813955,16731096071,-3096,,
15326506809,801.14146,16731149718,812864501,16731146617,-3101,,
15326557353,801.19200,16731200265,812915043,16731197160,-3105,,
15326607939,801.24259,16731250853,812965626,16731247743,-3110,,
15326658437,801.29309,16731301352,813016121,16731298237,-3115,,
15326709031,801.34368,16731351950,813066713,16731348829,-3121,,
15326759619,801.39427,16731402540,813117299,16731399415,-3125,,
15326809785,801.44443,16731452707,813167461,16731449577,-3130,,
15326860370,801.49502,16731503295,813218044,16731500160,-3135,,
15326910470,801.54512,16731553398,813268141,16731550257,-3141,,
15326960520,801.59517,16731603450,813318188,16731600305,-3145,,
15327011082,801.64573,16731654015,813368747,16731650863,-3152,,
15327062103,801.69675,16731705038,813419766,16731701883,-3155,,
15327112200,801.74685,16731755137,813469861,16731751977,-3160,,
15327163192,801.79784,16731806131,813520849,16731802965,-3166,,
15327213389,801.84804,16731856330,813571044,16731853160,-3170,,
15327264395,801.89904,16731907339,813622047,16731904164,-3175,,
15327315012,801.94966,16731957958,813672661,16731954778,-3180,,
15327366061,802.00071,16732009010,813723708,16732005824,-3186,,
15327416693,802.05134,16732059645,813774337,16732056454,-3191,,
15327467664,802.10231,16732110617,813825305,16732107421,-3196,,
15327518205,802.15285,16732161161,813875843,16732157960,-3201,,
15327568805,802.20345,16732211763,813926441,16732208558,-3205,,
15327619699,802.25435,16732262660,813977332,16732259449,-3211,,
15327669852,802.30450,16732312815,814027482,16732309599,-3216,,
15327720741,802.35539,16732363707,814078369,16732360485,-3222,,
15327771199,802.40585,16732414167,814128825,16732410941,-3226,,
15327821330,802.45598,16732464300,814178952,16732461069,-3231,,
15327871867,802.50652,16732514840,814229486,16732511603,-3237,,
15327922421,802.55707,16732565395,814280038,16732562154,-3241,,
15327972938,802.60759,16732615915,814330552,16732612669,-3246,,
15328023488,802.65814,16732666468,814381099,16732663216,-3252,,
15328074552,802.70920,16732717534,814432162,16732714278,-3256,,
15328125159,802.75981,16732768143,814482765,16732764882,-3261,,
15328175763,802.81041,16732818750,814533367,16732815483,-3267,,
15328226844,802.86149,16732869833,814584444,16732866561,-3272,,
15328277396,802.91204,16732920388,814634994,16732917110,-3278,,
15328328495,802.96314,16732971489,814686090,16732968207,-3282,,
15328379030,803.01368,16733022026,814736622,16733018739,-3287,,
15328429592,803.06424,16733072591,814787182,16733069299,-3292,,
15328480125,803.11477,16733123125,814837712,16733119828,-3297,,
15328531151,803.16580,16733174153,814888735,16733170851,-3302,,
15328582177,803.21682,16733225183,814939758,16733221875,-3308,,
15328632813,803.26746,16733275821,814990393,16733272509,-3312,,
15328683376,803.31802,16733326386,815040952,16733323068,-3318,,
15328734000,803.36865,16733377014,815091574,16733373691,-3323,,
15328785059,803.41971,16733428074,815142630,16733424747,-3327,,
15328835625,803.47027,16733478643,815193193,16733475310,-3333,,
15328885803,803.52045,16733528833,815243379,16733525495,-3338,,
15328936409,803.57106,16733579431,815293972,16733576088,-3343,,
15328987458,803.62211,16733630483,815345018,16733627135,-3348,,
15329038058,803.67271,16733681085,815395615,16733677732,-3353,,
15329089092,803.72374,16733732120,815446646,16733728762,-3358,,
15329139677,803.77432,16733782709,815497230,16733779346,-3363,,
15329190734,803.82538,16733833768,815548283,16733830400,-3368,,
15329241782,803.87643,16733884818,815599328,16733881444,-3374,,
15329292837,803.92749,16733935876,815650380,16733932497,-3379,,
15329343882,803.97853,16733986923,815701423,16733983539,-3384,,
15329394929,804.02958,16734037973,815752467,16734034583,-3390,,
15329445977,804.08063,16734089023,815803512,16734085628,-3395,,
15329497027,804.13167,16734140075,815854559,16734136676,-3399,,
15329548076,804.18272,16734191127,815905607,16734187723,-3404,,
15329598523,804.23317,16734241576,815956050,16734238167,-3409,,
15329648696,804.28334,16734291750,816006220,16734288336,-3414,,
15329699244,804.33389,16734342302,816056766,16734338883,-3419,,
15329750292,804.38494,16734393351,816107811,16734389927,-3424,,
15329801348,804.43600,16734444410,816158864,16734440981,-3429,,
15329851877,804.48653,16734494941,816209390,16734491506,-3435,,
15329902600,804.53725,16734545666,816260111,16734542237,-3429,,
15329953176,804.58782,16734596245,816310685,16734592801,-3444,,
15330003354,804.63800,16734646426,816360859,16734642976,-3450,,
15330053540,804.68819,16734696614,816411043,16734693160,-3454,,
15330104626,804.73927,16734747702,816462125,16734744252,-3450,,
15330154845,804.78949,16734797923,816512342,16734794459,-3464,,
15330205891,804.84054,16734848972,816563387,16734845503,-3469,,
15330256515,804.89116,16734899599,816614007,16734896123,-3476,,
15330307562,804.94221,16734950648,816665051,16734947167,-3481,,
15330358091,804.99274,16735001189,816715588,16734997704,-3485,,
15330408381,805.04303,16735051471,816765876,16735047992,-3479,,
15330459488,805.09414,16735102581,816816979,16735099096,-3485,,
15330510191,805.14484,16735153285,816867669,16735149785,-3500,,
15330561067,805.19571,16735204164,816918543,16735200660,-3504,,
15330611251,805.24590,16735254351,816968725,16735250841,-3510,,
15330661840,805.29649,16735304942,817019310,16735301427,-3515,,
15330712710,805.34736,16735355826,817070189,16735352305,-3521,,
15330763312,805.39796,16735406419,817120777,16735402893,-3526,,
15330814378,805.44903,16735457487,817171840,16735453956,-3531,,
15330864905,805.49955,16735508017,817222364,16735504481,-3536,,
15330914980,805.54963,16735558094,817272438,16735554554,-3540,,
15330965122,805.59977,16735608238,817322576,16735604692,-3546,,
15331015665,805.65031,16735658784,817373116,16735655233,-3551,,
15331066226,805.70087,16735709347,817423674,16735705791,-3556,,
15331116785,805.75143,16735759909,817474231,16735756348,-3561,,
15331167820,805.80247,16735810945,817525263,16735807379,-3566,,
15331218382,805.85303,16735861510,817575822,16735857939,-3571,,
15331268930,805.90358,16735912061,817626369,16735908485,-3576,,
15331319979,805.95463,16735963111,817677414,16735959530,-3581,,
15331371061,806.00571,16736014196,817728493,16736010610,-3586,,
15331422127,806.05678,16736065264,817779556,16736061672,-3592,,
15331473129,806.10778,16736116269,817830556,16736112673,-3596,,
15331524165,806.15881,16736167307,817881589,16736163705,-3602,,
15331574772,806.20942,16736217917,817932193,16736214310,-3607,,
15331625778,806.26043,16736268925,817983197,16736265314,-3611,,
15331676834,806.31148,16736319983,818034250,16736316366,-3617,,
15331727885,806.36253,16736371048,818085310,16736367426,-3622,,
15331778511,806.41316,16736421664,818135921,16736418038,-3626,,
15331829096,806.46374,16736472252,818186504,16736468620,-3632,,
15331880141,806.51479,16736523300,818237546,16736519662,-3638,,
15331931139,806.56579,16736574300,818288541,16736570658,-3642,,
15331981675,806.61632,16736624838,818339075,16736621191,-3647,,
15332032250,806.66690,16736675416,818389648,16736671764,-3652,,
15332083299,806.71795,16736726467,818440693,16736722809,-3658,,
15332134347,806.76900,16736777518,818491739,16736773855,-3663,,
15332184891,806.81954,16736828064,818542281,16736824397,-3667,,
15332235464,806.87011,16736878640,818592851,16736874967,-3673,,
15332286539,806.92119,16736929717,818643922,16736926039,-3678,,
15332337586,806.97223,16736980766,818694967,16736977083,-3683,,
15332388635,807.02328,16737031818,818746014,16737028131,-3687,,
15332439668,807.07432,16737082853,818797043,16737079160,-3693,,
15332490705,807.12535,16737133892,818848078,16737130195,-3697,,
15332541246,807.17589,16737184436,818898617,16737180733,-3703,,
15332591793,807.22644,16737234985,818949161,16737231277,-3708,,
15332642862,807.27751,16737286057,819000227,16737282343,-3714,,
15332693910,807.32856,16737337106,819051271,16737333387,-3719,,
15332744495,807.37914,16737387693,819101854,16737383970,-3723,,
15332795083,807.42973,16737438285,819152439,16737434556,-3729,,
15332845721,807.48037,16737488925,819203074,16737485191,-3734,,
15332896340,807.53099,16737539546,819253691,16737535808,-3738,,
15332946879,807.58153,16737590088,819304227,16737586344,-3744,,
15332997403,807.63205,16737640614,819354749,16737636865,-3749,,
15333048015,807.68266,16737691228,819405358,16737687474,-3754,,
15333099076,807.73372,16737742292,819456417,16737738533,-3759,,
15333149897,807.78454,16737793115,819507234,16737789351,-3764,,
15333200424,807.83507,16737843643,819557758,16737839874,-3769,,
15333251372,807.88602,16737894595,819608704,16737890820,-3775,,
15333302293,807.93694,16737945518,819659622,16737941738,-3780,,
15333352443,807.98709,16737995671,819709769,16737991886,-3785,,
15333403030,808.03768,16738046259,819760353,16738042469,-3790,,
15333453576,808.08822,16738096807,819810897,16738093013,-3794,,
15333503746,808.13839,16738146981,819861064,16738143181,-3800,,
15333554857,808.18951,16738198094,819912173,16738194289,-3805,,
15333605905,808.24055,16738249144,819963219,16738245335,-3809,,
15333656119,808.29077,16738299361,820013430,16738295546,-3815,,
15333706663,808.34131,16738349907,820063970,16738346086,-3821,,
15333757268,808.39192,16738400514,820114573,16738396689,-3825,,
15333807419,808.44207,16738450668,820164722,16738446838,-3830,,
15333858491,808.49314,16738501742,820215790,16738497907,-3835,,
15333909350,808.54400,16738552603,820266646,16738548763,-3840,,
15333959561,808.59421,16738602817,820316856,16738598972,-3845,,
15334010189,808.64484,16738653447,820367480,16738649596,-3851,,
15334060812,808.69546,16738704072,820418101,16738700217,-3855,,
15334111374,808.74602,16738754637,820468661,16738750777,-3860,,
15334161994,808.79664,16738805259,820519277,16738801394,-3865,,
15334212315,808.84696,16738855582,820569595,16738851711,-3871,,
15334263136,808.89778,16738906406,820620414,16738902530,-3876,,
15334314198,808.94885,16738957470,820671473,16738953590,-3880,,
15334365244,808.99989,16739008519,820722517,16739004633,-3886,,
15334416293,809.05094,16739059569,820773562,16739055678,-3891,,
15334467343,809.10199,16739110622,820824610,16739106727,-3895,,
15334518382,809.15303,16739161664,820875646,16739157763,-3901,,
15334568938,809.20359,16739212233,820926211,16739208327,-3906,,
15334619961,809.25461,16739263247,820977220,16739259336,-3911,,
15334670511,809.30516,16739313800,821027767,16739309884,-3916,,
15334721473,809.35612,16739364764,821078727,16739360843,-3921,,
15334772038,809.40669,16739415332,821129289,16739411405,-3927,,
15334823119,809.45777,16739466415,821180367,16739462483,-3932,,
15334873645,809.50829,16739516954,821230902,16739513018,-3936,,
15334924689,809.55934,16739567990,821281931,16739564048,-3942,,
15334975265,809.60991,16739618568,821332504,16739614621,-3947,,
15335026301,809.66095,16739669606,821383538,16739665655,-3951,,
15335076862,809.71151,16739720170,821434096,16739716213,-3957,,
15335126994,809.76164,16739770304,821484225,16739766342,-3962,,
15335177992,809.81264,16739821304,821535221,16739817338,-3966,,
15335228530,809.86318,16739871844,821585756,16739867872,-3972,,
15335279116,809.91376,16739922433,821636339,16739918456,-3977,,
15335330131,809.96478,16739973451,821687352,16739969468,-3983,,
15335381207,810.01585,16740024529,821738426,16740020542,-3987,,
15335432258,810.06691,16740075582,821789474,16740071590,-3992,,
15335483307,810.11796,16740126634,821840520,16740122636,-3998,,
15335534355,810.16900,16740177683,821891564,16740173680,-4003,,
15335585405,810.22005,16740228735,821942612,16740224728,-4007,,
15335636454,810.27110,16740279787,821993658,16740275774,-4013,,
15335687002,810.32165,16740330338,822044203,16740326320,-4018,,
15335738040,810.37269,16740381378,822095239,16740377355,-4023,,
15335789079,810.42373,16740432420,822146275,16740428392,-4028,,
15335839707,810.47435,16740483050,822196900,16740479016,-4034,,
15335890775,810.52542,16740534120,822247965,16740530081,-4039,,
15335941362,810.57601,16740584710,822298551,16740580667,-4043,,
15335992377,810.62703,16740635726,822349562,16740631678,-4048,,
15336042928,810.67758,16740686281,822400110,16740682226,-4055,,
15336093473,810.72812,16740736828,822450653,16740732770,-4058,,
15336144519,810.77917,16740787876,822501697,16740783813,-4063,,
15336194570,810.82922,16740837930,822551744,16740833861,-4069,,
15336245158,810.87981,16740888519,822602329,16740884446,-4073,,
15336295667,810.93031,16740939030,822652836,16740934952,-4078,,
15336346197,810.98085,16740989563,822703363,16740985479,-4084,,
15336396278,811.03093,16741039658,822753453,16741035570,-4088,,
15336446827,811.08147,16741090198,822803988,16741086105,-4093,,
15336497397,811.13204,16741140771,822854555,16741136672,-4099,,
15336548398,811.18305,16741191774,822905553,16741187670,-4104,,
15336598460,811.23311,16741241838,822955613,16741237730,-4108,,
15336649495,811.28414,16741292876,823006646,16741288762,-4114,,
15336699568,811.33422,16741342951,823056725,16741338842,-4109,,
15336750592,811.38524,16741393978,823107737,16741389853,-4125,,
15336801056,811.43570,16741444444,823158199,16741440315,-4129,,
15336851627,811.48627,16741495017,823208767,16741490883,-4134,,
15336902711,811.53736,16741546104,823259848,16741541964,-4140,,
15336953224,811.58787,16741596619,823310359,16741592475,-4144,,
15337003787,811.63843,16741647184,823360918,16741643035,-4149,,
15337054861,811.68951,16741698261,823411990,16741694107,-4154,,
15337105160,811.73981,16741748561,823462285,16741744402,-4159,,
15337156194,811.79084,16741799597,823513317,16741795434,-4163,,
15337206287,811.84093,16741849694,823563407,16741845524,-4170,,
15337256885,811.89153,16741900293,823614002,16741896118,-4175,,
15337307933,811.94258,16741951344,823665049,16741947165,-4179,,
15337358481,811.99313,16742001895,823715594,16741997710,-4185,,
15337408552,812.04320,16742051967,823765661,16742047777,-4190,,
15337459136,812.09378,16742102554,823816242,16742098358,-4196,,
15337510153,812.14480,16742153574,823867257,16742149373,-4201,,
15337560701,812.19535,16742204124,823917802,16742199919,-4205,,
15337611787,812.24644,16742255213,823968896,16742251012,-4201,,
15337662810,812.29746,16742306237,824019906,16742302022,-4215,,
15337713368,812.34802,16742356797,824070461,16742352577,-4220,,
15337764423,812.39907,16742407856,824121513,16742403630,-4226,,
15337814600,812.44925,16742458034,824171687,16742453804,-4230,,
15337864945,812.49959,16742508382,824222030,16742504147,-4235,,
15337915916,812.55056,16742559355,824272998,16742555114,-4241,,
15337966488,812.60114,16742609929,824323567,16742605684,-4245,,
15338016831,812.65148,16742660274,824373908,16742656024,-4250,,
15338067387,812.70204,16742710833,824424461,16742706577,-4256,,
15338117927,812.75257,16742761376,824474998,16742757115,-4261,,
15338169007,812.80366,16742812459,824526075,16742808192,-4267,,
15338219526,812.85417,16742862980,824576592,16742858709,-4271,,
15338270573,812.90522,16742914028,824627636,16742909752,-4276,,
15338321117,812.95577,16742964576,824678177,16742960294,-4282,,
15338371670,813.00632,16743015131,824728728,16743010845,-4286,,
15338422719,813.05737,16743066182,824779774,16743061891,-4291,,
15338473770,813.10842,16743117236,824830823,16743112939,-4297,,
15338524819,813.15947,16743168287,824881868,16743163985,-4302,,
15338575353,813.21000,16743218823,824932400,16743214517,-4306,,
15338625402,813.26005,16743268875,824982446,16743264563,-4312,,
15338675965,813.31061,16743319440,825033006,16743315122,-4318,,
15338726774,813.36142,16743370250,825083813,16743365929,-4321,,
15338789901,813.42455,16743433380,825146936,16743429052,-4328,,
15338854559,813.48921,16743498042,825211592,16743493708,-4334,,
15338905132,813.53978,16743548617,825262161,16743544277,-4340,,
15338955404,813.59005,16743598891,825312430,16743594546,-4345,,
15339005737,813.64039,16743649226,825362761,16743644877,-4349,,
15339055960,813.69061,16743699452,825412981,16743695097,-4355,,
15339106687,813.74134,16743750181,825463705,16743745822,-4359,,
15339157349,813.79200,16743800846,825514366,16743796482,-4364,,
15339207929,813.84258,16743851428,825564942,16743847059,-4369,,
15339258385,813.89303,16743901886,825615395,16743897512,-4374,,
15339308968,813.94362,16743952473,825665976,16743948093,-4380,,
15339359608,813.99426,16744003114,825716613,16743998730,-4384,,
15339410279,814.04493,16744053788,825767282,16744049399,-4389,,
15339460606,814.09525,16744104118,825817605,16744099721,-4397,,
15339511731,814.14638,16744155244,825868731,16744150848,-4396,,
15339562147,814.19679,16744205662,825919141,16744201257,-4405,,
15339612892,814.24754,16744256410,825969883,16744251999,-4411,,
15339663433,814.29808,16744306954,826020422,16744302539,-4415,,
15339714383,814.34903,16744357905,826071369,16744353485,-4420,,
15339764596,814.39924,16744408121,826121579,16744403695,-4426,,
15339815376,814.45002,16744458903,826172356,16744454472,-4431,,
15339865747,814.50040,16744509277,826222726,16744504842,-4435,,
15339917127,814.55178,16744560660,826274102,16744556219,-4441,,
15339967689,814.60234,16744611223,826324661,16744606777,-4446,,
15340018365,814.65301,16744661903,826375335,16744657451,-4452,,
15340068608,814.70326,16744712148,826425575,16744707691,-4457,,
15340119286,814.75393,16744762827,826476250,16744758366,-4461,,
15340170003,814.80465,16744813548,826526964,16744809081,-4467,,
15340220853,814.85550,16744864399,826577812,16744859928,-4471,,
15340271643,814.90629,16744915191,826628599,16744910715,-4476,,
15340321868,814.95652,16744965420,826678822,16744960939,-4481,,
15340372245,815.00689,16745015799,826729196,16745011313,-4486,,
15340422652,815.05730,16745066207,826779600,16745061716,-4491,,
15340473198,815.10785,16745116756,826830143,16745112259,-4497,,
15340523506,815.15815,16745167067,826880449,16745162566,-4501,,
15340574224,815.20887,16745217786,826931164,16745213280,-4506,,
15340624868,815.25952,16745268434,826981805,16745263922,-4512,,
15340675473,815.31012,16745319041,827032408,16745314524,-4517,,
15340725863,815.36051,16745369433,827082795,16745364912,-4521,,
15340776522,815.41117,16745420094,827133451,16745415568,-4526,,
15340826946,815.46159,16745470521,827183872,16745465989,-4532,,
15340877748,815.51240,16745521324,827234672,16745516788,-4536,,
15340928363,815.56301,16745571942,827285284,16745567400,-4542,,
15340979268,815.61392,16745622849,827336186,16745618302,-4547,,
15341030032,815.66468,16745673616,827386947,16745669063,-4553,,
15341080766,815.71541,16745724353,827437679,16745719796,-4557,,
15341131104,815.76575,16745774693,827488015,16745770131,-4562,,
15341181633,815.81628,16745825225,827538540,16745820657,-4568,,
15341231961,815.86661,16745875554,827588866,16745870982,-4572,,
15341282355,815.91700,16745925950,827639257,16745921374,-4576,,
15341332674,815.96732,16745976273,827689573,16745971690,-4583,,
15341383166,816.01781,16746026766,827740063,16746022179,-4587,,
15341433685,816.06833,16746077288,827790580,16746072696,-4592,,
15341483821,816.11847,16746127426,827840712,16746122828,-4598,,
15341534475,816.16912,16746178083,827891363,16746173479,-4604,,
15341584930,816.21958,16746228539,827941816,16746223932,-4607,,
15341635918,816.27057,16746279530,827992801,16746274917,-4613,,
15341686175,816.32082,16746329789,828043055,16746325172,-4617,,
15341736576,816.37122,16746380193,828093455,16746375571,-4622,,
15341786865,816.42151,16746430484,828143740,16746425856,-4628,,
15341837371,816.47202,16746480992,828194243,16746476359,-4633,,
15341887751,816.52240,16746531375,828244622,16746526738,-4637,,
15341938059,816.57271,16746581685,828294925,16746577042,-4643,,
15341988579,816.62323,16746632208,828345443,16746627560,-4648,,
15342039333,816.67398,16746682963,828396193,16746678310,-4653,,
15342090319,816.72497,16746733953,828447179,16746729295,-4658,,
15342140909,816.77556,16746784545,828497766,16746779882,-4663,,
15342191530,816.82618,16746835169,828548383,16746830500,-4669,,
15342242444,816.87709,16746886084,828599295,16746881412,-4672,,
15342292739,816.92739,16746936381,828649587,16746931703,-4678,,
15342343037,816.97768,16746986682,828699882,16746981998,-4684,,
15342394101,817.02875,16747037748,828750943,16747033059,-4689,,
15342445153,817.07980,16747088802,828801993,16747084109,-4693,,
15342495694,817.13034,16747139357,828852542,16747134659,-4698,,
15342546766,817.18141,16747190421,828903601,16747185717,-4704,,
15342597819,817.23247,16747241475,828954651,16747236768,-4707,,
15342648340,817.28299,16747291999,829005169,16747287285,-4714,,
15342698893,817.33354,16747342554,829055719,16747337835,-4719,,
15342748986,817.38363,16747392649,829105809,16747387925,-4724,,
15342799823,817.43447,16747443489,829156644,16747438760,-4729,,
15342850515,817.48516,16747494184,829207333,16747489450,-4734,,
15342901563,817.53621,16747545234,829258378,16747540494,-4740,,
15342952102,817.58675,16747595776,829308916,16747591032,-4744,,
15343002657,817.63730,16747646333,829359468,16747641584,-4749,,
15343053736,817.68838,16747697415,829410543,16747692660,-4755,,
15343104727,817.73937,16747748408,829461531,16747743648,-4760,,
15343155661,817.79031,16747799344,829512464,16747794580,-4764,,
15343205972,817.84062,16747849658,829562772,16747844888,-4770,,
15343256226,817.89087,16747899914,829613022,16747895139,-4775,,
15343306684,817.94133,16747950374,829663478,16747945595,-4779,,
15343357153,817.99180,16748000846,829713944,16747996061,-4785,,
15343407282,818.04193,16748050976,829764070,16748046186,-4790,,
15343457908,818.09256,16748101605,829814695,16748096811,-4794,,
15343508482,818.14313,16748152182,829865266,16748147382,-4800,,
15343559155,818.19380,16748202856,829915935,16748198052,-4804,,
15343609695,818.24434,16748253399,829966472,16748248589,-4810,,
15343660261,818.29491,16748303968,830017036,16748299153,-4815,,
15343710729,818.34538,16748354437,830067501,16748349618,-4819,,
15343760990,818.39564,16748404701,830117759,16748399885,-4816,,
15343811283,818.44593,16748454996,830168050,16748450166,-4830,,
15343861871,818.49652,16748505587,830218636,16748500752,-4835,,
15343912455,818.54710,16748556184,830269226,16748551342,-4842,,
15343962837,818.59749,16748606557,830319596,16748601713,-4844,,
15344013193,818.64784,16748656916,830369949,16748652066,-4850,,
15344063592,818.69824,16748707318,830420345,16748702462,-4856,,
15344113825,818.74847,16748757553,830470576,16748752692,-4861,,
15344164324,818.79897,16748808053,830521072,16748803188,-4865,,
15344214769,818.84942,16748858502,830571514,16748853631,-4871,,
15344265217,818.89986,16748908952,830621959,16748904075,-4877,,
15344315625,818.95027,16748959362,830672366,16748954482,-4880,,
15344365960,819.00061,16749009699,830722697,16749004813,-4886,,
15344416583,819.05123,16749060328,830773323,16749055441,-4887,,
15344466794,819.10144,16749110537,830823526,16749105642,-4895,,
15344517124,819.15177,16749160871,830873853,16749155970,-4901,,
15344567571,819.20222,16749211320,830924307,16749206424,-4896,,
15344618243,819.25289,16749261994,830974966,16749257083,-4911,,
15344668517,819.30317,16749312271,831025239,16749307355,-4916,,
15344718693,819.35334,16749362449,831075411,16749357528,-4921,,
15344769090,819.40374,16749412858,831125815,16749407931,-4927,,
15344819737,819.45439,16749463498,831176451,16749458567,-4931,,
15344870002,819.50465,16749513765,831226712,16749508829,-4936,,
15344920199,819.55485,16749563964,831276906,16749559023,-4941,,
15344970333,819.60498,16749614100,831327038,16749609164,-4936,,
15345021025,819.65567,16749664795,831377727,16749659844,-4951,,
15345071304,819.70595,16749715076,831428003,16749710120,-4956,,
15345121941,819.75659,16749765716,831478639,16749760755,-4961,,
15345172217,819.80687,16749815994,831528911,16749811027,-4967,,
15345222589,819.85724,16749866368,831579279,16749861396,-4972,,
15345273088,819.90774,16749916880,831629786,16749911903,-4977,,
15345323832,819.95848,16749967615,831680518,16749962634,-4981,,
15345374620,820.00927,16750018407,831731303,16750013419,-4988,,
15345424721,820.05937,16750068510,831781401,16750063518,-4992,,
15345475814,820.11046,16750119605,831832493,16750114610,-4995,,
15345526863,820.16151,16750170656,831883538,16750165665,-4991,,
15345577960,820.21261,16750221756,831934632,16750216748,-5008,,
15345628818,820.26347,16750272616,831985487,16750267603,-5013,,
15345678915,820.31356,16750322716,832035582,16750317698,-5018,,
15345729440,820.36409,16750373243,832086105,16750368221,-5022,,
15345780386,820.41503,16750424190,832137047,16750419163,-5027,,
15345830963,820.46561,16750474770,832187622,16750469738,-5032,,
15345881666,820.51631,16750525476,832238322,16750520439,-5037,,
15345932682,820.56733,16750576495,832289335,16750571452,-5043,,
15345983267,820.61792,16750627081,832339917,16750622033,-5048,,
15346034322,820.66897,16750678138,832390970,16750673086,-5052,,
15346084900,820.71955,16750728720,832441546,16750723662,-5058,,
15346135443,820.77009,16750779265,832492086,16750774202,-5063,,
15346185989,820.82064,16750829813,832542630,16750824746,-5067,,
15346237059,820.87171,16750880886,832593697,16750875814,-5072,,
15346287587,820.92224,16750931416,832644222,16750926338,-5078,,
15346338156,820.97280,16750981987,832694787,16750976904,-5083,,
15346388689,821.02334,16751032523,832745318,16751027435,-5088,,
15346439748,821.07440,16751083583,832796374,16751078490,-5093,,
15346490807,821.12545,16751134645,832847431,16751129548,-5097,,
15346540867,821.17552,16751184707,832897488,16751179604,-5103,,
15346591432,821.22608,16751235275,832948051,16751230167,-5108,,
15346642001,821.27665,16751285847,832998616,16751280733,-5114,,
15346693046,821.32769,16751336893,833049658,16751331775,-5118,,
15346743132,821.37778,16751386982,833099742,16751381858,-5124,,
15346793718,821.42837,16751437571,833150325,16751432442,-5129,,
15346844288,821.47894,16751488143,833200893,16751483009,-5134,,
15346895325,821.52997,16751539182,833251928,16751534044,-5138,,
15346945683,821.58033,16751589542,833302282,16751584398,-5144,,
15346996260,821.63091,16751640121,833352856,16751634972,-5149,,
15347046399,821.68105,16751690262,833402993,16751685109,-5153,,
15347096994,821.73164,16751740860,833453585,16751735701,-5159,,
15347147554,821.78220,16751791423,833504143,16751786259,-5164,,
15347198192,821.83284,16751842063,833554778,16751836894,-5169,,
15347249194,821.88384,16751893067,833605777,16751887893,-5174,,
15347299288,821.93394,16751943164,833655868,16751937985,-5179,,
15347349440,821.98409,16751993329,833706029,16751988145,-5184,,
15347399628,822.03428,16752043509,833756204,16752038320,-5189,,
15347450248,822.08490,16752094131,833806820,16752088937,-5194,,
15347501255,822.13590,16752145139,833857824,16752139940,-5199,,
15347551697,822.18634,16752195585,833908264,16752190381,-5204,,
15347602221,822.23687,16752246111,833958786,16752240902,-5209,,
15347652292,822.28694,16752296184,834008853,16752290970,-5214,,
15347702362,822.33701,16752346257,834058920,16752341037,-5220,,
15347752805,822.38745,16752396702,834109362,16752391478,-5224,,
15347803351,822.43800,16752447252,834159905,16752442022,-5230,,
15347854321,822.48897,16752498223,834210872,16752492988,-5235,,
15347905330,822.53998,16752549233,834261878,16752543994,-5239,,
15347955972,822.59062,16752599878,834312517,16752594633,-5245,,
15348006548,822.64120,16752650457,834363090,16752645207,-5250,,
15348057111,822.69176,16752701022,834413650,16752695767,-5255,,
15348107764,822.74241,16752751677,834464301,16752746417,-5260,,
15348157813,822.79246,16752801729,834514347,16752796464,-5265,,
15348208376,822.84302,16752852294,834564907,16752847024,-5270,,
15348258959,822.89361,16752902880,834615489,16752897606,-5274,,
15348309957,822.94461,16752953880,834666483,16752948599,-5281,,
15348360042,822.99469,16753003967,834716566,16752998682,-5285,,
15348410794,823.04544,16753054733,834767327,16753049443,-5290,,
15348461335,823.09598,16753105276,834817865,16753099982,-5294,,
15348512356,823.14700,16753156288,834868872,16753150988,-5300,,
15348562994,823.19764,16753206929,834919506,16753201622,-5307,,
15348614004,823.24865,16753257940,834970514,16753252630,-5310,,
15348665077,823.29972,16753309017,835021585,16753303701,-5316,,
15348715573,823.35022,16753359514,835072077,16753354193,-5321,,
15348765634,823.40028,16753409578,835122136,16753404253,-5325,,
15348816204,823.45085,16753460151,835172704,16753454820,-5331,,
15348867257,823.50190,16753511205,835223753,16753505869,-5336,,
15348917826,823.55247,16753561788,835274331,16753556447,-5341,,
15348968467,823.60312,16753612421,835324959,16753607075,-5346,,
15349019053,823.65370,16753663008,835375541,16753657658,-5350,,
15349069683,823.70433,16753713640,835426168,16753708285,-5355,,
15349126701,823.76135,16753770661,835483183,16753765299,-5362,,
15349182521,823.81717,16753826485,835539000,16753821117,-5368,,
15349235785,823.87043,16753879750,835592261,16753874377,-5373,,
15349286891,823.92154,16753930859,835643366,16753925482,-5377,,
15349337117,823.97177,16753981088,835693588,16753975705,-5383,,
15349387913,824.02256,16754031885,835744381,16754026497,-5388,,
15349438807,824.07345,16754082783,835795273,16754077390,-5393,,
15349489463,824.12411,16754133440,835845926,16754128043,-5397,,
15349540200,824.17485,16754184180,835896661,16754178777,-5403,,
15349590732,824.22538,16754234714,835947189,16754229306,-5408,,
15349641446,824.27609,16754285430,835997901,16754280017,-5413,,
15349691841,824.32649,16754335827,836048293,16754330409,-5418,,
15349742786,824.37743,16754386776,836099235,16754381352,-5424,,
15349793197,824.42785,16754437188,836149644,16754431760,-5428,,
15349843816,824.47846,16754487809,836200260,16754482377,-5432,,
15349894595,824.52924,16754538592,836251036,16754533153,-5439,,
15349946863,824.58151,16754590862,836303302,16754585418,-5444,,
15349996924,824.63157,16754640926,836353360,16754635477,-5449,,
15350047448,824.68210,16754691452,836403881,16754685998,-5454,,
15350098407,824.73306,16754742413,836454837,16754736953,-5460,,
15350148711,824.78336,16754792719,836505139,16754787255,-5464,,
15350199230,824.83388,16754843241,836555656,16754837772,-5469,,
15350249761,824.88441,16754893773,836606183,16754888299,-5474,,
15350300175,824.93482,16754944191,836656594,16754938711,-5480,,
15350350602,824.98525,16754994619,836707019,16754989135,-5484,,
15350401019,825.03567,16755045038,836757433,16755039549,-5489,,
15350451693,825.08634,16755095716,836808104,16755090220,-5496,,
15350502017,825.13666,16755146042,836858427,16755140543,-5499,,
15350552482,825.18713,16755196509,836908888,16755191005,-5504,,
15350603287,825.23793,16755247317,836959691,16755241807,-5510,,
15350653867,825.28851,16755297898,837010268,16755292384,-5514,,
15350704070,825.33872,16755348103,837060468,16755342584,-5519,,
15350754899,825.38955,16755398935,837111294,16755393411,-5524,,
15350805229,825.43988,16755449268,837161621,16755443738,-5530,,
15350855653,825.49030,16755499693,837212043,16755494159,-5534,,
15350905926,825.54057,16755549970,837262313,16755544430,-5540,,
15350956172,825.59082,16755600217,837312556,16755594672,-5545,,
15351006481,825.64113,16755650529,837362863,16755644980,-5549,,
15351056792,825.69144,16755700843,837413171,16755695288,-5555,,
15351107037,825.74168,16755751089,837463413,16755745529,-5560,,
15351157508,825.79216,16755801562,837513882,16755795998,-5564,,
15351208411,825.84306,16755852469,837564782,16755846899,-5570,,
15351259089,825.89374,16755903149,837615457,16755897574,-5575,,
15351309334,825.94398,16755953397,837665700,16755947816,-5581,,
15351359699,825.99435,16756003764,837716063,16755998179,-5585,,
15351409936,826.04458,16756054003,837766297,16756048413,-5590,,
15351460591,826.09524,16756104660,837816948,16756099064,-5596,,
15351511281,826.14593,16756155352,837867636,16756149752,-5600,,
15351561487,826.19614,16756205572,837917851,16756199967,-5605,,
15351611687,826.24634,16756255764,837968037,16756250153,-5611,,
15351661925,826.29657,16756306004,838018272,16756300389,-5615,,
15351712456,826.34710,16756356537,838068800,16756350916,-5621,,
15351763033,826.39768,16756407117,838119375,16756401491,-5626,,
15351813746,826.44839,16756457831,838170085,16756452202,-5629,,
15351863991,826.49864,16756508079,838220328,16756502444,-5635,,
15351914248,826.54890,16756558339,838270581,16756552698,-5641,,
15351964587,826.59924,16756608680,838320917,16756603034,-5646,,
15352015290,826.64994,16756659385,838371618,16756653735,-5650,,
15352065918,826.70057,16756710015,838422243,16756704359,-5656,,
15352116279,826.75093,16756760378,838472601,16756754717,-5661,,
15352166445,826.80109,16756810547,838522765,16756804882,-5665,,
15352217120,826.85177,16756861224,838573436,16756855553,-5671,,
15352267522,826.90217,16756911629,838623837,16756905953,-5676,,
15352318389,826.95304,16756962497,838674701,16756956817,-5680,,
15352368748,827.00340,16757012859,838725057,16757007173,-5686,,
15352419452,827.05410,16757063566,838775759,16757057875,-5691,,
15352470334,827.10498,16757114451,838826637,16757108754,-5697,,
15352520908,827.15556,16757165027,838877209,16757159326,-5701,,
15352571518,827.20617,16757215639,838927817,16757209933,-5706,,
15352621611,827.25626,16757265743,838977915,16757260031,-5712,,
15352671869,827.30652,16757315995,839028162,16757310279,-5716,,
15352722421,827.35707,16757366548,839078711,16757360827,-5721,,
15352773107,827.40775,16757417238,839129394,16757411511,-5727,,
15352823541,827.45819,16757467674,839179825,16757461942,-5732,,
15352873970,827.50862,16757518105,839230252,16757512369,-5736,,
15352924427,827.55908,16757568564,839280706,16757562822,-5742,,
15352974820,827.60947,16757618960,839331097,16757613213,-5747,,
15353025379,827.66003,16757669520,839381653,16757663770,-5750,,
15353075619,827.71027,16757719764,839431890,16757714007,-5757,,
15353125903,827.76055,16757770050,839482171,16757764288,-5762,,
15353176168,827.81082,16757820317,839532434,16757814551,-5766,,
15353226455,827.86110,16757870607,839582719,16757864835,-5772,,
15353276975,827.91162,16757921129,839633235,16757915352,-5777,,
15353327432,827.96208,16757971588,839683691,16757965807,-5781,,
15353377778,828.01243,16758021937,839734034,16758016150,-5787,,
15353428122,828.06277,16758072283,839784375,16758066491,-5792,,
15353478690,828.11334,16758122852,839834939,16758117056,-5796,,
15353529257,828.16390,16758173426,839885509,16758167625,-5801,,
15353579626,828.21427,16758223793,839935870,16758217986,-5807,,
15353630040,828.26469,16758274209,839986281,16758268398,-5811,,
15353680797,828.31544,16758324970,840037036,16758319153,-5817,,
15353731545,828.36619,16758375720,840087782,16758369898,-5822,,
15353781961,828.41661,16758426139,840138194,16758420311,-5828,,
15353832576,828.46722,16758476756,840188807,16758470923,-5833,,
15353882981,828.51763,16758527163,840239210,16758521326,-5837,,
15353933398,828.56805,16758577594,840289635,16758571751,-5843,,
15353983729,828.61838,16758627926,840339962,16758622078,-5848,,
15354034073,828.66872,16758678261,840390293,16758672409,-5852,,
15354084514,828.71916,16758728706,840440731,16758722847,-5859,,
15354135242,828.76989,16758779435,840491456,16758773572,-5863,,
15354185979,828.82063,16758830175,840542192,16758824308,-5867,,
15354236063,828.87071,16758880272,840592282,16758874399,-5873,,
15354286361,828.92101,16758930562,840642568,16758924684,-5878,,
15354337078,828.97173,16758981281,840693282,16758975399,-5882,,
15354387607,829.02225,16759031812,840743808,16759025924,-5888,,
15354438376,829.07302,16759082583,840794574,16759076690,-5893,,
15354489038,829.12369,16759133248,840845233,16759127350,-5898,,
15354539549,829.17420,16759183762,840895743,16759177859,-5903,,
15354590130,829.22478,16759234344,840946320,16759228437,-5907,,
15354640898,829.27555,16759285114,840997085,16759279202,-5912,,
15354691304,829.32595,16759335523,841047489,16759329605,-5918,,
15354741843,829.37649,16759386064,841098025,16759380141,-5923,,
15354792381,829.42703,16759436606,841148561,16759430677,-5929,,
15354843088,829.47774,16759487314,841199264,16759481380,-5934,,
15354893787,829.52843,16759538016,841249961,16759532077,-5939,,
15354944056,829.57870,16759588288,841300227,16759582344,-5944,,
15354994586,829.62923,16759638820,841350754,16759632871,-5949,,
15355044730,829.67938,16759688966,841400896,16759683013,-5953,,
15355095004,829.72965,16759739243,841451167,16759733284,-5959,,
15355145568,829.78022,16759789808,841501728,16759783844,-5964,,
15355195964,829.83061,16759840207,841552123,16759834239,-5968,,
15355246635,829.88128,16759890881,841602791,16759884907,-5974,,
15355296976,829.93162,16759941224,841653128,16759935245,-5979,,
15355347623,829.98227,16759991873,841703772,16759985889,-5984,,
15355398291,830.03294,16760042544,841754438,16760036555,-5989,,
15355448956,830.08360,16760093210,841805100,16760087216,-5994,,
15355499693,830.13434,16760143950,841855835,16760137951,-5999,,
15355549907,830.18456,16760194167,841906046,16760188163,-6004,,
15355600616,830.23526,16760244878,841956753,16760238870,-6008,,
15355651663,830.28631,16760295928,842007797,16760289914,-6014,,
15355702193,830.33684,16760346460,842058324,16760340440,-6020,,
15355752809,830.38746,16760397077,842108937,16760391054,-6023,,
15355803848,830.43850,16760448119,842159973,16760442090,-6029,,
15355854855,830.48950,16760499128,842210977,16760493093,-6035,,
15355905447,830.54009,16760549722,842261567,16760543683,-6039,,
15355956230,830.59088,16760600508,842312347,16760594463,-6045,,
15356006784,830.64143,16760651064,842362898,16760645014,-6050,,
15356057420,830.69207,16760701703,842413531,16760695648,-6055,,
15356108042,830.74269,16760752327,842464151,16760746267,-6060,,
15356159105,830.79375,16760803393,842515212,16760797328,-6065,,
15356209790,830.84444,16760854079,842565893,16760848142,-5937,,
15356260739,830.89539,16760905032,842616840,16760898957,-6075,,
15356311385,830.94603,16760955679,842667482,16760949599,-6080,,
15356365110,830.99976,16761009408,842721206,16761003322,-6086,,
15356416162,831.05081,16761060462,842772254,16761054371,-6091,,
15356467527,831.10217,16761111828,842823617,16761105733,-6095,,
15356518546,831.15319,16761162851,842874633,16761156750,-6101,,
15356570736,831.20538,16761215042,842926820,16761208936,-6106,,
15356625898,831.26055,16761270208,842981979,16761264096,-6112,,
15356678722,831.31337,16761323033,843034800,16761316916,-6117,,
15356734267,831.36892,16761378581,843090341,16761372458,-6123,,
15356785305,831.41995,16761429621,843141378,16761423494,-6127,,
15356836349,831.47100,16761480669,843192420,16761474536,-6133,,
15356886421,831.52107,16761530742,843242488,16761524605,-6137,,
15356937450,831.57210,16761581774,843293515,16761575632,-6142,,
15356987501,831.62215,16761631827,843343562,16761625679,-6148,,
15357038056,831.67270,16761682385,843394115,16761676232,-6153,,
15357090297,831.72495,16761734627,843446353,16761728469,-6158,,
15357141174,831.77582,16761785507,843497226,16761779343,-6164,,
15357192200,831.82685,16761836535,843548251,16761830367,-6168,,
15357242773,831.87742,16761887111,843598821,16761880938,-6173,,
15357293243,831.92789,16761937583,843649288,16761931404,-6179,,
15357344287,831.97893,16761988630,843700330,16761982447,-6183,,
15357395346,832.02999,16762039692,843751386,16762033503,-6189,,
15357446383,832.08103,16762090731,843802420,16762084537,-6194,,
15357496922,832.13157,16762141272,843852957,16762135073,-6199,,
15357546969,832.18162,16762191322,843903001,16762185118,-6204,,
15357597675,832.23232,16762242029,843953704,16762235820,-6209,,
15357648609,832.28326,16762292966,844004636,16762286752,-6214,,
15357699640,832.33429,16762344000,844055665,16762337781,-6219,,
15357750675,832.38532,16762395036,844106696,16762388812,-6224,,
15357801724,832.43637,16762446087,844157741,16762439858,-6229,,
15357851770,832.48642,16762496137,844207785,16762489901,-6236,,
15357901854,832.53650,16762546222,844257867,16762539983,-6239,,
15357952495,832.58714,16762596865,844308504,16762590621,-6244,,
15358002813,832.63746,16762647186,844358819,16762640936,-6250,,
15358053616,832.68826,16762697992,844409622,16762691738,-6254,,
15358105184,832.73983,16762749562,844461186,16762743302,-6260,,
15358155826,832.79047,16762800206,844511825,16762793941,-6265,,
15358207440,832.84209,16762851822,844563436,16762845552,-6270,,
15358258380,832.89303,16762902765,844614374,16762896491,-6274,,
15358308917,832.94357,16762953305,844664908,16762947025,-6280,,
15358359480,832.99413,16763003869,844715468,16762997584,-6285,,
15358410590,833.04524,16763054982,844766576,16763048692,-6290,,
15358461570,833.09622,16763105965,844817553,16763099670,-6295,,
15358515095,833.14974,16763159493,844871075,16763153192,-6301,,
15358565143,833.19979,16763209542,844921120,16763203236,-6306,,
15358615754,833.25040,16763260156,844971730,16763253846,-6310,,
15358666753,833.30140,16763311158,845022726,16763304842,-6316,,
15358717300,833.35195,16763361707,845073270,16763355386,-6321,,
15358767850,833.40250,16763412259,845123816,16763405933,-6326,,
15358818409,833.45306,16763462821,845174374,16763456490,-6331,,
15358869459,833.50411,16763513872,845225420,16763507536,-6336,,
15358920500,833.55515,16763564916,845276458,16763558575,-6341,,
15358971052,833.60570,16763615471,845327008,16763609125,-6346,,
15359022037,833.65669,16763666457,845377990,16763660106,-6351,,
15359072605,833.70725,16763717029,845428555,16763710672,-6357,,
15359123631,833.75828,16763768057,845479578,16763761695,-6362,,
15359174048,833.80870,16763818475,845529993,16763812109,-6366,,
15359224097,833.85874,16763868528,845580039,16763862156,-6372,,
15359274645,833.90929,16763919078,845630584,16763912701,-6377,,
15359325195,833.95984,16763969629,845681132,16763963248,-6381,,
15359375745,834.01039,16764020183,845731680,16764013796,-6387,,
15359426291,834.06094,16764070730,845782222,16764064338,-6392,,
15359477328,834.11198,16764121769,845833256,16764115372,-6397,,
15359527377,834.16202,16764171822,845883304,16764165420,-6402,,
15359577920,834.21257,16764222368,845933845,16764215961,-6407,,
15359627988,834.26264,16764272437,845983909,16764266025,-6412,,
15359679086,834.31373,16764323537,846035004,16764317120,-6417,,
15359729581,834.36423,16764374034,846085496,16764367612,-6422,,
15359780129,834.41478,16764424585,846136041,16764418157,-6428,,
15359830677,834.46533,16764475136,846186587,16764468704,-6432,,
15359881278,834.51593,16764525739,846237185,16764519302,-6437,,
15359931814,834.56646,16764576277,846287718,16764569834,-6443,,
15359982813,834.61746,16764627279,846338715,16764620831,-6448,,
15360033370,834.66802,16764677837,846389269,16764671385,-6452,,
15360083947,834.71860,16764728419,846439845,16764721961,-6458,,
15360134963,834.76961,16764779436,846490857,16764772973,-6463,,
15360185508,834.82016,16764829982,846541399,16764823515,-6467,,
15360236560,834.87121,16764881037,846592448,16764874564,-6473,,
15360287615,834.92226,16764932095,846643501,16764925617,-6478,,
15360338655,834.97330,16764983137,846694538,16764976654,-6483,,
15360389275,835.02392,16765033759,846745155,16765027271,-6488,,
15360440269,835.07492,16765084756,846796147,16765078263,-6493,,
15360491308,835.12596,16765135798,846847183,16765129299,-6499,,
15360541858,835.17651,16765186349,846897730,16765179846,-6503,,
15360593888,835.22854,16765238382,846949758,16765231874,-6508,,
15360643941,835.27859,16765288437,846999807,16765281923,-6514,,
15360694500,835.32915,16765338998,847050363,16765332480,-6518,,
15360745103,835.37975,16765389603,847100963,16765383080,-6523,,
15360798153,835.43280,16765442657,847154012,16765436128,-6529,,
15360849129,835.48378,16765493634,847204984,16765487100,-6534,,
15360899675,835.53432,16765544183,847255527,16765537643,-6540,,
15360949747,835.58439,16765594258,847305598,16765587714,-6544,,
15361000287,835.63494,16765644799,847356134,16765638250,-6549,,
15361050832,835.68548,16765695348,847406677,16765688793,-6555,,
15361100900,835.73555,16765745417,847456742,16765738858,-6559,,
15361151938,835.78659,16765796458,847507777,16765789894,-6564,,
15361202477,835.83713,16765847000,847558314,16765840430,-6570,,
15361252525,835.88717,16765897050,847608359,16765890476,-6574,,
15361303096,835.93774,16765947623,847658927,16765941044,-6579,,
15361354132,835.98878,16765998661,847709960,16765992077,-6584,,
15361404674,836.03932,16766049205,847760499,16766042615,-6590,,
15361455230,836.08988,16766099764,847811053,16766093169,-6595,,
15361506277,836.14093,16766150814,847862098,16766144214,-6600,,
15361557276,836.19192,16766201815,847913103,16766195219,-6596,,
15361608334,836.24298,16766252874,847964148,16766246264,-6610,,
15361658881,836.29353,16766303425,848014693,16766296810,-6615,,
15361709790,836.34444,16766354345,848065610,16766347726,-6619,,
15361760334,836.39498,16766404882,848116140,16766398256,-6626,,
15361810958,836.44561,16766455509,848166763,16766448879,-6630,,
15361861764,836.49641,16766506316,848217565,16766499682,-6634,,
15361912112,836.54676,16766556667,848267910,16766550026,-6641,,
15361962872,836.59752,16766607430,848318669,16766600785,-6645,,
15362013524,836.64817,16766658083,848369317,16766651433,-6650,,
15362063790,836.69844,16766708353,848419581,16766701697,-6656,,
15362114838,836.74949,16766759403,848470625,16766752742,-6661,,
15362165747,836.80039,16766810314,848521533,16766803649,-6665,,
15362216667,836.85131,16766861237,848572450,16766854566,-6671,,
15362267353,836.90200,16766911925,848623132,16766905248,-6677,,
15362318012,836.95266,16766962586,848673790,16766955906,-6680,,
15362368559,837.00321,16767013135,848724333,16767006449,-6686,,
15362419247,837.05390,16767063825,848775018,16767057134,-6691,,
15362469892,837.10454,16767114473,848825660,16767107776,-6697,,
15362520651,837.15530,16767165235,848876418,16767158534,-6701,,
15362571152,837.20580,16767215738,848926915,16767209032,-6706,,
15362621988,837.25664,16767266577,848977748,16767259865,-6712,,
15362672324,837.30697,16767316914,849028082,16767310198,-6716,,
15362723200,837.35785,16767367793,849078956,16767361072,-6721,,
15362773556,837.40820,16767418404,849129567,16767411706,-6698,,
15362824070,837.45872,16767468668,849179820,16767461936,-6732,,
15362874645,837.50929,16767519245,849230393,16767512509,-6736,,
15362925241,837.55989,16767569844,849280986,16767563102,-6742,,
15362975679,837.61033,16767620284,849331420,16767613537,-6747,,
15363026656,837.66130,16767671263,849382396,16767664512,-6751,,
15363077648,837.71230,16767722259,849433385,16767715502,-6757,,
15363127966,837.76261,16767772577,849483699,16767765815,-6762,,
15363178349,837.81300,16767822963,849534079,16767816196,-6767,,
15363229292,837.86394,16767873908,849585020,16767867136,-6772,,
15363279675,837.91432,16767924293,849635400,16767917516,-6777,,
15363329840,837.96449,16767974461,849685562,16767967679,-6782,,
15363380841,838.01549,16768025464,849736561,16768018678,-6786,,
15363431397,838.06605,16768076023,849787115,16768069231,-6792,,
15363481965,838.11661,16768126593,849837679,16768119795,-6798,,
15363532059,838.16671,16768176689,849887771,16768169887,-6802,,
15363582564,838.21721,16768227197,849938274,16768220390,-6807,,
15363633122,838.26777,16768277758,849988828,16768270945,-6813,,
15363683539,838.31819,16768328176,850039242,16768321358,-6818,,
15363734090,838.36874,16768378729,850089791,16768371907,-6822,,
15363784853,838.41950,16768429496,850140551,16768422668,-6828,,
15363835393,838.47004,16768480038,850191088,16768473205,-6833,,
15363885930,838.52058,16768530577,850241623,16768523740,-6837,,
15363936134,838.57078,16768580784,850291825,16768573941,-6843,,
15363986721,838.62137,16768631373,850342408,16768624525,-6848,,
15364036973,838.67162,16768681627,850392658,16768674775,-6852,,
15364087849,838.72250,16768732506,850443531,16768725648,-6858,,
15364138166,838.77281,16768782825,850493846,16768775962,-6863,,
15364188567,838.82322,16768833228,850544244,16768826361,-6867,,
15364239116,838.87376,16768883780,850594790,16768876907,-6873,,
15364289871,838.92452,16768934536,850645542,16768927658,-6878,,
15364340406,838.97505,16768985073,850696074,16768978190,-6883,,
15364390861,839.02551,16769035532,850746528,16769028644,-6888,,
15364441426,839.07607,16769086099,850797089,16769079206,-6893,,
15364491892,839.12654,16769136568,850847553,16769129669,-6899,,
15364542920,839.17757,16769187598,850898577,16769180694,-6904,,
15364593449,839.22810,16769238128,850949104,16769231220,-6908,,
15364643641,839.27829,16769288323,850999293,16769281409,-6914,,
15364693739,839.32839,16769338424,851049388,16769331505,-6919,,
15364744575,839.37922,16769389262,851100222,16769382339,-6923,,
15364794644,839.42929,16769439333,851150288,16769432404,-6929,,
15364845183,839.47983,16769489875,851200825,16769482941,-6934,,
15364896003,839.53065,16769540697,851251642,16769533759,-6938,,
15364946791,839.58144,16769591488,851302428,16769584544,-6944,,
15364997457,839.63211,16769642155,851353090,16769635206,-6949,,
15365047685,839.68233,16769692385,851403315,16769685431,-6954,,
15365098280,839.73293,16769742983,851453908,16769736024,-6959,,
15365148998,839.78365,16769793703,851504623,16769786739,-6964,,
15365199367,839.83402,16769844075,851554990,16769837106,-6969,,
15365250069,839.88472,16769894780,851605690,16769887806,-6974,,
15365300602,839.93525,16769945315,851656219,16769938336,-6979,,
15365350677,839.98532,16769995392,851706292,16769988408,-6984,,
15365401150,840.03580,16770045868,851756762,16770038878,-6990,,
15365451812,840.08646,16770096532,851807421,16770089538,-6994,,
15365502352,840.13700,16770147075,851857958,16770140075,-7000,,
15365553211,840.18786,16770197935,851908814,16770190930,-7005,,
15365603752,840.23840,16770248479,851959354,16770241470,-7009,,
15365654241,840.28889,16770298970,852009839,16770291955,-7015,,
15365704345,840.33899,16770349076,852059940,16770342056,-7020,,
15365755305,840.38995,16770400039,852110898,16770393015,-7024,,
15365805491,840.44014,16770450228,852161081,16770443197,-7031,,
15365856435,840.49108,16770501174,852212023,16770494139,-7035,,
15365907202,840.54185,16770551943,852262787,16770544904,-7039,,
15365957574,840.59222,16770602318,852313157,16770595273,-7045,,
15366007812,840.64246,16770652557,852363391,16770645507,-7050,,
15366058452,840.69310,16770703200,852414028,16770696145,-7055,,
15366109184,840.74383,16770753935,852464759,16770746875,-7060,,
15366159888,840.79454,16770804640,852515459,16770797576,-7064,,
15366209983,840.84463,16770854737,852565551,16770847667,-7070,,
15366260211,840.89486,16770904968,852615776,16770897893,-7075,,
15366310330,840.94498,16770955090,852665893,16770948010,-7080,,
15366360984,840.99563,16771005746,852716544,16770998661,-7085,,
15366411344,841.04599,16771056108,852766901,16771049018,-7090,,
15366462086,841.09673,16771106853,852817641,16771099758,-7095,,
15366512323,841.14697,16771157092,852867875,16771149992,-7100,,
15366563155,841.19780,16771207926,852918704,16771200820,-7106,,
15366613729,841.24838,16771258503,852969277,16771251393,-7110,,
15366664344,841.29899,16771309121,853019889,16771302005,-7116,,
15366714828,841.34948,16771359607,853070369,16771352486,-7121,,
15366764883,841.39953,16771409663,853120422,16771402538,-7125,,
15366814934,841.44958,16771459718,853170470,16771452587,-7131,,
15366864991,841.49964,16771509777,853220524,16771502641,-7136,,
15366915411,841.55006,16771560199,853270943,16771553059,-7140,,
15366966278,841.60093,16771611069,853321806,16771603923,-7146,,
15367016391,841.65104,16771661184,853371916,16771654033,-7151,,
15367066547,841.70119,16771711341,853422069,16771704185,-7156,,
15367117226,841.75187,16771762023,853472746,16771754862,-7161,,
15367167518,841.80217,16771812329,853523046,16771805163,-7166,,
15367218203,841.85285,16771863005,853573718,16771855834,-7171,,
15367268774,841.90342,16771913578,853624286,16771906402,-7176,,
15367319468,841.95412,16771964275,853674977,16771957094,-7181,,
15367370034,842.00468,16772014842,853725540,16772007656,-7186,,
15367420589,842.05524,16772065401,853776094,16772058210,-7191,,
15367470741,842.10539,16772115555,853826243,16772108359,-7196,,
15367521330,842.15598,16772166145,853876835,16772158952,-7193,,
15367571611,842.20626,16772216430,853927107,16772209223,-7207,,
15367621853,842.25650,16772266674,853977346,16772259463,-7211,,
15367672280,842.30693,16772317103,854027770,16772309887,-7216,,
15367722502,842.35715,16772367328,854077989,16772360106,-7222,,
15367773324,842.40797,16772418152,854128809,16772410926,-7226,,
15367824098,842.45875,16772468927,854179580,16772461696,-7231,,
15367874772,842.50942,16772519605,854230251,16772512367,-7238,,
15367925463,842.56011,16772570298,854280941,16772563057,-7241,,
15367976441,842.61109,16772621279,854331915,16772614032,-7247,,
15368027415,842.66206,16772672255,854382886,16772665003,-7252,,
15368077835,842.71248,16772722677,854433303,16772715420,-7257,,
15368128348,842.76300,16772773193,854483815,16772765931,-7262,,
15368178893,842.81354,16772823740,854534356,16772816473,-7267,,
15368229462,842.86411,16772874311,854584922,16772867039,-7272,,
15368279991,842.91464,16772924843,854635450,16772917566,-7277,,
15368330366,842.96501,16772975220,854685822,16772967938,-7282,,
15368380816,843.01546,16773025671,854736268,16773018384,-7287,,
15368431385,843.06603,16773076244,854786834,16773068951,-7293,,
15368481913,843.11656,16773126773,854837360,16773119476,-7297,,
15368532283,843.16693,16773177146,854887728,16773169844,-7302,,
15368582821,843.21747,16773227686,854938262,16773220378,-7308,,
15368633057,843.26770,16773277925,854988497,16773270613,-7312,,
15368683648,843.31830,16773328518,855039084,16773321200,-7318,,
15368733967,843.36861,16773378840,855089401,16773371517,-7323,,
15368784200,843.41885,16773429075,855139631,16773421748,-7327,,
15369044483,843.67913,16773689369,855399900,16773682016,-7353,16773688147,
15369069748,843.70440,16773714636,855425163,16773707309,-7327,,
15369120185,843.75483,16773765076,855475598,16773757806,-7270,,
15369170421,843.80507,16773815313,855525831,16773808100,-7213,,
15369221323,843.85597,16773866218,855576731,16773859062,-7156,,
15369271526,843.90617,16773916424,855626931,16773909325,-7099,,
15369322130,843.95678,16773967030,855677533,16773959988,-7042,,
15369372232,844.00688,16774017133,855727631,16774010148,-6985,,
15369422501,844.05715,16774067406,855777897,16774060476,-6930,,
15369473156,844.10780,16774118063,855828550,16774111191,-6872,,
15369523991,844.15864,16774168900,855879382,16774162085,-6815,,
15369574404,844.20905,16774219315,855929792,16774212556,-6759,,
15369624738,844.25939,16774269652,855980124,16774262951,-6701,,
15369675430,844.31008,16774320346,856030813,16774313701,-6645,,
15369725915,844.36056,16774370834,856081295,16774364245,-6589,,
15369776722,844.41137,16774421643,856132100,16774415113,-6530,,
15369826803,844.46145,16774471727,856182178,16774465253,-6474,,
15369877204,844.51185,16774522130,856232576,16774515713,-6417,,
15369927317,844.56196,16774572244,856282686,16774565883,-6361,,
15369978284,844.61293,16774623214,856333651,16774616911,-6303,,
15370029100,844.66375,16774674032,856384464,16774667786,-6246,,
15370079398,844.71405,16774724333,856434759,16774718144,-6189,,
15370129701,844.76435,16774774638,856485060,16774768507,-6131,,
15370179849,844.81450,16774824789,856535205,16774818713,-6076,,
15370229949,844.86460,16774874890,856585302,16774868872,-6018,,
15370280690,844.91534,16774925635,856636041,16774919673,-5962,,
15370331112,844.96576,16774976058,856686460,16774970153,-5905,,
15370381171,845.01582,16775026120,856736517,16775020271,-5849,,
15370431858,845.06651,16775076810,856787200,16775071017,-5793,,
15370482301,845.11695,16775127255,856837641,16775121520,-5735,,
15370532713,845.16736,16775177668,856888050,16775171991,-5677,,
15370583132,845.21778,16775228091,856938466,16775222469,-5622,,
15370633745,845.26839,16775278706,856989077,16775273142,-5564,,
15370684372,845.31902,16775329335,857039701,16775323828,-5507,,
15370734928,845.36958,16775379893,857090254,16775374442,-5451,,
15370785904,845.42055,16775430872,857141227,16775425478,-5394,,
15370836453,845.47110,16775481423,857191774,16775476087,-5336,,
15370886986,845.52163,16775531958,857242304,16775526678,-5280,,
15370937381,845.57203,16775582356,857292696,16775577132,-5224,,
15370987568,845.62222,16775632545,857342881,16775627379,-5166,,
15371037896,845.67254,16775682876,857393206,16775677767,-5109,,
15371088075,845.72272,16775733057,857443382,16775728004,-5053,,
15371138140,845.77279,16775783125,857493445,16775778128,-4997,,
15371188819,845.82347,16775833805,857544121,16775828866,-4939,,
15371239345,845.87399,16775884333,857594644,16775879451,-4882,,
15371289811,845.92446,16775934803,857645109,16775929977,-4826,,
15371339903,845.97455,16775984896,857695197,16775980127,-4769,,
15371390034,846.02468,16776035030,857745326,16776030317,-4713,,
15371440143,846.07479,16776085142,857795432,16776080485,-4657,,
15371490585,846.12523,16776135586,857845871,16776130987,-4599,,
15371541326,846.17597,16776186328,857896609,16776181786,-4542,,
15371591846,846.22649,16776236852,857947126,16776232365,-4487,,
15371642561,846.27721,16776287569,857997839,16776283140,-4429,,
15371692689,846.32734,16776337698,858047964,16776333327,-4371,,
15371743044,846.37769,16776388057,858098316,16776383740,-4317,,
15371793170,846.42782,16776438184,858148440,16776433926,-4258,,
15371843540,846.47819,16776488557,858198807,16776484355,-4202,,
15371893877,846.52852,16776538896,858249141,16776534750,-4146,,
15371944837,846.57948,16776589858,858300098,16776585778,-4080,,
15371995885,846.63053,16776640909,858351145,16776636880,-4029,,
15372046212,846.68086,16776691239,858401468,16776687265,-3974,,
15372096505,846.73115,16776741533,858451758,16776737616,-3917,,
15372147270,846.78192,16776792301,858502521,16776788441,-3860,,
15372197898,846.83255,16776842932,858553147,16776839129,-3803,,
15372248946,846.88359,16776893982,858604192,16776890237,-3745,,
15372299026,846.93367,16776944065,858654269,16776940376,-3689,,
15372349095,846.98374,16776994136,858704336,16776990504,-3632,,
15372399666,847.03431,16777044708,858754903,16777041133,-3575,,
15372449772,847.08442,16777094817,858805006,16777091297,-3520,,
15372500342,847.13499,16777145390,858855575,16777141928,-3462,,
15372550410,847.18506,16777195459,858905639,16777192054,-3405,,
15372600857,847.23550,16777245910,858956083,16777242561,-3349,,
15372651123,847.28577,16777296177,859006347,16777292885,-3292,,
15372701475,847.33612,16777346531,859056696,16777343296,-3235,,
15372751949,847.38660,16777397008,859107167,16777393829,-3179,,
15372802485,847.43713,16777447546,859157701,16777444425,-3121,,
15372852555,847.48720,16777497618,859207768,16777494553,-3065,,
15372903431,847.53808,16777548497,859258641,16777545489,-3008,,
15372953923,847.58857,16777598992,859309131,16777596041,-2951,,
15373004700,847.63935,16777649771,859359906,16777646878,-2893,,
15373055561,847.69021,16777700635,859410763,16777697798,-2837,,
15373106606,847.74125,16777751681,859461805,16777748902,-2779,,
15373156726,847.79137,16777801804,859511924,16777799082,-2722,,
15373207548,847.84220,16777852628,859562741,16777849963,-2665,,
15373258058,847.89271,16777903141,859613249,16777900533,-2608,,
15373308627,847.94327,16777953712,859663816,16777951161,-2551,,
15373358853,847.99350,16778003941,859714039,16778001446,-2495,,
15373409647,848.04430,16778054737,859764831,16778052300,-2437,,
15373460176,848.09482,16778105268,859815355,16778102887,-2381,,
15373510736,848.14538,16778155831,859865914,16778153508,-2323,,
15373561281,848.19593,16778206377,859916456,16778204111,-2266,,
15373611775,848.24642,16778256875,859966947,16778254664,-2211,,
15373662091,848.29674,16778307192,860017261,16778305039,-2153,,
15373712666,848.34731,16778357769,860067833,16778355674,-2095,,
15373763703,848.39835,16778408809,860118867,16778406770,-2039,,
15373814158,848.44881,16778459267,860169319,16778457285,-1982,,
15373864819,848.49947,16778509929,860219978,16778508005,-1924,,
15373914887,848.54953,16778560000,860270043,16778558132,-1868,,
15373965420,848.60007,16778610536,860320573,16778608724,-1812,,
15374015930,848.65058,16778661048,860371081,16778659294,-1754,,
15374066767,848.70141,16778711887,860421915,16778710163,-1724,,
15374117567,848.75221,16778762689,860472712,16778760960,-1729,,
15374168148,848.80280,16778813273,860523291,16778811540,-1733,,
15374218591,848.85324,16778863718,860573731,16778861979,-1739,,
15374269588,848.90424,16778914717,860624725,16778912973,-1744,,
15374320101,848.95475,16778965233,860675235,16778963483,-1750,,
15374370810,849.00546,16779015944,860725942,16779014190,-1754,,
15374421396,849.05604,16779066532,860776525,16779064773,-1759,,
15374471763,849.10641,16779116902,860826889,16779115137,-1765,,
15374521814,849.15646,16779166955,860876938,16779165187,-1768,,
15374572815,849.20746,16779217959,860927936,16779216184,-1775,,
15374623228,849.25788,16779268375,860978346,16779266595,-1780,,
15374673666,849.30831,16779318815,861028781,16779317030,-1785,,
15374724148,849.35880,16779369299,861079261,16779367509,-1790,,
15374775196,849.40984,16779420349,861130306,16779418554,-1795,,
15374825739,849.46039,16779470895,861180846,16779469095,-1800,,
15374876267,849.51091,16779521425,861231372,16779519621,-1804,,
15374926802,849.56145,16779571962,861281904,16779570153,-1809,,
15374976892,849.61154,16779622055,861331991,16779620240,-1815,,
15375027500,849.66215,16779672665,861382597,16779670845,-1820,,
15375077648,849.71230,16779722815,861432742,16779720990,-1825,,
15375128340,849.76299,16779773509,861483430,16779771679,-1830,,
15375178425,849.81307,16779823597,861533513,16779821762,-1835,,
15375228531,849.86318,16779873706,861583617,16779871866,-1840,,
15375279130,849.91378,16779924306,861634212,16779922461,-1845,,
15375329606,849.96425,16779974784,861684686,16779972934,-1850,,
15375379928,850.01458,16780025109,861735005,16780023254,-1855,,
15375430241,850.06489,16780075424,861785316,16780073565,-1859,,
15375481049,850.11570,16780126235,861836121,16780124369,-1866,,
15375531545,850.16619,16780176733,861886615,16780174864,-1869,,
15375581884,850.21653,16780227075,861936951,16780225200,-1875,,
15375632432,850.26708,16780277626,861987496,16780275745,-1881,,
15375682766,850.31741,16780327962,862037829,16780326077,-1885,,
15375733164,850.36781,16780378361,862088223,16780376471,-1890,,
15375784010,850.41866,16780429211,862139066,16780427314,-1897,,
15375834653,850.46930,16780479855,862189706,16780477954,-1901,,
15375884753,850.51940,16780529958,862239805,16780528053,-1905,,
15375935213,850.56986,16780580421,862290262,16780578510,-1911,,
15375986018,850.62067,16780631228,862341064,16780629312,-1916,,
15376036800,850.67145,16780682012,862391843,16780680091,-1921,,
15376087620,850.72227,16780732834,862442660,16780730908,-1926,,
15376138489,850.77314,16780783705,862493525,16780781774,-1931,,
15376189003,850.82365,16780834221,862544037,16780832285,-1936,,
15376239461,850.87411,16780884682,862594493,16780882741,-1941,,
15376289955,850.92460,16780935178,862644984,16780933232,-1946,,
15376340492,850.97514,16780985717,862695518,16780983766,-1951,,
15376390736,851.02538,16781035964,862745760,16781034008,-1956,,
15376441687,851.07633,16781086918,862796708,16781084956,-1962,,
15376491883,851.12653,16781137117,862846902,16781135150,-1967,,
15376542455,851.17710,16781187691,862897471,16781185719,-1972,,
15376592821,851.22747,16781238059,862947834,16781236083,-1976,,
15376642983,851.27763,16781288223,862997993,16781286242,-1981,,
15376693464,851.32811,16781338706,863048471,16781336719,-1987,,
15376743562,851.37821,16781388807,863098567,16781386816,-1991,,
15376794117,851.42876,16781439364,863149119,16781437367,-1997,,
15376845154,851.47980,16781490403,863200153,16781488401,-2002,,
15376895662,851.53031,16781540913,863250659,16781538907,-2006,,
15376946220,851.58087,16781591474,863301214,16781589463,-2011,,
15376996806,851.63145,16781642062,863351797,16781640045,-2017,,
15377047174,851.68182,16781692433,863402164,16781690412,-2021,,
15377097969,851.73262,16781743230,863452955,16781741204,-2026,,
15377148705,851.78335,16781793969,863503689,16781791937,-2032,,
15377199186,851.83383,16781844452,863554167,16781842415,-2037,,
15377249782,851.88443,16781895051,863604760,16781893009,-2042,,
15377300548,851.93520,16781945819,863655523,16781943771,-2048,,
15377350855,851.98550,16781996128,863705827,16781994076,-2052,,
15377401738,852.03639,16782047013,863756708,16782044956,-2057,,
15377452672,852.08732,16782097950,863807640,16782095888,-2062,,
15377503228,852.13788,16782148508,863858192,16782146440,-2068,,
15377553731,852.18838,16782199014,863908692,16782196941,-2073,,
15377604235,852.23888,16782249519,863959194,16782247442,-2077,,
15377654706,852.28935,16782299994,864009663,16782297911,-2083,,
15377705587,852.34024,16782350877,864060541,16782348789,-2088,,
15377755723,852.39037,16782401014,864110674,16782398922,-2092,,
15377805888,852.44054,16782451183,864160837,16782449085,-2098,,
15377856458,852.49111,16782501755,864211404,16782499652,-2103,,
15377906693,852.54134,16782551992,864261636,16782549885,-2107,,
15377957377,852.59203,16782602678,864312317,16782600566,-2112,,
15378007666,852.64231,16782652970,864362603,16782650851,-2119,,
15378058407,852.69305,16782703713,864413342,16782701590,-2123,,
15378108666,852.74331,16782753974,864463598,16782751846,-2128,,
15378159643,852.79429,16782804960,864514587,16782802836,-2124,,
15378210129,852.84478,16782855441,864565055,16782853303,-2138,,
15378260722,852.89537,16782906038,864615646,16782903895,-2143,,
15378310956,852.94560,16782956273,864665877,16782954125,-2148,,
15378361091,852.99574,16783006410,864716009,16783004257,-2153,,
15378411204,853.04585,16783056527,864766120,16783054369,-2158,,
15378461737,853.09639,16783107061,864816650,16783104898,-2163,,
15378512056,853.14670,16783157383,864866967,16783155215,-2168,,
15378562484,853.19713,16783207814,864917391,16783205640,-2174,,
15378612613,853.24726,16783257945,864967518,16783255766,-2179,,
15378663584,853.29823,16783308919,865018486,16783306735,-2184,,
15378713938,853.34859,16783359275,865068838,16783357086,-2189,,
15378764367,853.39901,16783409706,865119264,16783407513,-2193,,
15378815419,853.45007,16783460760,865170313,16783458561,-2199,,
15378866452,853.50110,16783511796,865221343,16783509592,-2204,,
15378917510,853.55216,16783562855,865272398,16783560646,-2209,,
15378967820,853.60247,16783613168,865322706,16783610954,-2214,,
15379018497,853.65314,16783663848,865373380,16783661629,-2219,,
15379069044,853.70369,16783714397,865423924,16783712173,-2224,,
15379119665,853.75431,16783765021,865474544,16783762792,-2229,,
15379170172,853.80482,16783815529,865525047,16783813295,-2234,,
15379221066,853.85571,16783866425,865575937,16783864186,-2239,,
15379271710,853.90636,16783917073,865626580,16783914829,-2244,,
15379322367,853.95701,16783967731,865677234,16783965482,-2249,,
15379372834,854.00748,16784018200,865727698,16784015947,-2253,,
15379423129,854.05778,16784068498,865777990,16784066238,-2260,,
15379473643,854.10829,16784119014,865828502,16784116750,-2264,,
15379524455,854.15910,16784169829,865879310,16784167559,-2270,,
15379575134,854.20978,16784220511,865929987,16784218236,-2275,,
15379626115,854.26076,16784271494,865980967,16784269215,-2279,,
15379677063,854.31171,16784322445,866031911,16784320160,-2285,,
15379727258,854.36191,16784372642,866082104,16784370352,-2290,,
15379777711,854.41236,16784423097,866132554,16784420802,-2295,,
15379828477,854.46312,16784473866,866183317,16784471565,-2301,,
15379878830,854.51348,16784524221,866233667,16784521916,-2305,,
15379929827,854.56448,16784575219,866284661,16784572909,-2310,,
15379980345,854.61499,16784625741,866335177,16784623426,-2315,,
15380031260,854.66591,16784676657,866386089,16784674337,-2320,,
15380082017,854.71667,16784727416,866436843,16784725091,-2325,,
15380132187,854.76684,16784777590,866487011,16784775259,-2331,,
15380182444,854.81709,16784827849,866537265,16784825513,-2336,,
15380233212,854.86786,16784878619,866588030,16784876279,-2340,,
15380283720,854.91837,16784929130,866638536,16784926784,-2346,,
15380334312,854.96896,16784979724,866689126,16784977374,-2350,,
15380384925,855.01957,16785030340,866739735,16785027984,-2356,,
15380435485,855.07013,16785080901,866790292,16785078541,-2360,,
15380486087,855.12073,16785131506,866840892,16785129140,-2366,,
15380536641,855.17129,16785182063,866891443,16785179692,-2371,,
15380587011,855.22166,16785232434,866941810,16785230058,-2376,,
15380637335,855.27198,16785282760,866992131,16785280379,-2381,,
15380687563,855.32221,16785332992,867042357,16785330605,-2387,,
15380738519,855.37317,16785383950,867093310,16785381559,-2391,,
15380788773,855.42342,16785434206,867143561,16785431810,-2396,,
15380839846,855.47449,16785485282,867194632,16785482881,-2401,,
15380890268,855.52492,16785535705,867245051,16785533300,-2405,,
15380941055,855.57570,16785586495,867295836,16785584084,-2411,,
15380991819,855.62647,16785637261,867346596,16785634844,-2417,,
15381042609,855.67726,16785688054,867397384,16785685633,-2421,,
15381092664,855.72731,16785738111,867447437,16785735686,-2425,,
15381142869,855.77752,16785788319,867497639,16785785887,-2432,,
15381192935,855.82758,16785838386,867547702,16785835951,-2435,,
15381243697,855.87834,16785889151,867598461,16785886710,-2441,,
15381294171,855.92882,16785939628,867648933,16785937182,-2446,,
15381344867,855.97951,16785990325,867699626,16785987874,-2451,,
15381395310,856.02996,16786040771,867750066,16786038314,-2457,,
15381445873,856.08052,16786091337,867800626,16786088875,-2462,,
15381496433,856.13108,16786141899,867851183,16786139432,-2467,,
15381546540,856.18119,16786192009,867901289,16786189537,-2472,,
15381597012,856.23166,16786242483,867951757,16786240006,-2477,,
15381647100,856.28175,16786292572,868001842,16786290090,-2482,,
15381697338,856.33199,16786342814,868052078,16786340327,-2487,,
15381747438,856.38209,16786392915,868102175,16786390423,-2492,,
15381797568,856.43222,16786443048,868152302,16786440550,-2498,,
15381848080,856.48273,16786493562,868202812,16786491060,-2502,,
15381898613,856.53326,16786544097,868253342,16786541590,-2507,,
15381948701,856.58335,16786594187,868303427,16786591675,-2512,,
15381999332,856.63398,16786644821,868354056,16786642305,-2516,,
15382049629,856.68428,16786695121,868404351,16786692599,-2522,,
15382100459,856.73511,16786745953,868455178,16786743426,-2527,,
15382150789,856.78544,16786796285,868505504,16786793752,-2533,,
15382201464,856.83611,16786846962,868556177,16786844426,-2536,,
15382251813,856.88646,16786897313,868606522,16786894771,-2542,,
15382302834,856.93748,16786948337,868657541,16786945789,-2548,,
15382353392,856.98804,16786998898,868708097,16786996346,-2552,,
15382404015,857.03866,16787049523,868758717,16787046966,-2557,,
15382454198,857.08885,16787099708,868808897,16787097145,-2563,,
15382504792,857.13944,16787150306,868859490,16787147738,-2568,,
15382555546,857.19019,16787201060,868910240,16787198488,-2572,,
15382606319,857.24097,16787251836,868961010,16787249258,-2578,,
15382656879,857.29153,16787302398,869011567,16787299815,-2583,,
15382707347,857.34199,16787352869,869062033,16787350281,-2588,,
15382758005,857.39265,16787403529,869112688,16787400936,-2593,,
15382808536,857.44318,16787454062,869163216,16787451464,-2598,,
15382859657,857.49431,16787505186,869214335,16787502584,-2602,,
15382910163,857.54481,16787555694,869264838,16787553087,-2607,,
15382960707,857.59536,16787606241,869315379,16787603627,-2614,,
15383011024,857.64567,16787656560,869365693,16787653941,-2619,,
15383061599,857.69625,16787707137,869416266,16787704514,-2623,,
15383111976,857.74662,16787757517,869466641,16787754889,-2628,,
15383162689,857.79734,16787808232,869517350,16787805598,-2634,,
15383213359,857.84801,16787858904,869568018,16787856266,-2638,,
15383264157,857.89881,16787909705,869618813,16787907062,-2643,,
15383314648,857.94930,16787960199,869669302,16787957550,-2649,,
15383365586,858.00023,16788011139,869720236,16788008484,-2655,,
15383416435,858.05108,16788061991,869771083,16788059332,-2659,,
15383466568,858.10122,16788112125,869821213,16788109461,-2664,,
15383517098,858.15175,16788162658,869871740,16788159989,-2669,,
15383567638,858.20229,16788213200,869922278,16788210526,-2674,,
15383618190,858.25284,16788263755,869972828,16788261076,-2679,,
15383668902,858.30355,16788314474,870023543,16788311792,-2682,,
15383719589,858.35424,16788365158,870074221,16788362469,-2689,,
15383770243,858.40489,16788415814,870124871,16788413120,-2694,,
15383820809,858.45546,16788466382,870175435,16788463683,-2699,,
15383871661,858.50631,16788517238,870226285,16788514533,-2705,,
15383922247,858.55690,16788567825,870276868,16788565116,-2709,,
15383972397,858.60704,16788617978,870327016,16788615264,-2714,,
15384022661,858.65731,16788668244,870377276,16788665524,-2720,,
15384073309,858.70796,16788718895,870427922,16788716171,-2724,,
15384123568,858.75822,16788769155,870478178,16788766426,-2729,,
15384173637,858.80828,16788819228,870528244,16788816493,-2735,,
15384223859,858.85851,16788869452,870578464,16788866712,-2740,,
15384274400,858.90905,16788919995,870629002,16788917251,-2744,,
15384325388,858.96004,16788970985,870679987,16788968235,-2750,,
15384375618,859.01027,16789021217,870730214,16789018462,-2755,,
15384426263,859.06091,16789071864,870780857,16789069105,-2759,,
15384477081,859.11173,16789122685,870831672,16789119920,-2765,,
15384527774,859.16242,16789173381,870882363,16789170611,-2770,,
15384578312,859.21296,16789223921,870932898,16789221146,-2775,,
15384628801,859.26345,16789274412,870983384,16789271632,-2780,,
15384679673,859.31432,16789325286,871034253,16789322501,-2785,,
15384730008,859.36466,16789375625,871084585,16789372834,-2791,,
15384780513,859.41516,16789426132,871135088,16789423336,-2796,,
15384831077,859.46573,16789476697,871185649,16789473897,-2800,,
15384882613,859.51726,16789528237,871237182,16789525431,-2806,,
15384933650,859.56830,16789579275,871288217,16789576465,-2810,,
15384984249,859.61890,16789629876,871338813,16789627061,-2815,,
15385034573,859.66922,16789680204,871389135,16789677383,-2821,,
15385085063,859.71971,16789730695,871439621,16789727870,-2825,,
15385135556,859.77020,16789781191,871490112,16789778361,-2830,,
15385186071,859.82072,16789831709,871540625,16789828873,-2836,,
15385236477,859.87113,16789882117,871591027,16789879276,-2841,,
15385287142,859.92179,16789932784,871641690,16789929938,-2846,,
15385337686,859.97233,16789983331,871692232,16789980480,-2851,,
15385388114,860.02276,16790033761,871742656,16790030905,-2856,,
15385438715,860.07336,16790084365,871793255,16790081504,-2861,,
15385489179,860.12383,16790134831,871843716,16790131965,-2866,,
15385539356,860.17400,16790185009,871893890,16790182138,-2871,,
15385589808,860.22446,16790235464,871944339,16790232587,-2877,,
15385640489,860.27514,16790286148,871995018,16790283267,-2881,,
15385690835,860.32548,16790336496,872045361,16790333610,-2886,,
15385741004,860.37565,16790386667,872095526,16790383775,-2892,,
15385791751,860.42640,16790437417,872146272,16790434521,-2896,,
15385842374,860.47702,16790488042,872196892,16790485141,-2901,,
15385892813,860.52746,16790538484,872247328,16790535577,-2907,,
15385943241,860.57789,16790588913,872297753,16790586002,-2911,,
15385993673,860.62832,16790639348,872348183,16790636432,-2916,,
15386044566,860.67921,16790690243,872399073,16790687322,-2921,,
15386094939,860.72959,16790740619,872449444,16790737692,-2927,,
15386145629,860.78028,16790791311,872500132,16790788380,-2931,,
15386195846,860.83049,16790841531,872550345,16790838594,-2937,,
15386246676,860.88132,16790892362,872601172,16790889421,-2941,,
15386297331,860.93198,16790943020,872651826,16790940074,-2946,,
15386347975,860.98262,16790993666,872702466,16790990714,-2952,,
15386398301,861.03295,16791043994,872752789,16791041037,-2957,,
15386448850,861.08350,16791094546,872803336,16791091584,-2962,,
15386499216,861.13386,16791144915,872853700,16791141948,-2967,,
15386549857,861.18450,16791195557,872904337,16791192585,-2972,,
15386600127,861.23478,16791245831,872954604,16791242853,-2978,,
15386650410,861.28506,16791296116,873004885,16791293134,-2982,,
15386701085,861.33573,16791346792,873055557,16791343805,-2987,,
15386751164,861.38581,16791396875,873105633,16791393881,-2994,,
15386801607,861.43625,16791447320,873156075,16791444323,-2997,,
15386852179,861.48683,16791497893,873206643,16791494891,-3002,,
15386902731,861.53738,16791548449,873257192,16791545440,-3009,,
15386952820,861.58747,16791598540,873307280,16791595528,-3012,,
15387003779,861.63843,16791649500,873358235,16791646483,-3017,,
15387054718,861.68937,16791700443,873409172,16791697420,-3023,,
15387105548,861.74020,16791751275,873459999,16791748247,-3028,,
15387156186,861.79083,16791801915,873510634,16791798882,-3033,,
15387207109,861.84176,16791852840,873561554,16791849802,-3038,,
15387257266,861.89191,16791902999,873611708,16791899956,-3043,,
15387307407,861.94205,16791953142,873661847,16791950096,-3046,,
15387357928,861.99258,16792003667,873712365,16792000613,-3054,,
15387408416,862.04306,16792054157,873762850,16792051099,-3058,,
15387467386,862.10203,16792113130,873821817,16792110066,-3064,,
15387524140,862.15879,16792169887,873878568,16792166817,-3070,,
15387583090,862.21774,16792228838,873937514,16792225763,-3075,,
15387633632,862.26828,16792279383,873988054,16792276302,-3081,,
15387683992,862.31864,16792329745,874038411,16792326660,-3085,,
15387734665,862.36931,16792380420,874089082,16792377330,-3090,,
15387784912,862.41956,16792430670,874139326,16792427574,-3096,,
15387835167,862.46982,16792480928,874189579,16792477827,-3101,,
15387887768,862.52242,16792533530,874242177,16792530425,-3105,,
15387938060,862.57271,16792583826,874292466,16792580715,-3111,,
15387988446,862.62309,16792634213,874342849,16792631097,-3116,,
15388039062,862.67371,16792684832,874393463,16792681711,-3121,,
15388089676,862.72432,16792735448,874444074,16792732322,-3126,,
15388140256,862.77490,16792786030,874494651,16792782899,-3131,,
15388190611,862.82526,16792836388,874545003,16792833251,-3137,,
15388240948,862.87560,16792886728,874595338,16792883586,-3142,,
15388291358,862.92601,16792937139,874645745,16792933993,-3146,,
15388341973,862.97662,16792987758,874696357,16792984606,-3152,,
15388392426,863.02707,16793038212,874746808,16793035056,-3156,,
15388442597,863.07724,16793088386,874796977,16793085225,-3161,,
15388493226,863.12787,16793139018,874847602,16793135851,-3167,,
15388543839,863.17849,16793189632,874898211,16793186460,-3172,,
15388594223,863.22887,16793240018,874948594,16793236843,-3175,,
15388644646,863.27929,16793290444,874999014,16793287262,-3182,,
15388695421,863.33007,16793341222,875049787,16793338035,-3187,,
15388745922,863.38057,16793391725,875100286,16793388534,-3191,,
15388796587,863.43124,16793442393,875150947,16793439196,-3197,,
15388854502,863.48915,16793500310,875208859,16793497108,-3202,,
15388905328,863.53998,16793551139,875259682,16793547931,-3208,,
15388955440,863.59009,16793601252,875309791,16793598039,-3213,,
15389005717,863.64036,16793651532,875360067,16793648315,-3217,,
15389056410,863.69106,16793702228,875410756,16793699005,-3223,,
15389106900,863.74155,16793752719,875461243,16793749491,-3228,,
15389157823,863.79247,16793803645,875512165,16793800413,-3232,,
15389208380,863.84303,16793854204,875562718,16793850966,-3238,,
15389259057,863.89370,16793904884,875613392,16793901641,-3243,,
15389309344,863.94399,16793955173,875663676,16793951925,-3248,,
15389359753,863.99440,16794005585,875714083,16794002332,-3253,,
15389410268,864.04492,16794056101,875764595,16794052843,-3258,,
15389461062,864.09571,16794106899,875815387,16794103636,-3263,,
15389511590,864.14624,16794157428,875865911,16794154160,-3268,,
15389561949,864.19660,16794207789,875916268,16794204516,-3273,,
15389612521,864.24717,16794258364,875966837,16794255086,-3278,,
15389662801,864.29745,16794308647,876017116,16794305364,-3283,,
15389713141,864.34779,16794358988,876067451,16794355700,-3288,,
15389763326,864.39797,16794409177,876117635,16794405883,-3294,,
15389813786,864.44843,16794459638,876168091,16794456339,-3299,,
15389864418,864.49907,16794510273,876218721,16794506970,-3303,,
15389915104,864.54975,16794560961,876269404,16794557652,-3309,,
15389965965,864.60061,16794611825,876320262,16794608510,-3315,,
15390016343,864.65099,16794662204,876370638,16794658886,-3318,,
15390066879,864.70153,16794712743,876421171,16794709419,-3324,,
15390117482,864.75213,16794763348,876471771,16794760019,-3329,,
15390167678,864.80233,16794813547,876521965,16794810213,-3334,,
15390218153,864.85280,16794864024,876572437,16794860686,-3338,,
15390268821,864.90347,16794914694,876623102,16794911350,-3344,,
15390319433,864.95408,16794965310,876673711,16794961960,-3350,,
15390369802,865.00445,16795015680,876724078,16795012327,-3353,,
15390420137,865.05479,16795066017,876774410,16795062658,-3359,,
15390470408,865.10506,16795116292,876824679,16795112927,-3365,,
15390520953,865.15560,16795166838,876875221,16795163470,-3368,,
15390571690,865.20634,16795217578,876925955,16795214204,-3374,,
15390621984,865.25663,16795267874,876976246,16795264494,-3380,,
15390672356,865.30700,16795318248,877026616,16795314864,-3384,,
15390723087,865.35774,16795368981,877077344,16795365592,-3389,,
15390773380,865.40803,16795419277,877127634,16795415882,-3395,,
15390824093,865.45874,16795469993,877178344,16795466593,-3400,,
15390874569,865.50922,16795520470,877228818,16795517066,-3404,,
15390924853,865.55950,16795570757,877279099,16795567347,-3410,,
15390975114,865.60976,16795621021,877329357,16795617606,-3415,,
15391025485,865.66013,16795671393,877379726,16795667974,-3419,,
15391075809,865.71046,16795721720,877430047,16795718295,-3425,,
15391126183,865.76083,16795772096,877480417,16795768666,-3430,,
15391176955,865.81160,16795822870,877531188,16795819436,-3434,,
15391227540,865.86219,16795873458,877581770,16795870018,-3440,,
15391278206,865.91285,16795924127,877632433,16795920682,-3445,,
15391328690,865.96334,16795974613,877682914,16795971163,-3450,,
15391379083,866.01373,16796025009,877733305,16796021554,-3455,,
15391429451,866.06410,16796075379,877783670,16796071919,-3460,,
15391479600,866.11425,16796125529,877833816,16796122064,-3465,,
15391530241,866.16489,16796176174,877884456,16796172704,-3470,,
15391580842,866.21549,16796226777,877935053,16796223302,-3475,,
15391631135,866.26578,16796277073,877985343,16796273591,-3482,,
15391681966,866.31661,16796327906,878036173,16796324421,-3485,,
15391732717,866.36736,16796378659,878086921,16796375169,-3490,,
15391783375,866.41802,16796429320,878137576,16796425824,-3496,,
15391833943,866.46859,16796479889,878188140,16796476388,-3501,,
15391884424,866.51907,16796530373,878238619,16796526867,-3506,,
15391935355,866.57000,16796581307,878289547,16796577795,-3512,,
15391986049,866.62070,16796632003,878340238,16796628487,-3516,,
15392036504,866.67115,16796682460,878390691,16796678940,-3520,,
15392087225,866.72187,16796733183,878441409,16796729657,-3526,,
15392137778,866.77243,16796783738,878491959,16796780208,-3530,,
15392188311,866.82296,16796834273,878542489,16796830738,-3535,,
15392238672,866.87332,16796884637,878592848,16796881096,-3541,,
15392288908,866.92356,16796934876,878643082,16796931330,-3546,,
15392339440,866.97409,16796985410,878693610,16796981859,-3551,,
15392390156,867.02480,16797036128,878744324,16797032572,-3556,,
15392440783,867.07543,16797086757,878794948,16797083196,-3561,,
15392491395,867.12604,16797137373,878845558,16797133806,-3567,,
15392541839,867.17649,16797187819,878895999,16797184248,-3571,,
15392592471,867.22712,16797238452,878946628,16797234876,-3576,,
15392642890,867.27754,16797288875,878997044,16797285293,-3582,,
15392693224,867.32787,16797339211,879047375,16797335624,-3587,,
15392743840,867.37849,16797389829,879097989,16797386238,-3591,,
15392794115,867.42876,16797440107,879148261,16797436510,-3597,,
15392844419,867.47907,16797490413,879198563,16797486811,-3602,,
15392894726,867.52937,16797540722,879248868,16797537116,-3606,,
15392945039,867.57969,16797591038,879299177,16797587425,-3613,,
15392995273,867.62992,16797641274,879349408,16797637657,-3617,,
15393045693,867.68034,16797691695,879399826,16797688074,-3621,,
15393096115,867.73076,16797742131,879450256,16797738504,-3627,,
15393146690,867.78134,16797792698,879500818,16797789066,-3632,,
15393197515,867.83216,16797843525,879551639,16797839888,-3637,,
15393248299,867.88295,16797894312,879602421,16797890670,-3642,,
15393298426,867.93307,16797944441,879652546,16797940794,-3647,,
15393348899,867.98355,16797994915,879703015,16797991263,-3652,,
15393399217,868.03386,16798045236,879753331,16798041579,-3657,,
15393449933,868.08458,16798095955,879804044,16798092293,-3662,,
15393500528,868.13518,16798146552,879854636,16798142885,-3667,,
15393550923,868.18557,16798196949,879905029,16798193277,-3672,,
15393601213,868.23586,16798247241,879955316,16798243564,-3677,,
15393651899,868.28655,16798297930,880006000,16798294248,-3682,,
15393702129,868.33678,16798348163,880056226,16798344475,-3688,,
15393752510,868.38716,16798398546,880106605,16798394854,-3692,,
15393802812,868.43746,16798448850,880156905,16798445153,-3697,,
15393853228,868.48788,16798499269,880207318,16798495566,-3703,,
15393903785,868.53843,16798549827,880257872,16798546120,-3707,,
15393954104,868.58875,16798600150,880308188,16798596437,-3713,,
15394004413,868.63906,16798650461,880358494,16798646743,-3718,,
15394054819,868.68947,16798700868,880408898,16798697146,-3722,,
15394105636,868.74028,16798751689,880459713,16798747961,-3728,,
15394156203,868.79085,16798802258,880510277,16798798525,-3733,,
15394206528,868.84118,16798852585,880560598,16798848847,-3738,,
15394256736,868.89138,16798902795,880610804,16798899053,-3742,,
15394307189,868.94184,16798953251,880661255,16798949503,-3748,,
15394357428,868.99208,16799003503,880711501,16798999750,-3753,,
15394408122,869.04277,16799054188,880762182,16799050430,-3758,,
15394458790,869.09344,16799104859,880812847,16799101096,-3763,,
15394509106,869.14375,16799155177,880863160,16799151409,-3768,,
15394559324,869.19397,16799205398,880913376,16799201625,-3773,,
15394609819,869.24447,16799255894,880963868,16799252116,-3778,,
15394659899,869.29455,16799305976,881013945,16799302194,-3782,,
15394710332,869.34498,16799356413,881064377,16799352625,-3788,,
15394761393,869.39604,16799407476,881115434,16799403683,-3793,,
15394811685,869.44633,16799457770,881165723,16799453971,-3799,,
15394862347,869.49699,16799508435,881216382,16799504630,-3805,,
15394912796,869.54744,16799558886,881266829,16799555077,-3809,,
15394963535,869.59818,16799609627,881317566,16799605814,-3813,,
15395014210,869.64886,16799660305,881368237,16799656486,-3819,,
15395065087,869.69974,16799711183,881419112,16799707361,-3822,,
15395115333,869.74998,16799761433,881469355,16799757604,-3829,,
15395166065,869.80071,16799812166,881520084,16799808333,-3833,,
15395216583,869.85123,16799862686,881570599,16799858848,-3838,,
15395266816,869.90146,16799912923,881620831,16799909079,-3844,,
15395317048,869.95170,16799963156,881671059,16799959307,-3849,,
15395367441,870.00209,16800013551,881721449,16800009697,-3854,,
15395417714,870.05236,16800063827,881771720,16800059968,-3859,,
15395468184,870.10283,16800114300,881822188,16800110436,-3864,,
15395518569,870.15322,16800164686,881872569,16800160817,-3869,,
15395568844,870.20349,16800214965,881922842,16800211090,-3875,,
15395619558,870.25421,16800265681,881973554,16800261802,-3879,,
15395669916,870.30456,16800316040,882023908,16800312156,-3884,,
15395720327,870.35497,16800366454,882074316,16800362564,-3890,,
15395771303,870.40595,16800417433,882125290,16800413539,-3894,,
15395821588,870.45624,16800467720,882175572,16800463821,-3899,,
15395871853,870.50650,16800517987,882225834,16800514082,-3905,,
15395922217,870.55687,16800568354,882276196,16800564445,-3909,,
15395972587,870.60723,16800618726,882326564,16800614812,-3914,,
15396022698,870.65735,16800668840,882376671,16800664920,-3920,,
15396073051,870.70770,16800719194,882427022,16800715270,-3924,,
15396124089,870.75874,16800770234,882478057,16800766305,-3929,,
15396174868,870.80952,16800821016,882528833,16800817081,-3935,,
15396225449,870.86010,16800871599,882579411,16800867659,-3940,,
15396276460,870.91111,16800922614,882630421,16800918669,-3945,,
15396326512,870.96116,16800972668,882680469,16800968718,-3950,,
15396376571,871.01122,16801022728,882730525,16801018773,-3955,,
15396427437,871.06209,16801073598,882781390,16801069639,-3959,,
15396477976,871.11262,16801124139,882831925,16801120174,-3965,,
15396529169,871.16382,16801175334,882883116,16801171364,-3970,,
15396580092,871.21474,16801226260,882934036,16801222284,-3976,,
15396630634,871.26528,16801276804,882984582,16801272830,-3974,,
15396681665,871.31631,16801327837,883035603,16801323851,-3986,,
15396732705,871.36735,16801378880,883086640,16801374889,-3991,,
15396783755,871.41840,16801429931,883137688,16801425937,-3994,,
15396834393,871.46904,16801480572,883188324,16801476572,-4000,,
15396885428,871.52008,16801531609,883239355,16801527603,-4006,,
15396935992,871.57064,16801582176,883289916,16801578165,-4011,,
15396986536,871.62118,16801632722,883340458,16801628707,-4015,,
15397037453,871.67210,16801683642,883391373,16801679621,-4021,,
15397088018,871.72267,16801734208,883441934,16801730182,-4026,,
15397138907,871.77355,16801785101,883492821,16801781069,-4032,,
15397188965,871.82361,16801835161,883542877,16801831125,-4036,,
15397239991,871.87464,16801886188,883593899,16801882147,-4041,,
15397290566,871.92521,16801936772,883644477,16801932725,-4047,,
15397341407,871.97605,16801987609,883695310,16801983558,-4051,,
15397392260,872.02691,16802038465,883746161,16802034409,-4056,,
15397442788,872.07744,16802088995,883796685,16802084933,-4062,,
15397493841,872.12849,16802140051,883847736,16802135985,-4066,,
15397544398,872.17905,16802190609,883898290,16802186538,-4071,,
15397594978,872.22963,16802241193,883948867,16802237116,-4077,,
15397645971,872.28062,16802292187,883999856,16802288105,-4082,,
15397696520,872.33117,16802342740,884050405,16802338653,-4087,,
15397746582,872.38123,16802392804,884100463,16802388712,-4092,,
15397797130,872.43178,16802443353,884151008,16802439256,-4097,,
15397847689,872.48234,16802493916,884201565,16802489814,-4102,,
15397898783,872.53343,16802545012,884252657,16802540905,-4107,,
15397949372,872.58402,16802595603,884303242,16802591491,-4112,,
15397999768,872.63442,16802646002,884353636,16802641885,-4117,,
15398050362,872.68501,16802696597,884404227,16802692475,-4122,,
15398100942,872.73559,16802747180,884454804,16802743053,-4127,,
15398151957,872.78661,16802798198,884505816,16802794065,-4133,,
15398202471,872.83712,16802848714,884556328,16802844577,-4137,,
15398253420,872.88807,16802899664,884607274,16802895522,-4142,,
15398304008,872.93866,16802950256,884657860,16802946109,-4147,,
15398354517,872.98916,16803000767,884708367,16802996615,-4152,,
15398405069,873.03972,16803051321,884758915,16803047164,-4157,,
15398455599,873.09025,16803101853,884809442,16803097690,-4163,,
15398506165,873.14081,16803152421,884860005,16803148253,-4168,,
15398556626,873.19127,16803202886,884910464,16803198713,-4173,,
15398607181,873.24183,16803253442,884961016,16803249264,-4178,,
15398658086,873.29273,16803304350,885011918,16803300167,-4183,,
15398708574,873.34322,16803354841,885062405,16803350653,-4188,,
15398759121,873.39377,16803405390,885112948,16803401197,-4193,,
15398809185,873.44383,16803455455,885163009,16803451258,-4197,,
15398860129,873.49478,16803506403,885213952,16803502200,-4203,,
15398910707,873.54535,16803556983,885264526,16803552775,-4208,,
15398961238,873.59589,16803607516,885315054,16803603302,-4214,,
15399012249,873.64690,16803658530,885366062,16803654311,-4219,,
15399062381,873.69703,16803708664,885416192,16803704441,-4223,,
15399113318,873.74797,16803759602,885467126,16803755375,-4227,,
15399163517,873.79817,16803809804,885517322,16803805570,-4234,,
15399213849,873.84850,16803860139,885567652,16803855901,-4238,,
15399264017,873.89867,16803910308,885617817,16803906065,-4243,,
15399314338,873.94899,16803960633,885668136,16803956384,-4249,,
15399365312,873.99996,16804011608,885719105,16804007354,-4254,,
15399416123,874.05077,16804062422,885769915,16804058164,-4258,,
15399466699,874.10135,16804113001,885820489,16804108737,-4264,,
15399517204,874.15185,16804163507,885870990,16804159239,-4268,,
15399567670,874.20232,16804213976,885921454,16804209702,-4274,,
15399617736,874.25238,16804264045,885971517,16804259766,-4279,,
15399668500,874.30315,16804314810,886022278,16804310526,-4284,,
15399718814,874.35346,16804365127,886072590,16804360839,-4288,,
15399769792,874.40444,16804416107,886123565,16804411814,-4293,,
15399820040,874.45469,16804466357,886173809,16804462058,-4299,,
15399871001,874.50565,16804517321,886224768,16804513016,-4305,,
15399921841,874.55649,16804568164,886275606,16804563855,-4309,,
15399972203,874.60685,16804618527,886325965,16804614214,-4313,,
15400023087,874.65774,16804669414,886376846,16804665094,-4320,,
15400073563,874.70821,16804719893,886427320,16804715569,-4324,,
15400124338,874.75899,16804770669,886478092,16804766340,-4329,,
15400174634,874.80928,16804820969,886528386,16804816634,-4335,,
15400225144,874.85979,16804871480,886578892,16804867141,-4339,,
15400275562,874.91021,16804921901,886629308,16804917557,-4344,,
15400326309,874.96096,16804972651,886680052,16804968300,-4351,,
15400376708,875.01136,16805023052,886730449,16805018697,-4355,,
15400427109,875.06176,16805073455,886780847,16805069096,-4359,,
15400478022,875.11267,16805124371,886831757,16805120006,-4365,,
15400528703,875.16335,16805175053,886882435,16805170683,-4370,,
15400579251,875.21390,16805225604,886932981,16805221229,-4375,,
15400629571,875.26422,16805275926,886983298,16805271546,-4380,,
15400680246,875.31489,16805326603,887033970,16805322218,-4385,,
15400730530,875.36518,16805376890,887084251,16805372499,-4391,,
15400781135,875.41578,16805427497,887134853,16805423102,-4395,,
15400831791,875.46644,16805478155,887185506,16805473755,-4400,,
15400882456,875.51710,16805528823,887236168,16805524417,-4406,,
15400932831,875.56748,16805579201,887286543,16805574791,-4410,,
15400983012,875.61766,16805629384,887336720,16805624969,-4415,,
15401033462,875.66811,16805679837,887387168,16805675417,-4420,,
15401084126,875.71877,16805730502,887437829,16805726077,-4425,,
15401134697,875.76935,16805781076,887488398,16805776646,-4430,,
15401185354,875.82000,16805831736,887539051,16805827300,-4436,,
15401235980,875.87063,16805882364,887589674,16805877923,-4441,,
15401286733,875.92138,16805933119,887640425,16805928674,-4445,,
15401337210,875.97186,16805983599,887690899,16805979148,-4451,,
15401387982,876.02263,16806034373,887741668,16806029917,-4456,,
15401438574,876.07322,16806084967,887792258,16806080507,-4460,,
15401489256,876.12390,16806135652,887842937,16806131186,-4466,,
15401539641,876.17429,16806186038,887893319,16806181568,-4470,,
15401590205,876.22485,16806236605,887943880,16806232128,-4477,,
15401640922,876.27557,16806287325,887994595,16806282843,-4482,,
15401690977,876.32562,16806337382,888044647,16806332896,-4486,,
15401741275,876.37592,16806387683,888094942,16806383191,-4492,,
15401791976,876.42662,16806438386,888145642,16806433890,-4496,,
15401842180,876.47683,16806488602,888195852,16806484101,-4501,,
15401892938,876.52759,16806539353,888246598,16806534846,-4507,,
15401943642,876.57829,16806590059,888297299,16806585548,-4511,,
15401994323,876.62897,16806640742,888347977,16806636226,-4516,,
15402044917,876.67957,16806691338,888398568,16806686816,-4522,,
15402095274,876.72992,16806741698,888448923,16806737171,-4527,,
15402145616,876.78026,16806792041,888499262,16806787510,-4531,,
15402195917,876.83056,16806842346,888549560,16806837809,-4537,,
15402246231,876.88088,16806892674,888599883,16806888131,-4543,,
15402296755,876.93140,16806943188,888650393,16806938642,-4546,,
15402347108,876.98176,16806993543,888700743,16806988992,-4551,,
15402398034,877.03268,16807044471,888751666,16807039915,-4556,,
15402448401,877.08305,16807094842,888802031,16807090280,-4562,,
15402498551,877.13320,16807144994,888852179,16807140427,-4567,,
15402549316,877.18396,16807195760,888902940,16807191188,-4572,,
15402599890,877.23454,16807246338,888953512,16807241760,-4578,,
15402650251,877.28490,16807296700,889003870,16807292118,-4582,,
15402701286,877.33593,16807347738,889054902,16807343151,-4587,,
15402752238,877.38689,16807398693,889105851,16807394100,-4593,,
15402802547,877.43719,16807449004,889156159,16807444407,-4597,,
15402853037,877.48769,16807499496,889206645,16807494894,-4602,,
15402903577,877.53823,16807550038,889257182,16807545430,-4608,,
15402954637,877.58929,16807601100,889308239,16807596487,-4613,,
15403005204,877.63985,16807651669,889358804,16807647053,-4616,,
15403055719,877.69037,16807702187,889409316,16807697564,-4623,,
15403106265,877.74091,16807752736,889459859,16807748108,-4628,,
15403156468,877.79112,16807802941,889510060,16807798309,-4632,,
15403206577,877.84123,16807853052,889560166,16807848415,-4637,,
15403257607,877.89225,16807904084,889611193,16807899441,-4643,,
15403308028,877.94268,16807954507,889661612,16807949860,-4647,,
15403358584,877.99323,16808005066,889712165,16808000413,-4653,,
15403409596,878.04424,16808056080,889763174,16808051422,-4658,,
15403460158,878.09481,16808106646,889813734,16808101982,-4664,,
15403510254,878.14490,16808156744,889863827,16808152076,-4668,,
15403560814,878.19546,16808207306,889914384,16808202633,-4673,,
15403611361,878.24601,16808257856,889964928,16808253176,-4680,,
15403661917,878.29656,16808308414,890015483,16808303731,-4683,,
15403712473,878.34712,16808358971,890066035,16808354283,-4688,,
15403763000,878.39765,16808409503,890116561,16808404809,-4694,,
15403813569,878.44822,16808460073,890167126,16808455375,-4698,,
15403864130,878.49878,16808510636,890217685,16808505934,-4702,,
15403914207,878.54886,16808560716,890267759,16808556007,-4709,,
15403965235,878.59988,16808611745,890318783,16808607031,-4714,,
15404015526,878.65017,16808662039,890369072,16808657321,-4718,,
15404066064,878.70071,16808712580,890419607,16808707856,-4724,,
15404116157,878.75081,16808762675,890469698,16808757946,-4729,,
15404166707,878.80135,16808813227,890520245,16808808494,-4733,,
15404217258,878.85191,16808863782,890570794,16808859042,-4740,,
15404267830,878.90248,16808914354,890621362,16808909610,-4744,,
15404318408,878.95306,16808964935,890671939,16808960187,-4748,,
15404369156,879.00380,16809015686,890722684,16809010932,-4754,,
15404419951,879.05460,16809066493,890773486,16809061734,-4759,,
15404470497,879.10514,16809117032,890824018,16809112267,-4765,,
15404520880,879.15553,16809167417,890874399,16809162647,-4770,,
15404571427,879.20608,16809217966,890924944,16809213192,-4774,,
15404622007,879.25666,16809268549,890975521,16809263770,-4779,,
15404672563,879.30721,16809319107,891026074,16809314323,-4784,,
15404723079,879.35773,16809369625,891076588,16809364836,-4789,,
15404774143,879.40879,16809420692,891127649,16809415897,-4795,,
15404825190,879.45984,16809471741,891178693,16809466941,-4800,,
15404876246,879.51089,16809522799,891229746,16809517995,-4804,,
15404926813,879.56146,16809573370,891280312,16809568561,-4809,,
15404977834,879.61248,16809624391,891331328,16809619576,-4815,,
15405028408,879.66306,16809674967,891381900,16809670148,-4819,,
15405078930,879.71358,16809725492,891432419,16809720667,-4825,,
15405129514,879.76416,16809776080,891483002,16809771250,-4830,,
15405180528,879.81518,16809827096,891534011,16809822260,-4836,,
15405230578,879.86523,16809877148,891584059,16809872308,-4840,,
15405281129,879.91578,16809927700,891634607,16809922856,-4844,,
15405331703,879.96635,16809978278,891685179,16809973427,-4851,,
15405382215,880.01686,16810028792,891735688,16810023937,-4855,,
15405433262,880.06791,16810079840,891786732,16810074981,-4859,,
15405483904,880.11855,16810130486,891837371,16810125619,-4867,,
15405533965,880.16861,16810180548,891887429,16810175678,-4870,,
15405584764,880.21941,16810231350,891938227,16810226476,-4874,,
15405635325,880.26997,16810281913,891988784,16810277032,-4881,,
15405685893,880.32054,16810332484,892039349,16810327598,-4886,,
15405736925,880.37157,16810383518,892090379,16810378628,-4890,,
15405786983,880.42163,16810433578,892140434,16810428682,-4896,,
15405837466,880.47211,16810484064,892190915,16810479163,-4901,,
15405888025,880.52267,16810534625,892241472,16810529721,-4904,,
15405938835,880.57348,16810585437,892292278,16810580526,-4911,,
15405989579,880.62423,16810636183,892343019,16810631267,-4916,,
15406040153,880.67480,16810686761,892393590,16810681839,-4922,,
15406090707,880.72536,16810737317,892444142,16810732391,-4926,,
15406141642,880.77629,16810788253,892495074,16810783322,-4931,,
15406192201,880.82685,16810838815,892545630,16810833879,-4936,,
15406242713,880.87736,16810889330,892596141,16810884389,-4941,,
15406293200,880.92785,16810939840,892646645,16810934894,-4946,,
15406344274,880.97892,16810990895,892697695,16810985943,-4952,,
15406395320,881.02997,16811041944,892748739,16811036987,-4957,,
15406445818,881.08047,16811092444,892799234,16811087483,-4961,,
15406496846,881.13149,16811143474,892850259,16811138507,-4967,,
15406547382,881.18203,16811194012,892900792,16811189040,-4972,,
15406597880,881.23253,16811244513,892951289,16811239537,-4976,,
15406648891,881.28354,16811295527,893002296,16811290545,-4982,,
15406698996,881.33364,16811345634,893052398,16811340647,-4987,,
15406749264,881.38391,16811395903,893102663,16811390911,-4992,,
15406799674,881.43432,16811446327,893153081,16811441330,-4997,,
15406850706,881.48535,16811497351,893204101,16811492349,-5002,,
15406901254,881.53590,16811547902,893254645,16811542894,-5008,,
15406952268,881.58692,16811598918,893305658,16811593906,-5012,,
15407002814,881.63746,16811649465,893356200,16811644448,-5017,,
15407053364,881.68801,16811700019,893406747,16811694996,-5023,,
15407104445,881.73909,16811751102,893457826,16811746074,-5028,,
15407155456,881.79010,16811802114,893508834,16811797082,-5032,,
15407206507,881.84115,16811853169,893559882,16811848131,-5038,,
15407257011,881.89166,16811903675,893610384,16811898632,-5043,,
15407307592,881.94224,16811954269,893660974,16811949222,-5047,,
15407358646,881.99329,16812005315,893712013,16812000262,-5053,,
15407409254,882.04390,16812055925,893762619,16812050867,-5058,,
15407459804,882.09445,16812106478,893813165,16812101414,-5064,,
15407510363,882.14501,16812157039,893863722,16812151971,-5068,,
15407560908,882.19556,16812207586,893914264,16812202513,-5073,,
15407611379,882.24603,16812258059,893964732,16812252981,-5078,,
15407661484,882.29613,16812308167,894014836,16812303084,-5083,,
15407711939,882.34659,16812358625,894065289,16812353538,-5087,,
15407762423,882.39707,16812409111,894115768,16812404017,-5094,,
15407812492,882.44714,16812459181,894165835,16812454083,-5098,,
15407863049,882.49770,16812509741,894216389,16812504638,-5103,,
15407914081,882.54873,16812560776,894267419,16812555667,-5109,,
15407965104,882.59975,16812611800,894318454,16812606702,-5098,,
15408016175,882.65082,16812662873,894369507,16812657756,-5117,,
15408066739,882.70139,16812713440,894420068,16812708316,-5124,,
15408117301,882.75195,16812764005,894470628,16812758876,-5129,,
15408168295,882.80294,16812815001,894521620,16812809868,-5133,,
15408218812,882.85346,16812865521,894572134,16812860382,-5139,,
15408269408,882.90406,16812916119,894622727,16812910975,-5144,,
15408320376,882.95502,16812967089,894673691,16812961940,-5149,,
15408371008,883.00566,16813017723,894724321,16813012569,-5154,,
15408422045,883.05669,16813068763,894775355,16813063603,-5160,,
15408472430,883.10708,16813119151,894825738,16813113986,-5165,,
15408522698,883.15735,16813169420,894876003,16813164251,-5169,,
15408573688,883.20834,16813220413,894926991,16813215239,-5174,,
15408624274,883.25892,16813271001,894977573,16813265821,-5180,,
15408674515,883.30916,16813321245,895027812,16813316060,-5185,,
15408724895,883.35954,16813371627,895078190,16813366438,-5189,,
15408775958,883.41061,16813422693,895129249,16813417498,-5195,,
15408827015,883.46166,16813473752,895180303,16813468552,-5200,,
15408877593,883.51224,16813524332,895230879,16813519128,-5204,,
15408929783,883.56443,16813576525,895283067,16813571315,-5210,,
15408980979,883.61563,16813627723,895334260,16813622508,-5215,,
15409031212,883.66586,16813677958,895384489,16813672737,-5221,,
15409081274,883.71592,16813728023,895434549,16813722798,-5225,,
15409131402,883.76605,16813778153,895484674,16813772922,-5231,,
15409181485,883.81613,16813828250,895534766,16813823015,-5235,,
15409232355,883.86700,16813879111,895585623,16813873871,-5240,,
15409283397,883.91805,16813930155,895636662,16813924910,-5245,,
15409334186,883.96883,16813980947,895687447,16813975696,-5251,,
15409384551,884.01920,16814031313,895737809,16814026057,-5256,,
15409437845,884.07249,16814084610,895791101,16814079349,-5261,,
15409495415,884.13006,16814142183,895848668,16814136917,-5266,,
15409546092,884.18074,16814192862,895899342,16814187590,-5272,,
15409597092,884.23174,16814243865,895950340,16814238588,-5277,,
15409648169,884.28282,16814294944,896001414,16814289662,-5282,,
15409698709,884.33336,16814345487,896051952,16814340200,-5287,,
15409749511,884.38416,16814396291,896102751,16814390999,-5292,,
15409800546,884.43519,16814447328,896153782,16814442031,-5297,,
15409851111,884.48576,16814497896,896204346,16814492594,-5302,,
15409902131,884.53678,16814548917,896255362,16814543611,-5306,,
15409952232,884.58688,16814599020,896305460,16814593708,-5312,,
15410002322,884.63697,16814649123,896355557,16814643806,-5317,,
15410053390,884.68804,16814700183,896406613,16814694861,-5322,,
15410103854,884.73850,16814750650,896457074,16814745323,-5327,,
15410154427,884.78908,16814801226,896507645,16814795893,-5333,,
15410205073,884.83972,16814851874,896558288,16814846537,-5337,,
15410255550,884.89020,16814902353,896608762,16814897010,-5343,,
15410306064,884.94071,16814952870,896659273,16814947521,-5349,,
15410357092,884.99174,16815003900,896710299,16814998547,-5353,,
15410407829,885.04248,16815054640,896761033,16815049282,-5358,,
15410458904,885.09355,16815105717,896812105,16815100353,-5364,,
15410509592,885.14424,16815156407,896862791,16815151039,-5368,,
15410560138,885.19479,16815206955,896913334,16815201582,-5373,,
15410610630,885.24528,16815257450,896963823,16815252071,-5379,,
15410660828,885.29548,16815307650,897014019,16815302268,-5382,,
15410711900,885.34655,16815358724,897065087,16815353335,-5389,,
15410762710,885.39736,16815409537,897115895,16815404144,-5393,,
15410818226,885.45287,16815465056,897171408,16815459657,-5399,,
15410869090,885.50374,16815515922,897222269,16815510517,-5405,,
15410919603,885.55425,16815566437,897272779,16815561028,-5409,,
15410969659,885.60431,16815616496,897322833,16815611082,-5414,,
15411020712,885.65536,16815667550,897373883,16815662131,-5419,,
15411071253,885.70590,16815718093,897424421,16815712669,-5424,,
15411122237,885.75689,16815769080,897475401,16815763650,-5430,,
15411173157,885.80781,16815820003,897526320,16815814568,-5435,,
15411223702,885.85835,16815870551,897576862,16815865111,-5440,,
15411274615,885.90926,16815921466,897627773,16815916021,-5445,,
15411325530,885.96018,16815972383,897678685,16815966934,-5449,,
15411376074,886.01072,16816022929,897729226,16816017474,-5455,,
15411426344,886.06099,16816073202,897779493,16816067742,-5460,,
15411477386,886.11203,16816124246,897830532,16816118781,-5465,,
15411528293,886.16294,16816175156,897881437,16816169686,-5470,,
15411578807,886.21345,16816225671,897931947,16816220196,-5475,,
15411633137,886.26779,16816280005,897986276,16816274524,-5481,,
15411683949,886.31860,16816330819,898037085,16816325333,-5486,,
15411734999,886.36965,16816381871,898088133,16816376382,-5489,,
15411785931,886.42058,16816432805,898139061,16816427309,-5496,,
15411836338,886.47099,16816483214,898189465,16816477713,-5501,,
15411887050,886.52170,16816533929,898240175,16816528423,-5506,,
15411937616,886.57226,16816584498,898290739,16816578987,-5511,,
15411987698,886.62235,16816634581,898340817,16816629065,-5516,,
15412037984,886.67263,16816684870,898391102,16816679350,-5520,,
15412088558,886.72321,16816735447,898441672,16816729921,-5526,,
15412139332,886.77398,16816786223,898492443,16816780692,-5531,,
15412189885,886.82453,16816836778,898542994,16816831242,-5536,,
15412240069,886.87472,16816886965,898593176,16816881424,-5541,,
15412290190,886.92484,16816937089,898643295,16816931544,-5545,,
15412340715,886.97536,16816987614,898693815,16816982063,-5551,,
15412391365,887.02601,16817038268,898744464,16817032712,-5556,,
15412441978,887.07663,16817088883,898795073,16817083322,-5561,,
15412492391,887.12704,16817139298,898845483,16817133732,-5566,,
15412543446,887.17809,16817190356,898896536,16817184785,-5571,,
15412593961,887.22861,16817240873,898947048,16817235297,-5576,,
15412644537,887.27918,16817291452,898997621,16817285870,-5582,,
15412695115,887.32976,16817342032,899048197,16817336445,-5587,,
15412746128,887.38078,16817393047,899099208,16817387456,-5591,,
15412797180,887.43183,16817444102,899150257,16817438505,-5597,,
15412848224,887.48287,16817495147,899201297,16817489545,-5602,,
15412899259,887.53391,16817546185,899252330,16817540578,-5607,,
15412949831,887.58448,16817596759,899302899,16817591147,-5612,,
15413000861,887.63551,16817647792,899353927,16817642175,-5617,,
15413051406,887.68605,16817698340,899404468,16817692717,-5623,,
15413101498,887.73615,16817748433,899454558,16817742806,-5627,,
15413152053,887.78670,16817798991,899505110,16817793359,-5632,,
15413202603,887.83725,16817849544,899555657,16817843906,-5638,,
15413252774,887.88742,16817899717,899605826,16817894075,-5642,,
15413303347,887.93800,16817950291,899656396,16817944645,-5646,,
15413353918,887.98857,16818000866,899706965,16817995213,-5653,,
15413404911,888.03956,16818051861,899757955,16818046203,-5658,,
15413455502,888.09015,16818102453,899808543,16818096791,-5662,,
15413505893,888.14054,16818152848,899858932,16818147180,-5668,,
15413555988,888.19064,16818202945,899909023,16818197271,-5674,,
15413606753,888.24140,16818253711,899959786,16818248034,-5677,,
15413657443,888.29209,16818304405,900010473,16818298722,-5683,,
15413708552,888.34320,16818355516,900061580,16818349828,-5688,,
15413759602,888.39425,16818406567,900112626,16818400875,-5692,,
15413810311,888.44496,16818457280,900163333,16818451582,-5698,,
15413860876,888.49552,16818507859,900213908,16818502156,-5703,,
15413911445,888.54609,16818558431,900264473,16818552722,-5709,,
15413961998,888.59665,16818608973,900315012,16818603261,-5712,,
15414012588,888.64724,16818659566,900365600,16818653848,-5718,,
15414063434,888.69808,16818710426,900416454,16818704702,-5724,,
15414114012,888.74866,16818760995,900467018,16818755266,-5729,,
15414164574,888.79922,16818811559,900517578,16818805826,-5733,,
15414215395,888.85004,16818862383,900568396,16818856644,-5739,,
15414266168,888.90082,16818913158,900619166,16818907414,-5744,,
15414316965,888.95161,16818963957,900669960,16818958209,-5748,,
15414367456,889.00210,16819014450,900720448,16819008696,-5754,,
15414418039,889.05269,16819065036,900771029,16819059277,-5759,,
15414468546,889.10319,16819115545,900821532,16819109781,-5764,,
15414519057,889.15370,16819166059,900872041,16819160289,-5770,,
15414569183,889.20383,16819216187,900922164,16819210413,-5774,,
15414619729,889.25438,16819266735,900972708,16819260956,-5779,,
15414670733,889.30538,16819317742,901023709,16819311958,-5784,,
15414721281,889.35593,16819368292,901074255,16819362503,-5789,,
15414771878,889.40653,16819418892,901124848,16819413096,-5796,,
15414822392,889.45704,16819469430,901175383,16819463631,-5799,,
15414872932,889.50758,16819519950,901225898,16819514146,-5804,,
15414923989,889.55864,16819571021,901276962,16819565211,-5810,,
15414974560,889.60921,16819621583,901327519,16819615768,-5815,,
15415025561,889.66021,16819672586,901378518,16819666767,-5819,,
15415076133,889.71078,16819723172,901429099,16819717347,-5825,,
15415126703,889.76135,16819773733,901479654,16819767903,-5830,,
15415177600,889.81225,16819824632,901530550,16819818798,-5834,,
15415228149,889.86280,16819875183,901581095,16819869344,-5839,,
15415278712,889.91336,16819925749,901631656,16819919904,-5845,,
15415328828,889.96348,16819975867,901681768,16819970017,-5850,,
15415379388,890.01404,16820026429,901732326,16820020574,-5855,,
15415429945,890.06459,16820076988,901782880,16820071129,-5859,,
15415480995,890.11564,16820128042,901833927,16820122176,-5866,,
15415531574,890.16622,16820178623,901884504,16820172753,-5870,,
15415582159,890.21681,16820229210,901935086,16820223335,-5875,,
15415632798,890.26745,16820279852,901985722,16820273971,-5881,,
15415683199,890.31785,16820330255,902036121,16820324369,-5886,,
15415733917,890.36856,16820380975,902086837,16820375085,-5890,,
15415784883,890.41953,16820431944,902137800,16820426048,-5896,,
15415835590,890.47024,16820482652,902188503,16820476751,-5901,,
15415886087,890.52073,16820533152,902238999,16820527247,-5905,,
15415936624,890.57127,16820583692,902289533,16820577781,-5911,,
15415986683,890.62133,16820633753,902339589,16820627837,-5916,,
15416037229,890.67188,16820684301,902390133,16820678381,-5920,,
15416088216,890.72286,16820735291,902441117,16820729365,-5926,,
15416139244,890.77389,16820786320,902492141,16820780389,-5931,,
15416189318,890.82397,16820836397,902542213,16820830461,-5936,,
15416239919,890.87457,16820887000,902592811,16820881060,-5940,,
15416290895,890.92554,16820937979,902643784,16820932033,-5946,,
15416341017,890.97567,16820988104,902693903,16820982152,-5952,,
15416391994,891.02664,16821039083,902744879,16821033127,-5956,,
15416442529,891.07718,16821089620,902795410,16821083659,-5961,,
15416493064,891.12771,16821140158,902845942,16821134191,-5967,,
15416544112,891.17876,16821191207,902896987,16821185235,-5972,,
15416594195,891.22884,16821241293,902947068,16821235317,-5976,,
15416644812,891.27946,16821291913,902997682,16821285930,-5983,,
15416695396,891.33004,16821342498,903048263,16821336511,-5987,,
15416746437,891.38108,16821393542,903099302,16821387551,-5991,,
15416796985,891.43163,16821444093,903149850,16821438099,-5994,,
15416847522,891.48217,16821494632,903200382,16821488630,-6002,,
15416898069,891.53272,16821545181,903250925,16821539174,-6007,,
15416948694,891.58334,16821595808,903301548,16821589796,-6012,,
15416999180,891.63383,16821646297,903352031,16821640280,-6017,,
15417049728,891.68438,16821696847,903402577,16821690825,-6022,,
15417100306,891.73495,16821747427,903453152,16821741401,-6026,,
15417150678,891.78533,16821797803,903503523,16821791771,-6032,,
15417201699,891.83635,16821848826,903554539,16821842788,-6038,,
15417252702,891.88735,16821899831,903605540,16821893789,-6042,,
15417303243,891.93789,16821950373,903656078,16821944326,-6047,,
15417354245,891.98889,16822001379,903707078,16821995326,-6053,,
15417404336,892.03898,16822051472,903757166,16822045414,-6058,,
15417454930,892.08958,16822102068,903807757,16822096006,-6062,,
15417505499,892.14015,16822152640,903858323,16822146572,-6068,,
15417556521,892.19117,16822203664,903909343,16822197591,-6073,,
15417607092,892.24174,16822254248,903959922,16822248171,-6077,,
15417657653,892.29230,16822304801,904010470,16822298718,-6083,,
15417708653,892.34330,16822355803,904061467,16822349715,-6088,,
15417759214,892.39386,16822406366,904112024,16822400273,-6093,,
15417809787,892.44443,16822456952,904162605,16822450854,-6098,,
15417860328,892.49498,16822507485,904213133,16822501382,-6103,,
15417911351,892.54600,16822558510,904264153,16822552401,-6109,,
15417961946,892.59659,16822609108,904314747,16822602995,-6113,,
15418012522,892.64717,16822659686,904365319,16822653568,-6118,,
15418063646,892.69829,16822710813,904416441,16822704689,-6124,,
15418114583,892.74923,16822761763,904467386,16822755634,-6129,,
15418165500,892.80015,16822812671,904518290,16822806538,-6133,,
15418215982,892.85063,16822863156,904568768,16822857017,-6139,,
15418266531,892.90118,16822913707,904619315,16822907563,-6144,,
15418317101,892.95175,16822964278,904669882,16822958130,-6148,,
15418368121,893.00277,16823015301,904720899,16823009147,-6154,,
15418418496,893.05314,16823065679,904771271,16823059520,-6159,,
15418469074,893.10372,16823116259,904821847,16823110096,-6163,,
15418519649,893.15430,16823166837,904872420,16823160668,-6169,,
15418570607,893.20525,16823217797,904923375,16823211623,-6174,,
15418621177,893.25582,16823268369,904973941,16823262189,-6180,,
15418671758,893.30641,16823318953,905024521,16823312769,-6184,,
15418722349,893.35700,16823369546,905075108,16823363357,-6189,,
15418772415,893.40706,16823419614,905125171,16823413419,-6195,,
15418822975,893.45762,16823470177,905175730,16823463979,-6198,,
15418873593,893.50824,16823520796,905226344,16823514592,-6204,,
15418924085,893.55873,16823571292,905276833,16823565082,-6210,,
15418974701,893.60935,16823621909,905327446,16823615694,-6215,,
15419024945,893.65959,16823672156,905377689,16823665937,-6219,,
15419075441,893.71009,16823722655,905428182,16823716430,-6225,,
15419125517,893.76017,16823772733,905478254,16823766503,-6230,,
15419176540,893.81119,16823823758,905529275,16823817524,-6234,,
15419227096,893.86174,16823874317,905579828,16823868076,-6241,,
15419277683,893.91233,16823924905,905630412,16823918660,-6245,,
15419328683,893.96333,16823975907,905681409,16823969657,-6250,,
15419379780,894.01443,16824027008,905732505,16824020753,-6255,,
15419430329,894.06498,16824077559,905783051,16824071299,-6260,,
15419480828,894.11548,16824128061,905833547,16824121795,-6266,,
15419531376,894.16602,16824178611,905884093,16824172341,-6270,,
15419581951,894.21660,16824229198,905934675,16824222923,-6275,,
15419633000,894.26765,16824280239,905985710,16824273958,-6281,,
15419684009,894.31866,16824331250,906036716,16824324964,-6286,,
15419734609,894.36926,16824381852,906087314,16824375562,-6290,,
15419785168,894.41982,16824432415,906137870,16824426119,-6296,,
15419835697,894.47034,16824482946,906188396,16824476645,-6301,,
15419886767,894.52142,16824534017,906239464,16824527713,-6304,,
15419937173,894.57182,16824584426,906289866,16824578115,-6311,,
15419988417,894.62306,16824635673,906341108,16824629357,-6316,,
15420038555,894.67320,16824685813,906391244,16824679492,-6321,,
15420089612,894.72426,16824736873,906442298,16824730546,-6327,,
15420139699,894.77435,16824786961,906492382,16824780631,-6330,,
15420190222,894.82487,16824837488,906542903,16824831151,-6337,,
15420241261,894.87591,16824888538,906593949,16824882197,-6341,,
15420291829,894.92648,16824939099,906644504,16824932753,-6346,,
15420342353,894.97700,16824989626,906695025,16824983273,-6353,,
15420393281,895.02793,16825040555,906745950,16825034198,-6357,,
15420443398,895.07805,16825090675,906796066,16825084315,-6360,,
15420493980,895.12863,16825141270,906846655,16825134904,-6366,,
15420544529,895.17918,16825191811,906897191,16825185439,-6372,,
15420595433,895.23008,16825242716,906948092,16825236340,-6376,,
15420645553,895.28020,16825292849,906998219,16825286468,-6381,,
15420696605,895.33125,16825343894,907049259,16825337507,-6387,,
15420746871,895.38152,16825394162,907099523,16825387771,-6391,,
15420797831,895.43248,16825445126,907150481,16825438729,-6397,,
15420847987,895.48263,16825495282,907200632,16825488880,-6402,,
15420898924,895.53357,16825546221,907251566,16825539814,-6407,,
15420949471,895.58412,16825596772,907302112,16825590360,-6412,,
15421000059,895.63471,16825647362,907352697,16825640945,-6417,,
15421051091,895.68574,16825698397,907403726,16825691974,-6423,,
15421101668,895.73632,16825748976,907454301,16825742549,-6427,,
15421151956,895.78660,16825799266,907504586,16825792834,-6432,,
15421202132,895.83678,16825849444,907554758,16825843006,-6438,,
15421252233,895.88688,16825899548,907604858,16825893106,-6442,,
15421303251,895.93790,16825950568,907655872,16825944120,-6448,,
15421354287,895.98893,16826001608,907706907,16825995156,-6452,,
15421404916,896.03956,16826052238,907757531,16826045780,-6458,,
15421455514,896.09016,16826102838,907808127,16826096376,-6462,,
15421506002,896.14065,16826153328,907858612,16826146860,-6468,,
15421556681,896.19133,16826204010,907909289,16826197537,-6473,,
15421607415,896.24206,16826254746,907960021,16826248269,-6477,,
15421657676,896.29232,16826305010,908010278,16826298527,-6483,,
15421708245,896.34289,16826355581,908060844,16826349092,-6489,,
15421758431,896.39308,16826405770,908111028,16826399278,-6492,,
15421808962,896.44361,16826456302,908161556,16826449805,-6497,,
15421859058,896.49371,16826506400,908211649,16826499897,-6503,,
15421909688,896.54434,16826557032,908262276,16826550524,-6508,,
15421960274,896.59492,16826607621,908312860,16826601108,-6513,,
15422010880,896.64553,16826658230,908363464,16826651712,-6518,,
15422061629,896.69628,16826708982,908414209,16826702458,-6524,,
15422112079,896.74673,16826759434,908464658,16826752906,-6528,,
15422162653,896.79730,16826810009,908515228,16826803476,-6533,,
15422213477,896.84812,16826860837,908566049,16826854298,-6539,,
15422264061,896.89871,16826911423,908616631,16826904879,-6544,,
15422315035,896.94968,16826962398,908667602,16826955851,-6547,,
15422366075,897.00072,16827013442,908718640,16827006888,-6554,,
15422416623,897.05127,16827063992,908769184,16827057433,-6559,,
15422466737,897.10139,16827114108,908819296,16827107544,-6564,,
15422517247,897.15189,16827164621,908869804,16827158052,-6569,,
15422567759,897.20241,16827215134,908920312,16827208560,-6574,,
15422618836,897.25348,16827266213,908971386,16827259634,-6579,,
15422669871,897.30452,16827317252,909022419,16827310668,-6584,,
15422720411,897.35506,16827367794,909072956,16827361205,-6589,,
15422771416,897.40606,16827418801,909123969,16827412218,-6583,,
15422821527,897.45618,16827468915,909174068,16827462316,-6599,,
15422872060,897.50671,16827519450,909224597,16827512846,-6604,,
15422922575,897.55722,16827569968,909275109,16827563358,-6610,,
15422973145,897.60779,16827620540,909325676,16827613925,-6615,,
15423024044,897.65869,16827671441,909376573,16827664821,-6620,,
15423074585,897.70923,16827721985,909427111,16827715360,-6625,,
15423125135,897.75978,16827772536,909477658,16827765907,-6629,,
15423175699,897.81035,16827823113,909528231,16827816479,-6634,,
15423226264,897.86091,16827873670,909578782,16827867030,-6640,,
15423277265,897.91191,16827924674,909629780,16827918028,-6646,,
15423328318,897.96297,16827975729,909680831,16827969079,-6650,,
15423379068,898.01372,16828026482,909731578,16828019827,-6655,,
15423429311,898.06396,16828076727,909781818,16828070067,-6660,,
15423479883,898.11453,16828127300,909832387,16828120635,-6665,,
15423530330,898.16498,16828177751,909882832,16828171081,-6670,,
15423581364,898.21601,16828228787,909933864,16828222112,-6675,,
15423632386,898.26703,16828279812,909984883,16828273131,-6681,,
15423682812,898.31746,16828330240,910035306,16828323555,-6685,,
15423733186,898.36783,16828380625,910085687,16828373935,-6690,,
15423783942,898.41859,16828431375,910136431,16828424679,-6696,,
15423834518,898.46917,16828481953,910187003,16828475251,-6702,,
15423884766,898.51941,16828532203,910237249,16828525498,-6705,,
15423935813,898.57046,16828583252,910288293,16828576542,-6710,,
15423986394,898.62104,16828633836,910338871,16828627119,-6717,,
15424036981,898.67163,16828684425,910389456,16828677705,-6720,,
15424087541,898.72219,16828734987,910440013,16828728261,-6726,,
15424138138,898.77279,16828785588,910490612,16828778861,-6727,,
15424188789,898.82344,16828836240,910541255,16828829504,-6736,,
15424239344,898.87399,16828886797,910591808,16828880056,-6741,,
15424289789,898.92444,16828937244,910642250,16828930498,-6746,,
15424340638,898.97529,16828988096,910693096,16828981345,-6751,,
15424391462,899.02611,16829038923,910743918,16829032167,-6756,,
15424441785,899.07643,16829089248,910794238,16829082487,-6761,,
15424492308,899.12696,16829139774,910844758,16829133007,-6767,,
15424543690,899.17834,16829191158,910896137,16829184386,-6772,,
15424594134,899.22878,16829241603,910946579,16829234827,-6776,,
15424644683,899.27933,16829292155,910997125,16829285373,-6782,,
15424695684,899.33033,16829343159,911048123,16829336372,-6787,,
15424745795,899.38044,16829393272,911098232,16829386481,-6791,,
15424796446,899.43109,16829443926,911148881,16829437129,-6797,,
15424846966,899.48161,16829494448,911199398,16829487646,-6802,,
15424897542,899.53219,16829545026,911249971,16829538220,-6806,,
15424948119,899.58277,16829595606,911300546,16829588794,-6812,,
15424998221,899.63287,16829645709,911350644,16829638892,-6817,,
15425049204,899.68385,16829696695,911401624,16829689873,-6822,,
15425099265,899.73391,16829746758,911451683,16829739931,-6827,,
15425149815,899.78446,16829797310,911502230,16829790479,-6831,,
15425200394,899.83504,16829847891,911552806,16829841054,-6837,,
15425251395,899.88604,16829898896,911603806,16829892054,-6842,,
15425301707,899.93636,16829949210,911654115,16829942363,-6847,,
15425352293,899.98694,16829999799,911704698,16829992946,-6853,,
15425402862,900.03751,16830050370,911755264,16830043512,-6858,,
15425453881,900.08853,16830101391,911806280,16830094529,-6862,,
15425503948,900.13860,16830151460,911856344,16830144592,-6868,,
15425555011,900.18966,16830202527,911907406,16830195654,-6873,,
15425605530,900.24018,16830253047,911957922,16830246170,-6877,,
15425656162,900.29081,16830303682,912008551,16830296799,-6883,,
15425706273,900.34092,16830353795,912058658,16830346907,-6888,,
15425756818,900.39147,16830404342,912109201,16830397450,-6892,,
15425807849,900.44250,16830455376,912160229,16830448478,-6898,,
15425858450,900.49310,16830505979,912210827,16830499076,-6903,,
15425909003,900.54365,16830556544,912261388,16830549636,-6908,,
15425959600,900.59425,16830607134,912311972,16830600221,-6913,,
15426010157,900.64481,16830657693,912362527,16830650775,-6918,,
15426060506,900.69515,16830708045,912412873,16830701121,-6924,,
15426111053,900.74570,16830758594,912463417,16830751666,-6928,,
15426162036,900.79668,16830809579,912514397,16830802646,-6933,,
15426212633,900.84728,16830860179,912564991,16830853240,-6939,,
15426263156,900.89780,16830910714,912615521,16830903770,-6944,,
15426313651,900.94830,16830961201,912666005,16830954253,-6948,,
15426364203,900.99885,16831011756,912716553,16831004801,-6955,,
15426414822,901.04947,16831062376,912767169,16831055417,-6959,,
15426465266,901.09991,16831112823,912817612,16831105860,-6963,,
15426516271,901.15092,16831163830,912868613,16831156861,-6969,,
15426566838,901.20149,16831214399,912919177,16831207425,-6974,,
15426616972,901.25162,16831264535,912969309,16831257557,-6978,,
15426667398,901.30205,16831314976,913019744,16831307993,-6983,,
15426718425,901.35307,16831365994,913070757,16831359005,-6989,,
15426769009,901.40366,16831416580,913121338,16831409586,-6994,,
15426819598,901.45425,16831467172,913171924,16831460173,-6999,,
15426870036,901.50468,16831517611,913222359,16831510607,-7004,,
15426920596,901.55524,16831568174,913272917,16831561165,-7009,,
15426970987,901.60564,16831618568,913323306,16831611554,-7014,,
15427021991,901.65664,16831669573,913374306,16831662554,-7019,,
15427072552,901.70720,16831720138,913424865,16831713113,-7025,,
15427123100,901.75775,16831770688,913475410,16831763658,-7030,,
15427173660,901.80831,16831821250,913525967,16831814216,-7034,,
15427224212,901.85886,16831871804,913576516,16831864764,-7040,,
15427274732,901.90938,16831922327,913627033,16831915282,-7045,,
15427325298,901.95995,16831972904,913677607,16831965855,-7049,,
15427375704,902.01035,16832023304,913728000,16832016249,-7055,,
15427426678,902.06133,16832074279,913778971,16832067219,-7060,,
15427477285,902.11193,16832124888,913829576,16832117825,-7063,,
15427527956,902.16260,16832175563,913880245,16832168493,-7070,,
15427578342,902.21299,16832225951,913930628,16832218876,-7075,,
15427629355,902.26400,16832276966,913981637,16832269885,-7081,,
15427680031,902.31468,16832327645,914032313,16832320561,-7084,,
15427731014,902.36566,16832378631,914083293,16832371541,-7090,,
15427782027,902.41668,16832429646,914134301,16832422550,-7096,,
15427832614,902.46726,16832480235,914184886,16832473135,-7100,,
15427883181,902.51783,16832530804,914235450,16832523699,-7105,,
15427933692,902.56834,16832581330,914285971,16832574219,-7111,,
15427984729,902.61938,16832632357,914336992,16832625241,-7116,,
15428035316,902.66996,16832682946,914387578,16832675826,-7120,,
15428085815,902.72046,16832733448,914438074,16832726322,-7126,,
15428136364,902.77101,16832783999,914488620,16832776868,-7131,,
15428186913,902.82156,16832834549,914539166,16832827414,-7135,,
15428237967,902.87261,16832885607,914590218,16832878466,-7141,,
15428288510,902.92316,16832936152,914640757,16832929005,-7147,,
15428339275,902.97392,16832986919,914691520,16832979768,-7151,,
15428389825,903.02447,16833037472,914742068,16833030316,-7156,,
15428440445,903.07509,16833088094,914792684,16833080933,-7161,,
15428490719,903.12537,16833138370,914842955,16833131204,-7166,,
15428541276,903.17592,16833188929,914893510,16833181758,-7171,,
15428591851,903.22650,16833239507,914944083,16833232331,-7176,,
15428642384,903.27703,16833290043,914994613,16833282861,-7182,,
15428693382,903.32803,16833341043,915045607,16833333856,-7187,,
15428743969,903.37862,16833391631,915096192,16833384441,-7190,,
15428794464,903.42911,16833442130,915146685,16833434933,-7197,,
15428844529,903.47918,16833492196,915196746,16833484994,-7202,,
15428895065,903.52971,16833542735,915247280,16833535529,-7206,,
15428945628,903.58028,16833593311,915297851,16833586100,-7211,,
15428996162,903.63081,16833643836,915348371,16833636619,-7217,,
15429046710,903.68136,16833694387,915398917,16833687166,-7221,,
15429281415,903.91606,16833929103,915633609,16833921869,-7234,16833927972,
15429306530,903.94118,16833954218,915658723,16833947001,-7217,,
15429357011,903.99166,16834004703,915709202,16833997542,-7161,,
15429408069,904.04272,16834055762,915760256,16834048658,-7104,,
15429458581,904.09323,16834106276,915810766,16834099231,-7045,,
15429509539,904.14419,16834157238,915861722,16834150248,-6990,,
15429560075,904.19472,16834207775,915912254,16834200842,-6933,,
15429610643,904.24529,16834258347,915962819,16834251469,-6878,,
15429661315,904.29596,16834309021,916013489,16834302202,-6819,,
15429711872,904.34652,16834359580,916064043,16834352818,-6762,,
15429762456,904.39710,16834410167,916114624,16834403460,-6707,,
15429812523,904.44717,16834460236,916164690,16834453587,-6649,,
15429862729,904.49738,16834510444,916214892,16834503851,-6593,,
15429913558,904.54821,16834561276,916265719,16834554739,-6537,,
15429964583,904.59923,16834612302,916316740,16834605823,-6479,,
15430014982,904.64963,16834662703,916367137,16834656282,-6421,,
15430065577,904.70023,16834713301,916417729,16834706935,-6366,,
15430116091,904.75074,16834763817,916468240,16834757509,-6308,,
15430167127,904.80178,16834814856,916519275,16834808606,-6250,,
15430217711,904.85236,16834865443,916569856,16834859250,-6193,,
15430268269,904.90292,16834916002,916620410,16834909864,-6138,,
15430319272,904.95392,16834967009,916671411,16834960928,-6081,,
15430369857,905.00450,16835017595,916721993,16835011572,-6023,,
15430420445,905.05509,16835068186,916772579,16835062220,-5966,,
15430470961,905.10561,16835118705,916823091,16835112794,-5911,,
15430521966,905.15661,16835169712,916874094,16835163860,-5852,,
15430572563,905.20721,16835220311,916924688,16835214516,-5795,,
15430623111,905.25776,16835270862,916975234,16835265123,-5739,,
15430674103,905.30875,16835321856,917026222,16835316174,-5682,,
15430724693,905.35934,16835372448,917076811,16835366824,-5624,,
15430775562,905.41021,16835423320,917127677,16835417752,-5568,,
15430826441,905.46109,16835474201,917178553,16835468690,-5511,,
15430877084,905.51173,16835524846,917229193,16835519393,-5453,,
15430927650,905.56230,16835575415,917279768,16835570029,-5386,,
15430978813,905.61346,16835626579,917330916,16835621240,-5339,,
15431029720,905.66437,16835677490,917381820,16835672207,-5283,,
15431079818,905.71447,16835727590,917431916,16835722364,-5226,,
15431130331,905.76498,16835778105,917482426,16835772936,-5169,,
15431180868,905.81552,16835828645,917532960,16835823532,-5113,,
15431231415,905.86606,16835879193,917583505,16835874139,-5054,,
15431282008,905.91666,16835929789,917634095,16835924791,-4998,,
15431332558,905.96721,16835980342,917684642,16835975399,-4943,,
15431383582,906.01823,16836031367,917735664,16836026483,-4884,,
15431434165,906.06881,16836081953,917786244,16836077126,-4827,,
15431484790,906.11944,16836132581,917836866,16836127810,-4771,,
15431535344,906.16999,16836183136,917887417,16836178421,-4715,,
15431585910,906.22056,16836233705,917937981,16836229048,-4657,,
15431636667,906.27131,16836284476,917988747,16836279875,-4601,,
15431687328,906.32198,16836335127,918039393,16836330583,-4544,,
15431737942,906.37259,16836385744,918090006,16836381258,-4486,,
15431788552,906.42320,16836436357,918140612,16836431927,-4430,,
15431839575,906.47422,16836487383,918191633,16836483011,-4372,,
15431890598,906.52525,16836538408,918242653,16836534092,-4316,,
15431941215,906.57586,16836589026,918293267,16836584768,-4258,,
15431991738,906.62639,16836639552,918343788,16836635352,-4200,,
15432042782,906.67743,16836690598,918394828,16836686453,-4145,,
15432093847,906.72849,16836741665,918445891,16836737583,-4082,,
15432144333,906.77898,16836792154,918496375,16836788124,-4030,,
15432194897,906.82955,16836842720,918546935,16836838746,-3974,,
15432244975,906.87962,16836892801,918597010,16836888884,-3917,,
15432295542,906.93019,16836943369,918647575,16836939509,-3860,,
15432346271,906.98092,16836994102,918698302,16836990300,-3802,,
15432397263,907.03191,16837045096,918749290,16837041350,-3746,,
15432447820,907.08247,16837095654,918799845,16837091967,-3687,,
15432498423,907.13307,16837146261,918850445,16837142629,-3632,,
15432548986,907.18363,16837196826,918901005,16837193249,-3577,,
15432599525,907.23417,16837247367,918951541,16837243847,-3520,,
15432649590,907.28424,16837297435,919001604,16837293973,-3462,,
15432700487,907.33514,16837348333,919052498,16837344928,-3405,,
15432750590,907.38524,16837398440,919102598,16837395090,-3350,,
15432801608,907.43626,16837449459,919153614,16837446168,-3291,,
15432852716,907.48736,16837500570,919204720,16837497336,-3234,,
15432903746,907.53839,16837551603,919255746,16837548424,-3179,,
15432954793,907.58944,16837602652,919306790,16837599532,-3120,,
15433005372,907.64002,16837653232,919357367,16837650170,-3062,,
15433055691,907.69034,16837703555,919407684,16837700548,-3007,,
15433106390,907.74104,16837754256,919458379,16837751306,-2950,,
15433157040,907.79169,16837804908,919509027,16837802016,-2892,,
15433207498,907.84215,16837855369,919559483,16837852533,-2836,,
15433258524,907.89317,16837906396,919610505,16837903617,-2779,,
15433309583,907.94423,16837957458,919661561,16837954736,-2722,,
15433360167,907.99482,16838008045,919712144,16838005381,-2664,,
15433410730,908.04538,16838058620,919762713,16838056012,-2608,,
15433461781,908.09643,16838109663,919813751,16838107112,-2551,,
15433512304,908.14695,16838160189,919864272,16838157696,-2493,,
15433562855,908.19750,16838210742,919914820,16838208306,-2436,,
15433613746,908.24839,16838261636,919965708,16838259256,-2380,,
15433664315,908.29896,16838312206,920016274,16838309883,-2323,,
15433714908,908.34956,16838362802,920066866,16838360537,-2265,,
15433765393,908.40004,16838413290,920117348,16838411081,-2209,,
15433816428,908.45108,16838464327,920168380,16838462175,-2152,,
15433867045,908.50169,16838514945,920218994,16838512851,-2094,,
15433917579,908.55223,16838565483,920269525,16838563445,-2038,,
15433968581,908.60323,16838616486,920320524,16838614505,-1981,,
15434018642,908.65329,16838666551,920370584,16838664626,-1925,,
15434069693,908.70434,16838717604,920421632,16838715737,-1867,,
15434120014,908.75466,16838767927,920471950,16838766116,-1811,,
15434170512,908.80516,16838818427,920522444,16838816672,-1755,,
15434221049,908.85570,16838868967,920572979,16838867270,-1697,,
15434271675,908.90632,16838919606,920623614,16838917966,-1640,,
15434322221,908.95687,16838970144,920674145,16838968510,-1634,,
15434372813,909.00746,16839020737,920724735,16839019099,-1638,,
15434423410,909.05806,16839071337,920775330,16839069694,-1643,,
15434473943,909.10859,16839121873,920825860,16839120225,-1648,,
15434524984,909.15963,16839172916,920876897,16839171262,-1654,,
15434575548,909.21020,16839223481,920927459,16839221823,-1658,,
15434626150,909.26080,16839274087,920978058,16839272423,-1664,,
15434677155,909.31180,16839325093,921029060,16839323424,-1669,,
15434727702,909.36235,16839375643,921079605,16839373970,-1673,,
15434778246,909.41289,16839426190,921130146,16839424511,-1679,,
15434828800,909.46345,16839476745,921180697,16839475061,-1684,,
15434879820,909.51447,16839527769,921231714,16839526079,-1690,,
15434930757,909.56541,16839578708,921282650,16839577014,-1694,,
15434981344,909.61599,16839629297,921333234,16839627599,-1698,,
15435031451,909.66610,16839679407,921383338,16839677702,-1705,,
15435081952,909.71660,16839729910,921433837,16839728201,-1709,,
15435132523,909.76717,16839780483,921484404,16839778769,-1714,,
15435183069,909.81772,16839831031,921534947,16839829311,-1720,,
15435234098,909.86875,16839882063,921585974,16839880339,-1724,,
15435284693,909.91934,16839932659,921636566,16839930930,-1729,,
15435335225,909.96987,16839983195,921687095,16839981460,-1735,,
15435386244,910.02089,16840034215,921738111,16840032475,-1740,,
15435436791,910.07144,16840084765,921788656,16840083021,-1744,,
15435487415,910.12206,16840135392,921839277,16840133642,-1750,,
15435537932,910.17258,16840185911,921889791,16840184156,-1755,,
15435588977,910.22362,16840236959,921940834,16840235199,-1760,,
15435640061,910.27471,16840288045,921991915,16840286280,-1765,,
15435690614,910.32526,16840338600,922042465,16840336830,-1770,,
15435741455,910.37610,16840389444,922093303,16840387668,-1776,,
15435792028,910.42668,16840440019,922143874,16840438239,-1780,,
15435842586,910.47723,16840490579,922194430,16840488795,-1784,,
15435893566,910.52821,16840541562,922245406,16840539771,-1791,,
15435944598,910.57925,16840592596,922296437,16840590801,-1795,,
15435994683,910.62933,16840642683,922346518,16840640883,-1800,,
15436044954,910.67960,16840692957,922396786,16840691150,-1807,,
15436095075,910.72972,16840743080,922446905,16840741269,-1811,,
15436146053,910.78070,16840794059,922497880,16840792244,-1815,,
15436196775,910.83142,16840844785,922548599,16840842964,-1821,,
15436247148,910.88180,16840895160,922598969,16840893334,-1826,,
15436298201,910.93285,16840946216,922650021,16840944385,-1831,,
15436348806,910.98345,16840996823,922700623,16840994987,-1836,,
15436399344,911.03399,16841047363,922751158,16841045522,-1841,,
15436449414,911.08406,16841097435,922801224,16841095588,-1847,,
15436500370,911.13502,16841148393,922852178,16841146542,-1851,,
15436551455,911.18610,16841199480,922903260,16841197624,-1856,,
15436601711,911.23636,16841249740,922953514,16841247878,-1862,,
15436651937,911.28658,16841299968,923003738,16841298102,-1866,,
15436702704,911.33735,16841350737,923054501,16841348866,-1871,,
15436753247,911.38789,16841401283,923105041,16841399406,-1877,,
15436804284,911.43893,16841452322,923156077,16841450441,-1881,,
15436854864,911.48951,16841502904,923206653,16841501018,-1886,,
15436905441,911.54009,16841553484,923257227,16841551592,-1892,,
15436956073,911.59072,16841604118,923307857,16841602221,-1897,,
15437007077,911.64172,16841655124,923358859,16841653223,-1901,,
15437057176,911.69182,16841705225,923408954,16841703319,-1906,,
15437107767,911.74242,16841755819,923459543,16841753907,-1912,,
15437158241,911.79289,16841806295,923510014,16841804378,-1917,,
15437208781,911.84343,16841856837,923560551,16841854915,-1922,,
15437258815,911.89346,16841906873,923610582,16841904946,-1927,,
15437309301,911.94395,16841957363,923661065,16841955430,-1933,,
15437360379,911.99503,16842008443,923712142,16842006507,-1936,,
15437411043,912.04569,16842059108,923762802,16842057166,-1942,,
15437461453,912.09610,16842109522,923813210,16842107575,-1947,,
15437512340,912.14699,16842160411,923864095,16842158459,-1952,,
15437562523,912.19717,16842210595,923914274,16842208639,-1956,,
15437613076,912.24772,16842261152,923964824,16842259189,-1963,,
15437663662,912.29831,16842311740,924015408,16842309773,-1967,,
15437714597,912.34924,16842362687,924066350,16842360715,-1972,,
15437765636,912.40028,16842413718,924117376,16842411740,-1978,,
15437815751,912.45040,16842463836,924167489,16842461853,-1983,,
15437866280,912.50093,16842514377,924218025,16842512389,-1988,,
15437916854,912.55150,16842564943,924268586,16842562950,-1993,,
15437967667,912.60231,16842615758,924319396,16842613760,-1998,,
15438017812,912.65246,16842665917,924369551,16842663915,-2002,,
15438068855,912.70350,16842716951,924420579,16842714943,-2008,,
15438119390,912.75404,16842767488,924471111,16842765475,-2013,,
15438170460,912.80511,16842818562,924522179,16842816543,-2019,,
15438221053,912.85570,16842869157,924572770,16842867134,-2023,,
15438272042,912.90669,16842920147,924623755,16842918119,-2028,,
15438323099,912.95775,16842971208,924674809,16842969174,-2034,,
15438373596,913.00824,16843021707,924725304,16843019669,-2038,,
15438423672,913.05832,16843071784,924775388,16843069752,-2032,,
15438473863,913.10851,16843121979,924825565,16843119930,-2049,,
15438524444,913.15909,16843172561,924876143,16843170507,-2054,,
15438574906,913.20955,16843223026,924926604,16843220968,-2058,,
15438625447,913.26009,16843273570,924977141,16843271506,-2064,,
15438675550,913.31020,16843323675,925027241,16843321605,-2070,,
15438726085,913.36073,16843374212,925077775,16843372139,-2073,,
15438776150,913.41080,16843424280,925127837,16843422201,-2079,,
15438826689,913.46134,16843474821,925178372,16843472736,-2085,,
15438877741,913.51239,16843525875,925229422,16843523786,-2089,,
15438928297,913.56295,16843576433,925279975,16843574339,-2094,,
15438978907,913.61356,16843627046,925330582,16843624947,-2099,,
15439029467,913.66412,16843677609,925381139,16843675504,-2105,,
15439080064,913.71471,16843728208,925431735,16843726100,-2108,,
15439130964,913.76561,16843779110,925482631,16843776996,-2114,,
15439181637,913.81628,16843829785,925533301,16843827665,-2120,,
15439232672,913.86732,16843880822,925584334,16843878698,-2124,,
15439283221,913.91787,16843931373,925634880,16843929244,-2129,,
15439333267,913.96791,16843981423,925684923,16843979288,-2135,,
15439383817,914.01846,16844031974,925735471,16844029835,-2139,,
15439434375,914.06902,16844082535,925786027,16844080391,-2144,,
15439484958,914.11961,16844133121,925836606,16844130971,-2150,,
15439535277,914.16993,16844183442,925886922,16844181287,-2155,,
15439586222,914.22087,16844234389,925937865,16844232230,-2159,,
15439636821,914.27147,16844284991,925988461,16844282826,-2165,,
15439687389,914.32204,16844335560,926039026,16844333390,-2170,,
15439738264,914.37291,16844386438,926089899,16844384264,-2174,,
15439789315,914.42396,16844437491,926140947,16844435311,-2180,,
15439839910,914.47456,16844488088,926191539,16844485903,-2185,,
15439890909,914.52556,16844539091,926242535,16844536900,-2191,,
15439941255,914.57590,16844589439,926292879,16844587244,-2195,,
15439991391,914.62604,16844639577,926343013,16844637377,-2200,,
15440041967,914.67661,16844690155,926393585,16844687950,-2205,,
15440092982,914.72763,16844741173,926444599,16844738963,-2210,,
15440143558,914.77821,16844791762,926495182,16844789547,-2215,,
15440194136,914.82878,16844842342,926545757,16844840121,-2221,,
15440244702,914.87935,16844892900,926596309,16844890674,-2226,,
15440295239,914.92989,16844943439,926646845,16844941209,-2230,,
15440345407,914.98005,16844993609,926697009,16844991373,-2236,,
15440395986,915.03063,16845044190,926747585,16845041949,-2241,,
15440446947,915.08159,16845095154,926798545,16845092909,-2245,,
15440497093,915.13174,16845145304,926848688,16845143052,-2252,,
15440548136,915.18278,16845196348,926899728,16845194092,-2256,,
15440598685,915.23333,16845246899,926950275,16845244639,-2260,,
15440649695,915.28434,16845297912,927001281,16845295646,-2266,,
15440700249,915.33490,16845348467,927051832,16845346197,-2270,,
15440751298,915.38595,16845399520,927102878,16845397243,-2277,,
15440801832,915.43648,16845450056,927153410,16845447774,-2282,,
15440852379,915.48703,16845500605,927203955,16845498319,-2286,,
15440902943,915.53759,16845551171,927254515,16845548879,-2292,,
15440953491,915.58814,16845601722,927305062,16845599426,-2296,,
15441004527,915.63918,16845652759,927356094,16845650458,-2301,,
15441055088,915.68974,16845703324,927406652,16845701017,-2307,,
15441105624,915.74027,16845753862,927457186,16845751550,-2312,,
15441156161,915.79081,16845804401,927507720,16845802085,-2316,,
15441206217,915.84087,16845854460,927557774,16845852138,-2322,,
15441256766,915.89141,16845905011,927608319,16845902684,-2327,,
15441306827,915.94147,16845955074,927658378,16845952743,-2331,,
15441357864,915.99251,16846006113,927709412,16846003776,-2337,,
15441408958,916.04361,16846057210,927760503,16846054867,-2343,,
15441459961,916.09461,16846108216,927811503,16846105868,-2348,,
15441510504,916.14515,16846158760,927862044,16846156408,-2352,,
15441561103,916.19575,16846209361,927912640,16846207004,-2357,,
15441611461,916.24611,16846259723,927962995,16846257360,-2363,,
15441662465,916.29711,16846310729,928013998,16846308362,-2367,,
15441712564,916.34721,16846360830,928064094,16846358458,-2372,,
15441763145,916.39779,16846411413,928114671,16846409035,-2378,,
15441813228,916.44788,16846461499,928164753,16846459117,-2382,,
15441863819,916.49847,16846512092,928215341,16846509705,-2387,,
15441913906,916.54855,16846562181,928265424,16846559788,-2393,,
15441964443,916.59909,16846612721,928315959,16846610323,-2398,,
15442015007,916.64966,16846663286,928366520,16846660884,-2402,,
15442065157,916.69980,16846713439,928416667,16846711031,-2408,,
15442115912,916.75056,16846764197,928467420,16846761784,-2413,,
15442166519,916.80117,16846814806,928518025,16846812389,-2417,,
15442217101,916.85175,16846865390,928568603,16846862967,-2423,,
15442267604,916.90225,16846915896,928619103,16846913468,-2428,,
15442318152,916.95280,16846966446,928669649,16846964014,-2432,,
15442368748,917.00340,16847017045,928720242,16847014607,-2438,,
15442419640,917.05429,16847067939,928771132,16847065496,-2443,,
15442470164,917.10481,16847118466,928821652,16847116017,-2449,,
15442520245,917.15489,16847168548,928871731,16847166095,-2453,,
15442570698,917.20535,16847219004,928922181,16847216546,-2458,,
15442621361,917.25601,16847269670,928972841,16847267206,-2464,,
15442671892,917.30654,16847320203,929023371,16847317735,-2468,,
15442722813,917.35746,16847371125,929074288,16847368652,-2473,,
15442773360,917.40801,16847421676,929124832,16847419197,-2479,,
15442823874,917.45852,16847472192,929175344,16847469708,-2484,,
15442874912,917.50956,16847523232,929226379,16847520744,-2488,,
15442925476,917.56012,16847573799,929276940,16847571305,-2494,,
15442976024,917.61067,16847624349,929327485,16847621850,-2499,,
15443027058,917.66171,16847675385,929378517,16847672882,-2503,,
15443077608,917.71226,16847725937,929429064,16847723428,-2509,,
15443128181,917.76283,16847776523,929479644,16847774009,-2514,,
15443179203,917.81385,16847827537,929530654,16847825018,-2519,,
15443229762,917.86441,16847878099,929581210,16847875575,-2524,,
15443280313,917.91496,16847928651,929631758,16847926122,-2529,,
15443330858,917.96551,16847979199,929682300,16847976664,-2535,,
15443381397,918.01604,16848029741,929732837,16848027202,-2539,,
15443432247,918.06690,16848080593,929783684,16848078049,-2544,,
15443482489,918.11714,16848130838,929833923,16848128288,-2550,,
15443532633,918.16728,16848180983,929884065,16848178430,-2553,,
15443583663,918.21831,16848232016,929935093,16848229457,-2559,,
15443634746,918.26939,16848283101,929986172,16848280536,-2565,,
15443685311,918.31996,16848333669,930036735,16848331099,-2570,,
15443736329,918.37098,16848384689,930087750,16848382114,-2575,,
15443786901,918.42155,16848435264,930138320,16848432684,-2580,,
15443837511,918.47216,16848485875,930188926,16848483290,-2585,,
15443888513,918.52316,16848536879,930239926,16848534290,-2589,,
15443939061,918.57371,16848587430,930290471,16848584836,-2594,,
15443989638,918.62429,16848638010,930341056,16848635420,-2590,,
15444040206,918.67485,16848688580,930391610,16848685974,-2606,,
15444090796,918.72544,16848739173,930442198,16848736563,-2610,,
15444141822,918.77647,16848790201,930493221,16848787586,-2615,,
15444192436,918.82708,16848840818,930543832,16848838197,-2621,,
15444243099,918.87775,16848891483,930594493,16848888858,-2625,,
15444294095,918.92874,16848942481,930645486,16848939851,-2630,,
15444344708,918.97936,16848993097,930696097,16848990461,-2636,,
15444395706,919.03035,16849044097,930747091,16849041456,-2641,,
15444446092,919.08074,16849094485,930797475,16849091840,-2645,,
15444496639,919.13129,16849145035,930848020,16849142384,-2651,,
15444547249,919.18190,16849195646,930898626,16849192990,-2656,,
15444598288,919.23294,16849246688,930949663,16849244028,-2660,,
15444649342,919.28399,16849297745,931000714,16849295079,-2666,,
15444699900,919.33455,16849348305,931051269,16849345634,-2671,,
15444750914,919.38556,16849399322,931102280,16849396645,-2677,,
15444801486,919.43613,16849449908,931152862,16849447227,-2681,,
15444852033,919.48668,16849500455,931203405,16849497769,-2686,,
15444902561,919.53721,16849550976,931253920,16849548284,-2692,,
15444952951,919.58760,16849601367,931304307,16849598672,-2695,,
15445003523,919.63817,16849651953,931354888,16849649252,-2701,,
15445054063,919.68871,16849702485,931405414,16849699778,-2707,,
15445105096,919.73974,16849753520,931456443,16849750808,-2712,,
15445156146,919.79079,16849804571,931507491,16849801855,-2716,,
15445206693,919.84134,16849855121,931558035,16849852399,-2722,,
15445257242,919.89189,16849905672,931608581,16849902945,-2727,,
15445307790,919.94244,16849956223,931659127,16849953492,-2731,,
15445358339,919.99299,16850006775,931709673,16850004038,-2737,,
15445408896,920.04354,16850057333,931760227,16850054592,-2741,,
15445459936,920.09458,16850108376,931811264,16850105628,-2748,,
15445510526,920.14517,16850158968,931861852,16850156217,-2751,,
15445561139,920.19579,16850209584,931912462,16850206826,-2758,,
15445611644,920.24629,16850260092,931962964,16850257329,-2763,,
15445662041,920.29669,16850310491,932013359,16850307724,-2767,,
15445712590,920.34724,16850361042,932063906,16850358270,-2772,,
15445763115,920.39776,16850411570,932114427,16850408792,-2778,,
15445813858,920.44851,16850462315,932165167,16850459531,-2784,,
15445864652,920.49930,16850513110,932215959,16850510323,-2787,,
15445915195,920.54984,16850563657,932266500,16850560865,-2792,,
15445965769,920.60042,16850614243,932317081,16850611445,-2798,,
15446016823,920.65147,16850665288,932368122,16850662486,-2802,,
15446067079,920.70173,16850715557,932418385,16850712749,-2808,,
15446117613,920.75226,16850766084,932468907,16850763271,-2813,,
15446168485,920.80313,16850816958,932519777,16850814141,-2817,,
15446219458,920.85411,16850867934,932570747,16850865111,-2823,,
15446270095,920.90474,16850918572,932621380,16850915744,-2828,,
15446320588,920.95524,16850969068,932671870,16850966235,-2833,,
15446371134,921.00578,16851019617,932722414,16851016779,-2838,,
15446421847,921.05650,16851070332,932773124,16851067489,-2843,,
15446472395,921.10704,16851120883,932823669,16851118034,-2849,,
15446522943,921.15759,16851171433,932874215,16851168580,-2853,,
15446573524,921.20817,16851222016,932924793,16851219158,-2858,,
15446624347,921.25900,16851272842,932975614,16851269978,-2864,,
15446674932,921.30958,16851323429,933026196,16851320560,-2869,,
15446726019,921.36067,16851374517,933077280,16851371644,-2873,,
15446776139,921.41079,16851424641,933127397,16851421762,-2879,,
15446826743,921.46139,16851475247,933177999,16851472363,-2884,,
15446877581,921.51223,16851526087,933228834,16851523199,-2888,,
15446928172,921.56282,16851576680,933279421,16851573786,-2894,,
15446978859,921.61351,16851627380,933330116,16851624481,-2899,,
15447029435,921.66408,16851677949,933380679,16851675043,-2906,,
15447080431,921.71508,16851728947,933431673,16851726038,-2909,,
15447130994,921.76564,16851779512,933482234,16851776598,-2914,,
15447181552,921.81620,16851830083,933532799,16851827163,-2920,,
15447232077,921.86672,16851880599,933583311,16851877675,-2924,,
15447282626,921.91727,16851931151,933633857,16851928222,-2929,,
15447333185,921.96783,16851981712,933684413,16851978777,-2935,,
15447383769,922.01842,16852032299,933734996,16852029360,-2939,,
15447434770,922.06942,16852083301,933785993,16852080357,-2944,,
15447485833,922.12048,16852134368,933837054,16852131418,-2950,,
15447535933,922.17058,16852184470,933887150,16852181514,-2956,,
15447586947,922.22159,16852235486,933938163,16852232527,-2959,,
15447637533,922.27218,16852286074,933988745,16852283109,-2965,,
15447688081,922.32273,16852336625,934039290,16852333654,-2971,,
15447738308,922.37296,16852386854,934089516,16852383880,-2974,,
15447789196,922.42384,16852437745,934140401,16852434765,-2980,,
15447839770,922.47442,16852488333,934190983,16852485347,-2986,,
15447890340,922.52499,16852538894,934241539,16852535903,-2991,,
15447941378,922.57603,16852589934,934292574,16852586939,-2995,,
15447991940,922.62659,16852640497,934343133,16852637497,-3000,,
15448042504,922.67715,16852691075,934393705,16852688070,-3005,,
15448093525,922.72817,16852742087,934444713,16852739077,-3010,,
15448144081,922.77873,16852792645,934495266,16852789630,-3015,,
15448194155,922.82880,16852842723,934545338,16852839702,-3021,,
15448244714,922.87936,16852893283,934595893,16852890257,-3026,,
15448295714,922.93036,16852944286,934646891,16852941256,-3030,,
15448346274,922.98092,16852994849,934697448,16852991813,-3036,,
15448396827,923.03148,16853045404,934747998,16853042363,-3041,,
15448447444,923.08209,16853096023,934798613,16853092978,-3045,,
15448498309,923.13296,16853146891,934849475,16853143840,-3051,,
15448548898,923.18355,16853197482,934900062,16853194426,-3056,,
15448599280,923.23393,16853247866,934950440,16853244804,-3062,,
15448649895,923.28454,16853298483,935001053,16853295417,-3066,,
15448700933,923.33558,16853349524,935052089,16853346453,-3071,,
15448751912,923.38656,16853400506,935103065,16853397429,-3077,,
15448802927,923.43758,16853451522,935154077,16853448441,-3081,,
15448853488,923.48814,16853502085,935204635,16853498999,-3086,,
15448904023,923.53867,16853552624,935255168,16853549532,-3092,,
15448954585,923.58923,16853603188,935305727,16853600091,-3097,,
15449005616,923.64026,16853654220,935356755,16853651119,-3101,,
15449055683,923.69033,16853704291,935406819,16853701184,-3107,,
15449106262,923.74091,16853754872,935457395,16853751760,-3112,,
15449156765,923.79141,16853805376,935507896,16853802260,-3116,,
15449207308,923.84196,16853855923,935558436,16853852801,-3122,,
15449257373,923.89202,16853905990,935608499,16853902863,-3127,,
15449307922,923.94257,16853956540,935659045,16853953409,-3131,,
15449358491,923.99314,16854007114,935709613,16854003977,-3137,,
15449409005,924.04365,16854057628,935760122,16854054486,-3142,,
15449459586,924.09423,16854108214,935810702,16854105066,-3148,,
15449510197,924.14485,16854158826,935861310,16854155674,-3152,,
15449560874,924.19552,16854209505,935911983,16854206348,-3157,,
15449611919,924.24657,16854260552,935963025,16854257389,-3163,,
15449662070,924.29672,16854310705,936013174,16854307538,-3167,,
15449713103,924.34775,16854361741,936064204,16854358569,-3172,,
15449763651,924.39830,16854412292,936114749,16854409114,-3178,,
15449814215,924.44886,16854462858,936165311,16854459675,-3183,,
15449864763,924.49941,16854513408,936215857,16854510221,-3187,,
15449915297,924.54994,16854563945,936266387,16854560751,-3194,,
15449965845,924.60049,16854614495,936316932,16854611297,-3198,,
15450015909,924.65056,16854664561,936366995,16854661360,-3201,,
15450066957,924.70160,16854715612,936418039,16854712404,-3208,,
15450117990,924.75264,16854766646,936469069,16854763433,-3213,,
15450168557,924.80321,16854817216,936519635,16854813999,-3217,,
15450219134,924.85378,16854867796,936570209,16854864573,-3223,,
15450269636,924.90428,16854918300,936620708,16854915072,-3228,,
15450320735,924.95538,16854969401,936671803,16854966167,-3234,,
15450370909,925.00556,16855019578,936721976,16855016340,-3238,,
15450421434,925.05608,16855070104,936772497,16855066862,-3242,,
15450471946,925.10659,16855120620,936823007,16855117371,-3249,,
15450522508,925.15716,16855171196,936873578,16855167943,-3253,,
15450573077,925.20772,16855221754,936924132,16855218496,-3258,,
15450624074,925.25872,16855272755,936975126,16855269491,-3264,,
15450674218,925.30887,16855322901,937025267,16855319632,-3269,,
15450724844,925.35949,16855373528,937075891,16855370255,-3273,,
15450775862,925.41051,16855424550,937126907,16855421271,-3279,,
15450826896,925.46154,16855475586,937177938,16855472302,-3284,,
15450877027,925.51167,16855525719,937228066,16855522431,-3288,,
15450927842,925.56249,16855576536,937278878,16855573242,-3294,,
15450978031,925.61268,16855626727,937329064,16855623428,-3299,,
15451028259,925.66291,16855676957,937379290,16855673654,-3303,,
15451078812,925.71346,16855727513,937429840,16855724204,-3309,,
15451129364,925.76401,16855778068,937480390,16855774754,-3314,,
15451179895,925.81454,16855828601,937530917,16855825281,-3320,,
15451230475,925.86512,16855879184,937581496,16855875861,-3323,,
15451281013,925.91566,16855929724,937632030,16855926395,-3329,,
15451331574,925.96622,16855980288,937682589,16855976953,-3335,,
15451382512,926.01716,16856031228,937733524,16856027889,-3339,,
15451432872,926.06752,16856081590,937783882,16856078246,-3344,,
15451483452,926.11810,16856132173,937834458,16856128823,-3350,,
15451533980,926.16863,16856182703,937884983,16856179348,-3355,,
15451584231,926.21888,16856232956,937935232,16856229597,-3359,,
15451634873,926.26952,16856283611,937985881,16856280246,-3365,,
15451685529,926.32018,16856334259,938036525,16856330889,-3370,,
15451735674,926.37032,16856384406,938086667,16856381031,-3375,,
15451786229,926.42088,16856434964,938137219,16856431584,-3380,,
15451836720,926.47137,16856485457,938187708,16856482072,-3385,,
15451887767,926.52242,16856536505,938238752,16856533116,-3389,,
15451938875,926.57352,16856587616,938289857,16856584222,-3394,,
15451989413,926.62406,16856638157,938340392,16856634757,-3400,,
15452039546,926.67419,16856688292,938390523,16856684887,-3405,,
15452090429,926.72508,16856739178,938441403,16856735768,-3410,,
15452140980,926.77563,16856789731,938491951,16856786316,-3415,,
15452191316,926.82596,16856840080,938542294,16856836659,-3421,,
15452241881,926.87653,16856890637,938592848,16856887212,-3425,,
15452292895,926.92754,16856941653,938643859,16856938223,-3430,,
15452343047,926.97770,16856991808,938694007,16856988372,-3436,,
15452393591,927.02824,16857042354,938744548,16857038913,-3441,,
15452444201,927.07885,16857092966,938795156,16857089521,-3445,,
15452494764,927.12941,16857143532,938845716,16857140081,-3451,,
15452545367,927.18002,16857194137,938896316,16857190681,-3456,,
15452595914,927.23056,16857244686,938946861,16857241225,-3461,,
15452646427,927.28107,16857295202,938997371,16857291736,-3466,,
15452696530,927.33118,16857345307,939047472,16857341836,-3471,,
15452747524,927.38217,16857396303,939098463,16857392828,-3475,,
15452798106,927.43275,16857446888,939149043,16857443407,-3481,,
15452849120,927.48377,16857497903,939200053,16857494417,-3486,,
15452899645,927.53429,16857548430,939250574,16857544939,-3491,,
15452949721,927.58437,16857598509,939300649,16857595013,-3496,,
15453000303,927.63495,16857649094,939351228,16857645593,-3501,,
15453051323,927.68597,16857700117,939402245,16857696610,-3507,,
15453102366,927.73701,16857751162,939453287,16857747651,-3511,,
15453152915,927.78756,16857801712,939503832,16857798196,-3516,,
15453203956,927.83860,16857852757,939554871,16857849235,-3522,,
15453254496,927.88914,16857903298,939605407,16857899771,-3527,,
15453304545,927.93919,16857953349,939655454,16857949818,-3531,,
15453355107,927.98975,16858003914,939706013,16858000377,-3537,,
15453406152,928.04080,16858054961,939757055,16858051419,-3542,,
15453457213,928.09186,16858106025,939808115,16858102479,-3546,,
15453507809,928.14246,16858156623,939858707,16858153071,-3552,,
15453558815,928.19346,16858207631,939909710,16858204074,-3557,,
15453609882,928.24453,16858258701,939960774,16858255138,-3563,,
15453660469,928.29512,16858309290,940011359,16858305723,-3567,,
15453711446,928.34609,16858360269,940062333,16858356697,-3572,,
15453762003,928.39665,16858410829,940112887,16858407251,-3578,,
15453812993,928.44764,16858461822,940163876,16858458240,-3582,,
15453863564,928.49821,16858512395,940214444,16858508808,-3587,,
15453914221,928.54887,16858563054,940265097,16858559461,-3593,,
15453964728,928.59938,16858613563,940315601,16858609965,-3598,,
15454015276,928.64992,16858664114,940366148,16858660512,-3602,,
15454066014,928.70066,16858714855,940416882,16858711247,-3608,,
15454116583,928.75123,16858765426,940467449,16858761813,-3613,,
15454167039,928.80169,16858815883,940517902,16858812266,-3617,,
15454217533,928.85218,16858866381,940568393,16858862758,-3623,,
15454268090,928.90274,16858916939,940618947,16858913311,-3628,,
15454318633,928.95328,16858967485,940669487,16858963852,-3633,,
15454369202,929.00385,16859018057,940720054,16859014419,-3638,,
15454419817,929.05447,16859068674,940770666,16859065031,-3643,,
15454470695,929.10534,16859119555,940821541,16859115906,-3649,,
15454521005,929.15565,16859169867,940871850,16859166215,-3652,,
15454571418,929.20607,16859220282,940922260,16859216625,-3657,,
15454622456,929.25710,16859271322,940973294,16859267658,-3664,,
15454672558,929.30721,16859321428,941023395,16859317760,-3668,,
15454722714,929.35736,16859371585,941073548,16859367912,-3673,,
15454772830,929.40748,16859421704,941123660,16859418025,-3679,,
15454823632,929.45828,16859472508,941174460,16859468824,-3684,,
15454874714,929.50936,16859523593,941225540,16859519905,-3688,,
15454925273,929.55992,16859574154,941276096,16859570460,-3694,,
15454976049,929.61070,16859624932,941326868,16859621233,-3699,,
15455026595,929.66124,16859675480,941377412,16859671777,-3703,,
15455077163,929.71181,16859726062,941427989,16859722354,-3708,,
15455127732,929.76238,16859776622,941478544,16859772908,-3714,,
15455178738,929.81339,16859827630,941529547,16859823911,-3719,,
15455229308,929.86396,16859878214,941580126,16859874491,-3723,,
15455279852,929.91450,16859928748,941630655,16859925019,-3729,,
15455330885,929.96553,16859979785,941681686,16859976050,-3735,,
15455381430,930.01608,16860030331,941732228,16860026593,-3738,,
15455432259,930.06691,16860081174,941783066,16860077430,-3744,,
15455482559,930.11721,16860131466,941833351,16860127716,-3750,,
15455533570,930.16822,16860182479,941884359,16860178724,-3755,,
15455584607,930.21925,16860233517,941935394,16860229758,-3759,,
15455635204,930.26985,16860284118,941985989,16860280353,-3765,,
15455686249,930.32090,16860335165,942037031,16860331395,-3770,,
15455736344,930.37099,16860385262,942087123,16860381488,-3774,,
15455786473,930.42112,16860435394,942137249,16860431614,-3780,,
15455836997,930.47164,16860485920,942187770,16860482135,-3785,,
15455887531,930.52218,16860536456,942238302,16860532667,-3789,,
15455938118,930.57277,16860587046,942288887,16860583251,-3795,,
15455989150,930.62380,16860638080,942339915,16860634280,-3800,,
15456039686,930.67433,16860688618,942390448,16860684812,-3806,,
15456090235,930.72488,16860739169,942440995,16860735359,-3810,,
15456140831,930.77548,16860789767,942491588,16860785952,-3815,,
15456191377,930.82602,16860840316,942542131,16860836495,-3821,,
15456241879,930.87653,16860890820,942592631,16860886995,-3825,,
15456292426,930.92707,16860941370,942643175,16860937540,-3830,,
15456342523,930.97717,16860991470,942693269,16860987634,-3836,,
15456393524,931.02817,16861042473,942744268,16861038632,-3841,,
15456444072,931.07872,16861093023,942794813,16861089178,-3845,,
15456494657,931.12931,16861143612,942845397,16861139761,-3851,,
15456545247,931.17989,16861194202,942895982,16861190346,-3856,,
15456595781,931.23043,16861244739,942946515,16861240879,-3860,,
15456646319,931.28097,16861295280,942997049,16861291414,-3866,,
15456696885,931.33153,16861345847,943047612,16861341976,-3871,,
15456747032,931.38168,16861395997,943097758,16861392122,-3875,,
15456798057,931.43271,16861447025,943148779,16861443144,-3881,,
15456848655,931.48330,16861497625,943199375,16861493739,-3886,,
15456899169,931.53382,16861548152,943249897,16861544262,-3890,,
15456950201,931.58485,16861599176,943300915,16861595280,-3896,,
15457000674,931.63532,16861649651,943351385,16861645750,-3901,,
15457051127,931.68578,16861700108,943401837,16861696201,-3907,,
15457101839,931.73649,16861750820,943452545,16861746909,-3911,,
15457152849,931.78750,16861801833,943503552,16861797916,-3917,,
15457203516,931.83816,16861852503,943554216,16861848581,-3922,,
15457254296,931.88894,16861903285,943604994,16861899358,-3927,,
15457305025,931.93967,16861954016,943655721,16861950085,-3931,,
15457355078,931.98973,16862004072,943705770,16862000135,-3937,,
15457405627,932.04027,16862054623,943756316,16862050681,-3942,,
15457455739,932.09039,16862104737,943806427,16862100792,-3945,,
15457506440,932.14109,16862155440,943857124,16862151488,-3952,,
15457556820,932.19147,16862205823,943907501,16862201866,-3957,,
15457607892,932.24254,16862256897,943958583,16862252948,-3949,,
15457658009,932.29266,16862307016,944008685,16862303049,-3967,,
15457708958,932.34361,16862357968,944059632,16862353996,-3972,,
15457759557,932.39421,16862408569,944110227,16862404592,-3977,,
15457809875,932.44452,16862458889,944160543,16862454907,-3982,,
15457860920,932.49557,16862509937,944211585,16862505950,-3987,,
15457911985,932.54663,16862561005,944262648,16862557012,-3993,,
15457962546,932.59719,16862611578,944313217,16862607581,-3997,,
15458013074,932.64772,16862662098,944363731,16862658096,-4002,,
15458064125,932.69877,16862713152,944414779,16862709144,-4008,,
15458114690,932.74934,16862763729,944465351,16862759716,-4013,,
15458165226,932.79987,16862814257,944515875,16862810240,-4017,,
15458215941,932.85059,16862864975,944566588,16862860952,-4023,,
15458266482,932.90113,16862915518,944617125,16862911489,-4029,,
15458317043,932.95169,16862966080,944667684,16862962048,-4032,,
15458367611,933.00226,16863016652,944718249,16863012614,-4038,,
15458418530,933.05318,16863067573,944769166,16863063530,-4043,,
15458469095,933.10374,16863118139,944819727,16863114092,-4047,,
15458519673,933.15432,16863168720,944870303,16863164667,-4053,,
15458570255,933.20490,16863219304,944920882,16863215246,-4058,,
15458620840,933.25549,16863269893,944971464,16863265829,-4064,,
15458671924,933.30657,16863320979,945022547,16863316911,-4068,,
15458722956,933.35760,16863372012,945073575,16863367939,-4073,,
15458773449,933.40810,16863422509,945124066,16863418430,-4079,,
15458824029,933.45868,16863473101,945174652,16863469017,-4084,,
15458874595,933.50924,16863523659,945225207,16863519571,-4088,,
15458925631,933.56028,16863574697,945276239,16863570603,-4094,,
15458976686,933.61133,16863625755,945327292,16863621657,-4098,,
15459027270,933.66192,16863676341,945377874,16863672238,-4103,,
15459077796,933.71244,16863726869,945428396,16863722760,-4109,,
15459128308,933.76296,16863777383,945478905,16863773269,-4114,,
15459178432,933.81308,16863827510,945529026,16863823391,-4119,,
15459228929,933.86358,16863878010,945579521,16863873886,-4124,,
15459279983,933.91463,16863929066,945630573,16863924937,-4129,,
15459330533,933.96518,16863979618,945681119,16863975483,-4135,,
15459381081,934.01573,16864030169,945731665,16864026030,-4139,,
15459432113,934.06676,16864081203,945782694,16864077059,-4144,,
15459482669,934.11732,16864131761,945833247,16864127611,-4150,,
15459533221,934.16787,16864182315,945883797,16864178161,-4154,,
15459583616,934.21826,16864232713,945934190,16864228554,-4159,,
15459634207,934.26886,16864283307,945984777,16864279142,-4165,,
15459684922,934.31957,16864334024,946035490,16864329854,-4170,,
15459735497,934.37014,16864384612,946086074,16864380438,-4174,,
15459785935,934.42058,16864435042,946136498,16864430867,-4175,,
15459836515,934.47116,16864485624,946187075,16864481439,-4185,,
15459887075,934.52172,16864536186,946237632,16864531997,-4189,,
15459937242,934.57189,16864586356,946287796,16864582161,-4195,,
15459988003,934.62265,16864637119,946338554,16864632919,-4200,,
15460038314,934.67296,16864687431,946388862,16864683226,-4205,,
15460088881,934.72353,16864738001,946439427,16864733791,-4210,,
15460139948,934.77460,16864789071,946490492,16864784856,-4215,,
15460190483,934.82513,16864839609,946541024,16864835388,-4221,,
15460241083,934.87573,16864890211,946591621,16864885986,-4225,,
15460291638,934.92629,16864940768,946642173,16864936538,-4230,,
15460342628,934.97728,16864991760,946693160,16864987524,-4236,,
15460393196,935.02784,16865042330,946743726,16865038090,-4240,,
15460443738,935.07839,16865092875,946794265,16865088630,-4245,,
15460494321,935.12897,16865143460,946844845,16865139209,-4251,,
15460545129,935.17978,16865194271,946895650,16865190015,-4256,,
15460595701,935.23035,16865244844,946946220,16865240584,-4260,,
15460646171,935.28082,16865295318,946996688,16865291052,-4266,,
15460697195,935.33184,16865346343,947047708,16865342072,-4271,,
15460747756,935.38240,16865396907,947098267,16865392632,-4275,,
15460798341,935.43299,16865447495,947148849,16865443214,-4281,,
15460849178,935.48383,16865498333,947199683,16865494048,-4285,,
15460900205,935.53485,16865549363,947250707,16865545071,-4292,,
15460950745,935.58539,16865599906,947301245,16865595610,-4296,,
15461001306,935.63595,16865650469,947351803,16865646168,-4301,,
15461051748,935.68640,16865700914,947402243,16865696607,-4307,,
15461102276,935.73692,16865751444,947452768,16865747133,-4311,,
15461152768,935.78742,16865801938,947503257,16865797622,-4316,,
15461202861,935.83751,16865852034,947553347,16865847712,-4322,,
15461253440,935.88809,16865902614,947603923,16865898287,-4327,,
15461304016,935.93866,16865953192,947654497,16865948861,-4331,,
15461354558,935.98921,16866003737,947705036,16865999401,-4336,,
15461404616,936.03926,16866053798,947755092,16866049456,-4342,,
15461455662,936.09031,16866104846,947806136,16866100500,-4346,,
15461506200,936.14085,16866155387,947856671,16866151035,-4352,,
15461556248,936.19090,16866205437,947906715,16866201080,-4357,,
15461606322,936.24097,16866255523,947956798,16866251162,-4361,,
15461657342,936.29199,16866306535,948007804,16866302168,-4367,,
15461707917,936.34257,16866357113,948058376,16866352741,-4372,,
15461759003,936.39365,16866408201,948109459,16866403823,-4378,,
15461809993,936.44464,16866459194,948160447,16866454811,-4383,,
15461861055,936.49570,16866510258,948211506,16866505871,-4387,,
15461912138,936.54679,16866561344,948262587,16866556951,-4393,,
15461963145,936.59779,16866612353,948313591,16866607955,-4398,,
15462013746,936.64839,16866662956,948364189,16866658554,-4402,,
15462064271,936.69892,16866713485,948414713,16866709077,-4408,,
15462114808,936.74946,16866764022,948465245,16866759609,-4413,,
15462165839,936.80049,16866815056,948516274,16866810639,-4417,,
15462216441,936.85109,16866865661,948566873,16866861237,-4424,,
15462266979,936.90163,16866916202,948617409,16866911774,-4428,,
15462318001,936.95265,16866967225,948668428,16866962793,-4432,,
15462369068,937.00372,16867018306,948719504,16867013868,-4438,,
15462419639,937.05429,16867068867,948770060,16867064424,-4443,,
15462470140,937.10479,16867119372,948820558,16867114922,-4450,,
15462520696,937.15534,16867169930,948871112,16867165477,-4453,,
15462570864,937.20551,16867220100,948921277,16867215642,-4458,,
15462621414,937.25606,16867270653,948971825,16867266189,-4464,,
15462671955,937.30660,16867321196,949022364,16867316728,-4468,,
15462722495,937.35714,16867371738,949072900,16867367265,-4473,,
15462773102,937.40775,16867422348,949123504,16867417869,-4479,,
15462824102,937.45875,16867473350,949174501,16867468866,-4484,,
15462874693,937.50934,16867523943,949225090,16867519455,-4488,,
15462925301,937.55995,16867574554,949275696,16867570060,-4494,,
15462975844,937.61049,16867625099,949326235,16867620600,-4499,,
15463026848,937.66150,16867676104,949377237,16867671601,-4503,,
15463077439,937.71209,16867726699,949427826,16867722190,-4509,,
15463127919,937.76257,16867777191,949478313,16867772677,-4514,,
15463178798,937.81345,16867828061,949529178,16867823542,-4519,,
15463229754,937.86440,16867879021,949580133,16867874497,-4524,,
15463280549,937.91520,16867929818,949630924,16867925289,-4529,,
15463331086,937.96573,16867980358,949681458,16867975823,-4535,,
15463381609,938.01626,16868030883,949731980,16868026344,-4539,,
15463432657,938.06731,16868081932,949783024,16868077388,-4544,,
15463482753,938.11740,16868132032,949833118,16868127482,-4550,,
15463533605,938.16825,16868182886,949883966,16868178331,-4555,,
15463583664,938.21831,16868232947,949934023,16868228388,-4559,,
15463634250,938.26890,16868283536,949984606,16868278971,-4565,,
15463684843,938.31949,16868334131,950035197,16868329561,-4570,,
15463735819,938.37047,16868385108,950086170,16868380534,-4574,,
15463785921,938.42057,16868435214,950136269,16868430634,-4580,,
15463836651,938.47130,16868485946,950186997,16868481361,-4585,,
15463887187,938.52184,16868536484,950237530,16868531895,-4589,,
15463938220,938.57287,16868587519,950288560,16868582924,-4595,,
15463988770,938.62342,16868638071,950339107,16868633471,-4600,,
15464039333,938.67398,16868688637,950389667,16868684032,-4605,,
15464090365,938.72501,16868739672,950440697,16868735062,-4610,,
15464140942,938.77559,16868790251,950491272,16868785637,-4614,,
15464191504,938.82615,16868840816,950541831,16868836195,-4621,,
15464242019,938.87667,16868891333,950592343,16868886707,-4626,,
15464293058,938.92771,16868942374,950643379,16868937744,-4630,,
15464343615,938.97826,16868992934,950693934,16868988298,-4636,,
15464394196,939.02884,16869043517,950744512,16869038876,-4641,,
15464445203,939.07985,16869094526,950795516,16869089881,-4645,,
15464496293,939.13094,16869145619,950846603,16869140968,-4651,,
15464546827,939.18147,16869196155,950897135,16869191499,-4656,,
15464597843,939.23249,16869247173,950948148,16869242513,-4660,,
15464648356,939.28300,16869297688,950998658,16869293022,-4666,,
15464699367,939.33402,16869348701,951049666,16869344030,-4671,,
15464750404,939.38505,16869399742,951100700,16869395065,-4677,,
15464800948,939.43560,16869450287,951151242,16869445607,-4680,,
15464851374,939.48602,16869500715,951201665,16869496029,-4686,,
15464902331,939.53698,16869551680,951252624,16869546988,-4692,,
15464952879,939.58753,16869602225,951303165,16869597529,-4696,,
15465003443,939.63809,16869652792,951353726,16869648091,-4701,,
15465054490,939.68914,16869703842,951404771,16869699135,-4707,,
15465105531,939.74018,16869754885,951455808,16869750172,-4713,,
15465156072,939.79072,16869805428,951506347,16869800712,-4716,,
15465207136,939.84178,16869856494,951557408,16869851772,-4722,,
15465258169,939.89282,16869907530,951608438,16869902803,-4727,,
15465308719,939.94337,16869958082,951658986,16869953350,-4732,,
15465359277,939.99392,16870008643,951709542,16870003906,-4737,,
15465409851,940.04450,16870059220,951760114,16870054478,-4742,,
15465460376,940.09502,16870109746,951810634,16870104998,-4748,,
15465510920,940.14557,16870160293,951861176,16870155541,-4752,,
15465561476,940.19612,16870210851,951911730,16870206094,-4757,,
15465611850,940.24650,16870261228,951962101,16870256465,-4763,,
15465662393,940.29704,16870311773,952012642,16870307006,-4767,,
15465712903,940.34755,16870362285,952063148,16870357513,-4772,,
15465763506,940.39815,16870412891,952113749,16870408113,-4778,,
15465814006,940.44865,16870463392,952164245,16870458609,-4783,,
15465864543,940.49919,16870513931,952214780,16870509144,-4787,,
15465915125,940.54977,16870564517,952265359,16870559724,-4793,,
15465966129,940.60078,16870615523,952316360,16870610725,-4798,,
15466016698,940.65135,16870666094,952366927,16870661291,-4803,,
15466067772,940.70242,16870717171,952417998,16870712362,-4809,,
15466118279,940.75293,16870767680,952468503,16870762867,-4813,,
15466168810,940.80346,16870818214,952519032,16870813396,-4818,,
15466218901,940.85355,16870868307,952569119,16870863484,-4823,,
15466269461,940.90411,16870918869,952619676,16870914041,-4828,,
15466320004,940.95465,16870969414,952670216,16870964580,-4834,,
15466371039,941.00569,16871020452,952721249,16871015614,-4838,,
15466421608,941.05626,16871071023,952771816,16871066180,-4843,,
15466472149,941.10680,16871121566,952822353,16871116717,-4849,,
15466523192,941.15784,16871172612,952873395,16871167759,-4853,,
15466573790,941.20844,16871223212,952923989,16871218354,-4858,,
15466624316,941.25896,16871273742,952974513,16871268878,-4864,,
15466675370,941.31002,16871324796,953025563,16871319928,-4868,,
15466726378,941.36103,16871375806,953076569,16871370934,-4872,,
15466777272,941.41192,16871426705,953127461,16871421826,-4879,,
15466828304,941.46295,16871477737,953178488,16871472853,-4884,,
15466878469,941.51312,16871527906,953228653,16871523017,-4889,,
15466929562,941.56421,16871579001,953279743,16871574107,-4894,,
15466980111,941.61476,16871629552,953330289,16871624653,-4899,,
15467031124,941.66577,16871680568,953381298,16871675663,-4905,,
15467081664,941.71631,16871731110,953431837,16871726201,-4909,,
15467132257,941.76690,16871781705,953482426,16871776790,-4915,,
15467182755,941.81740,16871832206,953532921,16871827286,-4920,,
15467233317,941.86797,16871882770,953583482,16871877846,-4924,,
15467283869,941.91852,16871933324,953634030,16871928395,-4929,,
15467334524,941.96917,16871983981,953684682,16871979047,-4934,,
15467385560,942.02021,16872035019,953735715,16872030079,-4940,,
15467436700,942.07135,16872086162,953786854,16872081218,-4944,,
15467487153,942.12180,16872136617,953837303,16872131668,-4949,,
15467538192,942.17284,16872187659,953888339,16872182704,-4955,,
15467588279,942.22293,16872237749,953938425,16872232789,-4960,,
15467638825,942.27347,16872288297,953988968,16872283332,-4965,,
15467689712,942.32436,16872339186,954039851,16872334216,-4970,,
15467740754,942.37540,16872390231,954090890,16872385255,-4976,,
15467791521,942.42617,16872441000,954141655,16872436019,-4981,,
15467841899,942.47655,16872491380,954192031,16872486395,-4985,,
15467892785,942.52743,16872542269,954242913,16872537277,-4992,,
15467943712,942.57836,16872593198,954293838,16872588202,-4996,,
15467994209,942.62886,16872643697,954344333,16872638697,-5000,,
15468044311,942.67896,16872693801,954394431,16872688795,-5006,,
15468095350,942.73000,16872744843,954445467,16872739831,-5012,,
15468146403,942.78105,16872795898,954496519,16872790883,-5015,,
15468196952,942.83160,16872846450,954547064,16872841429,-5021,,
15468247986,942.88263,16872897486,954598095,16872892460,-5026,,
15468298549,942.93320,16872948052,954648657,16872943021,-5031,,
15468349119,942.98377,16872998624,954699224,16872993589,-5035,,
15468400132,943.03478,16873049639,954750233,16873044598,-5041,,
15468450681,943.08533,16873100191,954800779,16873095144,-5047,,
15468501274,943.13592,16873150785,954851370,16873145734,-5051,,
15468551829,943.18648,16873201343,954901923,16873196287,-5056,,
15468602315,943.23696,16873251831,954952405,16873246769,-5062,,
15468652899,943.28755,16873302418,955002987,16873297352,-5066,,
15468703416,943.33806,16873352936,955053501,16873347866,-5070,,
15468754427,943.38908,16873403951,955104509,16873398874,-5077,,
15468804522,943.43917,16873454047,955154601,16873448965,-5082,,
15468855105,943.48975,16873504633,955205182,16873499547,-5086,,
15468905639,943.54029,16873555170,955255713,16873550078,-5092,,
15468956679,943.59133,16873606212,955306751,16873601115,-5097,,
15469007229,943.64188,16873656763,955357298,16873651662,-5101,,
15469057776,943.69242,16873707314,955407842,16873702207,-5107,,
15469107862,943.74251,16873757402,955457926,16873752291,-5111,,
15469158861,943.79351,16873808404,955508923,16873803287,-5117,,
15469209423,943.84407,16873858968,955559481,16873853845,-5123,,
15469260019,943.89467,16873909566,955610074,16873904439,-5127,,
15469311019,943.94567,16873960569,955661071,16873955436,-5133,,
15469361603,943.99625,16874011155,955711653,16874006018,-5137,,
15469412159,944.04681,16874061713,955762206,16874056571,-5142,,
15469462220,944.09687,16874111777,955812264,16874106629,-5148,,
15469513248,944.14790,16874162807,955863290,16874157655,-5152,,
15469563835,944.19848,16874213397,955913876,16874208240,-5157,,
15469614382,944.24903,16874263947,955964420,16874258784,-5163,,
15469665325,944.29997,16874314891,956015358,16874309723,-5168,,
15469716321,944.35097,16874365901,956066365,16874360729,-5172,,
15469766895,944.40154,16874416466,956116923,16874411288,-5178,,
15469817926,944.45257,16874467499,956167951,16874462316,-5183,,
15469868342,944.50299,16874517918,956218366,16874512730,-5188,,
15469918649,944.55330,16874568227,956268669,16874563034,-5193,,
15469969197,944.60384,16874618776,956319214,16874613578,-5198,,
15470020196,944.65484,16874669779,956370211,16874664575,-5204,,
15470070773,944.70542,16874720368,956420796,16874715161,-5207,,
15470120988,944.75564,16874770574,956470997,16874765362,-5212,,
15470171527,944.80618,16874821117,956521533,16874815897,-5220,,
15470222536,944.85718,16874872128,956572541,16874866905,-5223,,
15470273123,944.90777,16874922717,956623125,16874917489,-5228,,
15470323682,944.95833,16874973278,956673680,16874968045,-5233,,
15470374690,945.00934,16875024288,956724685,16875019049,-5239,,
15470425264,945.05991,16875074864,956775257,16875069622,-5242,,
15470475815,945.11046,16875125419,956825806,16875120171,-5248,,
15470526351,945.16100,16875175956,956876338,16875170703,-5253,,
15470576875,945.21152,16875226483,956926860,16875221225,-5258,,
15470627425,945.26207,16875277036,956977407,16875271772,-5264,,
15470678016,945.31266,16875327629,957027995,16875322360,-5269,,
15470729021,945.36367,16875378637,957078998,16875373362,-5275,,
15470779654,945.41430,16875429272,957129628,16875423993,-5279,,
15470830185,945.46483,16875479804,957180166,16875474531,-5273,,
15470880321,945.51497,16875529944,957230289,16875524654,-5290,,
15470930860,945.56551,16875580484,957280826,16875575190,-5294,,
15470981423,945.61607,16875631050,957331386,16875625751,-5299,,
15471031970,945.66662,16875681600,957381930,16875676295,-5305,,
15471082507,945.71716,16875732138,957432465,16875726829,-5309,,
15471133053,945.76770,16875782686,957483008,16875777372,-5314,,
15471183615,945.81826,16875833252,957533568,16875827932,-5320,,
15471234164,945.86881,16875883803,957584114,16875878478,-5325,,
15471285197,945.91985,16875934837,957635144,16875929508,-5329,,
15471335260,945.96991,16875984903,957685204,16875979568,-5335,,
15471385809,946.02046,16876035455,957735750,16876030114,-5341,,
15471436352,946.07100,16876086000,957786291,16876080656,-5344,,
15471487392,946.12204,16876137043,957837328,16876131693,-5350,,
15471537940,946.17259,16876187593,957887874,16876182238,-5355,,
15471588489,946.22314,16876238145,957938421,16876232785,-5360,,
15471639027,946.27368,16876288685,957988955,16876283320,-5365,,
15471689566,946.32421,16876339226,958039492,16876333856,-5370,,
15471739985,946.37463,16876389648,958089907,16876384271,-5377,,
15471790283,946.42493,16876439948,958140204,16876434568,-5380,,
15471840829,946.47548,16876490495,958190746,16876485110,-5385,,
15471891109,946.52576,16876540778,958241023,16876535388,-5390,,
15471941659,946.57631,16876591330,958291571,16876585935,-5395,,
15471992226,946.62687,16876641900,958342136,16876636500,-5400,,
15472042979,946.67763,16876692655,958392885,16876687249,-5406,,
15472093082,946.72773,16876742760,958442986,16876737350,-5410,,
15472143546,946.77819,16876793226,958493447,16876787811,-5415,,
15472193732,946.82838,16876843415,958543630,16876837994,-5421,,
15472244283,946.87893,16876893969,958594178,16876888543,-5426,,
15472294889,946.92954,16876944588,958644793,16876939158,-5430,,
15472345462,946.98011,16876995152,958695352,16876989716,-5436,,
15472396033,947.03068,16877045725,958745920,16877040284,-5441,,
15472446927,947.08158,16877096622,958796813,16877091177,-5445,,
15472497488,947.13214,16877147186,958847370,16877141735,-5451,,
15472547572,947.18222,16877197272,958897451,16877191816,-5456,,
15472598564,947.23321,16877248266,958948441,16877242805,-5461,,
15472649131,947.28378,16877298835,958999005,16877293370,-5465,,
15472700246,947.33489,16877349953,959050117,16877344482,-5471,,
15472750478,947.38513,16877400188,959100346,16877394711,-5477,,
15472800964,947.43561,16877450676,959150830,16877445195,-5481,,
15472851663,947.48631,16877501377,959201526,16877495891,-5486,,
15472902692,947.53734,16877552409,959252552,16877546917,-5492,,
15472953253,947.58790,16877602971,959303111,16877597475,-5496,,
15473004326,947.63897,16877654047,959354182,16877648546,-5501,,
15473054875,947.68952,16877704599,959404727,16877699091,-5508,,
15473105888,947.74054,16877755614,959455738,16877750102,-5512,,
15473156467,947.79111,16877806195,959506314,16877800679,-5516,,
15473206586,947.84123,16877856317,959556430,16877850795,-5522,,
15473257138,947.89179,16877906871,959606979,16877901344,-5527,,
15473308137,947.94278,16877957872,959657976,16877952341,-5531,,
15473358811,947.99346,16878008548,959708647,16878003011,-5537,,
15473409169,948.04382,16878058909,959759003,16878053367,-5542,,
15473459232,948.09388,16878108975,959809062,16878103427,-5548,,
15473509766,948.14441,16878159511,959859595,16878153959,-5552,,
15473560322,948.19497,16878210069,959910147,16878204512,-5557,,
15473610760,948.24541,16878260511,959960584,16878254948,-5563,,
15473661774,948.29642,16878311526,960011594,16878305959,-5567,,
15473712323,948.34697,16878362076,960062140,16878356504,-5572,,
15473762898,948.39755,16878412655,960112712,16878407077,-5578,,
15473813440,948.44809,16878463199,960163253,16878457617,-5582,,
15473863999,948.49865,16878513760,960213809,16878508173,-5587,,
15473914400,948.54905,16878564164,960264207,16878558571,-5593,,
15473964487,948.59914,16878614253,960314291,16878608655,-5598,,
15474014561,948.64921,16878664328,960364362,16878658726,-5602,,
15474065106,948.69975,16878714877,960414904,16878709269,-5608,,
15474115653,948.75030,16878765426,960465449,16878759813,-5613,,
15474166217,948.80087,16878815992,960516010,16878810374,-5618,,
15474216765,948.85141,16878866543,960566555,16878860920,-5623,,
15474267309,948.90196,16878917088,960617096,16878911460,-5628,,
15474317893,948.95254,16878967674,960667678,16878962042,-5632,,
15474368443,949.00309,16879018228,960718225,16879012590,-5638,,
15474418967,949.05362,16879068753,960768746,16879063110,-5643,,
15474469538,949.10419,16879119326,960819314,16879113678,-5648,,
15474520133,949.15478,16879169924,960869907,16879164272,-5652,,
15474570626,949.20527,16879220419,960920397,16879214762,-5657,,
15474621555,949.25620,16879271352,960971324,16879265688,-5664,,
15474672126,949.30677,16879321924,961021892,16879316256,-5668,,
15474723226,949.35787,16879373027,961072990,16879367354,-5673,,
15474773727,949.40837,16879423531,961123487,16879417852,-5679,,
15474824325,949.45897,16879474130,961174082,16879468446,-5684,,
15474875338,949.50999,16879525146,961225094,16879519458,-5688,,
15474925887,949.56053,16879575698,961275640,16879570004,-5694,,
15474976466,949.61111,16879626279,961326215,16879620580,-5699,,
15475027079,949.66173,16879676893,961376826,16879671191,-5702,,
15475077598,949.71225,16879727416,961427342,16879721707,-5709,,
15475128631,949.76328,16879778451,961478373,16879772737,-5714,,
15475179178,949.81383,16879829000,961528917,16879823281,-5719,,
15475230196,949.86484,16879880021,961579932,16879874297,-5724,,
15475280682,949.91533,16879930509,961630416,16879924780,-5729,,
15475331686,949.96633,16879981516,961681416,16879975781,-5735,,
15475382749,950.01740,16880032581,961732478,16880026842,-5739,,
15475433582,950.06823,16880083416,961783308,16880077672,-5744,,
15475484618,950.11927,16880134455,961834340,16880128705,-5750,,
15475535157,950.16980,16880184996,961884877,16880179241,-5755,,
15475585268,950.21992,16880235108,961934985,16880229349,-5759,,
15475635694,950.27034,16880285537,961985408,16880279772,-5765,,
15475686235,950.32088,16880336081,962035947,16880330311,-5770,,
15475736810,950.37146,16880386668,962086530,16880380894,-5774,,
15475787377,950.42202,16880437228,962137084,16880431448,-5780,,
15475838376,950.47302,16880488229,962188080,16880482444,-5785,,
15475888930,950.52358,16880538785,962238631,16880532995,-5790,,
15475939519,950.57417,16880589377,962289217,16880583582,-5795,,
15475989817,950.62446,16880639677,962339513,16880633877,-5800,,
15476040816,950.67546,16880690679,962390508,16880684873,-5806,,
15476091380,950.72603,16880741244,962441070,16880735434,-5810,,
15476141928,950.77658,16880791794,962491615,16880785979,-5815,,
15476192461,950.82711,16880842331,962542146,16880836510,-5821,,
15476243514,950.87816,16880893386,962593196,16880887561,-5825,,
15476294073,950.92872,16880943947,962643752,16880938117,-5830,,
15476344603,950.97925,16880994479,962694279,16880988643,-5836,,
15476395154,951.02980,16881045033,962744828,16881039192,-5841,,
15476445704,951.08035,16881095585,962795375,16881089740,-5845,,
15476496266,951.13091,16881146150,962845934,16881140299,-5851,,
15476547300,951.18195,16881197186,962896965,16881191330,-5856,,
15476597883,951.23253,16881247771,962947546,16881241911,-5860,,
15476648502,951.28315,16881298393,962998162,16881292527,-5866,,
15476699513,951.33416,16881349406,963049170,16881343535,-5871,,
15476750556,951.38520,16881400452,963100210,16881394574,-5878,,
15476800669,951.43532,16881450578,963150333,16881444698,-5880,,
15476851474,951.48612,16881501373,963201123,16881495487,-5886,,
15476902105,951.53675,16881552007,963251751,16881546115,-5892,,
15476952954,951.58760,16881602858,963302598,16881596962,-5896,,
15477003475,951.63812,16881653382,963353116,16881647481,-5901,,
15477054026,951.68867,16881703936,963403665,16881698029,-5907,,
15477105058,951.73971,16881754970,963454693,16881749058,-5912,,
15477155688,951.79034,16881805602,963505322,16881799686,-5916,,
15477206304,951.84095,16881856221,963555935,16881850300,-5921,,
15477257272,951.89192,16881907191,963606899,16881901264,-5927,,
15477307849,951.94250,16881957781,963657487,16881951851,-5930,,
15477358434,951.99308,16882008358,963708057,16882002422,-5936,,
15477409378,952.04403,16882059304,963758997,16882053362,-5942,,
15477460435,952.09508,16882110363,963810051,16882104415,-5948,,
15477510987,952.14563,16882160918,963860601,16882154966,-5952,,
15477561516,952.19616,16882211449,963911128,16882205492,-5957,,
15477611644,952.24629,16882261580,963961253,16882255617,-5963,,
15477662214,952.29686,16882312163,964011831,16882306196,-5967,,
15477712778,952.34743,16882362718,964062382,16882356747,-5971,,
15477763365,952.39801,16882413308,964112965,16882407330,-5978,,
15477813933,952.44858,16882463878,964163530,16882457895,-5983,,
15477864522,952.49917,16882514469,964214118,16882508482,-5987,,
15477915110,952.54976,16882565059,964264702,16882559067,-5992,,
15477966111,952.60076,16882616062,964315700,16882610064,-5998,,
15478016684,952.65133,16882666637,964366271,16882660636,-6001,,
15478067631,952.70228,16882717588,964417215,16882711579,-6009,,
15478118166,952.75281,16882768124,964467747,16882762111,-6013,,
15478168713,952.80336,16882818675,964518292,16882812657,-6018,,
15478219276,952.85392,16882869240,964568852,16882863217,-6023,,
15478269824,952.90447,16882919790,964619397,16882913762,-6028,,
15478320866,952.95551,16882970834,964670436,16882964800,-6034,,
15478371421,953.00607,16883021393,964720991,16883015355,-6038,,
15478421942,953.05659,16883071914,964771507,16883065871,-6043,,
15478472476,953.10712,16883122452,964822038,16883116403,-6049,,
15478522554,953.15720,16883172532,964872115,16883166479,-6053,,
15478573063,953.20771,16883223043,964922621,16883216985,-6058,,
15478623691,953.25834,16883273674,964973245,16883267610,-6064,,
15478674471,953.30912,16883324456,965024022,16883318387,-6069,,
15478725098,953.35975,16883375084,965074647,16883369011,-6073,,
15478775978,953.41063,16883425967,965125524,16883419888,-6079,,
15478826522,953.46117,16883476514,965176065,16883470430,-6084,,
15478877021,953.51167,16883527015,965226563,16883520927,-6088,,
15478927089,953.56174,16883577085,965276627,16883570991,-6094,,
15478977660,953.61231,16883627659,965327195,16883621560,-6099,,
15479028673,953.66332,16883678674,965378207,16883672571,-6103,,
15479079725,953.71437,16883729728,965429255,16883723619,-6109,,
15479130785,953.76543,16883780800,965480322,16883774686,-6114,,
15479181808,953.81646,16883831816,965531332,16883825696,-6120,,
15479232904,953.86755,16883882914,965582426,16883876790,-6124,,
15479283421,953.91807,16883933434,965632940,16883927305,-6129,,
15479334461,953.96911,16883984477,965683978,16883978342,-6135,,
15479385510,954.02016,16884035528,965735024,16884029388,-6140,,
15479436072,954.07072,16884086092,965785584,16884079949,-6143,,
15479486598,954.12125,16884136621,965836107,16884130471,-6150,,
15479536646,954.17129,16884186670,965886151,16884180515,-6155,,
15479587182,954.22183,16884237209,965936685,16884231049,-6160,,
15479637758,954.27241,16884287788,965987259,16884281623,-6165,,
15479688517,954.32317,16884338548,966038014,16884332383,-6165,,
15479739138,954.37379,16884389172,966088632,16884382997,-6175,,
15479789271,954.42392,16884439308,966138763,16884433128,-6180,,
15479839983,954.47463,16884490032,966189483,16884483847,-6185,,
15479890281,954.52493,16884540323,966239767,16884534132,-6191,,
15479940840,954.57549,16884590883,966290324,16884584688,-6195,,
15479991443,954.62609,16884641489,966340925,16884635290,-6199,,
15480041739,954.67639,16884691788,966391217,16884685582,-6206,,
15480092314,954.72696,16884742364,966441790,16884736154,-6210,,
15480142863,954.77751,16884792915,966492336,16884786700,-6215,,
15480193129,954.82778,16884843185,966542599,16884836964,-6221,,
15480243827,954.87847,16884893885,966593295,16884887659,-6226,,
15480294874,954.92952,16884944934,966644340,16884938704,-6230,,
15480345425,954.98007,16884995488,966694888,16884989252,-6236,,
15480395972,955.03062,16885046037,966745431,16885039796,-6241,,
15480446522,955.08117,16885096589,966795979,16885090344,-6245,,
15480497069,955.13172,16885147139,966846523,16885140887,-6252,,
15480547616,955.18226,16885197688,966897067,16885191432,-6256,,
15480598665,955.23331,16885248738,966948114,16885242478,-6260,,
15480648715,955.28336,16885298792,966998162,16885292526,-6266,,
15480699264,955.33391,16885349342,967048707,16885343071,-6271,,
15480750320,955.38497,16885400402,967099760,16885394125,-6277,,
15480801321,955.43597,16885451404,967150759,16885445123,-6281,,
15480851364,955.48601,16885501450,967200799,16885495164,-6286,,
15480901430,955.53608,16885551519,967250862,16885545227,-6292,,
15480952096,955.58674,16885602186,967301526,16885595890,-6296,,
15481002668,955.63732,16885652761,967352095,16885646460,-6301,,
15481053707,955.68836,16885703803,967403131,16885697496,-6307,,
15481104449,955.73910,16885754547,967453870,16885748235,-6312,,
15481155027,955.78967,16885805137,967504457,16885798822,-6315,,
15481206100,955.84075,16885856203,967555516,16885849881,-6322,,
15481256714,955.89136,16885906819,967606128,16885900492,-6327,,
15481306864,955.94151,16885956970,967656275,16885950639,-6331,,
15481357428,955.99208,16886007537,967706836,16886001200,-6337,,
15481408020,956.04267,16886058132,967757426,16886051790,-6342,,
15481458621,956.09327,16886108735,967808024,16886102389,-6346,,
15481509122,956.14377,16886159239,967858523,16886152887,-6352,,
15481560159,956.19481,16886210278,967909556,16886203920,-6358,,
15481610731,956.24538,16886260864,967960137,16886254501,-6363,,
15481661789,956.29644,16886311912,968011181,16886305545,-6367,,
15481712808,956.34746,16886362934,968062197,16886356562,-6372,,
15481763861,956.39851,16886413990,968113247,16886407612,-6378,,
15481813993,956.44864,16886464123,968163376,16886457740,-6383,,
15481864535,956.49918,16886514678,968213927,16886508292,-6386,,
15481915572,956.55022,16886565708,968264950,16886559315,-6393,,
15481965937,956.60059,16886616074,968315312,16886609676,-6398,,
15482016050,956.65070,16886666189,968365423,16886659787,-6402,,
15482067054,956.70170,16886717197,968416425,16886710789,-6408,,
15482117590,956.75224,16886767735,968466958,16886761322,-6413,,
15482168180,956.80283,16886818326,968517545,16886811909,-6417,,
15482218727,956.85338,16886868876,968568089,16886862453,-6423,,
15482269231,956.90388,16886919382,968618590,16886912954,-6428,,
15482320325,956.95497,16886970480,968669681,16886964045,-6435,,
15482370873,957.00552,16887021030,968720228,16887014592,-6438,,
15482421877,957.05652,16887072036,968771229,16887065593,-6443,,
15482472427,957.10708,16887122589,968821775,16887116140,-6449,,
15482522979,957.15763,16887173143,968872325,16887166690,-6453,,
15482573542,957.20819,16887223708,968922886,16887217250,-6458,,
15482624573,957.25922,16887274742,968973914,16887268278,-6464,,
15482675169,957.30982,16887325341,969024508,16887318872,-6469,,
15482725732,957.36038,16887375905,969075068,16887369433,-6472,,
15482776741,957.41139,16887426917,969126073,16887420438,-6479,,
15482827298,957.46195,16887477476,969176628,16887470992,-6484,,
15482877406,957.51205,16887527586,969226733,16887521097,-6489,,
15482927733,957.56238,16887577916,969277058,16887571422,-6494,,
15482978738,957.61339,16887628923,969328060,16887622424,-6499,,
15483028824,957.66347,16887679022,969378154,16887672518,-6504,,
15483079298,957.71395,16887729488,969428614,16887722979,-6509,,
15483129800,957.76445,16887779992,969479113,16887773478,-6514,,
15483180355,957.81500,16887830550,969529665,16887824030,-6520,,
15483230907,957.86555,16887881104,969580216,16887874580,-6524,,
15483281469,957.91612,16887931668,969630775,16887925139,-6529,,
15483332481,957.96713,16887982682,969681783,16887976147,-6535,,
15483383054,958.01770,16888033258,969732355,16888026719,-6539,,
15483433613,958.06826,16888083819,969782911,16888077275,-6544,,
15483484156,958.11880,16888134366,969833452,16888127816,-6550,,
15483534686,958.16933,16888184897,969883978,16888178342,-6555,,
15483585237,958.21988,16888235450,969934526,16888228891,-6559,,
15483636306,958.27095,16888286521,969985592,16888279956,-6565,,
15483686854,958.32150,16888337072,970036137,16888330502,-6570,,
15483737433,958.37208,16888387652,970086714,16888381079,-6573,,
15483787567,958.42222,16888437790,970136845,16888431210,-6580,,
15483838098,958.47275,16888488323,970187374,16888481738,-6585,,
15483888852,958.52350,16888539078,970238124,16888532488,-6590,,
15483939894,958.57454,16888590124,970289164,16888583528,-6596,,
15483990818,958.62547,16888641050,970340085,16888634450,-6600,,
15484040926,958.67557,16888691161,970390191,16888684555,-6606,,
15484091545,958.72619,16888741782,970440807,16888735172,-6610,,
15484142146,958.77679,16888792385,970491406,16888785770,-6615,,
15484192519,958.82717,16888842761,970541775,16888836140,-6621,,
15484243347,958.87800,16888893591,970592601,16888886966,-6625,,
15484294397,958.92904,16888944643,970643648,16888938013,-6630,,
15484345042,958.97969,16888995291,970694291,16888988655,-6636,,
15484396046,959.03069,16889046296,970745291,16889039655,-6641,,
15484446622,959.08127,16889096886,970795877,16889090242,-6644,,
15484497184,959.13183,16889147439,970846424,16889140788,-6651,,
15484548224,959.18287,16889198482,970897461,16889191826,-6656,,
15484598772,959.23342,16889249032,970948007,16889242372,-6660,,
15484649372,959.28402,16889299635,970998605,16889292969,-6666,,
15484699886,959.33453,16889350150,971049115,16889343479,-6671,,
15484750443,959.38509,16889400711,971099669,16889394033,-6678,,
15484801498,959.43615,16889451768,971150722,16889445087,-6681,,
15484852132,959.48678,16889502404,971201353,16889495718,-6686,,
15484902627,959.53728,16889552913,971251856,16889546221,-6692,,
15484953176,959.58782,16889603452,971302392,16889596756,-6696,,
15485003652,959.63830,16889653931,971352865,16889647230,-6701,,
15485054560,959.68921,16889704842,971403770,16889698135,-6707,,
15485105602,959.74025,16889755886,971454809,16889749174,-6712,,
15485156572,959.79122,16889806858,971505778,16889800142,-6716,,
15485206755,959.84140,16889857043,971555957,16889850321,-6722,,
15485257255,959.89190,16889907545,971606454,16889900818,-6727,,
15485307798,959.94245,16889958090,971656995,16889951359,-6731,,
15485358371,959.99302,16890008667,971707565,16890001930,-6737,,
15485408947,960.04359,16890059245,971758139,16890052503,-6742,,
15485459457,960.09411,16890109758,971808645,16890103009,-6749,,
15485509991,960.14464,16890160294,971859177,16890153542,-6752,,
15485560546,960.19519,16890210851,971909730,16890204094,-6757,,
15485610605,960.24525,16890260913,971959785,16890254149,-6764,,
15485661159,960.29581,16890311469,972010338,16890304702,-6767,,
15485711698,960.34635,16890362010,972060873,16890355238,-6772,,
15485762651,960.39730,16890412965,972111823,16890406187,-6778,,
15485813041,960.44769,16890463358,972162212,16890456576,-6782,,
15485863606,960.49825,16890513924,972212772,16890507137,-6787,,
15485914190,960.54884,16890564512,972263354,16890557719,-6793,,
15485965268,960.59992,16890615592,972314429,16890608793,-6799,,
15486015805,960.65045,16890666131,972364964,16890659329,-6802,,
15486066653,960.70130,16890716982,972415810,16890710174,-6808,,
15486117373,960.75202,16890767704,972466526,16890760891,-6813,,
15486168268,960.80292,16890818600,972517419,16890811783,-6817,,
15486218996,960.85364,16890869332,972568144,16890862509,-6823,,
15486269119,960.90377,16890919457,972618264,16890912629,-6828,,
15486319692,960.95434,16890970043,972668845,16890963209,-6834,,
15486370720,961.00537,16891021063,972719861,16891014225,-6838,,
15486421291,961.05594,16891071647,972770440,16891064804,-6843,,
15486472120,961.10677,16891122479,972821266,16891115630,-6849,,
15486523176,961.15782,16891173526,972872308,16891166673,-6853,,
15486573753,961.20840,16891224105,972922882,16891217247,-6858,,
15486624313,961.25896,16891274667,972973439,16891267804,-6863,,
15486675066,961.30971,16891325423,973024189,16891318553,-6870,,
15486725606,961.36025,16891375965,973074727,16891369092,-6873,,
15486775734,961.41038,16891426096,973124853,16891419218,-6878,,
15486826021,961.46067,16891476385,973175136,16891469500,-6885,,
15486876274,961.51092,16891526639,973225387,16891519751,-6888,,
15486927295,961.56194,16891577664,973276405,16891570770,-6894,,
15486977875,961.61252,16891628246,973326982,16891621347,-6899,,
15487028374,961.66302,16891678746,973377479,16891671843,-6903,,
15487079389,961.71404,16891729765,973428492,16891722856,-6909,,
15487129458,961.76411,16891779836,973478557,16891772922,-6914,,
15487180037,961.81469,16891830417,973529133,16891823497,-6920,,
15487230396,961.86504,16891880779,973579490,16891873854,-6925,,
15487281187,961.91584,16891931572,973630278,16891924643,-6929,,
15487331711,961.96636,16891982099,973680800,16891975164,-6935,,
15487382776,962.01742,16892033166,973731862,16892026227,-6939,,
15487433327,962.06798,16892083719,973782410,16892076774,-6945,,
15487483782,962.11843,16892134176,973832862,16892127226,-6950,,
15487533842,962.16849,16892184239,973882919,16892177284,-6955,,
15487584399,962.21905,16892234798,973933475,16892227839,-6959,,
15487635435,962.27008,16892285836,973984507,16892278872,-6964,,
15487686049,962.32070,16892336452,974035118,16892329482,-6970,,
15487736572,962.37122,16892386978,974085639,16892380004,-6974,,
15487787072,962.42172,16892437480,974136136,16892430500,-6980,,
15487837620,962.47227,16892488031,974186681,16892481046,-6985,,
15487888194,962.52284,16892538617,974237264,16892531628,-6989,,
15487938765,962.57341,16892589180,974287821,16892582186,-6994,,
15487989265,962.62391,16892639683,974338319,16892632683,-7000,,
15488039814,962.67446,16892690235,974388864,16892683229,-7006,,
15488090410,962.72506,16892740833,974439459,16892733823,-7010,,
15488140951,962.77560,16892791386,974490007,16892784371,-7015,,
15488191983,962.82663,16892842411,974541025,16892835390,-7021,,
15488242537,962.87719,16892892966,974591577,16892885941,-7025,,
15488293116,962.92776,16892943548,974642153,16892936518,-7030,,
15488343620,962.97827,16892994055,974692654,16892987018,-7037,,
15488394668,963.02932,16893045105,974743699,16893038064,-7041,,
15488444741,963.07939,16893095190,974793781,16893088145,-7045,,
15488495310,963.12996,16893145751,974844336,16893138700,-7051,,
15488546313,963.18096,16893196757,974895337,16893189701,-7056,,
15488596372,963.23102,16893246818,974945394,16893239758,-7060,,
15488646955,963.28160,16893297404,974995973,16893290338,-7066,,
15488697374,963.33202,16893347836,975046401,16893340765,-7071,,
15488748422,963.38307,16893398874,975097434,16893391798,-7076,,
15488799030,963.43368,16893449485,975148040,16893442405,-7080,,
15488849611,963.48426,16893500068,975198618,16893492983,-7085,,
15488900673,963.53532,16893551134,975249677,16893544042,-7092,,
15488951260,963.58591,16893601723,975300262,16893594627,-7096,,
15489001350,963.63600,16893651814,975350349,16893644713,-7101,,
15489052396,963.68704,16893702864,975401393,16893695757,-7107,,
15489102945,963.73759,16893753414,975451939,16893746303,-7111,,
15489153507,963.78815,16893803979,975502499,16893796863,-7116,,
15489204055,963.83870,16893854530,975553044,16893847408,-7122,,
15489255090,963.88974,16893905567,975604075,16893898440,-7127,,
15489305639,963.94029,16893956118,975654622,16893948987,-7131,,
15489542298,964.17695,16894192787,975891268,16894185632,-7155,16894190713,
15489567391,964.20204,16894217882,975916360,16894210750,-7132,,
15489617450,964.25210,16894267943,975966416,16894260856,-7087,,
15489668485,964.30313,16894318980,976017448,16894311940,-7040,,
15489719563,964.35421,16894370062,976068524,16894363069,-6993,,
15489770315,964.40496,16894420815,976119273,16894413869,-6946,,
15489820553,964.45520,16894471056,976169508,16894464156,-6900,,
15489871099,964.50575,16894521615,976220062,16894514760,-6855,,
15489922122,964.55677,16894572630,976271072,16894565823,-6807,,
15489972658,964.60731,16894623168,976321605,16894616408,-6760,,
15490022764,964.65741,16894673277,976371708,16894666561,-6716,,
15490073514,964.70816,16894724040,976422468,16894717372,-6668,,
15490124490,964.75914,16894775007,976473429,16894768386,-6621,,
15490175517,964.81016,16894826037,976524453,16894819462,-6575,,
15490226127,964.86077,16894876649,976575060,16894870120,-6529,,
15490277157,964.91180,16894927681,976626088,16894921199,-6482,,
15490327758,964.96241,16894978285,976676686,16894971850,-6435,,
15490378585,965.01323,16895029114,976727511,16895022725,-6389,,
15490429550,965.06420,16895080082,976778473,16895073740,-6342,,
15490480152,965.11480,16895130686,976829072,16895124390,-6296,,
15490531165,965.16581,16895181701,976880083,16895175452,-6249,,
15490581742,965.21639,16895232281,976930656,16895226078,-6203,,
15490632806,965.26745,16895283346,976981718,16895277191,-6155,,
15490683371,965.31802,16895333914,977032281,16895327805,-6109,,
15490733926,965.36857,16895384484,977082844,16895378419,-6065,,
15490784283,965.41893,16895434831,977133187,16895428815,-6016,,
15490835026,965.46967,16895485576,977183927,16895479606,-5970,,
15490885104,965.51975,16895535667,977234012,16895529742,-5925,,
15490935635,965.57028,16895586189,977284530,16895580310,-5879,,
15490986173,965.62082,16895636730,977335066,16895630899,-5831,,
15491036625,965.67127,16895687185,977385515,16895681398,-5787,,
15491087203,965.72185,16895737764,977436090,16895732025,-5739,,
15491137776,965.77242,16895788341,977486661,16895782648,-5693,,
15491188800,965.82345,16895839367,977537682,16895833720,-5647,,
15491239374,965.87402,16895889943,977588254,16895884343,-5600,,
15491289931,965.92458,16895940502,977638808,16895934949,-5553,,
15491340084,965.97473,16895990658,977688959,16895985151,-5507,,
15491390608,966.02526,16896041183,977739479,16896035722,-5461,,
15491441203,966.07585,16896091782,977790071,16896086366,-5416,,
15491491751,966.12640,16896142332,977840618,16896136964,-5368,,
15491542503,966.17715,16896193086,977891367,16896187764,-5322,,
15491593040,966.22769,16896243625,977941900,16896238349,-5276,,
15491643111,966.27776,16896293699,977991969,16896288470,-5229,,
15491693695,966.32834,16896344284,978042550,16896339101,-5183,,
15491744633,966.37928,16896395226,978093485,16896390089,-5137,,
15491795532,966.43018,16896446127,978144381,16896441036,-5091,,
15491846146,966.48079,16896496744,978194993,16896491700,-5044,,
15491897082,966.53173,16896547681,978245926,16896542684,-4997,,
15491947762,966.58241,16896598363,978296603,16896593412,-4951,,
15491998802,966.63345,16896649417,978347652,16896644513,-4904,,
15492049383,966.68403,16896699990,978398220,16896695133,-4857,,
15492100413,966.73506,16896751022,978449247,16896746212,-4810,,
15492150892,966.78554,16896801504,978499722,16896796739,-4765,,
15492201406,966.83605,16896852019,978550234,16896847301,-4718,,
15492251953,966.88660,16896902569,978600778,16896897897,-4672,,
15492302507,966.93715,16896953126,978651330,16896948500,-4626,,
15492353085,966.98773,16897003706,978701906,16896999127,-4579,,
15492403598,967.03825,16897054221,978752416,16897049689,-4532,,
15492454638,967.08929,16897105263,978803452,16897100777,-4486,,
15492505200,967.13985,16897155827,978854012,16897151388,-4439,,
15492555759,967.19041,16897206399,978904578,16897202006,-4393,,
15492606795,967.24144,16897257427,978955601,16897253080,-4347,,
15492657331,967.29198,16897307966,979006135,16897303666,-4300,,
15492707418,967.34207,16897358056,979056219,16897353802,-4254,,
15492757955,967.39260,16897408605,979106764,16897404397,-4208,,
15492808986,967.44363,16897459628,979157782,16897455467,-4161,,
15492859582,967.49423,16897510227,979208376,16897506112,-4115,,
15492910119,967.54477,16897560766,979258909,16897556698,-4068,,
15492961132,967.59578,16897611781,979309919,16897607759,-4022,,
15493011433,967.64608,16897662096,979360229,16897658120,-3976,,
15493062019,967.69667,16897712673,979410802,16897708744,-3929,,
15493112540,967.74719,16897763196,979461319,16897759313,-3883,,
15493163094,967.79774,16897813753,979511870,16897809916,-3837,,
15493213680,967.84833,16897864341,979562454,16897860551,-3790,,
15493264235,967.89888,16897914898,979613007,16897911155,-3743,,
15493315239,967.94989,16897965905,979664007,16897962207,-3698,,
15493366336,968.00098,16898017004,979715102,16898013353,-3651,,
15493416862,968.05151,16898067543,979765635,16898063939,-3604,,
15493467886,968.10253,16898118559,979816646,16898115001,-3558,,
15493518435,968.15308,16898169110,979867193,16898165599,-3511,,
15493568991,968.20364,16898219669,979917746,16898216204,-3465,,
15493619531,968.25418,16898270210,979968283,16898266792,-3418,,
15493670078,968.30473,16898320760,980018827,16898317388,-3372,,
15493720139,968.35479,16898370823,980068886,16898367497,-3326,,
15493770633,968.40528,16898421320,980119378,16898418041,-3279,,
15493821490,968.45614,16898472179,980170232,16898468946,-3233,,
15493871607,968.50626,16898522299,980220345,16898519111,-3188,,
15493922659,968.55731,16898573353,980271395,16898570213,-3140,,
15493972934,968.60758,16898623630,980321668,16898620536,-3094,,
15494023467,968.65811,16898674166,980372198,16898671117,-3049,,
15494074019,968.70867,16898724720,980422747,16898721719,-3001,,
15494124224,968.75887,16898774927,980472949,16898771972,-2955,,
15494174738,968.80939,16898825443,980523460,16898822534,-2909,,
15494225776,968.86042,16898876484,980574495,16898873620,-2864,,
15494276340,968.91099,16898927050,980625057,16898924233,-2817,,
15494326918,968.96157,16898977630,980675632,16898974860,-2770,,
15494377951,969.01260,16899028666,980726662,16899025942,-2724,,
15494428496,969.06314,16899079214,980777206,16899076537,-2677,,
15494479034,969.11368,16899129754,980827740,16899127122,-2632,,
15494529557,969.16421,16899180279,980878261,16899177695,-2584,,
15494580618,969.21527,16899231343,980929318,16899228766,-2577,,
15494631227,969.26588,16899281953,980979925,16899279372,-2581,,
15494681742,969.31639,16899332482,981030448,16899329896,-2586,,
15494732765,969.36741,16899383497,981081457,16899380905,-2592,,
15494783083,969.41773,16899433817,981131774,16899431221,-2596,,
15494833865,969.46851,16899484601,981182553,16899482000,-2601,,
15494884405,969.51905,16899535155,981233101,16899532548,-2607,,
15494934941,969.56959,16899585682,981283623,16899583071,-2611,,
15494985524,969.62017,16899636266,981334203,16899633650,-2616,,
15495036002,969.67065,16899686748,981384679,16899684126,-2622,,
15495086541,969.72119,16899737289,981435215,16899734662,-2627,,
15495137091,969.77174,16899787841,981485762,16899785209,-2632,,
15495187665,969.82231,16899838428,981536343,16899835791,-2637,,
15495238232,969.87288,16899888987,981586897,16899886345,-2642,,
15495289236,969.92388,16899939994,981637900,16899937347,-2647,,
15495340318,969.97497,16899991078,981688979,16899988426,-2652,,
15495391285,970.02593,16900042047,981739952,16900039400,-2647,,
15495442125,970.07677,16900092889,981790779,16900090226,-2663,,
15495492637,970.12729,16900143403,981841289,16900140736,-2667,,
15495543254,970.17790,16900194023,981891904,16900191351,-2672,,
15495593314,970.22796,16900244086,981941960,16900241408,-2678,,
15495643866,970.27851,16900294640,981992510,16900291958,-2682,,
15495694902,970.32955,16900345678,982043543,16900342991,-2687,,
15495745486,970.38013,16900396265,982094124,16900393572,-2693,,
15495796042,970.43069,16900446823,982144677,16900444125,-2698,,
15495847059,970.48171,16900497843,982195692,16900495140,-2703,,
15495897604,970.53225,16900548390,982246234,16900545682,-2708,,
15495948077,970.58272,16900598875,982296714,16900596162,-2713,,
15495998719,970.63337,16900649509,982347344,16900646791,-2718,,
15496048807,970.68345,16900699600,982397430,16900696877,-2723,,
15496099413,970.73406,16900750208,982448033,16900747480,-2728,,
15496149913,970.78456,16900800711,982498530,16900797978,-2733,,
15496200987,970.83564,16900851805,982549625,16900849072,-2733,,
15496251558,970.88621,16900902360,982600169,16900899617,-2743,,
15496302134,970.93678,16900952939,982650742,16900950190,-2749,,
15496352728,970.98738,16901003534,982701334,16901000781,-2753,,
15496403317,971.03796,16901054137,982751932,16901051379,-2758,,
15496453850,971.08850,16901104671,982802460,16901101908,-2763,,
15496504451,971.13910,16901155265,982853049,16901152497,-2768,,
15496555005,971.18965,16901205821,982903600,16901203048,-2773,,
15496605851,971.24050,16901256670,982954443,16901253891,-2779,,
15496656385,971.29103,16901307217,983004985,16901304433,-2784,,
15496707435,971.34208,16901358259,983056023,16901355470,-2789,,
15496757999,971.39265,16901408825,983106584,16901406031,-2794,,
15496808279,971.44293,16901459116,983156870,16901456317,-2799,,
15496858847,971.49350,16901509677,983207426,16901506873,-2804,,
15496909858,971.54451,16901560691,983258434,16901557882,-2809,,
15496959922,971.59457,16901610756,983308495,16901607942,-2814,,
15497010942,971.64559,16901661780,983359513,16901658960,-2820,,
15497061494,971.69614,16901712334,983410062,16901709510,-2824,,
15497112043,971.74669,16901762884,983460608,16901760055,-2829,,
15497162150,971.79680,16901812995,983510712,16901810160,-2835,,
15497212680,971.84733,16901863527,983561240,16901860687,-2840,,
15497263258,971.89791,16901914107,983611816,16901911263,-2844,,
15497313807,971.94845,16901964658,983662361,16901961808,-2850,,
15497363924,971.99857,16902014778,983712477,16902011924,-2854,,
15497414470,972.04912,16902065336,983763029,16902062477,-2859,,
15497465507,972.10015,16902116366,983814053,16902113500,-2866,,
15497516113,972.15076,16902166974,983864656,16902164103,-2871,,
15497566680,972.20133,16902217544,983915222,16902214669,-2875,,
15497617603,972.25225,16902268469,983966141,16902265589,-2880,,
15497668652,972.30330,16902319520,984017188,16902316635,-2885,,
15497719212,972.35386,16902370083,984067746,16902367193,-2890,,
15497769780,972.40443,16902420652,984118310,16902417757,-2895,,
15497820687,972.45533,16902471561,984169214,16902468661,-2900,,
15497871171,972.50582,16902522060,984219707,16902519154,-2906,,
15497921665,972.55631,16902572545,984270187,16902569635,-2910,,
15497972567,972.60721,16902623449,984321086,16902620533,-2916,,
15498023488,972.65814,16902674373,984372005,16902671452,-2921,,
15498073586,972.70823,16902724473,984422101,16902721548,-2925,,
15498124123,972.75877,16902775011,984472634,16902772082,-2929,,
15498175109,972.80976,16902826000,984523617,16902823064,-2936,,
15498225705,972.86035,16902876598,984574210,16902873657,-2941,,
15498276241,972.91089,16902927138,984624744,16902924192,-2946,,
15498327244,972.96189,16902978143,984675745,16902975192,-2951,,
15498377792,973.01244,16903028693,984726289,16903025737,-2956,,
15498427863,973.06251,16903078778,984776370,16903075818,-2960,,
15498478441,973.11309,16903129347,984826933,16903126381,-2966,,
15498529462,973.16411,16903180370,984877951,16903177399,-2971,,
15498580104,973.21475,16903231015,984928592,16903228039,-2976,,
15498630411,973.26506,16903281324,984978896,16903278343,-2981,,
15498681050,973.31570,16903331965,985029531,16903328978,-2987,,
15498731915,973.36656,16903382833,985080393,16903379840,-2993,,
15498782511,973.41716,16903433431,985130987,16903430435,-2996,,
15498833055,973.46770,16903483977,985181529,16903480976,-3001,,
15498883601,973.51825,16903534526,985232071,16903531519,-3007,,
15498933699,973.56835,16903584636,985282177,16903581625,-3011,,
15498984248,973.61890,16903635177,985332714,16903632161,-3016,,
15499034782,973.66943,16903685713,985383244,16903682691,-3022,,
15499085777,973.72042,16903736711,985434236,16903733684,-3027,,
15499135891,973.77054,16903786827,985484348,16903783795,-3032,,
15499186426,973.82107,16903837364,985534880,16903834327,-3037,,
15499237261,973.87191,16903888202,985585712,16903885160,-3042,,
15499287809,973.92246,16903938753,985636258,16903935706,-3047,,
15499338404,973.97305,16903989349,985686850,16903986297,-3052,,
15499388950,974.02360,16904039898,985737393,16904036841,-3057,,
15499439954,974.07460,16904090905,985788394,16904087842,-3063,,
15499490566,974.12521,16904141519,985839004,16904138451,-3068,,
15499541111,974.17576,16904192065,985889546,16904188993,-3072,,
15499592116,974.22676,16904243073,985940548,16904239995,-3078,,
15499642692,974.27734,16904293652,985991122,16904290569,-3083,,
15499693224,974.32787,16904344186,986041652,16904341099,-3087,,
15499743773,974.37842,16904394738,986092197,16904391645,-3093,,
15499794809,974.42946,16904445776,986143232,16904442679,-3097,,
15499845407,974.48005,16904496376,986193826,16904493274,-3102,,
15499895952,974.53060,16904546924,986244368,16904543816,-3108,,
15499946476,974.58112,16904597450,986294889,16904594337,-3113,,
15499997463,974.63211,16904648440,986345875,16904645322,-3118,,
15500047571,974.68222,16904698549,986395979,16904695426,-3123,,
15500097655,974.73230,16904748635,986446060,16904745507,-3128,,
15500148404,974.78305,16904799387,986496807,16904796254,-3133,,
15500199209,974.83386,16904850195,986547609,16904847057,-3138,,
15500249393,974.88404,16904900381,986597790,16904897238,-3143,,
15500300395,974.93504,16904951385,986648789,16904948236,-3149,,
15500350950,974.98560,16905001943,986699342,16904998790,-3153,,
15500401501,975.03615,16905052496,986749890,16905049338,-3158,,
15500452033,975.08668,16905103031,986800419,16905099866,-3165,,
15500502614,975.13726,16905153614,986850998,16905150445,-3169,,
15500553167,975.18782,16905204169,986901549,16905200996,-3173,,
15500603707,975.23835,16905254712,986952086,16905251533,-3179,,
15500654761,975.28941,16905305768,987003137,16905302585,-3183,,
15500705804,975.34045,16905356813,987054177,16905353624,-3189,,
15500756369,975.39102,16905407381,987104739,16905404187,-3194,,
15500806960,975.44161,16905457985,987155339,16905454786,-3199,,
15500857910,975.49256,16905508927,987206275,16905505722,-3205,,
15500908463,975.54311,16905559482,987256825,16905556272,-3210,,
15500959468,975.59412,16905610489,987307827,16905607275,-3214,,
15501010492,975.64514,16905661516,987358848,16905658296,-3220,,
15501061578,975.69623,16905712604,987409932,16905709379,-3225,,
15501111961,975.74661,16905762989,987460312,16905759760,-3229,,
15501162153,975.79680,16905813184,987510501,16905809949,-3235,,
15501212701,975.84735,16905863734,987561047,16905860495,-3239,,
15501263211,975.89786,16905914245,987611554,16905911002,-3243,,
15501314176,975.94882,16905965214,987662516,16905961964,-3250,,
15501365180,975.99983,16906016220,987713517,16906012965,-3255,,
15501415755,976.05040,16906066796,987764100,16906063547,-3249,,
15501466325,976.10097,16906117369,987814657,16906114104,-3265,,
15501516828,976.15148,16906167874,987865157,16906164604,-3270,,
15501567861,976.20251,16906218911,987916188,16906215636,-3275,,
15501618393,976.25304,16906269445,987966718,16906266165,-3280,,
15501668917,976.30357,16906319970,988017238,16906316686,-3284,,
15501719967,976.35461,16906371023,988068286,16906367734,-3289,,
15501770529,976.40518,16906421598,988118856,16906418303,-3295,,
15501821582,976.45623,16906472642,988169895,16906469343,-3299,,
15501872247,976.50689,16906523311,988220558,16906520005,-3306,,
15501923041,976.55769,16906574107,988271349,16906570797,-3310,,
15501973153,976.60780,16906624221,988321458,16906620906,-3315,,
15502023656,976.65830,16906674727,988371959,16906671406,-3321,,
15502074219,976.70887,16906725291,988422519,16906721966,-3325,,
15502125079,976.75973,16906776154,988473377,16906772824,-3330,,
15502175640,976.81029,16906826718,988523934,16906823382,-3336,,
15502226174,976.86082,16906877254,988574466,16906873913,-3341,,
15502277223,976.91187,16906928306,988625512,16906924960,-3346,,
15502327771,976.96242,16906978856,988676057,16906975505,-3351,,
15502378820,977.01347,16907029906,988727103,16907026550,-3356,,
15502429369,977.06402,16907080459,988777651,16907077098,-3361,,
15502479921,977.11457,16907131013,988828199,16907127647,-3366,,
15502530479,977.16513,16907181572,988878754,16907178201,-3371,,
15502581501,977.21615,16907232597,988929773,16907229220,-3377,,
15502632067,977.26671,16907283165,988980337,16907279785,-3380,,
15502682655,977.31730,16907333756,989030922,16907330370,-3386,,
15502732863,977.36751,16907383977,989081138,16907380585,-3392,,
15502783886,977.41853,16907434991,989132148,16907431595,-3396,,
15502834920,977.46957,16907486028,989183179,16907482627,-3401,,
15502885528,977.52018,16907536639,989233785,16907533232,-3407,,
15502936276,977.57092,16907587389,989284529,16907583977,-3412,,
15502986375,977.62102,16907637490,989334626,16907634073,-3417,,
15503036940,977.67159,16907688058,989385188,16907684635,-3423,,
15503087602,977.72225,16907738722,989435847,16907735294,-3428,,
15503138267,977.77292,16907789390,989486510,16907785958,-3432,,
15503188780,977.82343,16907839904,989537020,16907836467,-3437,,
15503239330,977.87398,16907890457,989587567,16907887015,-3442,,
15503290334,977.92498,16907941464,989638570,16907938017,-3447,,
15503340882,977.97553,16907992013,989689114,16907988561,-3452,,
15503391456,978.02610,16908042601,989739696,16908039144,-3457,,
15503442000,978.07665,16908093137,989790226,16908089684,-3453,,
15503493025,978.12767,16908144163,989841249,16908140696,-3467,,
15503543616,978.17826,16908194756,989891837,16908191284,-3472,,
15503594167,978.22882,16908245310,989942385,16908241832,-3478,,
15503645168,978.27982,16908296314,989993384,16908292832,-3482,,
15503695228,978.32988,16908346376,990043441,16908342889,-3487,,
15503745776,978.38042,16908396927,990093986,16908393433,-3494,,
15503796361,978.43101,16908447514,990144568,16908444016,-3498,,
15503847362,978.48201,16908498518,990195567,16908495015,-3503,,
15503898456,978.53310,16908549614,990246659,16908546106,-3508,,
15503949003,978.58365,16908600163,990297202,16908596649,-3514,,
15503999104,978.63375,16908650267,990347302,16908646749,-3518,,
15504049518,978.68417,16908700683,990397712,16908697159,-3524,,
15504100096,978.73474,16908751273,990448297,16908747745,-3528,,
15504150665,978.78531,16908801834,990498853,16908798300,-3534,,
15504201668,978.83632,16908852840,990549854,16908849302,-3538,,
15504252240,978.88689,16908903423,990600433,16908899881,-3542,,
15504302798,978.93745,16908953975,990650978,16908950426,-3549,,
15504353820,978.98847,16909005002,990702015,16909001462,-3540,,
15504404876,979.03952,16909056068,990753063,16909052511,-3557,,
15504455414,979.09006,16909106598,990803586,16909103034,-3564,,
15504505947,979.14059,16909157133,990854116,16909153564,-3569,,
15504556496,979.19114,16909207684,990904663,16909204111,-3573,,
15504607093,979.24174,16909258284,990955257,16909254705,-3579,,
15504657639,979.29229,16909308832,991005800,16909305248,-3584,,
15504708642,979.34329,16909359837,991056801,16909356248,-3589,,
15504759192,979.39384,16909410389,991107348,16909406796,-3593,,
15504809330,979.44398,16909460530,991157483,16909456931,-3599,,
15504860333,979.49498,16909511535,991208484,16909507931,-3604,,
15504910852,979.54550,16909562056,991259000,16909558447,-3609,,
15504961412,979.59606,16909612619,991309557,16909609005,-3614,,
15505012463,979.64711,16909663684,991360616,16909660064,-3620,,
15505063285,979.69793,16909714497,991411425,16909710873,-3624,,
15505113678,979.74833,16909764891,991461815,16909761262,-3629,,
15505164242,979.79889,16909815459,991512376,16909811824,-3635,,
15505214785,979.84943,16909866003,991562917,16909862364,-3639,,
15505265822,979.90047,16909917044,991613951,16909913399,-3645,,
15505315959,979.95061,16909967183,991664086,16909963533,-3650,,
15505366969,980.00162,16910018195,991715092,16910014540,-3655,,
15505417529,980.05218,16910068758,991765650,16910065098,-3660,,
15505468077,980.10272,16910119308,991816196,16910115643,-3665,,
15505518785,980.15343,16910170028,991866910,16910166358,-3670,,
15505569323,980.20397,16910220559,991917437,16910216884,-3675,,
15505619645,980.25429,16910270883,991967755,16910267203,-3680,,
15505670196,980.30484,16910321436,992018303,16910317751,-3685,,
15505720746,980.35539,16910371988,992068850,16910368297,-3691,,
15505771290,980.40594,16910422540,992119398,16910418846,-3694,,
15505821870,980.45652,16910473117,992169970,16910469417,-3700,,
15505872428,980.50708,16910523678,992220524,16910519972,-3706,,
15505923034,980.55768,16910574286,992271128,16910570576,-3710,,
15505973957,980.60861,16910625211,992322048,16910621495,-3716,,
15506024540,980.65919,16910675797,992372629,16910672076,-3721,,
15506075141,980.70979,16910726400,992423228,16910722675,-3725,,
15506125233,980.75988,16910776494,992473316,16910772764,-3730,,
15506175745,980.81039,16910827008,992523825,16910823272,-3736,,
15506226307,980.86095,16910877582,992574394,16910873841,-3741,,
15506276843,980.91149,16910928112,992624918,16910924365,-3747,,
15506327375,980.96202,16910978645,992675447,16910974894,-3751,,
15506377933,981.01258,16911029206,992726002,16911025450,-3756,,
15506428523,981.06317,16911079799,992776591,16911076038,-3761,,
15506479033,981.11368,16911130311,992827097,16911126545,-3766,,
15506529579,981.16423,16911180859,992877641,16911177088,-3771,,
15506580653,981.21530,16911231936,992928712,16911228159,-3777,,
15506631194,981.26584,16911282479,992979251,16911278699,-3780,,
15506682214,981.31686,16911333500,993030267,16911329715,-3785,,
15506733266,981.36791,16911384556,993081316,16911380764,-3792,,
15506783861,981.41851,16911435153,993131910,16911431357,-3796,,
15506834389,981.46904,16911485694,993182446,16911481894,-3800,,
15506885420,981.52007,16911536717,993233462,16911532910,-3807,,
15506935985,981.57063,16911587284,993284024,16911583471,-3813,,
15506986539,981.62119,16911637841,993334577,16911634024,-3817,,
15507037556,981.67220,16911688859,993385590,16911685038,-3821,,
15507088099,981.72275,16911739404,993436129,16911735577,-3827,,
15507138688,981.77334,16911789996,993486717,16911786164,-3832,,
15507189715,981.82436,16911841026,993537741,16911837189,-3837,,
15507240764,981.87541,16911892077,993588787,16911888234,-3843,,
15507291325,981.92597,16911942640,993639345,16911938793,-3847,,
15507341874,981.97652,16911993191,993689892,16911989339,-3852,,
15507392918,982.02757,16912044238,993740933,16912040381,-3857,,
15507443974,982.07862,16912095296,993791986,16912091433,-3863,,
15507495007,982.12965,16912146332,993843018,16912142465,-3867,,
15507546066,982.18071,16912197394,993894074,16912193521,-3873,,
15507597117,982.23176,16912248447,993945122,16912244569,-3878,,
15507647668,982.28232,16912299000,993995670,16912295117,-3883,,
15507698701,982.33335,16912350035,994046700,16912346147,-3888,,
15507748755,982.38340,16912400092,994096751,16912396199,-3893,,
15507799805,982.43445,16912451143,994147798,16912447245,-3898,,
15507850347,982.48500,16912501689,994198339,16912497786,-3903,,
15507900889,982.53554,16912552233,994248877,16912548324,-3909,,
15507951496,982.58614,16912602842,994299482,16912598930,-3912,,
15508002042,982.63669,16912653391,994350025,16912649472,-3919,,
15508052557,982.68720,16912703907,994400537,16912699984,-3923,,
15508103613,982.73826,16912754966,994451590,16912751038,-3928,,
15508154189,982.78884,16912805545,994502163,16912801611,-3934,,
15508204973,982.83962,16912856331,994552945,16912852393,-3938,,
15508255509,982.89016,16912906870,994603479,16912902926,-3944,,
15508306108,982.94076,16912957471,994654075,16912953522,-3949,,
15508356655,982.99130,16913008020,994704619,16913004066,-3954,,
15508407645,983.04229,16913059013,994755607,16913055054,-3959,,
15508458228,983.09288,16913109598,994806187,16913105634,-3964,,
15508508777,983.14342,16913160149,994856733,16913156180,-3969,,
15508559790,983.19444,16913211164,994907743,16913207190,-3974,,
15508610361,983.24501,16913261738,994958311,16913257759,-3979,,
15508660937,983.29558,16913312315,995008884,16913308332,-3983,,
15508711202,983.34585,16913362595,995059158,16913358605,-3990,,
15508762053,983.39670,16913413436,995109995,16913409442,-3994,,
15508812651,983.44730,16913464037,995160591,16913460038,-3999,,
15508863661,983.49831,16913515050,995211597,16913511045,-4005,,
15508913748,983.54840,16913565139,995261682,16913561129,-4010,,
15508964308,983.59896,16913615700,995312239,16913611686,-4014,,
15509014877,983.64953,16913666273,995362806,16913662253,-4020,,
15509065416,983.70006,16913716813,995413342,16913712789,-4024,,
15509115931,983.75058,16913767332,995463854,16913763302,-4030,,
15509166584,983.80123,16913817988,995514506,16913813953,-4035,,
15509217571,983.85222,16913868986,995565499,16913864947,-4039,,
15509268094,983.90274,16913919502,995616010,16913915457,-4045,,
15509318663,983.95331,16913970073,995666576,16913966023,-4050,,
15509369243,984.00389,16914020655,995717153,16914016600,-4055,,
15509420192,984.05484,16914071607,995768099,16914067547,-4060,,
15509471209,984.10586,16914122625,995819113,16914118561,-4064,,
15509521771,984.15642,16914173190,995869673,16914169120,-4070,,
15509572696,984.20734,16914224118,995920594,16914220042,-4076,,
15509623730,984.25838,16914275154,995971626,16914271074,-4080,,
15509674312,984.30896,16914325740,996022206,16914321654,-4086,,
15509724821,984.35947,16914376250,996072711,16914372159,-4091,,
15509774880,984.40953,16914426311,996122768,16914422216,-4095,,
15509825417,984.46006,16914476850,996173302,16914472749,-4101,,
15509875619,984.51027,16914527066,996223512,16914522959,-4107,,
15509926159,984.56081,16914577597,996274038,16914573486,-4111,,
15509977185,984.61183,16914628626,996325062,16914624510,-4116,,
15510027736,984.66238,16914679178,996375610,16914675058,-4120,,
15510078365,984.71301,16914729809,996426236,16914725683,-4126,,
15510128900,984.76355,16914780347,996476769,16914776216,-4131,,
15510179925,984.81457,16914831374,996527791,16914827238,-4136,,
15510230473,984.86512,16914881925,996578337,16914877784,-4141,,
15510281503,984.91615,16914932957,996629363,16914928810,-4147,,
15510332538,984.96719,16914983994,996680396,16914979844,-4150,,
15510383642,985.01829,16915035100,996731497,16915030944,-4156,,
15510434148,985.06880,16915085609,996782000,16915081447,-4162,,
15510485201,985.11985,16915136664,996833051,16915132498,-4166,,
15510536238,985.17089,16915187705,996884086,16915183533,-4172,,
15510586838,985.22149,16915238307,996934682,16915234130,-4177,,
15510637646,985.27229,16915289117,996985488,16915284935,-4182,,
15510688679,985.32333,16915340153,997036519,16915335966,-4187,,
15510739749,985.37440,16915391225,997087585,16915387033,-4192,,
15510790281,985.42493,16915441759,997138114,16915437562,-4197,,
15510840825,985.47547,16915492306,997188657,16915488104,-4202,,
15510891399,985.52605,16915542891,997239237,16915538684,-4207,,
15510941957,985.57660,16915593442,997289782,16915589230,-4212,,
15510992956,985.62760,16915644444,997340778,16915640225,-4219,,
15511043505,985.67815,16915694994,997391325,16915690772,-4222,,
15511093636,985.72828,16915745128,997441453,16915740900,-4228,,
15511143958,985.77861,16915795453,997491772,16915791219,-4234,,
15511195022,985.82967,16915846519,997542834,16915842282,-4237,,
15511245908,985.88056,16915897408,997593717,16915893165,-4243,,
15511296534,985.93118,16915948036,997644341,16915943788,-4248,,
15511347152,985.98180,16915998655,997694955,16915994402,-4253,,
15511397700,986.03235,16916049207,997745501,16916044948,-4259,,
15511448297,986.08294,16916099806,997796096,16916095543,-4263,,
15511498850,986.13350,16916150361,997846646,16916146093,-4268,,
15511549473,986.18412,16916200986,997897266,16916196713,-4273,,
15511600541,986.23519,16916252058,997948333,16916247780,-4278,,
15511651101,986.28575,16916302619,997998889,16916298336,-4283,,
15511701794,986.33644,16916353315,998049578,16916349026,-4289,,
15511752342,986.38699,16916403865,998100124,16916399572,-4293,,
15511802895,986.43754,16916454419,998150674,16916450121,-4298,,
15511853639,986.48829,16916505166,998201415,16916500862,-4304,,
15511903932,986.53858,16916555462,998251707,16916551154,-4308,,
15511954658,986.58931,16916606190,998302429,16916601876,-4314,,
15512005211,986.63986,16916656755,998352989,16916652436,-4319,,
15512055860,986.69051,16916707397,998403626,16916703074,-4323,,
15512106901,986.74155,16916758440,998454664,16916754111,-4329,,
15512157477,986.79213,16916809019,998505237,16916804685,-4334,,
15512207999,986.84265,16916859543,998555757,16916855204,-4339,,
15512258579,986.89323,16916910126,998606334,16916905782,-4344,,
15512309482,986.94413,16916961031,998657235,16916956682,-4349,,
15512360029,986.99468,16917011581,998707779,16917007227,-4354,,
15512411037,987.04569,16917062590,998758784,16917058231,-4359,,
15512461585,987.09623,16917113141,998809329,16917108777,-4364,,
15512512133,987.14678,16917163691,998859875,16917159322,-4369,,
15512562699,987.19735,16917214260,998910438,16917209885,-4375,,
15512613787,987.24843,16917265350,998961523,16917260971,-4379,,
15512664300,987.29895,16917315866,999012034,16917311481,-4385,,
15512715334,987.34998,16917366902,999063065,16917362512,-4390,,
15512766369,987.40102,16917417938,999114097,16917413544,-4394,,
15512817439,987.45209,16917469012,999165164,16917464611,-4401,,
15512868014,987.50266,16917519588,999215736,16917515183,-4405,,
15512918513,987.55316,16917570090,999266233,16917565680,-4410,,
15512968563,987.60321,16917620143,999316280,16917615728,-4415,,
15513019131,987.65378,16917670713,999366846,16917666293,-4420,,
15513069719,987.70437,16917721303,999417431,16917716878,-4425,,
15513120603,987.75525,16917772190,999468313,16917767760,-4430,,
15513171201,987.80585,16917822789,999518907,16917818355,-4434,,
15513221759,987.85641,16917873349,999569462,16917868909,-4440,,
15513271893,987.90654,16917923486,999619593,16917919040,-4446,,
15513322834,987.95748,16917974430,999670533,16917969980,-4450,,
15513373411,988.00806,16918025010,999721107,16918020555,-4455,,
15513424161,988.05881,16918075762,999771853,16918071301,-4461,,
15513474477,988.10912,16918126080,999822167,16918121615,-4465,,
15513524565,988.15921,16918176170,999872252,16918171700,-4470,,
15513575534,988.21018,16918227142,999923219,16918222666,-4476,,
15513626068,988.26072,16918277678,999973750,16918273198,-4480,,
15513677021,988.31167,16918328634,1000024700,16918324148,-4486,,
15513727573,988.36222,16918379188,1000075249,16918374697,-4491,,
15513778119,988.41277,16918429736,1000125792,16918425240,-4496,,
15513828658,988.46331,16918480278,1000176329,16918475777,-4501,,
15513879205,988.51385,16918530827,1000226873,16918526321,-4506,,
15513929779,988.56443,16918581414,1000277456,16918576903,-4511,,
15513980341,988.61499,16918631968,1000328005,16918627453,-4515,,
15514031360,988.66601,16918682989,1000379021,16918678468,-4521,,
15514081962,988.71661,16918733592,1000429619,16918729066,-4526,,
15514132980,988.76763,16918784614,1000480635,16918780082,-4532,,
15514183048,988.81770,16918834683,1000530700,16918830147,-4536,,
15514233597,988.86825,16918885235,1000581246,16918880693,-4542,,
15514284182,988.91883,16918935824,1000631829,16918931277,-4547,,
15514334732,988.96938,16918986375,1000682376,16918981824,-4551,,
15514385750,989.02040,16919037396,1000733392,16919032839,-4557,,
15514436826,989.07147,16919088474,1000784465,16919083913,-4561,,
15514487404,989.12205,16919139054,1000835039,16919134487,-4567,,
15514538396,989.17304,16919190049,1000886030,16919185477,-4572,,
15514588948,989.22360,16919240603,1000936579,16919236026,-4577,,
15514639547,989.27419,16919291203,1000987174,16919286621,-4582,,
15514690535,989.32518,16919342195,1001038160,16919337608,-4587,,
15514741043,989.37569,16919392704,1001088665,16919388112,-4592,,
15514791627,989.42628,16919443291,1001139246,16919438693,-4598,,
15514842161,989.47681,16919493838,1001189788,16919489236,-4602,,
15514893237,989.52788,16919544906,1001240851,16919540298,-4608,,
15514944015,989.57866,16919595687,1001291626,16919591074,-4613,,
15514995015,989.62966,16919646689,1001342624,16919642071,-4618,,
15515045264,989.67991,16919696939,1001392870,16919692317,-4622,,
15515095813,989.73046,16919747491,1001443416,16919742863,-4628,,
15515146392,989.78104,16919798074,1001493994,16919793441,-4633,,
15515197386,989.83203,16919849069,1001544983,16919844431,-4638,,
15515247904,989.88255,16919899590,1001595499,16919894946,-4644,,
15515298488,989.93314,16919950177,1001646082,16919945529,-4648,,
15515349046,989.98369,16920000736,1001696635,16919996083,-4653,,
15515400054,990.03470,16920051746,1001747641,16920047088,-4658,,
15515451153,990.08580,16920102848,1001798738,16920098185,-4663,,
15515501692,990.13634,16920153389,1001849274,16920148721,-4668,,
15515552191,990.18684,16920203891,1001899770,16920199217,-4674,,
15515602740,990.23739,16920254442,1001950316,16920249764,-4678,,
15515653792,990.28844,16920305497,1002001366,16920300813,-4684,,
15515704383,990.33903,16920356090,1002051954,16920351401,-4689,,
15515755386,990.39003,16920407094,1002102954,16920402401,-4693,,
15515805935,990.44058,16920457646,1002153500,16920452947,-4699,,
15515856482,990.49113,16920508195,1002204044,16920503491,-4704,,
15515907031,990.54168,16920558747,1002254592,16920554039,-4708,,
15515957579,990.59223,16920609298,1002305136,16920604584,-4714,,
15516008628,990.64328,16920660348,1002356182,16920655629,-4719,,
15516059176,990.69382,16920710899,1002406728,16920706175,-4724,,
15516110232,990.74488,16920761958,1002457781,16920757229,-4729,,
15516160811,990.79546,16920812539,1002508358,16920807806,-4733,,
15516211337,990.84599,16920863067,1002558881,16920858328,-4739,,
15516262371,990.89702,16920914104,1002609912,16920909359,-4745,,
15516312920,990.94757,16920964655,1002660458,16920959905,-4750,,
15516363516,990.99816,16921015254,1002711051,16921010499,-4755,,
15516414009,991.04866,16921065749,1002761541,16921060988,-4761,,
15516465065,991.09971,16921116806,1002812595,16921112042,-4764,,
15516515658,991.15031,16921167403,1002863185,16921162633,-4770,,
15516566197,991.20084,16921217944,1002913721,16921213169,-4775,,
15516617061,991.25171,16921268810,1002964583,16921264031,-4779,,
15516668137,991.30278,16921319899,1003015667,16921315114,-4785,,
15516718596,991.35324,16921370350,1003066113,16921365560,-4790,,
15516769041,991.40369,16921420797,1003116555,16921416002,-4795,,
15516819660,991.45431,16921471418,1003167171,16921466618,-4800,,
15516870155,991.50480,16921521916,1003217675,16921517122,-4794,,
15516920736,991.55538,16921572499,1003268242,16921567689,-4810,,
15516971725,991.60637,16921623491,1003319229,16921618676,-4815,,
15517022777,991.65742,16921674544,1003370277,16921669724,-4820,,
15517073384,991.70803,16921725165,1003420892,16921720339,-4826,,
15517124425,991.75907,16921776197,1003471919,16921771366,-4831,,
15517175101,991.80975,16921826876,1003522593,16921822041,-4835,,
15517225790,991.86044,16921877568,1003573280,16921872727,-4841,,
15517276262,991.91091,16921928041,1003623748,16921923195,-4846,,
15517326901,991.96155,16921978683,1003674385,16921973833,-4850,,
15517377380,992.01203,16922029165,1003724862,16922024309,-4856,,
15517427952,992.06260,16922079740,1003775432,16922074880,-4860,,
15517478973,992.11362,16922130761,1003826448,16922125896,-4865,,
15517530063,992.16471,16922181855,1003877536,16922176984,-4871,,
15517581077,992.21573,16922232871,1003928547,16922227995,-4876,,
15517631610,992.26626,16922283406,1003979077,16922278525,-4881,,
15517682147,992.31679,16922333946,1004029612,16922329060,-4886,,
15517732209,992.36686,16922384010,1004079672,16922379119,-4891,,
15517782255,992.41690,16922434058,1004129714,16922429161,-4897,,
15517832306,992.46695,16922484111,1004179763,16922479210,-4901,,
15517882351,992.51700,16922534158,1004229805,16922529252,-4906,,
15517932911,992.56756,16922584722,1004280363,16922579810,-4912,,
15517982964,992.61761,16922634777,1004330413,16922629860,-4917,,
15518033506,992.66815,16922685321,1004380952,16922680400,-4921,,
15518083635,992.71828,16922735453,1004431078,16922730526,-4927,,
15518134056,992.76870,16922785875,1004481496,16922780943,-4932,,
15518184602,992.81925,16922836424,1004532040,16922831488,-4936,,
15518234650,992.86930,16922886475,1004582085,16922881533,-4942,,
15518284711,992.91936,16922936537,1004632143,16922931590,-4947,,
15518335746,992.97039,16922987575,1004683177,16922982624,-4951,,
15518385846,993.02049,16923037678,1004733273,16923032721,-4957,,
15518436859,993.07151,16923088693,1004784283,16923083731,-4962,,
15518487892,993.12254,16923139728,1004835313,16923134761,-4967,,
15518538056,993.17270,16923189895,1004885475,16923184923,-4972,,
15518588314,993.22296,16923240154,1004935730,16923235177,-4977,,
15518638695,993.27334,16923290537,1004986108,16923285555,-4982,,
15518689242,993.32389,16923341088,1005036653,16923336101,-4987,,
15518739805,993.37445,16923391653,1005087213,16923386661,-4992,,
15518790354,993.42500,16923442204,1005137760,16923437207,-4997,,
15518841409,993.47606,16923493261,1005188812,16923488259,-5002,,
15518891506,993.52615,16923543380,1005238926,16923538373,-5007,,
15518942004,993.57665,16923593861,1005289402,16923588849,-5012,,
15518992533,993.62718,16923644393,1005339928,16923639376,-5017,,
15519043519,993.67817,16923695381,1005390911,16923690359,-5022,,
15519093702,993.72835,16923745567,1005441091,16923740539,-5028,,
15519144196,993.77884,16923796063,1005491583,16923791030,-5033,,
15519195222,993.82987,16923847091,1005542606,16923842054,-5037,,
15519246077,993.88072,16923897949,1005593458,16923892905,-5044,,
15519296564,993.93121,16923948438,1005643942,16923943390,-5048,,
15519347082,993.98173,16923998958,1005694457,16923993905,-5053,,
15519398118,994.03277,16924049996,1005745491,16924044938,-5058,,
15519448180,994.08283,16924100061,1005795550,16924094998,-5063,,
15519499235,994.13388,16924151118,1005846602,16924146050,-5068,,
15519550270,994.18492,16924202155,1005897635,16924197082,-5073,,
15519601312,994.23596,16924253200,1005948674,16924248122,-5078,,
15519651860,994.28651,16924303749,1005999219,16924298666,-5083,,
15519702919,994.33757,16924354812,1006050275,16924349722,-5090,,
15519753959,994.38861,16924405853,1006101313,16924400761,-5092,,
15519804519,994.43917,16924456417,1006151871,16924451318,-5099,,
15519855067,994.48972,16924506966,1006202415,16924501862,-5104,,
15519905601,994.54025,16924557503,1006252948,16924552395,-5108,,
15519956165,994.59081,16924608070,1006303508,16924602956,-5114,,
15520006758,994.64141,16924658676,1006354110,16924653557,-5119,,
15520057767,994.69241,16924709676,1006405105,16924704552,-5124,,
15520108319,994.74297,16924760230,1006455654,16924755101,-5129,,
15520158953,994.79360,16924810866,1006506285,16924805733,-5133,,
15520209603,994.84425,16924861519,1006556933,16924856380,-5139,,
15520260080,994.89473,16924911998,1006607407,16924906854,-5144,,
15520310950,994.94560,16924962871,1006658275,16924957723,-5148,,
15520361486,994.99613,16925013409,1006708807,16925008255,-5154,,
15520412520,995.04717,16925064446,1006759838,16925059285,-5161,,
15520463064,995.09771,16925114992,1006810381,16925109828,-5164,,
15520513633,995.14828,16925165564,1006860947,16925160394,-5170,,
15520564675,995.19932,16925216608,1006911985,16925211433,-5175,,
15520615732,995.25038,16925267667,1006963040,16925262488,-5179,,
15520666295,995.30094,16925318233,1007013601,16925313048,-5185,,
15520716814,995.35146,16925368754,1007064116,16925363564,-5190,,
15520767361,995.40201,16925419303,1007114660,16925414108,-5195,,
15520818407,995.45305,16925470352,1007165705,16925465153,-5199,,
15520868981,995.50363,16925520940,1007216288,16925515735,-5205,,
15520920004,995.55465,16925571953,1007267295,16925566743,-5210,,
15520970127,995.60478,16925622078,1007317416,16925616864,-5214,,
15521020687,995.65534,16925672641,1007367974,16925667421,-5220,,
15521071247,995.70590,16925723203,1007418530,16925717978,-5225,,
15521121723,995.75637,16925773682,1007469005,16925768452,-5230,,
15521172558,995.80721,16925824520,1007519838,16925819285,-5235,,
15521222722,995.85737,16925874686,1007569997,16925869445,-5241,,
15521273173,995.90782,16925925139,1007620446,16925919893,-5246,,
15521323834,995.95848,16925975803,1007671105,16925970553,-5250,,
15521374770,996.00942,16926026752,1007722048,16926021496,-5256,,
15521424875,996.05952,16926076848,1007772140,16926071587,-5261,,
15521475898,996.11055,16926127872,1007823160,16926122607,-5265,,
15521526150,996.16080,16926178128,1007873409,16926172857,-5271,,
15521576565,996.21121,16926228545,1007923821,16926223269,-5276,,
15521627152,996.26180,16926279133,1007974405,16926273852,-5281,,
15521678131,996.31278,16926330116,1008025382,16926324830,-5286,,
15521728672,996.36332,16926380658,1008075920,16926375367,-5291,,
15521778776,996.41342,16926430764,1008126021,16926425469,-5295,,
15521829835,996.46448,16926481827,1008177078,16926476526,-5301,,
15521880375,996.51502,16926532369,1008227615,16926527062,-5307,,
15521931407,996.56606,16926583403,1008278645,16926578092,-5311,,
15521981499,996.61615,16926633498,1008328734,16926628182,-5316,,
15522032054,996.66670,16926684055,1008379286,16926678734,-5321,,
15522082618,996.71727,16926734621,1008429847,16926729295,-5326,,
15522132767,996.76742,16926784773,1008479993,16926779441,-5332,,
15522182988,996.81764,16926834996,1008530212,16926829660,-5336,,
15522233562,996.86821,16926885572,1008580783,16926880230,-5342,,
15522284593,996.91924,16926936606,1008631812,16926931259,-5347,,
15522334661,996.96931,16926986675,1008681877,16926981324,-5351,,
15522385221,997.01987,16927037249,1008732445,16927031892,-5357,,
15522436243,997.07089,16927088262,1008783453,16927082900,-5362,,
15522486829,997.12148,16927138855,1008834041,16927133488,-5367,,
15522537329,997.17198,16927189353,1008884534,16927183981,-5372,,
15522587889,997.22254,16927239915,1008935091,16927234538,-5377,,
15522638436,997.27308,16927290465,1008985636,16927285083,-5382,,
15522688999,997.32365,16927341031,1009036196,16927335644,-5387,,
15522739583,997.37423,16927391616,1009086777,16927386224,-5392,,
15522790590,997.42524,16927442626,1009137781,16927437228,-5398,,
15522841645,997.47629,16927493684,1009188834,16927488281,-5403,,
15522892695,997.52734,16927544736,1009239881,16927539329,-5407,,
15522943742,997.57839,16927595786,1009290925,16927590373,-5413,,
15522994305,997.62895,16927646362,1009341497,16927640944,-5418,,
15523045331,997.67998,16927697379,1009392510,16927691957,-5422,,
15523095940,997.73059,16927747991,1009443115,16927742563,-5428,,
15523147025,997.78167,16927799077,1009494197,16927793644,-5433,,
15523197108,997.83176,16927849162,1009544277,16927843724,-5438,,
15523247661,997.88231,16927899719,1009594829,16927894276,-5443,,
15523298230,997.93288,16927950289,1009645394,16927944841,-5448,,
15523348974,997.98362,16928001036,1009696135,16927995582,-5454,,
15523399545,998.03419,16928051610,1009746705,16928046152,-5458,,
15523450555,998.08520,16928102622,1009797712,16928097159,-5463,,
15523501137,998.13579,16928153206,1009848290,16928147738,-5468,,
15523551726,998.18637,16928203798,1009898877,16928198325,-5473,,
15523602330,998.23698,16928254415,1009949489,16928248937,-5478,,
15523653337,998.28799,16928305413,1010000482,16928299929,-5484,,
15523703933,998.33858,16928356012,1010051076,16928350523,-5489,,
15523754481,998.38913,16928406562,1010101622,16928401069,-5493,,
15523805170,998.43982,16928457254,1010152307,16928451754,-5500,,
15523856071,998.49072,16928508157,1010203206,16928502653,-5504,,
15523906123,998.54077,16928558211,1010253256,16928552703,-5508,,
15523956707,998.59136,16928608798,1010303836,16928603284,-5514,,
15524007301,998.64195,16928659393,1010354427,16928653874,-5519,,
15524057412,998.69206,16928709507,1010404535,16928703983,-5524,,
15524107932,998.74258,16928760030,1010455054,16928754501,-5529,,
15524158267,998.79291,16928810367,1010505385,16928804833,-5534,,
15524208835,998.84348,16928860937,1010555951,16928855398,-5539,,
15524259746,998.89439,16928911851,1010606860,16928906307,-5544,,
15524310336,998.94498,16928962442,1010657446,16928956893,-5549,,
15524361342,998.99599,16929013450,1010708449,16929007897,-5553,,
15524412419,999.04707,16929064532,1010759524,16929058972,-5560,,
15524462979,999.09763,16929115093,1010810082,16929109529,-5564,,
15524513988,999.14864,16929166104,1010861087,16929160534,-5570,,
15524564530,999.19918,16929216649,1010911627,16929211074,-5575,,
15524615126,999.24977,16929267247,1010962220,16929261668,-5579,,
15524665625,999.30027,16929317749,1011012716,16929312163,-5586,,
15524716173,999.35082,16929368299,1011063261,16929362709,-5590,,
15524766748,999.40140,16929418876,1011113834,16929413282,-5594,,
15524817307,999.45195,16929469438,1011164391,16929463838,-5600,,
15524868320,999.50297,16929520453,1011215400,16929514848,-5605,,
15524918413,999.55306,16929570548,1011265490,16929564938,-5610,,
15524968917,999.60357,16929621055,1011315992,16929615440,-5615,,
15525019460,999.65411,16929671599,1011366532,16929665979,-5620,,
15525070491,999.70514,16929722633,1011417560,16929717008,-5625,,
15525121128,999.75578,16929773272,1011468195,16929767642,-5630,,
15525171724,999.80637,16929823871,1011518788,16929818235,-5636,,
15525222761,999.85741,16929874910,1011569822,16929869269,-5641,,
15525273295,999.90794,16929925446,1011620353,16929919800,-5646,,
15525323887,999.95853,16929976041,1011670943,16929970390,-5651,,
15525374389,1000.00904,16930026545,1011721442,16930020889,-5656,,
15525424684,1000.05933,16930076843,1011771734,16930071182,-5661,,
15525474796,1000.10944,16930126957,1011821844,16930121292,-5665,,
15525525350,1000.16000,16930177514,1011872395,16930171843,-5671,,
15525575510,1000.21016,16930227676,1011922553,16930222000,-5676,,
15525626450,1000.26110,16930278618,1011973491,16930272938,-5680,,
15525676982,1000.31163,16930329164,1012024031,16930323479,-5685,,
15525727199,1000.36185,16930379372,1012074233,16930373681,-5691,,
15525778010,1000.41266,16930430184,1012125041,16930424488,-5696,,
15525828565,1000.46321,16930480743,1012175594,16930475042,-5701,,
15525879113,1000.51376,16930531293,1012226140,16930525587,-5706,,
15525929660,1000.56431,16930581842,1012276683,16930576130,-5712,,
15525980663,1000.61531,16930632848,1012327684,16930627132,-5716,,
15526031211,1000.66586,16930683408,1012378239,16930677687,-5721,,
15526081812,1000.71646,16930734001,1012428827,16930728275,-5726,,
15526132345,1000.76699,16930784536,1012479357,16930778804,-5732,,
15526183280,1000.81793,16930835474,1012530290,16930829738,-5736,,
15526233429,1000.86808,16930885626,1012580436,16930879884,-5742,,
15526283995,1000.91864,16930936194,1012631000,16930930447,-5747,,
15526334581,1000.96923,16930986782,1012681583,16930981031,-5751,,
15526385621,1001.02027,16931037824,1012732620,16931032067,-5757,,
15526436204,1001.07085,16931088422,1012783212,16931082660,-5762,,
15526487175,1001.12182,16931139382,1012834168,16931133615,-5767,,
15526537976,1001.17262,16931190187,1012884968,16931184415,-5772,,
15526588780,1001.22343,16931240993,1012935769,16931235217,-5776,,
15526639171,1001.27382,16931291386,1012986157,16931285605,-5781,,
15526689845,1001.32449,16931342063,1013036829,16931336276,-5787,,
15526740508,1001.37516,16931392728,1013087488,16931386936,-5792,,
15526791108,1001.42576,16931443341,1013138097,16931437544,-5797,,
15526841351,1001.47600,16931493577,1013188327,16931487775,-5802,,
15526892361,1001.52701,16931544587,1013239333,16931538780,-5807,,
15526943281,1001.57793,16931595510,1013290250,16931589697,-5813,,
15526993832,1001.62848,16931646063,1013340798,16931640246,-5817,,
15527044574,1001.67922,16931696807,1013391538,16931690986,-5821,,
15527095455,1001.73010,16931747692,1013442417,16931741864,-5828,,
15527146208,1001.78086,16931798446,1013493166,16931792614,-5832,,
15527196707,1001.83136,16931848947,1013543663,16931843110,-5837,,
15527246813,1001.88146,16931899056,1013593766,16931893214,-5842,,
15527297833,1001.93248,16931950079,1013644783,16931944231,-5848,,
15527347945,1001.98259,16932000192,1013694892,16931994339,-5853,,
15527398945,1002.03359,16932051196,1013745890,16932045338,-5858,,
15527449512,1002.08416,16932101764,1013796454,16932095901,-5863,,
15527500059,1002.13471,16932152314,1013846998,16932146446,-5868,,
15527550603,1002.18525,16932202861,1013897540,16932196987,-5874,,
15527601138,1002.23579,16932253398,1013948072,16932247520,-5878,,
15527651704,1002.28635,16932303966,1013998636,16932298083,-5883,,
15527702284,1002.33693,16932354548,1014049212,16932348660,-5888,,
15527753287,1002.38793,16932405554,1014100213,16932399661,-5893,,
15527803898,1002.43855,16932456168,1014150822,16932450269,-5899,,
15527854397,1002.48905,16932506669,1014201317,16932500765,-5904,,
15527904946,1002.53959,16932557220,1014251864,16932551312,-5908,,
15527955494,1002.59014,16932607771,1014302409,16932601856,-5915,,
15528006031,1002.64068,16932658309,1014352943,16932652390,-5919,,
15528056506,1002.69115,16932708786,1014403416,16932702863,-5923,,
15528107405,1002.74205,16932759689,1014454312,16932753760,-5929,,
15528158063,1002.79271,16932810348,1014504967,16932804414,-5934,,
15528208631,1002.84328,16932860918,1014555532,16932854979,-5939,,
15528259232,1002.89388,16932911523,1014606131,16932905579,-5944,,
15528310199,1002.94485,16932962492,1014657095,16932956543,-5949,,
15528360766,1002.99541,16933013060,1014707659,16933007107,-5953,,
15528411242,1003.04589,16933063540,1014758134,16933057581,-5959,,
15528462277,1003.09693,16933114577,1014809165,16933108613,-5964,,
15528512830,1003.14748,16933165133,1014859716,16933159163,-5970,,
15528563425,1003.19807,16933215730,1014910307,16933209755,-5975,,
15528613907,1003.24856,16933266214,1014960788,16933260235,-5979,,
15528664901,1003.29955,16933317211,1015011778,16933311226,-5985,,
15528715500,1003.35015,16933367812,1015062374,16933361822,-5990,,
15528766025,1003.40067,16933418340,1015112899,16933412347,-5993,,
15528817046,1003.45169,16933469362,1015163915,16933463363,-5999,,
15528867595,1003.50224,16933519913,1015214461,16933513908,-6005,,
15528918182,1003.55283,16933570503,1015265046,16933564493,-6010,,
15528969169,1003.60382,16933621492,1015316030,16933615477,-6015,,
15529020217,1003.65486,16933672543,1015367076,16933666523,-6020,,
15529070780,1003.70543,16933723107,1015417635,16933717082,-6025,,
15529121361,1003.75601,16933773692,1015468215,16933767662,-6030,,
15529172184,1003.80683,16933824517,1015519035,16933818482,-6035,,
15529222641,1003.85729,16933874977,1015569488,16933868936,-6041,,
15529273221,1003.90787,16933925559,1015620066,16933919513,-6046,,
15529324044,1003.95869,16933976384,1015670886,16933970334,-6050,,
15529374616,1004.00926,16934026959,1015721456,16934020903,-6056,,
15529424849,1004.05950,16934077193,1015771685,16934071132,-6061,,
15529475147,1004.10979,16934127494,1015821981,16934121429,-6065,,
15529526160,1004.16081,16934178509,1015872991,16934172438,-6071,,
15529576766,1004.21141,16934229118,1015923595,16934223042,-6076,,
15529627369,1004.26202,16934279723,1015974195,16934273642,-6081,,
15529678410,1004.31306,16934330767,1016025233,16934324681,-6086,,
15529728988,1004.36364,16934381347,1016075809,16934375256,-6091,,
15529779523,1004.41417,16934431895,1016126352,16934425799,-6096,,
15529830074,1004.46472,16934482449,1016176900,16934476348,-6101,,
15529881105,1004.51575,16934533470,1016227917,16934527364,-6106,,
15529931644,1004.56629,16934584012,1016278454,16934577901,-6111,,
15529981707,1004.61635,16934634078,1016328515,16934627962,-6116,,
15530032064,1004.66671,16934684436,1016378868,16934678315,-6121,,
15530083064,1004.71771,16934735439,1016429865,16934729312,-6127,,
15530133650,1004.76830,16934786028,1016480449,16934779897,-6131,,
15530184006,1004.81865,16934836386,1016530803,16934830251,-6135,,
15530235024,1004.86967,16934887407,1016581817,16934881265,-6142,,
15530285598,1004.92025,16934937983,1016632388,16934931836,-6147,,
15530336175,1004.97082,16934988562,1016682964,16934982411,-6151,,
15530386557,1005.02121,16935038947,1016733342,16935032790,-6157,,
15530437162,1005.07181,16935089553,1016783944,16935083391,-6162,,
15530487371,1005.12202,16935139765,1016834150,16935133598,-6167,,
15530537926,1005.17257,16935190323,1016884704,16935184151,-6172,,
15530588473,1005.22312,16935240872,1016935248,16935234695,-6177,,
15530639228,1005.27388,16935291628,1016985999,16935285446,-6182,,
15530689810,1005.32446,16935342224,1017036589,16935336037,-6187,,
15530740835,1005.37548,16935393251,1017087611,16935387059,-6192,,
15530790993,1005.42564,16935443401,1017137756,16935437204,-6197,,
15530841614,1005.47626,16935494025,1017188376,16935487823,-6202,,
15530892686,1005.52733,16935545099,1017239445,16935538893,-6206,,
15530943265,1005.57791,16935595681,1017290020,16935589467,-6214,,
15530994266,1005.62891,16935646683,1017341018,16935640466,-6217,,
15531044821,1005.67947,16935697241,1017391572,16935691019,-6222,,
15531095728,1005.73038,16935748151,1017442475,16935741923,-6228,,
15531146294,1005.78094,16935798719,1017493039,16935792486,-6233,,
15531196830,1005.83148,16935849256,1017543572,16935843019,-6237,,
15531247422,1005.88207,16935899851,1017594161,16935893609,-6242,,
15531297925,1005.93257,16935950357,1017644661,16935944109,-6248,,
15531348895,1005.98354,16936001371,1017695671,16935995119,-6252,,
15531399539,1006.03419,16936051976,1017746270,16936045717,-6259,,
15531450562,1006.08521,16936103001,1017797290,16936096738,-6263,,
15531501533,1006.13618,16936153974,1017848258,16936147706,-6268,,
15531551905,1006.18655,16936204349,1017898629,16936198077,-6272,,
15531602945,1006.23759,16936255401,1017949675,16936249123,-6278,,
15531653859,1006.28851,16936306308,1018000576,16936300024,-6284,,
15531704456,1006.33910,16936356906,1018051170,16936350617,-6289,,
15531755101,1006.38975,16936407554,1018101813,16936401260,-6294,,
15531806024,1006.44067,16936458480,1018152733,16936452181,-6299,,
15531856605,1006.49125,16936509063,1018203311,16936502758,-6305,,
15531907153,1006.54180,16936559613,1018253857,16936553305,-6308,,
15531957215,1006.59186,16936609678,1018303917,16936603364,-6314,,
15532008253,1006.64290,16936660718,1018354951,16936654399,-6319,,
15532058857,1006.69350,16936711324,1018405552,16936705000,-6324,,
15532109423,1006.74407,16936761893,1018456117,16936755564,-6329,,
15532160477,1006.79512,16936812949,1018507167,16936806615,-6334,,
15532211060,1006.84571,16936863534,1018557748,16936857195,-6339,,
15532261161,1006.89581,16936913638,1018607846,16936907294,-6344,,
15532311297,1006.94595,16936963775,1018657979,16936957426,-6349,,
15532361425,1006.99607,16937013906,1018708105,16937007552,-6354,,
15532411973,1007.04662,16937064457,1018758649,16937058097,-6360,,
15532462553,1007.09720,16937115038,1018809227,16937108675,-6363,,
15532513096,1007.14774,16937165596,1018859778,16937159226,-6370,,
15532564120,1007.19877,16937216611,1018910788,16937210236,-6375,,
15532614688,1007.24934,16937267181,1018961355,16937260802,-6379,,
15532665276,1007.29992,16937317772,1019011939,16937311387,-6385,,
15532715767,1007.35041,16937368264,1019062427,16937361874,-6390,,
15532766335,1007.40098,16937418834,1019112993,16937412440,-6394,,
15532816924,1007.45157,16937469427,1019163580,16937463027,-6400,,
15532867473,1007.50212,16937519977,1019214125,16937513572,-6405,,
15532918481,1007.55313,16937570987,1019265130,16937564577,-6410,,
15532969022,1007.60367,16937621531,1019315669,16937615117,-6414,,
15533019619,1007.65427,16937672131,1019366263,16937665711,-6420,,
15533070621,1007.70527,16937723135,1019417263,16937716710,-6425,,
15533121217,1007.75586,16937773733,1019467856,16937767303,-6430,,
15533171799,1007.80645,16937824318,1019518436,16937817883,-6435,,
15533222476,1007.85712,16937874998,1019569109,16937868556,-6442,,
15533272539,1007.90719,16937925063,1019619170,16937918617,-6446,,
15533323577,1007.95822,16937976102,1019670205,16937969652,-6450,,
15533373918,1008.00857,16938026447,1019720543,16938019991,-6456,,
15533424490,1008.05914,16938077022,1019771124,16938070572,-6450,,
15533474684,1008.10933,16938127217,1019821304,16938120752,-6465,,
15533525720,1008.16037,16938178256,1019872338,16938171785,-6471,,
15533576284,1008.21093,16938228822,1019922898,16938222346,-6476,,
15533626817,1008.26147,16938279357,1019973429,16938272877,-6480,,
15533677364,1008.31201,16938329907,1020023974,16938323421,-6486,,
15533727450,1008.36210,16938379996,1020074058,16938373506,-6490,,
15533777999,1008.41265,16938430546,1020124603,16938424051,-6495,,
15533829011,1008.46366,16938481561,1020175612,16938475060,-6501,,
15533879572,1008.51422,16938532124,1020226170,16938525618,-6506,,
15533930628,1008.56528,16938583181,1020277223,16938576670,-6511,,
15533981157,1008.61581,16938633713,1020327750,16938627197,-6516,,
15534031703,1008.66635,16938684262,1020378294,16938677741,-6521,,
15534082269,1008.71692,16938734830,1020428856,16938728304,-6526,,
15534133250,1008.76790,16938785824,1020479845,16938779292,-6532,,
15534183672,1008.81832,16938836237,1020530254,16938829702,-6535,,
15534234254,1008.86890,16938886824,1020580834,16938880281,-6543,,
15534285181,1008.91983,16938937752,1020631758,16938931205,-6547,,
15534336153,1008.97080,16938988725,1020682727,16938982174,-6551,,
15534386710,1009.02136,16939039286,1020733282,16939032729,-6557,,
15534437609,1009.07226,16939090187,1020784178,16939083625,-6562,,
15534488209,1009.12286,16939140788,1020834774,16939134221,-6567,,
15534538730,1009.17338,16939191313,1020885294,16939184741,-6572,,
15534589324,1009.22397,16939241909,1020935884,16939235332,-6577,,
15534639886,1009.27453,16939292473,1020986443,16939285891,-6582,,
15534690282,1009.32493,16939342872,1021036837,16939336284,-6588,,
15534740821,1009.37547,16939393413,1021087373,16939386821,-6592,,
15534790919,1009.42557,16939443513,1021137469,16939436916,-6597,,
15534841959,1009.47661,16939494556,1021188506,16939487953,-6603,,
15534892472,1009.52712,16939545070,1021239016,16939538464,-6606,,
15534943557,1009.57821,16939596158,1021290098,16939589545,-6613,,
15534993884,1009.62853,16939646487,1021340422,16939639869,-6618,,
15535044914,1009.67956,16939697520,1021391451,16939690898,-6622,,
15535095965,1009.73061,16939748574,1021442498,16939741946,-6628,,
15535146513,1009.78116,16939799123,1021493043,16939792490,-6633,,
15535197058,1009.83171,16939849681,1021543596,16939843043,-6638,,
15535248108,1009.88276,16939900724,1021594634,16939894081,-6643,,
15535298870,1009.93352,16939951487,1021645392,16939944840,-6647,,
15535348926,1009.98357,16940001545,1021695445,16939994892,-6653,,
15535399124,1010.03377,16940051747,1021745641,16940045089,-6658,,
15535449718,1010.08437,16940102342,1021796232,16940095679,-6663,,
15535500582,1010.13523,16940153209,1021847094,16940146541,-6668,,
15535551085,1010.18573,16940203715,1021897594,16940197042,-6673,,
15535601653,1010.23630,16940254285,1021948159,16940247607,-6678,,
15535652705,1010.28735,16940305340,1021999209,16940298656,-6684,,
15535703749,1010.33840,16940356386,1022050249,16940349697,-6689,,
15535754684,1010.38933,16940407323,1022101182,16940400630,-6693,,
15535805781,1010.44043,16940458422,1022152276,16940451723,-6699,,
15535856370,1010.49102,16940509014,1022202863,16940502310,-6704,,
15535907371,1010.54202,16940560016,1022253860,16940553307,-6709,,
15535957933,1010.59258,16940610582,1022304421,16940603869,-6713,,
15536007993,1010.64264,16940660643,1022354477,16940653924,-6719,,
15536058563,1010.69321,16940711216,1022405044,16940704492,-6724,,
15536109437,1010.74409,16940762092,1022455916,16940755363,-6729,,
15536160195,1010.79484,16940812853,1022506671,16940806119,-6734,,
15536210717,1010.84537,16940863376,1022557190,16940856638,-6738,,
15536261279,1010.89593,16940913942,1022607751,16940907198,-6744,,
15536312224,1010.94687,16940964889,1022658693,16940958140,-6749,,
15536362714,1010.99736,16941015381,1022709179,16941008626,-6755,,
15536414371,1011.04902,16941067040,1022760833,16941060280,-6760,,
15536464954,1011.09960,16941117625,1022811414,16941110861,-6764,,
15536515486,1011.15013,16941168160,1022861942,16941161390,-6770,,
15536565621,1011.20027,16941218298,1022912076,16941211523,-6775,,
15536616621,1011.25127,16941269300,1022963074,16941262521,-6779,,
15536667195,1011.30184,16941319877,1023013644,16941313091,-6786,,
15536717459,1011.35211,16941370142,1023063905,16941363352,-6790,,
15536768020,1011.40267,16941420705,1023114463,16941413911,-6794,,
15536819039,1011.45369,16941471728,1023165481,16941464928,-6800,,
15536869617,1011.50427,16941522308,1023216056,16941515504,-6804,,
15536920337,1011.55498,16941573031,1023266773,16941566221,-6810,,
15536970733,1011.60538,16941623429,1023317167,16941616614,-6815,,
15537021426,1011.65607,16941674124,1023367857,16941667304,-6820,,
15537071978,1011.70663,16941724678,1023418405,16941717852,-6826,,
15537122956,1011.75760,16941775659,1023469380,16941768828,-6831,,
15537173502,1011.80815,16941826207,1023519925,16941819372,-6835,,
15537224107,1011.85875,16941876815,1023570526,16941869974,-6841,,
15537274985,1011.90963,16941927695,1023621401,16941920849,-6846,,
15537325553,1011.96020,16941978265,1023671968,16941971415,-6850,,
15537376642,1012.01129,16942029357,1023723054,16942022501,-6856,,
15537427179,1012.06183,16942079895,1023773587,16942073035,-6860,,
15537478065,1012.11271,16942130784,1023824470,16942123918,-6866,,
15537528620,1012.16327,16942181342,1023875023,16942174471,-6871,,
15537579178,1012.21383,16942231902,1023925578,16942225026,-6876,,
15537629735,1012.26438,16942282471,1023976143,16942275590,-6881,,
15537680758,1012.31541,16942333487,1024027154,16942326601,-6886,,
15537731318,1012.36597,16942384049,1024077711,16942377158,-6891,,
15537781868,1012.41652,16942434602,1024128257,16942427705,-6897,,
15537832409,1012.46706,16942485144,1024178796,16942478243,-6901,,
15537882952,1012.51760,16942535689,1024229336,16942528784,-6905,,
15537933500,1012.56815,16942586241,1024279881,16942579328,-6913,,
15537983559,1012.61821,16942636302,1024329937,16942629384,-6918,,
15538034106,1012.66875,16942686851,1024380482,16942679930,-6921,,
15538084645,1012.71929,16942737392,1024431018,16942730465,-6927,,
15538134738,1012.76939,16942787487,1024481108,16942780556,-6931,,
15538185703,1012.82035,16942838455,1024532071,16942831519,-6936,,
15538236706,1012.87135,16942889461,1024583072,16942882519,-6942,,
15538286843,1012.92149,16942939600,1024633205,16942932653,-6947,,
15538336923,1012.97157,16942989681,1024683283,16942982731,-6950,,
15538387038,1013.02169,16943039800,1024733396,16943032843,-6957,,
15538438051,1013.07270,16943090815,1024784405,16943083853,-6962,,
15538488600,1013.12325,16943141366,1024834951,16943134398,-6968,,
15538539426,1013.17407,16943192205,1024885785,16943185233,-6972,,
15538589893,1013.22454,16943242663,1024936239,16943235686,-6977,,
15538639975,1013.27462,16943292748,1024986319,16943285766,-6982,,
15538690577,1013.32523,16943343365,1025036931,16943336378,-6987,,
15538741125,1013.37577,16943393914,1025087474,16943386922,-6992,,
15538792146,1013.42679,16943444925,1025138481,16943437928,-6997,,
15538843038,1013.47769,16943495821,1025189370,16943488818,-7003,,
15538893747,1013.52840,16943546532,1025240078,16943539526,-7006,,
15538944292,1013.57894,16943597080,1025290619,16943590067,-7013,,
15538994914,1013.62956,16943647704,1025341238,16943640686,-7018,,
15539045528,1013.68018,16943698320,1025391850,16943691298,-7022,,
15539096092,1013.73074,16943748887,1025442412,16943741859,-7028,,
15539146639,1013.78129,16943799436,1025492955,16943792403,-7033,,
15539196734,1013.83138,16943849533,1025543048,16943842496,-7037,,
15539247339,1013.88199,16943900140,1025593650,16943893097,-7043,,
15539297895,1013.93254,16943950698,1025644203,16943943651,-7047,,
15539348908,1013.98356,16944001713,1025695213,16943994660,-7053,,
15539399482,1014.03413,16944052301,1025745795,16944045242,-7059,,
15539450040,1014.08469,16944102861,1025796350,16944095798,-7063,,
15539501118,1014.13577,16944153931,1025847428,16944146875,-7056,,
15539552169,1014.18682,16944204984,1025898463,16944197910,-7074,,
15539603184,1014.23783,16944256012,1025949486,16944248934,-7078,,
15539653729,1014.28838,16944306549,1026000018,16944299465,-7084,,
15539704549,1014.33920,16944357372,1026050835,16944350283,-7089,,
15539754697,1014.38935,16944407522,1026100982,16944400429,-7093,,
15539805320,1014.43997,16944458147,1026151601,16944451048,-7099,,
15539855894,1014.49054,16944508724,1026202172,16944501620,-7104,,
15539906444,1014.54109,16944559276,1026252721,16944552168,-7108,,
15539957492,1014.59214,16944610326,1026303765,16944603212,-7114,,
15540008069,1014.64272,16944660906,1026354340,16944653787,-7119,,
15540059132,1014.69378,16944711971,1026405400,16944704847,-7124,,
15540109653,1014.74430,16944762495,1026455918,16944755366,-7129,,
15540160230,1014.79488,16944813073,1026506492,16944805940,-7133,,
15540210824,1014.84547,16944863670,1026557084,16944856531,-7139,,
15540261437,1014.89608,16944914286,1026607694,16944907141,-7145,,
15540312008,1014.94666,16944964859,1026658262,16944957710,-7149,,
15540362522,1014.99717,16945015376,1026708773,16945008221,-7155,,
15540413070,1015.04772,16945065926,1026759318,16945058766,-7160,,
15540463620,1015.09827,16945116478,1026809867,16945109314,-7164,,
15540514192,1015.14884,16945167053,1026860435,16945159883,-7170,,
15540565215,1015.19986,16945218078,1026911456,16945210903,-7175,,
15540615763,1015.25041,16945268628,1026962001,16945261449,-7179,,
15540666360,1015.30101,16945319227,1027012595,16945312042,-7185,,
15540716902,1015.35155,16945369772,1027063134,16945362582,-7190,,
15540767910,1015.40256,16945420782,1027114139,16945413587,-7195,,
15540818494,1015.45314,16945471369,1027164722,16945464169,-7200,,
15540869052,1015.50370,16945521929,1027215276,16945514724,-7205,,
15540920055,1015.55470,16945572934,1027266277,16945565724,-7210,,
15540971020,1015.60567,16945623902,1027317240,16945616687,-7215,,
15541021580,1015.65623,16945674464,1027367797,16945667244,-7220,,
15541072604,1015.70725,16945725490,1027418817,16945718264,-7226,,
15541123152,1015.75780,16945776040,1027469362,16945768809,-7231,,
15541173714,1015.80836,16945826605,1027519923,16945819370,-7235,,
15541224264,1015.85891,16945877158,1027570469,16945869917,-7241,,
15541275297,1015.90994,16945928193,1027621500,16945920947,-7246,,
15541325860,1015.96051,16945978758,1027672060,16945971507,-7251,,
15541376442,1016.01109,16946029343,1027722640,16946022087,-7256,,
15541428080,1016.06273,16946080983,1027774274,16946073722,-7261,,
15541479011,1016.11366,16946131915,1027825202,16946124649,-7266,,
15541529590,1016.16424,16946182498,1027875779,16946175227,-7271,,
15541580579,1016.21523,16946233489,1027926765,16946226213,-7276,,
15541631165,1016.26581,16946284078,1027977348,16946276796,-7282,,
15541682215,1016.31686,16946335130,1028028396,16946327843,-7287,,
15541733247,1016.36789,16946386164,1028079425,16946378873,-7291,,
15541783840,1016.41849,16946436760,1028130016,16946429463,-7297,,
15541834809,1016.46946,16946487730,1028180981,16946480428,-7302,,
15541885640,1016.52029,16946538563,1028231810,16946531257,-7306,,
15541936853,1016.57150,16946589780,1028283020,16946582468,-7312,,
15541987285,1016.62193,16946640213,1028333449,16946632896,-7317,,
15542037343,1016.67199,16946690273,1028383505,16946682952,-7321,,
15542087879,1016.72253,16946740812,1028434038,16946733485,-7327,,
15542138008,1016.77266,16946790943,1028484164,16946783611,-7332,,
15542188977,1016.82362,16946841915,1028535130,16946834578,-7337,,
15542239510,1016.87416,16946892451,1028585661,16946885109,-7342,,
15542290065,1016.92471,16946943008,1028636214,16946935661,-7347,,
15542341105,1016.97575,16946994051,1028687250,16946986698,-7353,,
15542391197,1017.02585,16947044145,1028737341,16947036789,-7356,,
15542442132,1017.07678,16947095082,1028788272,16947087720,-7362,,
15542493222,1017.12787,16947146176,1028839360,16947138808,-7368,,
15542543769,1017.17842,16947196724,1028889904,16947189352,-7372,,
15542594789,1017.22944,16947247746,1028940922,16947240369,-7377,,
15542645862,1017.28051,16947298822,1028991992,16947291440,-7382,,
15542696408,1017.33106,16947349381,1029042546,16947341993,-7388,,
15542746931,1017.38158,16947399894,1029093055,16947392502,-7392,,
15542797475,1017.43212,16947450442,1029143597,16947443044,-7398,,
15542848068,1017.48272,16947501037,1029194186,16947493634,-7403,,
15542898572,1017.53322,16947551542,1029244687,16947544135,-7407,,
15542949622,1017.58427,16947602595,1029295735,16947595182,-7413,,
15543000169,1017.63482,16947653145,1029346280,16947645727,-7418,,
15543050780,1017.68543,16947703759,1029396887,16947696335,-7424,,
15543101445,1017.73609,16947754425,1029447550,16947746997,-7428,,
15543151906,1017.78655,16947804889,1029498008,16947797456,-7433,,
15543202443,1017.83709,16947855440,1029548553,16947848001,-7439,,
15543253029,1017.88768,16947906017,1029599126,16947898573,-7444,,
15543303603,1017.93825,16947956593,1029649697,16947949145,-7448,,
15543354161,1017.98881,16948007154,1029700253,16947999700,-7454,,
15543404420,1018.03907,16948057415,1029750509,16948049957,-7458,,
15543454527,1018.08917,16948107524,1029800614,16948100061,-7463,,
15543505085,1018.13973,16948158085,1029851169,16948150616,-7469,,
15543556085,1018.19073,16948209086,1029902165,16948201612,-7474,,
15543606183,1018.24083,16948259187,1029952261,16948251709,-7478,,
15543657241,1018.29189,16948310247,1030003316,16948302764,-7483,,
15543707937,1018.34258,16948360946,1030054009,16948353457,-7489,,
15543758784,1018.39343,16948411795,1030104853,16948404301,-7494,,
15543809337,1018.44398,16948462362,1030155416,16948454863,-7499,,
15543859886,1018.49453,16948512901,1030205950,16948505398,-7503,,
15543910430,1018.54508,16948563448,1030256491,16948555939,-7509,,
15543961482,1018.59613,16948614503,1030307541,16948606988,-7515,,
15544011534,1018.64618,16948664557,1030357590,16948657037,-7520,,
15544062079,1018.69673,16948715105,1030408132,16948707580,-7525,,
15544113105,1018.74775,16948766133,1030459156,16948758603,-7530,,
15544163225,1018.79787,16948816254,1030509273,16948808721,-7533,,
15544213669,1018.84832,16948866702,1030559714,16948859162,-7540,,
15544263828,1018.89848,16948916863,1030609870,16948909318,-7545,,
15544314421,1018.94907,16948967457,1030660461,16948959908,-7549,,
15544365224,1018.99987,16949018264,1030711262,16949010709,-7555,,
15544416287,1019.05093,16949069329,1030762321,16949061769,-7560,,
15544467319,1019.10197,16949120363,1030813351,16949112799,-7564,,
15544517868,1019.15252,16949170914,1030863897,16949163344,-7570,,
15544568408,1019.20306,16949221456,1030914434,16949213882,-7574,,
15544618872,1019.25352,16949271923,1030964895,16949264342,-7581,,
15544669445,1019.30409,16949322499,1031015467,16949314914,-7585,,
15544720003,1019.35465,16949373059,1031066021,16949365468,-7591,,
15544770862,1019.40551,16949423920,1031116877,16949416324,-7596,,
15544821412,1019.45606,16949474473,1031167425,16949466873,-7600,,
15544872332,1019.50698,16949525394,1031218342,16949517790,-7604,,
15544922505,1019.55715,16949575582,1031268524,16949567971,-7611,,
15544973025,1019.60767,16949626093,1031319030,16949618477,-7616,,
15545023620,1019.65827,16949676690,1031369622,16949669070,-7620,,
15545074637,1019.70929,16949727710,1031420636,16949720083,-7627,,
15545125171,1019.75982,16949778245,1031471167,16949770614,-7631,,
15545175723,1019.81037,16949828799,1031521717,16949821164,-7635,,
15545226196,1019.86084,16949879276,1031572187,16949871635,-7641,,
15545276768,1019.91142,16949929850,1031622756,16949922204,-7646,,
15545326870,1019.96152,16949979954,1031672856,16949972304,-7650,,
15545377935,1020.01258,16950031032,1031723928,16950023376,-7656,,
15545428813,1020.06346,16950081912,1031774803,16950074251,-7661,,
15545479836,1020.11448,16950132927,1031825813,16950125261,-7666,,
15545530384,1020.16503,16950183477,1031876359,16950175806,-7671,,
15545580977,1020.21563,16950234072,1031926949,16950226396,-7676,,
15545631527,1020.26617,16950284625,1031977496,16950276943,-7682,,
15545682529,1020.31718,16950335630,1032028497,16950327944,-7686,,
15545733125,1020.36777,16950386228,1032079089,16950378537,-7691,,
15545783652,1020.41830,16950436767,1032129623,16950429070,-7697,,
15545834693,1020.46934,16950487801,1032180651,16950480098,-7703,,
15545885268,1020.51992,16950538389,1032231235,16950530683,-7706,,
15545935820,1020.57047,16950588933,1032281773,16950581220,-7713,,
15545986839,1020.62149,16950639954,1032332789,16950632237,-7717,,
15546037888,1020.67254,16950691005,1032383836,16950683284,-7721,,
15546088935,1020.72358,16950742055,1032434880,16950734328,-7727,,
15546139988,1020.77464,16950793109,1032485930,16950785378,-7731,,
15546190534,1020.82518,16950843658,1032536473,16950835920,-7738,,
15546240584,1020.87523,16950893710,1032586521,16950885969,-7741,,
15546290985,1020.92563,16950944114,1032636919,16950936367,-7747,,
15546341976,1020.97662,16950995107,1032687907,16950987354,-7753,,
15546392758,1021.02741,16951045892,1032738687,16951038135,-7757,,
15546442918,1021.07757,16951096054,1032788844,16951088292,-7762,,
15546493462,1021.12811,16951146601,1032839385,16951138833,-7768,,
15546544027,1021.17867,16951197167,1032889947,16951189394,-7773,,
15546594774,1021.22942,16951247917,1032940692,16951240140,-7777,,
15546645256,1021.27990,16951298401,1032991171,16951290618,-7783,,
15546695356,1021.33000,16951348503,1033041268,16951340715,-7788,,
15546745419,1021.38007,16951398569,1033091330,16951390777,-7792,,
15546795967,1021.43061,16951449119,1033141874,16951441321,-7798,,
15546846833,1021.48148,16951499997,1033192747,16951492194,-7803,,
15546897395,1021.53204,16951550552,1033243298,16951542745,-7807,,
15546948432,1021.58308,16951601592,1033294331,16951593778,-7814,,
15546999531,1021.63418,16951652693,1033345427,16951644875,-7818,,
15547050041,1021.68469,16951703204,1033395934,16951695381,-7823,,
15547101076,1021.73572,16951754243,1033446967,16951746414,-7829,,
15547151677,1021.78633,16951804846,1033497565,16951797013,-7833,,
15547202221,1021.83687,16951855393,1033548107,16951847554,-7839,,
15547253184,1021.88783,16951906358,1033599067,16951898514,-7844,,
15547304134,1021.93878,16951957310,1033650015,16951949462,-7848,,
15547354711,1021.98936,16952007890,1033700589,16952000036,-7854,,
15547405758,1022.04041,16952058939,1033751632,16952051080,-7859,,
15547456808,1022.09146,16952109991,1033802681,16952102128,-7863,,
15547507197,1022.14184,16952160383,1033853066,16952152514,-7869,,
15547557738,1022.19239,16952210926,1033903604,16952203052,-7874,,
15547608744,1022.24339,16952261934,1033954608,16952254055,-7879,,
15547659330,1022.29398,16952312523,1034005191,16952304639,-7884,,
15547709856,1022.34450,16952363051,1034055714,16952355162,-7889,,
15547760890,1022.39554,16952414087,1034106745,16952406192,-7895,,
15547810983,1022.44563,16952464183,1034156836,16952456284,-7899,,
15547861531,1022.49618,16952514733,1034207381,16952506829,-7904,,
15547912535,1022.54718,16952565740,1034258383,16952557830,-7910,,
15547962595,1022.59724,16952615802,1034308440,16952607888,-7914,,
15548013626,1022.64827,16952666835,1034359468,16952658916,-7919,,
15548063680,1022.69833,16952716891,1034409519,16952708966,-7925,,
15548113725,1022.74837,16952766939,1034459562,16952759009,-7930,,
15548164289,1022.79894,16952817505,1034510123,16952809571,-7934,,
15548214852,1022.84950,16952868071,1034560683,16952860131,-7940,,
15548265744,1022.90039,16952918965,1034611573,16952911020,-7945,,
15548316321,1022.95097,16952969544,1034662147,16952961595,-7949,,
15548366865,1023.00151,16953020091,1034712689,16953012137,-7954,,
15548417006,1023.05165,16953070234,1034762826,16953062274,-7960,,
15548467999,1023.10265,16953121229,1034813817,16953113264,-7965,,
15548518824,1023.15347,16953172057,1034864640,16953164087,-7970,,
15548569874,1023.20452,16953223109,1034915686,16953215134,-7975,,
15548620416,1023.25506,16953273654,1034966225,16953265673,-7981,,
15548671450,1023.30610,16953324690,1035017258,16953316705,-7985,,
15548722517,1023.35717,16953375758,1035068321,16953367769,-7989,,
15548773062,1023.40771,16953426307,1035118863,16953418311,-7996,,
15548824104,1023.45875,16953477351,1035169902,16953469350,-8001,,
15548875170,1023.50982,16953528418,1035220966,16953520413,-8005,,
15548925708,1023.56036,16953578960,1035271501,16953570949,-8011,,
15548976265,1023.61091,16953629518,1035322055,16953621502,-8016,,
15549026808,1023.66146,16953680064,1035372597,16953672044,-8020,,
15549077371,1023.71202,16953730630,1035423157,16953722604,-8026,,
15549127931,1023.76258,16953781202,1035473723,16953773171,-8031,,
15549178447,1023.81309,16953831710,1035524227,16953823674,-8036,,
15549228611,1023.86326,16953881877,1035574389,16953873836,-8041,,
15549279133,1023.91378,16953932401,1035624907,16953924355,-8046,,
15549329224,1023.96387,16953982505,1035675006,16953974454,-8051,,
15549380259,1024.01491,16954033532,1035726029,16954025476,-8056,,
15549430668,1024.06532,16954083942,1035776434,16954075881,-8061,,
15549480868,1024.11552,16954134145,1035826631,16954126078,-8067,,
15549531139,1024.16579,16954184419,1035876901,16954176348,-8071,,
15549791777,1024.42643,16954445068,1036137523,16954436971,-8097,16954443482,
15549816855,1024.45150,16954470148,1036162600,16954462080,-8068,,
15549867424,1024.50207,16954520718,1036213167,16954512712,-8006,,
15549917986,1024.55263,16954571284,1036263727,16954563338,-7946,,
15549968513,1024.60316,16954621812,1036314250,16954613927,-7885,,
15550018581,1024.65323,16954671884,1036364317,16954664059,-7825,,
15550069610,1024.70426,16954722915,1036415343,16954715152,-7763,,
15550120158,1024.75481,16954773464,1036465887,16954765761,-7703,,
15550170720,1024.80537,16954824030,1036516447,16954816387,-7643,,
15550220888,1024.85554,16954874199,1036566612,16954866618,-7581,,
15550271443,1024.90609,16954924757,1036617165,16954917237,-7520,,
15550321578,1024.95623,16954974894,1036667296,16954967433,-7461,,
15550371679,1025.00633,16955024998,1036717395,16955017598,-7400,,
15550422480,1025.05713,16955075801,1036768194,16955068462,-7339,,
15550473050,1025.10770,16955126373,1036818760,16955119094,-7279,,
15550523675,1025.15832,16955177000,1036869383,16955169783,-7217,,
15550574223,1025.20887,16955227551,1036919928,16955220395,-7156,,
15550625247,1025.25989,16955278578,1036970949,16955271481,-7097,,
15550676288,1025.31094,16955329621,1037021987,16955322587,-7034,,
15550726836,1025.36148,16955380171,1037072533,16955373198,-6973,,
15550777870,1025.41252,16955431208,1037123565,16955424296,-6912,,
15550828433,1025.46308,16955481773,1037174124,16955474922,-6851,,
15550878981,1025.51363,16955532324,1037224670,16955525534,-6790,,
15550929529,1025.56418,16955582875,1037275216,16955576146,-6729,,
15550980564,1025.61521,16955633911,1037326248,16955627243,-6668,,
15551031161,1025.66581,16955684511,1037376842,16955677903,-6608,,
15551081675,1025.71632,16955735027,1037427353,16955728481,-6546,,
15551132710,1025.76736,16955786064,1037478385,16955779579,-6485,,
15551182777,1025.81742,16955836134,1037528449,16955829709,-6425,,
15551233846,1025.86849,16955887204,1037579516,16955880841,-6363,,
15551284880,1025.91953,16955938241,1037630547,16955931940,-6301,,
15551335911,1025.97056,16955989275,1037681575,16955983034,-6241,,
15551386485,1026.02113,16956039851,1037732147,16956033671,-6180,,
15551437513,1026.07216,16956090881,1037783172,16956084762,-6119,,
15551488506,1026.12315,16956141878,1037834163,16956135821,-6057,,
15551539065,1026.17371,16956192438,1037884719,16956186442,-5996,,
15551589665,1026.22431,16956243042,1037935317,16956237106,-5936,,
15551640458,1026.27511,16956293836,1037986107,16956287962,-5874,,
15551691057,1026.32570,16956344436,1038036702,16956338624,-5812,,
15551741615,1026.37626,16956394998,1038087258,16956389244,-5754,,
15551792132,1026.42678,16956445517,1038137773,16956439825,-5692,,
15551842767,1026.47742,16956496153,1038188404,16956490522,-5631,,
15551893317,1026.52796,16956546706,1038238951,16956541136,-5570,,
15551944224,1026.57887,16956597616,1038289856,16956592107,-5509,,
15551994785,1026.62943,16956648179,1038340415,16956642731,-5448,,
15552044843,1026.67949,16956698240,1038390469,16956692851,-5389,,
15552095392,1026.73004,16956748790,1038441015,16956743463,-5327,,
15552145917,1026.78057,16956799317,1038491538,16956794051,-5266,,
15552196947,1026.83160,16956850351,1038542566,16956845146,-5205,,
15552247060,1026.88171,16956900466,1038592676,16956895321,-5145,,
15552297848,1026.93250,16956951266,1038643471,16956946182,-5084,,
15552348414,1026.98306,16957001824,1038694024,16956996801,-5023,,
15552398800,1027.03345,16957052212,1038744407,16957047249,-4963,,
15552448883,1027.08353,16957102298,1038794488,16957097396,-4902,,
15552499359,1027.13401,16957152777,1038844962,16957147935,-4842,,
15552550359,1027.18501,16957203779,1038895959,16957198999,-4780,,
15552600944,1027.23559,16957254366,1038946540,16957249646,-4720,,
15552651961,1027.28661,16957305386,1038997555,16957300728,-4658,,
15552702995,1027.33764,16957356422,1039048586,16957351826,-4596,,
15552753070,1027.38772,16957406499,1039098658,16957401962,-4537,,
15552804117,1027.43877,16957457549,1039149704,16957453074,-4475,,
15552854649,1027.48930,16957508083,1039200233,16957503669,-4414,,
15552905219,1027.53987,16957558656,1039250799,16957554302,-4354,,
15552955740,1027.59039,16957609179,1039301317,16957604886,-4293,,
15553006300,1027.64095,16957659740,1039351875,16957655509,-4231,,
15553056799,1027.69145,16957710243,1039402371,16957706072,-4171,,
15553107314,1027.74196,16957760760,1039452884,16957756649,-4111,,
15553157940,1027.79259,16957811387,1039503507,16957807339,-4048,,
15553208525,1027.84317,16957861978,1039554091,16957857989,-3989,,
15553259400,1027.89405,16957912853,1039604961,16957908925,-3928,,
15553309963,1027.94461,16957963430,1039655533,16957959562,-3868,,
15553360560,1027.99521,16958014018,1039706116,16958010212,-3806,,
15553410744,1028.04539,16958064204,1039756298,16958060459,-3745,,
15553461398,1028.09605,16958114861,1039806949,16958111176,-3685,,
15553511980,1028.14663,16958165455,1039857539,16958161831,-3624,,
15553562821,1028.19747,16958216288,1039908366,16958212726,-3562,,
15553613884,1028.24853,16958267353,1039959426,16958263851,-3502,,
15553664500,1028.29915,16958317983,1040010051,16958314542,-3441,,
15553715086,1028.34973,16958368560,1040060623,16958365181,-3379,,
15553766132,1028.40078,16958419614,1040111704,16958416328,-3286,,
15553816843,1028.45149,16958470322,1040162375,16958467065,-3257,,
15553867006,1028.50165,16958520487,1040212535,16958517291,-3196,,
15553917328,1028.55198,16958570813,1040262855,16958567676,-3137,,
15553968367,1028.60301,16958621852,1040313890,16958618778,-3074,,
15554019456,1028.65410,16958672944,1040364976,16958669930,-3014,,
15554069963,1028.70461,16958723453,1040415481,16958720500,-2953,,
15554120515,1028.75516,16958774008,1040466031,16958771116,-2892,,
15554171532,1028.80618,16958825028,1040517044,16958822197,-2831,,
15554221655,1028.85630,16958875153,1040567165,16958872383,-2770,,
15554272203,1028.90685,16958925702,1040617710,16958922994,-2708,,
15554323212,1028.95786,16958976715,1040668716,16958974065,-2650,,
15554373716,1029.00836,16959027220,1040719218,16959024633,-2587,,
15554423781,1029.05843,16959077288,1040769280,16959074761,-2527,,
15554474227,1029.10887,16959127737,1040819723,16959125270,-2467,,
15554525047,1029.15970,16959178559,1040870540,16959176153,-2406,,
15554575677,1029.21033,16959229202,1040921180,16959226858,-2344,,
15554626238,1029.26089,16959279755,1040971727,16959277471,-2284,,
15554676755,1029.31140,16959330274,1041022240,16959328051,-2223,,
15554727305,1029.36195,16959380825,1041072788,16959378664,-2161,,
15554778369,1029.41302,16959431893,1041123850,16959429793,-2100,,
15554829393,1029.46404,16959482919,1041174871,16959480831,-2088,,
15554880443,1029.51509,16959533972,1041225918,16959531878,-2094,,
15554931038,1029.56569,16959584568,1041276510,16959582470,-2098,,
15554981587,1029.61623,16959635119,1041327056,16959633016,-2103,,
15555032595,1029.66724,16959686130,1041378061,16959684021,-2109,,
15555083416,1029.71806,16959736954,1041428881,16959734841,-2113,,
15555133752,1029.76840,16959787291,1041479213,16959785173,-2118,,
15555184377,1029.81903,16959837920,1041529835,16959835795,-2125,,
15555235121,1029.86977,16959888666,1041580576,16959886537,-2129,,
15555286193,1029.92084,16959939740,1041631646,16959937606,-2134,,
15555337199,1029.97185,16959990749,1041682649,16959988610,-2139,,
15555387747,1030.02239,16960041298,1041733194,16960039154,-2144,,
15555438755,1030.07340,16960092309,1041784200,16960090161,-2148,,
15555489304,1030.12395,16960142861,1041834747,16960140707,-2154,,
15555539628,1030.17428,16960193186,1041885067,16960191027,-2159,,
15555590029,1030.22468,16960243591,1041935465,16960241425,-2166,,
15555640577,1030.27523,16960294141,1041986011,16960291972,-2169,,
15555690661,1030.32531,16960344227,1042036092,16960342053,-2174,,
15555740794,1030.37544,16960394363,1042086222,16960392183,-2180,,
15555791372,1030.42602,16960444942,1042136798,16960442758,-2184,,
15555841969,1030.47662,16960495542,1042187393,16960493353,-2189,,
15555892502,1030.52715,16960546078,1042237922,16960543883,-2195,,
15555943079,1030.57773,16960596656,1042288497,16960594457,-2199,,
15555993396,1030.62804,16960646976,1042338811,16960644772,-2204,,
15556043926,1030.67857,16960697508,1042389338,16960695298,-2210,,
15556094967,1030.72961,16960748552,1042440377,16960746337,-2215,,
15556145495,1030.78014,16960799082,1042490902,16960796863,-2219,,
15556196049,1030.83070,16960849639,1042541453,16960847414,-2225,,
15556246116,1030.88076,16960899707,1042591517,16960897477,-2230,,
15556297143,1030.93179,16960950737,1042642542,16960948503,-2234,,
15556348013,1030.98266,16961001610,1042693409,16960999369,-2241,,
15556398556,1031.03320,16961052155,1042743949,16961049909,-2246,,
15556449085,1031.08373,16961102686,1042794476,16961100436,-2250,,
15556499572,1031.13422,16961153175,1042844960,16961150921,-2254,,
15556550315,1031.18496,16961203932,1042895712,16961201672,-2260,,
15556601117,1031.23576,16961254726,1042946500,16961252460,-2266,,
15556651739,1031.28639,16961305349,1042997119,16961303079,-2270,,
15556702231,1031.33688,16961355844,1043047609,16961353569,-2275,,
15556752777,1031.38742,16961406393,1043098152,16961404112,-2281,,
15556803370,1031.43802,16961456988,1043148743,16961454703,-2285,,
15556853929,1031.48858,16961507548,1043199297,16961505258,-2290,,
15556904415,1031.53906,16961558038,1043249782,16961555742,-2296,,
15556955008,1031.58966,16961608640,1043300379,16961606339,-2301,,
15557006046,1031.64069,16961659672,1043351407,16961657367,-2305,,
15557057123,1031.69177,16961710752,1043402481,16961708441,-2311,,
15557108013,1031.74266,16961761656,1043453379,16961759340,-2316,,
15557158517,1031.79317,16961812152,1043503871,16961809831,-2321,,
15557209083,1031.84373,16961862720,1043554433,16961860394,-2326,,
15557259697,1031.89434,16961913335,1043605044,16961911005,-2330,,
15557310250,1031.94490,16961963891,1043655594,16961961554,-2337,,
15557360801,1031.99545,16962014445,1043706143,16962012104,-2341,,
15557411362,1032.04601,16962065008,1043756702,16962062662,-2346,,
15557462274,1032.09692,16962115923,1043807611,16962113571,-2352,,
15557512577,1032.14722,16962166228,1043857912,16962163873,-2355,,
15557563067,1032.19772,16962216719,1043908397,16962214358,-2361,,
15557613638,1032.24829,16962267294,1043958967,16962264927,-2367,,
15557664178,1032.29883,16962317835,1044009504,16962315464,-2371,,
15557715213,1032.34986,16962368873,1044060536,16962366496,-2377,,
15557765765,1032.40041,16962419428,1044111086,16962417046,-2382,,
15557816323,1032.45097,16962469987,1044161640,16962467601,-2386,,
15557866864,1032.50151,16962520530,1044212179,16962518139,-2391,,
15557917905,1032.55255,16962571575,1044263218,16962569178,-2397,,
15557968468,1032.60312,16962622140,1044313777,16962619737,-2403,,
15558019559,1032.65421,16962673234,1044364865,16962670826,-2408,,
15558070560,1032.70521,16962724237,1044415864,16962721824,-2413,,
15558120600,1032.75525,16962774279,1044465901,16962771861,-2418,,
15558170660,1032.80531,16962824342,1044515958,16962821919,-2423,,
15558221697,1032.85634,16962875381,1044566993,16962872954,-2427,,
15558272246,1032.90689,16962925932,1044617539,16962923500,-2432,,
15558322532,1032.95718,16962976231,1044667832,16962973793,-2438,,
15558373142,1033.00779,16963026832,1044718430,16963024390,-2442,,
15558424146,1033.05879,16963077838,1044769431,16963075391,-2447,,
15558474662,1033.10931,16963128358,1044819944,16963125905,-2453,,
15558525273,1033.15992,16963178970,1044870552,16963176512,-2458,,
15558575816,1033.21046,16963229516,1044921094,16963227054,-2462,,
15558626409,1033.26106,16963280112,1044971683,16963277644,-2468,,
15558676973,1033.31162,16963330678,1045022244,16963328205,-2473,,
15558727842,1033.36249,16963381561,1045073122,16963379083,-2478,,
15558778913,1033.41356,16963432623,1045124179,16963430140,-2483,,
15558829006,1033.46365,16963482717,1045174269,16963480229,-2488,,
15558879553,1033.51420,16963533268,1045224814,16963530774,-2494,,
15558930145,1033.56479,16963583862,1045275404,16963581364,-2498,,
15558980934,1033.61558,16963634653,1045326189,16963632150,-2503,,
15559031191,1033.66584,16963684912,1045376443,16963682403,-2509,,
15559081746,1033.71639,16963735469,1045426996,16963732956,-2513,,
15559132750,1033.76740,16963786476,1045477997,16963783957,-2519,,
15559183822,1033.81847,16963837562,1045529078,16963835038,-2524,,
15559234362,1033.86901,16963888093,1045579603,16963885564,-2529,,
15559285382,1033.92003,16963939115,1045630622,16963936582,-2533,,
15559336423,1033.97107,16963990159,1045681659,16963987620,-2539,,
15559386996,1034.02164,16964040734,1045732239,16964038200,-2534,,
15559437970,1034.07262,16964091710,1045783201,16964089161,-2549,,
15559488394,1034.12304,16964142137,1045833622,16964139583,-2554,,
15559539445,1034.17409,16964193190,1045884670,16964190630,-2560,,
15559590527,1034.22518,16964244275,1045935749,16964241710,-2565,,
15559641527,1034.27617,16964295276,1045986747,16964292707,-2569,,
15559692095,1034.32674,16964345847,1046037312,16964343273,-2574,,
15559742634,1034.37728,16964396388,1046087848,16964393808,-2580,,
15559793173,1034.42782,16964446929,1046138385,16964444345,-2584,,
15559843717,1034.47836,16964497476,1046188927,16964494887,-2589,,
15559893783,1034.52843,16964547545,1046238989,16964544950,-2595,,
15559944331,1034.57898,16964598095,1046289535,16964595496,-2599,,
15559994865,1034.62951,16964648630,1046340066,16964646026,-2604,,
15560045414,1034.68006,16964699183,1046390613,16964696573,-2610,,
15560095975,1034.73062,16964749745,1046441170,16964747130,-2615,,
15560146519,1034.78117,16964800292,1046491712,16964797673,-2619,,
15560197058,1034.83171,16964850833,1046542248,16964848208,-2625,,
15560247621,1034.88227,16964901399,1046592808,16964898769,-2630,,
15560298277,1034.93293,16964952058,1046643463,16964949423,-2635,,
15560348707,1034.98336,16965002490,1046693889,16964999850,-2640,,
15560398937,1035.03358,16965052722,1046744116,16965050077,-2645,,
15560449324,1035.08397,16965103111,1046794500,16965100461,-2650,,
15560499942,1035.13459,16965153732,1046845116,16965151077,-2655,,
15560550165,1035.18481,16965203957,1046895336,16965201297,-2660,,
15560600683,1035.23533,16965254478,1046945852,16965251812,-2666,,
15560651279,1035.28593,16965305076,1046996446,16965302407,-2669,,
15560701909,1035.33656,16965355707,1047047072,16965353032,-2675,,
15560752452,1035.38710,16965406254,1047097612,16965403573,-2681,,
15560802907,1035.43755,16965456710,1047148065,16965454025,-2685,,
15560853357,1035.48800,16965507163,1047198512,16965504473,-2690,,
15560903903,1035.53855,16965557723,1047249067,16965555028,-2695,,
15560954933,1035.58958,16965608744,1047300082,16965606043,-2701,,
15561005615,1035.64026,16965659428,1047350762,16965656723,-2705,,
15561056198,1035.69085,16965710013,1047401342,16965707302,-2711,,
15561107211,1035.74186,16965761029,1047452353,16965758313,-2716,,
15561157672,1035.79232,16965811492,1047502811,16965808771,-2721,,
15561207821,1035.84247,16965861644,1047552958,16965858919,-2725,,
15561258816,1035.89346,16965912641,1047603949,16965909910,-2731,,
15561309551,1035.94420,16965963379,1047654681,16965960642,-2737,,
15561360122,1035.99477,16966013952,1047705252,16966011212,-2740,,
15561411118,1036.04577,16966064950,1047756243,16966062203,-2747,,
15561461998,1036.09665,16966115833,1047807120,16966113081,-2752,,
15561513044,1036.14769,16966166881,1047858164,16966164125,-2756,,
15561563293,1036.19794,16966217132,1047908410,16966214371,-2761,,
15561613818,1036.24847,16966267667,1047958940,16966264901,-2766,,
15561664388,1036.29904,16966318231,1048009499,16966315460,-2771,,
15561714960,1036.34961,16966368806,1048060069,16966366029,-2777,,
15561765045,1036.39969,16966418906,1048110163,16966416124,-2782,,
15561815568,1036.45022,16966469419,1048160672,16966466632,-2787,,
15561865680,1036.50033,16966519532,1048210781,16966516741,-2791,,
15561916286,1036.55093,16966570142,1048261384,16966567345,-2797,,
15561966723,1036.60137,16966620581,1048311818,16966617778,-2803,,
15562017153,1036.65180,16966671013,1048362247,16966668207,-2806,,
15562067706,1036.70235,16966721569,1048412797,16966718757,-2812,,
15562117758,1036.75241,16966771623,1048462846,16966768806,-2817,,
15562168306,1036.80295,16966822172,1048513391,16966819351,-2821,,
15562218842,1036.85349,16966872712,1048563925,16966869885,-2827,,
15562269389,1036.90404,16966923261,1048614468,16966920429,-2832,,
15562319935,1036.95458,16966973809,1048665011,16966970971,-2838,,
15562370496,1037.00514,16967024373,1048715571,16967021531,-2842,,
15562421198,1037.05585,16967075076,1048766269,16967072229,-2847,,
15562471747,1037.10640,16967125629,1048816815,16967122776,-2853,,
15562521862,1037.15651,16967175746,1048866929,16967172889,-2857,,
15562572357,1037.20700,16967226243,1048917420,16967223381,-2862,,
15562623094,1037.25774,16967276983,1048968154,16967274115,-2868,,
15562673633,1037.30828,16967327523,1049018690,16967324650,-2873,,
15562724197,1037.35884,16967378090,1049069252,16967375213,-2877,,
15562775234,1037.40988,16967429130,1049120286,16967426247,-2883,,
15562826246,1037.46089,16967480144,1049171295,16967477256,-2888,,
15562876359,1037.51101,16967530258,1049221406,16967527366,-2892,,
15562926624,1037.56127,16967580527,1049271669,16967577630,-2897,,
15562977501,1037.61215,16967631406,1049322543,16967628503,-2903,,
15563028064,1037.66271,16967681971,1049373103,16967679064,-2907,,
15563078651,1037.71330,16967732560,1049423687,16967729647,-2913,,
15563129701,1037.76435,16967783612,1049474734,16967780695,-2917,,
15563180733,1037.81538,16967834648,1049525764,16967831724,-2924,,
15563231296,1037.86594,16967885212,1049576324,16967882285,-2927,,
15563281845,1037.91649,16967935763,1049626870,16967932830,-2933,,
15563332866,1037.96751,16967986787,1049677888,16967983848,-2939,,
15563383913,1038.01856,16968037837,1049728933,16968034893,-2944,,
15563434477,1038.06912,16968088403,1049779495,16968085455,-2948,,
15563485469,1038.12012,16968139397,1049830483,16968136444,-2953,,
15563536028,1038.17068,16968189959,1049881040,16968187000,-2959,,
15563586572,1038.22122,16968240505,1049931582,16968237542,-2963,,
15563637618,1038.27227,16968291554,1049982624,16968288584,-2970,,
15563688157,1038.32281,16968342095,1050033161,16968339121,-2974,,
15563739255,1038.37390,16968393195,1050084254,16968390215,-2980,,
15563790254,1038.42490,16968444197,1050135253,16968441213,-2984,,
15563841269,1038.47592,16968495213,1050186264,16968492224,-2989,,
15563892333,1038.52698,16968546281,1050237325,16968543286,-2995,,
15563943379,1038.57803,16968597329,1050288370,16968594330,-2999,,
15563994419,1038.62907,16968648371,1050339407,16968645367,-3004,,
15564044491,1038.67914,16968698446,1050389476,16968695436,-3010,,
15564095049,1038.72970,16968749017,1050440042,16968746003,-3014,,
15564146098,1038.78075,16968800057,1050491077,16968797037,-3020,,
15564197132,1038.83178,16968851094,1050542108,16968848069,-3025,,
15564247667,1038.88232,16968901631,1050592640,16968898601,-3030,,
15564298218,1038.93287,16968952185,1050643189,16968949150,-3035,,
15564348819,1038.98347,16969002788,1050693788,16968999748,-3040,,
15564399394,1039.03404,16969053365,1050744360,16969050320,-3045,,
15564450424,1039.08507,16969104398,1050795387,16969101347,-3051,,
15564500991,1039.13564,16969154967,1050845952,16969151912,-3055,,
15564551649,1039.18630,16969205627,1050896606,16969202567,-3060,,
15564602059,1039.23671,16969256040,1050947013,16969252974,-3066,,
15564653018,1039.28767,16969307000,1050997970,16969303930,-3070,,
15564704044,1039.33869,16969358029,1051048993,16969354954,-3075,,
15564754596,1039.38924,16969408583,1051099542,16969405503,-3080,,
15564805142,1039.43979,16969459132,1051150086,16969456046,-3086,,
15564855638,1039.49029,16969509630,1051200579,16969506540,-3090,,
15564906311,1039.54096,16969560306,1051251249,16969557210,-3096,,
15564956462,1039.59111,16969610459,1051301398,16969607359,-3100,,
15565007460,1039.64211,16969661460,1051352393,16969658353,-3107,,
15565057599,1039.69225,16969711600,1051402529,16969708490,-3110,,
15565108183,1039.74283,16969762187,1051453111,16969759071,-3116,,
15565158727,1039.79337,16969812734,1051503652,16969809613,-3121,,
15565209769,1039.84442,16969863777,1051554691,16969860651,-3126,,
15565259905,1039.89455,16969913916,1051604825,16969910785,-3131,,
15565310006,1039.94465,16969964020,1051654923,16969960883,-3137,,
15565360729,1039.99538,16970014744,1051705643,16970011604,-3140,,
15565411158,1040.04581,16970065176,1051756070,16970062030,-3146,,
15565461744,1040.09639,16970115764,1051806652,16970112613,-3151,,
15565512279,1040.14693,16970166302,1051857186,16970163146,-3156,,
15565563248,1040.19790,16970217272,1051908151,16970214111,-3161,,
15565613793,1040.24844,16970267821,1051958693,16970264654,-3167,,
15565664433,1040.29908,16970318463,1052009330,16970315291,-3172,,
15565714984,1040.34963,16970369015,1052059879,16970365840,-3175,,
15565766015,1040.40066,16970420050,1052110907,16970416868,-3182,,
15565816599,1040.45125,16970470636,1052161489,16970467450,-3186,,
15565867122,1040.50177,16970521161,1052212009,16970517970,-3191,,
15565918169,1040.55282,16970572210,1052263053,16970569013,-3197,,
15565968735,1040.60338,16970622779,1052313617,16970619577,-3202,,
15566019290,1040.65394,16970673337,1052364170,16970670130,-3207,,
15566069802,1040.70445,16970723850,1052414678,16970720638,-3212,,
15566120364,1040.75501,16970774414,1052465237,16970771197,-3217,,
15566170911,1040.80556,16970824965,1052515782,16970821742,-3223,,
15566221452,1040.85610,16970875508,1052566320,16970872280,-3228,,
15566272504,1040.90715,16970926562,1052617369,16970923329,-3233,,
15566323048,1040.95770,16970977108,1052667910,16970973870,-3238,,
15566373583,1041.00823,16971027645,1052718443,16971024404,-3241,,
15566423650,1041.05830,16971077715,1052768508,16971074468,-3247,,
15566474194,1041.10884,16971128261,1052819048,16971125009,-3252,,
15566524741,1041.15939,16971178811,1052869592,16971175553,-3258,,
15566575788,1041.21044,16971229860,1052920637,16971226598,-3262,,
15566626361,1041.26101,16971280436,1052971207,16971277168,-3268,,
15566676524,1041.31117,16971330601,1053021368,16971327328,-3273,,
15566727472,1041.36212,16971381551,1053072313,16971378274,-3277,,
15566778061,1041.41271,16971432142,1053122899,16971428859,-3283,,
15566828627,1041.46328,16971482711,1053173462,16971479422,-3289,,
15566879021,1041.51367,16971533107,1053223854,16971529814,-3293,,
15566929666,1041.56431,16971583755,1053274496,16971580457,-3298,,
15566980214,1041.61486,16971634304,1053325041,16971631001,-3303,,
15567031220,1041.66587,16971685314,1053376044,16971682005,-3309,,
15567081801,1041.71645,16971735897,1053426623,16971732584,-3313,,
15567132352,1041.76700,16971786449,1053477171,16971783131,-3318,,
15567182873,1041.81752,16971836973,1053527689,16971833649,-3324,,
15567233460,1041.86811,16971887563,1053578275,16971884235,-3328,,
15567284236,1041.91888,16971938340,1053629047,16971935007,-3333,,
15567335019,1041.96967,16971989126,1053679827,16971985787,-3339,,
15567385600,1042.02025,16972039710,1053730405,16972036365,-3345,,
15567436278,1042.07093,16972090390,1053781082,16972087042,-3348,,
15567487124,1042.12177,16972141249,1053831934,16972137895,-3354,,
15567537459,1042.17211,16972191575,1053882256,16972188216,-3359,,
15567588491,1042.22314,16972242610,1053933286,16972239246,-3364,,
15567639914,1042.27456,16972294035,1053984706,16972290666,-3369,,
15567690055,1042.32470,16972344189,1054034854,16972340815,-3374,,
15567740615,1042.37526,16972394742,1054085402,16972391362,-3380,,
15567790692,1042.42534,16972444821,1054135476,16972441437,-3384,,
15567843918,1042.47857,16972498048,1054188699,16972494659,-3389,,
15567894799,1042.52945,16972548933,1054239577,16972545538,-3395,,
15567945840,1042.58049,16972599975,1054290615,16972596575,-3400,,
15567996850,1042.63150,16972650989,1054341624,16972647584,-3405,,
15568047919,1042.68257,16972702060,1054392689,16972698650,-3410,,
15568098500,1042.73315,16972752643,1054443267,16972749228,-3415,,
15568149503,1042.78415,16972803649,1054494269,16972800229,-3420,,
15568200051,1042.83470,16972854199,1054544813,16972850774,-3425,,
15568250108,1042.88476,16972904258,1054594867,16972900827,-3431,,
15568300171,1042.93482,16972954323,1054644927,16972950888,-3435,,
15568350505,1042.98515,16973004659,1054695259,16973001220,-3439,,
15568401048,1043.03570,16973055204,1054745799,16973051759,-3445,,
15568451618,1043.08627,16973105777,1054796366,16973102326,-3451,,
15568502649,1043.13730,16973156810,1054847395,16973153355,-3455,,
15568552722,1043.18737,16973206886,1054897465,16973203426,-3460,,
15568603255,1043.23790,16973257421,1054947995,16973253955,-3466,,
15568653795,1043.28844,16973307964,1054998534,16973304494,-3470,,
15568704840,1043.33949,16973359011,1055049576,16973355536,-3475,,
15568755860,1043.39051,16973410034,1055100592,16973406553,-3481,,
15568806270,1043.44092,16973460446,1055150999,16973456960,-3486,,
15568856839,1043.49149,16973511027,1055201577,16973507538,-3489,,
15568907158,1043.54181,16973561339,1055251883,16973557843,-3496,,
15568958086,1043.59273,16973612268,1055302807,16973608768,-3500,,
15569008336,1043.64298,16973662521,1055353055,16973659015,-3506,,
15569058839,1043.69349,16973713026,1055403555,16973709516,-3510,,
15569109209,1043.74386,16973763399,1055453922,16973759883,-3516,,
15569159642,1043.79429,16973813835,1055504352,16973810313,-3522,,
15569209811,1043.84446,16973864005,1055554519,16973860479,-3526,,
15569260296,1043.89494,16973914493,1055605001,16973910962,-3531,,
15569312388,1043.94704,16973966588,1055657090,16973963051,-3537,,
15569363359,1043.99801,16974017560,1055708059,16974014019,-3541,,
15569414091,1044.04874,16974068295,1055758788,16974064749,-3546,,
15569464943,1044.09959,16974119150,1055809638,16974115599,-3551,,
15569515470,1044.15012,16974169679,1055860161,16974166122,-3557,,
15569566508,1044.20116,16974220718,1055911197,16974217158,-3560,,
15569616599,1044.25125,16974270813,1055961285,16974267246,-3567,,
15569666683,1044.30133,16974320899,1056011366,16974317327,-3572,,
15569717287,1044.35193,16974371506,1056061969,16974367929,-3577,,
15569767864,1044.40251,16974422085,1056112543,16974418503,-3582,,
15569818482,1044.45313,16974472705,1056163158,16974469118,-3587,,
15569869172,1044.50382,16974523398,1056213845,16974519806,-3592,,
15569919710,1044.55436,16974573938,1056264380,16974570340,-3598,,
15569970751,1044.60540,16974624980,1056315418,16974621378,-3602,,
15570021321,1044.65597,16974675554,1056365985,16974671946,-3608,,
15570071915,1044.70656,16974726149,1056416577,16974722538,-3611,,
15570122063,1044.75671,16974776300,1056466723,16974772683,-3617,,
15570172587,1044.80723,16974826826,1056517243,16974823203,-3623,,
15570222644,1044.85729,16974876886,1056567298,16974873259,-3627,,
15570273184,1044.90783,16974927428,1056617835,16974923796,-3632,,
15570323339,1044.95799,16974977586,1056667988,16974973948,-3638,,
15570374422,1045.00907,16975028670,1056719068,16975025028,-3642,,
15570425440,1045.06009,16975079690,1056770083,16975076043,-3647,,
15570476532,1045.11118,16975130786,1056821172,16975127133,-3653,,
15570527127,1045.16178,16975181382,1056871764,16975177724,-3658,,
15570577234,1045.21188,16975231491,1056921869,16975227829,-3662,,
15570628258,1045.26291,16975282519,1056972890,16975278851,-3668,,
15570679295,1045.31394,16975333558,1057023925,16975329885,-3673,,
15570729352,1045.36400,16975383618,1057073979,16975379939,-3679,,
15570779415,1045.41406,16975433693,1057124049,16975430010,-3683,,
15570829504,1045.46415,16975483774,1057174125,16975480086,-3688,,
15570879819,1045.51447,16975534092,1057224437,16975530398,-3694,,
15570930726,1045.56537,16975585000,1057275342,16975581302,-3698,,
15570981366,1045.61601,16975635643,1057325980,16975631940,-3703,,
15571031926,1045.66657,16975686216,1057376547,16975682507,-3709,,
15571082954,1045.71760,16975737236,1057427563,16975733523,-3713,,
15571133908,1045.76856,16975788192,1057478514,16975784474,-3718,,
15571184791,1045.81944,16975839078,1057529404,16975835365,-3713,,
15571235434,1045.87008,16975889723,1057580033,16975885994,-3729,,
15571286480,1045.92113,16975940771,1057631077,16975937038,-3733,,
15571337025,1045.97167,16975991319,1057681620,16975987580,-3739,,
15571387597,1046.02225,16976041893,1057732188,16976038149,-3744,,
15571438670,1046.07332,16976092969,1057783260,16976089220,-3749,,
15571489215,1046.12386,16976143516,1057833801,16976139761,-3755,,
15571540035,1046.17468,16976194338,1057884618,16976190579,-3759,,
15571590615,1046.22526,16976244931,1057935205,16976241166,-3765,,
15571641732,1046.27638,16976296040,1057986310,16976292271,-3769,,
15571691861,1046.32651,16976346181,1058036446,16976342407,-3774,,
15571742923,1046.37757,16976397236,1058087495,16976393456,-3780,,
15571793964,1046.42861,16976448279,1058138535,16976444495,-3784,,
15571844516,1046.47916,16976498832,1058189083,16976495043,-3789,,
15571895101,1046.52975,16976549421,1058239665,16976545625,-3796,,
15571946132,1046.58078,16976600454,1058290693,16976596654,-3800,,
15571997182,1046.63183,16976651506,1058341741,16976647702,-3804,,
15572047759,1046.68241,16976702085,1058392315,16976698275,-3810,,
15572098807,1046.73346,16976753136,1058443360,16976749321,-3815,,
15572149825,1046.78447,16976804156,1058494376,16976800336,-3820,,
15572200373,1046.83502,16976854707,1058544921,16976850882,-3825,,
15572250918,1046.88557,16976905254,1058595464,16976901424,-3830,,
15572301501,1046.93615,16976955840,1058646044,16976952004,-3836,,
15572352521,1046.98717,16977006862,1058697061,16977003022,-3840,,
15572403565,1047.03821,16977057907,1058748102,16977054062,-3845,,
15572454149,1047.08880,16977108494,1058798683,16977104643,-3851,,
15572504302,1047.13895,16977158650,1058848835,16977154795,-3855,,
15572554503,1047.18915,16977208853,1058899032,16977204993,-3860,,
15572604925,1047.23957,16977259288,1058949461,16977255422,-3866,,
15572655960,1047.29061,16977310315,1059000483,16977306444,-3871,,
15572706508,1047.34116,16977360866,1059051030,16977356990,-3876,,
15572756632,1047.39128,16977410992,1059101151,16977407112,-3880,,
15572807672,1047.44232,16977462034,1059152188,16977458148,-3886,,
15572857771,1047.49242,16977512136,1059202285,16977508245,-3891,,
15572908377,1047.54302,16977562743,1059252887,16977558847,-3896,,
15572958917,1047.59356,16977613286,1059303425,16977609385,-3901,,
15573009053,1047.64370,16977663424,1059353558,16977659518,-3906,,
15573059617,1047.69427,16977713991,1059404132,16977710092,-3899,,
15573110255,1047.74490,16977764631,1059454755,16977760715,-3916,,
15573161244,1047.79589,16977815622,1059505740,16977811700,-3922,,
15573211323,1047.84597,16977865704,1059555818,16977861779,-3925,,
15573261911,1047.89656,16977916294,1059606403,16977912364,-3930,,
15573312673,1047.94732,16977967059,1059657161,16977963122,-3937,,
15573363222,1047.99787,16978017610,1059707708,16978013668,-3942,,
15573414240,1048.04889,16978068630,1059758723,16978064684,-3946,,
15573464891,1048.09954,16978119284,1059809372,16978115332,-3952,,
15573515467,1048.15011,16978169861,1059859944,16978165905,-3956,,
15573565599,1048.20025,16978219996,1059910075,16978216036,-3960,,
15573616170,1048.25082,16978270570,1059960643,16978266603,-3967,,
15573666701,1048.30135,16978321103,1060011170,16978317131,-3972,,
15573717750,1048.35240,16978372155,1060062218,16978368178,-3977,,
15573767861,1048.40251,16978422268,1060112325,16978418286,-3982,,
15573818015,1048.45266,16978472424,1060162477,16978468437,-3987,,
15573868613,1048.50326,16978523037,1060213085,16978519046,-3991,,
15573918787,1048.55344,16978573200,1060263243,16978569203,-3997,,
15573969352,1048.60400,16978623768,1060313806,16978619766,-4002,,
15574020099,1048.65475,16978674517,1060364549,16978670509,-4008,,
15574070679,1048.70533,16978725099,1060415127,16978721088,-4011,,
15574121726,1048.75637,16978776148,1060466171,16978772131,-4017,,
15574172240,1048.80689,16978826666,1060516683,16978822643,-4023,,
15574222817,1048.85747,16978877245,1060567258,16978873218,-4027,,
15574273851,1048.90850,16978928281,1060618289,16978924249,-4032,,
15574324893,1048.95954,16978979326,1060669327,16978975288,-4038,,
15574375461,1049.01011,16979029897,1060719894,16979025854,-4043,,
15574426462,1049.06111,16979080899,1060770891,16979076852,-4047,,
15574477535,1049.11218,16979131975,1060821962,16979127922,-4053,,
15574528593,1049.16324,16979183035,1060873016,16979178977,-4058,,
15574579653,1049.21430,16979234098,1060924074,16979230035,-4063,,
15574630671,1049.26532,16979285117,1060975089,16979281049,-4068,,
15574681205,1049.31585,16979335654,1061025621,16979331581,-4073,,
15574731322,1049.36597,16979385774,1061075734,16979381694,-4080,,
15574781808,1049.41646,16979436262,1061126219,16979432179,-4083,,
15574832411,1049.46706,16979486867,1061176818,16979482779,-4088,,
15574883016,1049.51766,16979537475,1061227420,16979533380,-4095,,
15574933543,1049.56819,16979588004,1061277946,16979583906,-4098,,
15574983617,1049.61827,16979638091,1061328027,16979633988,-4103,,
15575034663,1049.66931,16979689129,1061379060,16979685020,-4109,,
15575085685,1049.72033,16979740153,1061430078,16979736039,-4114,,
15575136735,1049.77138,16979791205,1061481126,16979787087,-4118,,
15575187166,1049.82181,16979841639,1061531555,16979837515,-4124,,
15575238220,1049.87287,16979892694,1061582605,16979888565,-4129,,
15575288788,1049.92344,16979943265,1061633171,16979939131,-4134,,
15575339370,1049.97402,16979993860,1061683761,16979989722,-4138,,
15575389979,1050.02463,16980044460,1061734356,16980040316,-4144,,
15575440876,1050.07552,16980095361,1061785250,16980091211,-4150,,
15575491874,1050.12652,16980146361,1061836246,16980142207,-4154,,
15575542848,1050.17750,16980197336,1061887217,16980193177,-4159,,
15575593153,1050.22780,16980247644,1061937519,16980243479,-4165,,
15575643848,1050.27850,16980298341,1061988212,16980294172,-4169,,
15575694068,1050.32872,16980348563,1062038429,16980344390,-4173,,
15575745113,1050.37976,16980399611,1062089471,16980395431,-4180,,
15575795723,1050.43037,16980450224,1062140078,16980446039,-4185,,
15575846325,1050.48097,16980500829,1062190678,16980496639,-4190,,
15575897354,1050.53200,16980551860,1062241705,16980547665,-4195,,
15575947940,1050.58259,16980602447,1062292287,16980598247,-4200,,
15575998765,1050.63341,16980653275,1062343110,16980649071,-4204,,
15576049342,1050.68399,16980703855,1062393685,16980699645,-4210,,
15576100366,1050.73501,16980754880,1062444705,16980750666,-4214,,
15576150939,1050.78559,16980805457,1062495276,16980801236,-4221,,
15576200986,1050.83563,16980855506,1062545321,16980851281,-4225,,
15576251136,1050.88578,16980905658,1062595468,16980901428,-4230,,
15576301746,1050.93639,16980956271,1062646074,16980952035,-4236,,
15576352326,1050.98697,16981006852,1062696652,16981002613,-4239,,
15576403185,1051.03783,16981057714,1062747509,16981053469,-4245,,
15576453745,1051.08839,16981108277,1062798065,16981104026,-4251,,
15576504437,1051.13909,16981158970,1062848755,16981154715,-4255,,
15576555041,1051.18969,16981209577,1062899357,16981205317,-4260,,
15576605578,1051.24023,16981260117,1062949891,16981255851,-4266,,
15576656019,1051.29067,16981310560,1063000329,16981306289,-4271,,
15576706749,1051.34140,16981361292,1063051056,16981357017,-4275,,
15576757319,1051.39197,16981411865,1063101624,16981407585,-4280,,
15576807857,1051.44250,16981462405,1063152159,16981458119,-4286,,
15576858404,1051.49305,16981512955,1063202703,16981508664,-4291,,
15576909442,1051.54409,16981563994,1063253738,16981559698,-4296,,
15576959987,1051.59463,16981614542,1063304280,16981610241,-4301,,
15577010044,1051.64469,16981664602,1063354334,16981660295,-4307,,
15577061096,1051.69574,16981715655,1063405384,16981711344,-4311,,
15577112179,1051.74683,16981766740,1063456464,16981762425,-4315,,
15577163198,1051.79785,16981817763,1063507480,16981813441,-4322,,
15577213809,1051.84846,16981868377,1063558090,16981864051,-4326,,
15577264358,1051.89901,16981918927,1063608636,16981914597,-4330,,
15577315378,1051.95003,16981969950,1063659653,16981965613,-4337,,
15577365602,1052.00025,16982020176,1063709874,16982015834,-4342,,
15577416505,1052.05115,16982071082,1063760775,16982066735,-4347,,
15577467078,1052.10173,16982121656,1063811344,16982117305,-4351,,
15577517640,1052.15229,16982172221,1063861903,16982167874,-4347,,
15577568731,1052.20338,16982223314,1063912992,16982218952,-4362,,
15577619783,1052.25443,16982274369,1063964041,16982270002,-4367,,
15577670832,1052.30548,16982325420,1064015088,16982321049,-4371,,
15577721888,1052.35654,16982376479,1064066140,16982372101,-4378,,
15577772030,1052.40668,16982426623,1064116280,16982422241,-4382,,
15577823080,1052.45773,16982477674,1064167327,16982473287,-4387,,
15577874109,1052.50876,16982528706,1064218353,16982524313,-4393,,
15577924660,1052.55931,16982579259,1064268902,16982574862,-4397,,
15577975191,1052.60984,16982629794,1064319431,16982625391,-4403,,
15578025770,1052.66042,16982680375,1064370006,16982675966,-4409,,
15578076808,1052.71146,16982731415,1064421041,16982727002,-4413,,
15578127907,1052.76256,16982782517,1064472139,16982778099,-4418,,
15578178393,1052.81304,16982833004,1064522621,16982828581,-4423,,
15578228443,1052.86309,16982883057,1064572669,16982878629,-4428,,
15578278484,1052.91313,16982933101,1064622708,16982928668,-4433,,
15578328596,1052.96324,16982983215,1064672817,16982978777,-4438,,
15578379598,1053.01425,16983034219,1064723815,16983029776,-4443,,
15578430123,1053.06477,16983084747,1064774339,16983080299,-4448,,
15578482675,1053.11732,16983137301,1064826887,16983132848,-4453,,
15578532725,1053.16737,16983187352,1064876934,16983182895,-4457,,
15578582874,1053.21752,16983237505,1064927081,16983233041,-4464,,
15578634607,1053.26925,16983289239,1064978811,16983284771,-4468,,
15578686988,1053.32164,16983341623,1065031189,16983337149,-4474,,
15578737934,1053.37258,16983392572,1065082132,16983388092,-4480,,
15578788539,1053.42319,16983443178,1065132734,16983438694,-4484,,
15578839026,1053.47367,16983493669,1065183219,16983489179,-4490,,
15578889576,1053.52422,16983544221,1065233766,16983539726,-4495,,
15578940125,1053.57477,16983594772,1065284312,16983590273,-4499,,
15578991173,1053.62582,16983645823,1065335359,16983641319,-4504,,
15579041903,1053.67655,16983696555,1065386086,16983692046,-4509,,
15579092508,1053.72716,16983747161,1065436687,16983742648,-4513,,
15579142940,1053.77759,16983797597,1065487116,16983793077,-4520,,
15579193811,1053.82846,16983848469,1065537985,16983843945,-4524,,
15579244093,1053.87874,16983898754,1065588264,16983894224,-4530,,
15579294772,1053.92942,16983949436,1065638940,16983944901,-4535,,
15579345074,1053.97972,16983999739,1065689240,16983995201,-4538,,
15579395760,1054.03041,16984050429,1065739923,16984045884,-4545,,
15579446084,1054.08073,16984100754,1065790244,16984096204,-4550,,
15579496555,1054.13120,16984151227,1065840712,16984146673,-4554,,
15579547391,1054.18204,16984202067,1065891546,16984197507,-4560,,
15579597722,1054.23237,16984252399,1065941874,16984247838,-4561,,
15579648400,1054.28305,16984303079,1065992549,16984298510,-4569,,
15579699027,1054.33368,16984353709,1066043174,16984349134,-4575,,
15579749607,1054.38425,16984404292,1066093763,16984399723,-4569,,
15579800051,1054.43470,16984454737,1066144192,16984450163,-4574,,
15579850554,1054.48520,16984505243,1066194693,16984500654,-4589,,
15579901610,1054.53626,16984556302,1066245746,16984551707,-4595,,
15579952101,1054.58675,16984606795,1066296234,16984602195,-4600,,
15580002402,1054.63705,16984657098,1066346532,16984652492,-4606,,
15580052884,1054.68753,16984707582,1066397023,16984702983,-4599,,
15580103474,1054.73812,16984758175,1066447599,16984753560,-4615,,
15580154085,1054.78873,16984808789,1066498207,16984804168,-4621,,
15580204612,1054.83926,16984859317,1066548732,16984854692,-4625,,
15580254981,1054.88963,16984909690,1066599098,16984905058,-4632,,
15580305520,1054.94017,16984960231,1066649634,16984955595,-4636,,
15580355856,1054.99050,16985010568,1066699967,16985005938,-4630,,
15580406600,1055.04125,16985061316,1066750709,16985056670,-4646,,
15580456844,1055.09149,16985111562,1066800950,16985106911,-4651,,
15580507259,1055.14191,16985161979,1066851362,16985157322,-4657,,
15580557379,1055.19203,16985212102,1066901480,16985207440,-4662,,
15580607585,1055.24223,16985262309,1066951683,16985257654,-4655,,
15580658162,1055.29281,16985312888,1067002257,16985308218,-4670,,
15580708890,1055.34354,16985363620,1067052984,16985358944,-4676,,
15580759965,1055.39461,16985414697,1067104055,16985410016,-4681,,
15580810952,1055.44560,16985465686,1067155039,16985461000,-4686,,
15580862001,1055.49665,16985516737,1067206085,16985512045,-4692,,
15580913050,1055.54770,16985567789,1067257132,16985563093,-4696,,
15580963876,1055.59852,16985618617,1067307956,16985613916,-4701,,
15581014488,1055.64914,16985669232,1067358565,16985664525,-4707,,
15581065049,1055.69970,16985719795,1067409123,16985715084,-4711,,
15581116129,1055.75078,16985770878,1067460200,16985766161,-4717,,
15581167183,1055.80183,16985821934,1067511252,16985817212,-4722,,
15581218207,1055.85286,16985872960,1067562272,16985868233,-4727,,
15581269240,1055.90389,16985923996,1067613304,16985919264,-4732,,
15581320326,1055.95497,16985975083,1067664386,16985970347,-4736,,
15581371381,1056.00603,16986026141,1067715438,16986021399,-4742,,
15581422408,1056.05706,16986077171,1067766462,16986072423,-4748,,
15581473455,1056.10810,16986128220,1067817517,16986123478,-4742,,
15581524524,1056.15917,16986179292,1067868573,16986174534,-4758,,
15581575578,1056.21023,16986230348,1067919624,16986225585,-4763,,
15581626624,1056.26127,16986281396,1067970668,16986276628,-4768,,
15581677256,1056.31190,16986332031,1068021298,16986327258,-4773,,
15581727793,1056.36244,16986382569,1068071843,16986377803,-4766,,
15581777974,1056.41262,16986432752,1068122009,16986427970,-4782,,
15581828139,1056.46279,16986482921,1068172183,16986478144,-4777,,
15581878627,1056.51328,16986533411,1068222657,16986528618,-4793,,
15581929135,1056.56378,16986583921,1068273163,16986579123,-4798,,
15581979755,1056.61440,16986634543,1068323780,16986629740,-4803,,
15582029889,1056.66454,16986684679,1068373911,16986679871,-4808,,
15582080269,1056.71492,16986735062,1068424288,16986730249,-4813,,
15582130860,1056.76551,16986785656,1068474877,16986780838,-4818,,
15582181733,1056.81638,16986836531,1068525748,16986831708,-4823,,
15582232273,1056.86692,16986887072,1068576284,16986882244,-4828,,
15582282846,1056.91749,16986937649,1068626854,16986932815,-4834,,
15582333903,1056.96855,16986988708,1068677909,16986983870,-4838,,
15582384951,1057.01960,16987039758,1068728954,16987034914,-4844,,
15582436001,1057.07065,16987090811,1068780001,16987085962,-4849,,
15582487046,1057.12169,16987141857,1068831043,16987137003,-4854,,
15582538045,1057.17269,16987192860,1068882041,16987188001,-4859,,
15582589109,1057.22376,16987243926,1068933101,16987239062,-4864,,
15582640159,1057.27481,16987294978,1068984148,16987290109,-4869,,
15582690721,1057.32537,16987345543,1069034708,16987340669,-4874,,
15582741314,1057.37596,16987396138,1069085298,16987391259,-4879,,
15582792403,1057.42705,16987447230,1069136384,16987442345,-4885,,
15582842481,1057.47713,16987497310,1069186471,16987492432,-4878,,
15582893532,1057.52818,16987548363,1069237508,16987543469,-4894,,
15582944079,1057.57873,16987598913,1069288053,16987594013,-4900,,
15582995157,1057.62981,16987649993,1069339127,16987645088,-4905,,
15583046215,1057.68086,16987701053,1069390183,16987696144,-4909,,
15583096686,1057.73133,16987751527,1069440651,16987746612,-4915,,
15583147210,1057.78186,16987802053,1069491172,16987797133,-4920,,
15583197811,1057.83246,16987852656,1069541771,16987847731,-4925,,
15583248045,1057.88269,16987902892,1069592002,16987897963,-4929,,
15583298215,1057.93286,16987953064,1069642169,16987948129,-4935,,
15583349282,1057.98393,16988004134,1069693233,16987999194,-4940,,
15583399854,1058.03450,16988054709,1069743803,16988049775,-4934,,
15583450927,1058.08558,16988105784,1069794874,16988100834,-4950,,
15583501046,1058.13569,16988155905,1069844989,16988150950,-4955,,
15583551178,1058.18583,16988206040,1069895119,16988201080,-4960,,
15583601772,1058.23642,16988256635,1069945710,16988251670,-4965,,
15583652368,1058.28702,16988307233,1069996303,16988302263,-4970,,
15583702960,1058.33761,16988357829,1070046892,16988352853,-4976,,
15583754009,1058.38866,16988408880,1070097939,16988403900,-4980,,
15583804560,1058.43921,16988459434,1070148488,16988454448,-4986,,
15583855608,1058.49026,16988510484,1070199533,16988505493,-4991,,
15583906172,1058.54082,16988561049,1070250106,16988556066,-4983,,
15583957202,1058.59185,16988612083,1070301122,16988607082,-5001,,
15584007290,1058.64194,16988662173,1070351206,16988657167,-5006,,
15584057846,1058.69249,16988712730,1070401759,16988707720,-5010,,
15584108894,1058.74354,16988763781,1070452805,16988758765,-5016,,
15584159943,1058.79459,16988814833,1070503851,16988809812,-5021,,
15584210993,1058.84564,16988865885,1070554898,16988860859,-5026,,
15584262017,1058.89666,16988916911,1070605920,16988911881,-5030,,
15584313098,1058.94775,16988967995,1070656998,16988962958,-5037,,
15584364140,1058.99879,16989019040,1070708037,16989013997,-5043,,
15584414654,1059.04930,16989069556,1070758549,16989064509,-5047,,
15584465269,1059.09992,16989120173,1070809161,16989115122,-5051,,
15584516096,1059.15074,16989171003,1070859986,16989165946,-5057,,
15584566658,1059.20131,16989221567,1070910544,16989216505,-5062,,
15584617417,1059.25206,16989272328,1070961301,16989267262,-5066,,
15584668058,1059.30271,16989322971,1071011939,16989317900,-5071,,
15584718645,1059.35329,16989373561,1071062535,16989368495,-5066,,
15584769496,1059.40414,16989424414,1071113371,16989419331,-5083,,
15584820510,1059.45516,16989475430,1071164383,16989470343,-5087,,
15584871127,1059.50578,16989526050,1071214998,16989520958,-5092,,
15584921913,1059.55656,16989576839,1071265781,16989571741,-5098,,
15584972479,1059.60713,16989627406,1071316344,16989622304,-5102,,
15585023068,1059.65772,16989677997,1071366930,16989672890,-5107,,
15585073634,1059.70828,16989728578,1071417505,16989723465,-5113,,
15585124160,1059.75881,16989779095,1071468028,16989773989,-5106,,
15585175095,1059.80974,16989830032,1071518949,16989824910,-5122,,
15585225681,1059.86033,16989880621,1071569533,16989875493,-5128,,
15585276328,1059.91098,16989931270,1071620176,16989926137,-5133,,
15585326483,1059.96113,16989981426,1071670329,16989976290,-5136,,
15585377531,1060.01218,16990032478,1071721374,16990027335,-5143,,
15585428119,1060.06277,16990083068,1071771960,16990077920,-5148,,
15585478689,1060.11334,16990133640,1071822526,16990128487,-5153,,
15585529782,1060.16443,16990184735,1071873617,16990179577,-5158,,
15585580416,1060.21506,16990235371,1071924248,16990230208,-5163,,
15585630997,1060.26564,16990285954,1071974826,16990280786,-5168,,
15585681586,1060.31623,16990336547,1072025414,16990331374,-5173,,
15585732630,1060.36728,16990387604,1072076466,16990382427,-5177,,
15585783122,1060.41777,16990438087,1072126943,16990432904,-5183,,
15585834164,1060.46881,16990489132,1072177983,16990483943,-5189,,
15585884781,1060.51943,16990539750,1072228597,16990534558,-5192,,
15585935415,1060.57006,16990590388,1072279229,16990585189,-5199,,
15585986064,1060.62071,16990641038,1072329874,16990635834,-5204,,
15586037079,1060.67173,16990692056,1072380888,16990686849,-5207,,
15586087641,1060.72229,16990742620,1072431446,16990737407,-5213,,
15586138246,1060.77289,16990793227,1072482048,16990788008,-5219,,
15586189265,1060.82391,16990844249,1072533065,16990839036,-5213,,
15586240336,1060.87498,16990895323,1072584133,16990890094,-5229,,
15586290855,1060.92550,16990945843,1072634649,16990940609,-5234,,
15586341897,1060.97654,16990996889,1072685688,16990991649,-5240,,
15586392456,1061.02710,16991047449,1072736245,16991042205,-5244,,
15586442616,1061.07726,16991097612,1072786403,16991092363,-5249,,
15586493197,1061.12784,16991148195,1072836980,16991142940,-5255,,
15586544247,1061.17890,16991199247,1072888027,16991193987,-5260,,
15586594803,1061.22945,16991249805,1072938581,16991244541,-5264,,
15586645871,1061.28052,16991300876,1072989646,16991295606,-5270,,
15586696843,1061.33149,16991351851,1073040615,16991346576,-5275,,
15586747502,1061.38215,16991402512,1073091272,16991397233,-5279,,
15586798051,1061.43270,16991453064,1073141818,16991447779,-5285,,
15586848843,1061.48349,16991503858,1073192607,16991498568,-5290,,
15586899237,1061.53389,16991554254,1073242999,16991548959,-5295,,
15586949813,1061.58446,16991604844,1073293583,16991599544,-5300,,
15587000400,1061.63505,16991655421,1073344156,16991650116,-5305,,
15587051434,1061.68608,16991706459,1073395187,16991701148,-5311,,
15587102519,1061.73717,16991757546,1073446270,16991752231,-5315,,
15587153525,1061.78817,16991808554,1073497273,16991803234,-5320,,
15587203598,1061.83825,16991858630,1073547343,16991853304,-5326,,
15587253786,1061.88843,16991908819,1073597528,16991903488,-5331,,
15587304816,1061.93946,16991959852,1073648557,16991954517,-5335,,
15587355031,1061.98968,16992010069,1073698768,16992004728,-5341,,
15587406014,1062.04066,16992061055,1073749748,16992055708,-5347,,
15587456593,1062.09124,16992111636,1073800326,16992106286,-5350,,
15587507188,1062.14184,16992162234,1073850917,16992156878,-5356,,
15587558224,1062.19287,16992213271,1073901950,16992207910,-5361,,
15587609272,1062.24392,16992264321,1073952995,16992258955,-5366,,
15587659900,1062.29455,16992314953,1074003621,16992309581,-5372,,
15587710452,1062.34510,16992365507,1074054171,16992360131,-5376,,
15587761098,1062.39575,16992416155,1074104813,16992410773,-5382,,
15587811705,1062.44635,16992466764,1074155418,16992461378,-5386,,
15587862767,1062.49742,16992517828,1074206477,16992512437,-5391,,
15587913318,1062.54797,16992568382,1074257025,16992562985,-5397,,
15587963543,1062.59819,16992618610,1074307247,16992613208,-5402,,
15588014361,1062.64901,16992669430,1074358063,16992664024,-5406,,
15588065413,1062.70006,16992720484,1074409112,16992715072,-5412,,
15588116461,1062.75111,16992771534,1074460157,16992766117,-5417,,
15588167008,1062.80166,16992822083,1074510702,16992816662,-5421,,
15588218039,1062.85269,16992873118,1074561730,16992867690,-5428,,
15588268688,1062.90334,16992923769,1074612377,16992918337,-5432,,
15588319692,1062.95434,16992974776,1074663377,16992969338,-5438,,
15588370286,1063.00493,16993025372,1074713970,16993019930,-5442,,
15588420831,1063.05548,16993075918,1074764511,16993070471,-5447,,
15588471472,1063.10612,16993126563,1074815149,16993121110,-5453,,
15588521867,1063.15651,16993176960,1074865542,16993171503,-5457,,
15588572318,1063.20697,16993227412,1074915990,16993221962,-5450,,
15588622953,1063.25760,16993278051,1074966622,16993272583,-5468,,
15588673508,1063.30816,16993328608,1075017175,16993323135,-5473,,
15588724139,1063.35879,16993379241,1075067803,16993373764,-5477,,
15588774291,1063.40894,16993429396,1075117952,16993423913,-5483,,
15588825356,1063.46000,16993480462,1075169014,16993474974,-5488,,
15588876285,1063.51093,16993531394,1075219941,16993525902,-5492,,
15588927333,1063.56198,16993582445,1075270987,16993576947,-5498,,
15588977957,1063.61261,16993633070,1075321607,16993627567,-5503,,
15589028573,1063.66322,16993683689,1075372221,16993678182,-5507,,
15589079411,1063.71406,16993734542,1075423068,16993729029,-5513,,
15589130493,1063.76514,16993785614,1075474135,16993780096,-5518,,
15589181109,1063.81576,16993836233,1075524748,16993830709,-5524,,
15589231725,1063.86637,16993886851,1075575362,16993881323,-5528,,
15589282328,1063.91698,16993937456,1075625962,16993931922,-5534,,
15589333353,1063.96800,16993988483,1075676984,16993982944,-5539,,
15589383893,1064.01854,16994039026,1075727521,16994033482,-5544,,
15589434967,1064.06962,16994090101,1075778593,16994084553,-5548,,
15589485479,1064.12013,16994140617,1075829103,16994135063,-5554,,
15589536124,1064.17077,16994191264,1075879744,16994185705,-5559,,
15589586243,1064.22089,16994241385,1075929862,16994235822,-5563,,
15589636814,1064.27146,16994291959,1075980430,16994286390,-5569,,
15589687385,1064.32203,16994342532,1076030998,16994336958,-5574,,
15589737988,1064.37264,16994393137,1076081598,16994387559,-5578,,
15589788057,1064.42270,16994443209,1076131665,16994437625,-5584,,
15589839079,1064.47373,16994494233,1076182683,16994488644,-5589,,
15589889531,1064.52418,16994544688,1076233132,16994539093,-5595,,
15589940584,1064.57523,16994595743,1076284183,16994590144,-5599,,
15589990644,1064.62529,16994645805,1076334241,16994640201,-5604,,
15590041480,1064.67613,16994696644,1076385074,16994691034,-5610,,
15590091623,1064.72627,16994746788,1076435214,16994741174,-5614,,
15590142671,1064.77732,16994797838,1076486259,16994792220,-5618,,
15590193697,1064.82834,16994848868,1076537283,16994843243,-5625,,
15590243911,1064.87856,16994899084,1076587493,16994893454,-5630,,
15590294431,1064.92908,16994949606,1076638012,16994943972,-5634,,
15590345486,1064.98013,16995000664,1076689064,16994995024,-5640,,
15590395881,1065.03053,16995051061,1076739455,16995045416,-5645,,
15590446840,1065.08149,16995102022,1076790412,16995096373,-5649,,
15590497446,1065.13209,16995152631,1076841016,16995146976,-5655,,
15590547981,1065.18263,16995203168,1076891547,16995197507,-5661,,
15590599023,1065.23367,16995254213,1076942586,16995248547,-5666,,
15590649579,1065.28423,16995304771,1076993140,16995299100,-5671,,
15590700164,1065.33481,16995355359,1077043725,16995349687,-5672,,
15590750942,1065.38559,16995406139,1077094498,16995400458,-5681,,
15590801499,1065.43615,16995456698,1077145053,16995451014,-5684,,
15590852038,1065.48669,16995507239,1077195588,16995501549,-5690,,
15590902635,1065.53728,16995557838,1077246182,16995552142,-5696,,
15590952763,1065.58741,16995607980,1077296320,16995602280,-5700,,
15591003288,1065.63794,16995658496,1077346831,16995652791,-5705,,
15591053453,1065.68810,16995708663,1077396992,16995702952,-5711,,
15591103847,1065.73850,16995759060,1077447384,16995753344,-5716,,
15591154189,1065.78884,16995809415,1077497735,16995803695,-5720,,
15591205249,1065.83990,16995860467,1077548780,16995854740,-5727,,
15591255800,1065.89045,16995911020,1077599328,16995905289,-5731,,
15591306373,1065.94102,16995961594,1077649899,16995955859,-5735,,
15591356447,1065.99110,16996011672,1077699970,16996005931,-5741,,
15591407496,1066.04214,16996062723,1077751017,16996056977,-5746,,
15591458075,1066.09272,16996113304,1077801593,16996107554,-5750,,
15591509124,1066.14377,16996164356,1077852640,16996158600,-5756,,
15591559640,1066.19429,16996214874,1077903153,16996209113,-5761,,
15591610199,1066.24485,16996265436,1077953709,16996259669,-5767,,
15591661226,1066.29587,16996316465,1078004733,16996310694,-5771,,
15591711794,1066.34644,16996367035,1078055298,16996361259,-5776,,
15591762336,1066.39698,16996417579,1078105837,16996411798,-5781,,
15591813378,1066.44803,16996468623,1078156877,16996462837,-5786,,
15591863908,1066.49856,16996519156,1078207404,16996513364,-5792,,
15591913980,1066.54863,16996569231,1078257474,16996563434,-5797,,
15591964525,1066.59917,16996619778,1078308015,16996613975,-5803,,
15592015075,1066.64972,16996670330,1078358563,16996664524,-5806,,
15592065635,1066.70028,16996720904,1078409131,16996715092,-5812,,
15592116674,1066.75132,16996771934,1078460156,16996766117,-5817,,
15592167208,1066.80186,16996822470,1078510689,16996816649,-5821,,
15592217771,1066.85242,16996873036,1078561248,16996867209,-5827,,
15592268354,1066.90300,16996923621,1078611829,16996917789,-5832,,
15592319398,1066.95405,16996974668,1078662869,16996968830,-5838,,
15592369462,1067.00411,16997024744,1078712941,16997018902,-5842,,
15592420113,1067.05476,16997075386,1078763579,16997069539,-5847,,
15592471138,1067.10579,16997126414,1078814601,16997120561,-5853,,
15592521185,1067.15583,16997176464,1078864646,16997170607,-5857,,
15592572245,1067.20689,16997227525,1078915702,16997221663,-5862,,
15592622832,1067.25748,16997278115,1078966287,16997272247,-5868,,
15592673638,1067.30829,16997328924,1079017091,16997323051,-5873,,
15592724187,1067.35883,16997379475,1079067638,16997373598,-5877,,
15592774321,1067.40897,16997429612,1079117768,16997423729,-5883,,
15592825355,1067.46000,16997480648,1079168800,16997474760,-5888,,
15592875946,1067.51059,16997531241,1079219388,16997525349,-5892,,
15592926493,1067.56114,16997581790,1079269932,16997575892,-5898,,
15592977298,1067.61195,16997632598,1079320735,16997626695,-5903,,
15593028888,1067.66354,16997684190,1079372321,16997678282,-5908,,
15593079641,1067.71429,16997734945,1079423072,16997729032,-5913,,
15593130660,1067.76531,16997785967,1079474088,16997780049,-5918,,
15593181694,1067.81634,16997837004,1079525119,16997831080,-5924,,
15593231820,1067.86647,16997887131,1079575243,16997881203,-5928,,
15593282868,1067.91752,16997938181,1079626288,16997932248,-5933,,
15593333914,1067.96856,16997989231,1079677331,16997983292,-5939,,
15593384533,1068.01918,16998039852,1079727947,16998033908,-5944,,
15593434668,1068.06932,16998089988,1079778080,16998084040,-5948,,
15593485732,1068.12038,16998141055,1079829141,16998135101,-5954,,
15593535856,1068.17050,16998191182,1079879262,16998185223,-5959,,
15593586704,1068.22135,16998242032,1079930108,16998236069,-5963,,
15593636765,1068.27141,16998292096,1079980167,16998286127,-5969,,
15593686913,1068.32156,16998342246,1080030311,16998336272,-5974,,
15593737293,1068.37194,16998392628,1080080689,16998386650,-5978,,
15593788027,1068.42268,16998443365,1080131420,16998437381,-5984,,
15593838646,1068.47329,16998493986,1080182036,16998487997,-5989,,
15593889726,1068.52437,16998545069,1080233114,16998539074,-5995,,
15593940311,1068.57496,16998595656,1080283696,16998589657,-5999,,
15593991327,1068.62597,16998646674,1080334720,16998640681,-5993,,
15594041946,1068.67659,16998697296,1080385325,16998691286,-6010,,
15594092559,1068.72721,16998747911,1080435936,16998741897,-6014,,
15594142698,1068.77735,16998798051,1080486072,16998792032,-6019,,
15594193236,1068.82788,16998848593,1080536607,16998842568,-6025,,
15594243765,1068.87841,16998899124,1080587134,16998893094,-6030,,
15594294376,1068.92902,16998949737,1080637742,16998943703,-6034,,
15594345381,1068.98003,16999000745,1080688744,16998994705,-6040,,
15594395975,1069.03062,16999051340,1080739335,16999045295,-6045,,
15594446507,1069.08116,16999101875,1080789865,16999095826,-6049,,
15594497132,1069.13178,16999152503,1080840487,16999146447,-6056,,
15594547746,1069.18239,16999203119,1080891098,16999197059,-6060,,
15594598314,1069.23296,16999253689,1080941664,16999247625,-6064,,
15594648830,1069.28348,16999304207,1080992177,16999298137,-6070,,
15594699113,1069.33376,16999354493,1081042457,16999348418,-6075,,
15594749276,1069.38392,16999404658,1081092617,16999398577,-6081,,
15594799354,1069.43400,16999454739,1081142693,16999448654,-6085,,
15594850215,1069.48486,16999505602,1081193551,16999499512,-6090,,
15594901255,1069.53590,16999556646,1081244590,16999550550,-6096,,
15594951807,1069.58645,16999607199,1081295138,16999601099,-6100,,
15595002848,1069.63750,16999658242,1081346177,16999652137,-6105,,
15595053412,1069.68806,16999708809,1081396737,16999702698,-6111,,
15595103957,1069.73861,16999759356,1081447279,16999753239,-6117,,
15595155006,1069.78965,16999810407,1081498326,16999804287,-6120,,
15595205107,1069.83975,16999860511,1081548424,16999854385,-6126,,
15595255672,1069.89032,16999911078,1081598987,16999904947,-6131,,
15595306273,1069.94092,16999961681,1081649585,16999955545,-6136,,
15595356841,1069.99149,17000012262,1081700161,17000006121,-6141,,
15595407813,1070.04246,17000063225,1081751119,17000057079,-6146,,
15595458845,1070.09349,17000114259,1081802148,17000108108,-6151,,
15595508956,1070.14360,17000164374,1081852257,17000158218,-6156,,
15595559520,1070.19417,17000214940,1081902818,17000208779,-6161,,
15595610523,1070.24517,17000265946,1081953818,17000259779,-6167,,
15595661085,1070.29573,17000316510,1082004379,17000310339,-6171,,
15595711675,1070.34632,17000367102,1082054966,17000360926,-6176,,
15595761863,1070.39651,17000417292,1082105150,17000411110,-6182,,
15595812501,1070.44715,17000467932,1082155786,17000461746,-6186,,
15595863533,1070.49818,17000518978,1082206827,17000512787,-6191,,
15595914094,1070.54874,17000569541,1082257384,17000563344,-6197,,
15595965162,1070.59981,17000620601,1082308438,17000614398,-6203,,
15596016209,1070.65086,17000671650,1082359483,17000665444,-6206,,
15596067164,1070.70181,17000722608,1082410435,17000716396,-6212,,
15596117822,1070.75247,17000773268,1082461090,17000767050,-6218,,
15596168462,1070.80311,17000823910,1082511729,17000817689,-6221,,
15596219131,1070.85378,17000874582,1082562394,17000868355,-6227,,
15596269722,1070.90437,17000925175,1082612982,17000918942,-6233,,
15596320788,1070.95544,17000976254,1082664056,17000970016,-6238,,
15596370985,1071.00563,17001026443,1082714241,17001020201,-6242,,
15596422003,1071.05665,17001077462,1082765255,17001071215,-6247,,
15596472583,1071.10723,17001128046,1082815833,17001121793,-6253,,
15596523228,1071.15788,17001178693,1082866475,17001172436,-6257,,
15596573328,1071.20798,17001228794,1082916571,17001222532,-6262,,
15596623496,1071.25814,17001278966,1082966737,17001272697,-6269,,
15596673969,1071.30862,17001329440,1083017207,17001323167,-6273,,
15596724533,1071.35918,17001380006,1083067769,17001373729,-6277,,
15596775529,1071.41018,17001431006,1083118763,17001424723,-6283,,
15596825667,1071.46032,17001481146,1083168897,17001474858,-6288,,
15596876716,1071.51136,17001532208,1083219956,17001525917,-6291,,
15596927781,1071.56243,17001583265,1083271006,17001576967,-6298,,
15596978425,1071.61307,17001633910,1083321647,17001627607,-6303,,
15597029473,1071.66412,17001684961,1083372692,17001678652,-6309,,
15597080297,1071.71494,17001735788,1083423514,17001729485,-6303,,
15597130549,1071.76520,17001786042,1083473763,17001779724,-6318,,
15597181474,1071.81612,17001836969,1083524684,17001830645,-6324,,
15597232038,1071.86669,17001887536,1083575247,17001881207,-6329,,
15597283058,1071.91771,17001938558,1083626265,17001932225,-6333,,
15597333618,1071.96827,17001989120,1083676821,17001982781,-6339,,
15597384177,1072.01883,17002039682,1083727377,17002033338,-6344,,
15597434238,1072.06889,17002089745,1083777436,17002083397,-6348,,
15597485289,1072.11994,17002140799,1083828485,17002134445,-6354,,
15597535421,1072.17007,17002190933,1083878613,17002184574,-6359,,
15597585904,1072.22055,17002241418,1083929095,17002235055,-6363,,
15597636437,1072.27109,17002291953,1083979624,17002285584,-6369,,
15597687467,1072.32211,17002342985,1084030651,17002336611,-6374,,
15597738040,1072.37269,17002393561,1084081223,17002387183,-6378,,
15597789088,1072.42374,17002444612,1084132268,17002438228,-6384,,
15597839720,1072.47437,17002495246,1084182933,17002488893,-6353,,
15597890182,1072.52483,17002545710,1084233355,17002539315,-6395,,
15597941209,1072.57586,17002596740,1084284381,17002590341,-6399,,
15597991625,1072.62627,17002647158,1084334793,17002640754,-6404,,
15598042069,1072.67672,17002697605,1084385234,17002691195,-6410,,
15598092630,1072.72728,17002748168,1084435794,17002741754,-6414,,
15598143659,1072.77831,17002799208,1084486829,17002792790,-6418,,
15598194020,1072.82867,17002849562,1084537177,17002843137,-6425,,
15598244627,1072.87928,17002900172,1084587782,17002893742,-6430,,
15598295201,1072.92985,17002950747,1084638353,17002944313,-6434,,
15598345311,1072.97996,17003000861,1084688461,17002994421,-6440,,
15598395369,1073.03002,17003050921,1084738516,17003044476,-6445,,
15598445948,1073.08060,17003101502,1084789093,17003095053,-6449,,
15598496511,1073.13116,17003152067,1084839652,17003145612,-6455,,
15598547274,1073.18192,17003202833,1084890413,17003196373,-6460,,
15598597409,1073.23206,17003252970,1084940545,17003246506,-6464,,
15598648009,1073.28266,17003303572,1084991142,17003297102,-6470,,
15598699022,1073.33367,17003354588,1085042153,17003348113,-6475,,
15598757456,1073.39210,17003413025,1085100584,17003406544,-6481,,
15598808112,1073.44276,17003463683,1085151236,17003457197,-6486,,
15598859140,1073.49379,17003514714,1085202262,17003508223,-6491,,
15598909702,1073.54435,17003565278,1085252821,17003558782,-6496,,
15598960759,1073.59541,17003616336,1085303875,17003609836,-6500,,
15599011700,1073.64635,17003667281,1085354813,17003660773,-6508,,
15599062725,1073.69737,17003718308,1085405837,17003711797,-6511,,
15599113310,1073.74796,17003768894,1085456418,17003762378,-6516,,
15599164133,1073.79878,17003819720,1085507238,17003813198,-6522,,
15599214829,1073.84948,17003870418,1085557932,17003863893,-6525,,
15599265172,1073.89982,17003920763,1085608272,17003914233,-6530,,
15599316095,1073.95074,17003971689,1085659192,17003965152,-6537,,
15599367166,1074.00181,17004022762,1085710260,17004016220,-6542,,
15599418224,1074.05287,17004073823,1085761316,17004067277,-6546,,
15599469272,1074.10392,17004124874,1085812361,17004118322,-6552,,
15599520320,1074.15497,17004175924,1085863407,17004169367,-6557,,
15599570966,1074.20561,17004226573,1085914049,17004220010,-6563,,
15599621503,1074.25615,17004277112,1085964585,17004270545,-6567,,
15599672024,1074.30667,17004327635,1086015102,17004321063,-6572,,
15599722541,1074.35719,17004378155,1086065617,17004371577,-6578,,
15599772617,1074.40727,17004428233,1086115691,17004421651,-6582,,
15599823007,1074.45765,17004478625,1086166078,17004472038,-6587,,
15599873671,1074.50832,17004529291,1086216738,17004522698,-6593,,
15599924704,1074.55935,17004580326,1086267768,17004573729,-6597,,
15599975270,1074.60992,17004630895,1086318332,17004624292,-6603,,
15600026323,1074.66097,17004681950,1086369382,17004675342,-6608,,
15600077337,1074.71198,17004732967,1086420393,17004726354,-6613,,
15600127934,1074.76258,17004783566,1086470987,17004776948,-6618,,
15600178972,1074.81362,17004834606,1086522023,17004827983,-6623,,
15600229880,1074.86453,17004885516,1086572928,17004878888,-6628,,
15600280484,1074.91513,17004936123,1086623529,17004929490,-6633,,
15600331031,1074.96568,17004986672,1086674074,17004980034,-6638,,
15600381189,1075.01584,17005036833,1086724229,17005030190,-6643,,
15600432267,1075.06692,17005087914,1086775304,17005081265,-6649,,
15600482828,1075.11748,17005138476,1086825863,17005131823,-6653,,
15600532941,1075.16759,17005188591,1086875973,17005181934,-6657,,
15600583982,1075.21863,17005239635,1086927011,17005232971,-6664,,
15600634406,1075.26905,17005290062,1086977433,17005283394,-6668,,
15600684554,1075.31920,17005340211,1087027578,17005333538,-6673,,
15600735136,1075.36978,17005390797,1087078158,17005384118,-6679,,
15600786160,1075.42081,17005441823,1087129178,17005435139,-6684,,
15600837214,1075.47186,17005492879,1087180230,17005486191,-6688,,
15600887788,1075.52244,17005543455,1087230801,17005536762,-6693,,
15600938771,1075.57342,17005594440,1087281781,17005587741,-6699,,
15600989236,1075.62388,17005644920,1087332255,17005638216,-6704,,
15601039931,1075.67458,17005695606,1087382936,17005688897,-6709,,
15601090979,1075.72563,17005746656,1087433982,17005739942,-6714,,
15601141571,1075.77622,17005797250,1087484569,17005790530,-6720,,
15601192053,1075.82670,17005847735,1087535050,17005841011,-6724,,
15601242642,1075.87729,17005898326,1087585636,17005891597,-6729,,
15601293693,1075.92834,17005949379,1087636684,17005942645,-6734,,
15601344299,1075.97895,17005999988,1087687289,17005993249,-6739,,
15601394879,1076.02953,17006050571,1087737865,17006043826,-6745,,
15601444945,1076.07959,17006100639,1087787929,17006093889,-6750,,
15601495997,1076.13064,17006151693,1087838978,17006144939,-6754,,
15601547048,1076.18170,17006202747,1087890027,17006195987,-6760,,
15601597209,1076.23186,17006252910,1087940184,17006246145,-6765,,
15601648203,1076.28285,17006303905,1087991175,17006297135,-6770,,
15601698896,1076.33354,17006354601,1088041866,17006347826,-6775,,
15601749516,1076.38416,17006405224,1088092483,17006398444,-6780,,
15601800572,1076.43522,17006456281,1088143536,17006449496,-6785,,
15601851504,1076.48615,17006507216,1088194465,17006500425,-6791,,
15601902531,1076.53718,17006558246,1088245490,17006551450,-6796,,
15601953086,1076.58773,17006608803,1088296043,17006602003,-6800,,
15602004120,1076.63877,17006659839,1088347073,17006653033,-6806,,
15602054689,1076.68934,17006710410,1088397640,17006703600,-6810,,
15602105738,1076.74039,17006761462,1088448685,17006754646,-6816,,
15602156783,1076.79143,17006812509,1088499728,17006805689,-6820,,
15602207860,1076.84251,17006863589,1088550803,17006856763,-6826,,
15602258758,1076.89341,17006914490,1088601699,17006907659,-6831,,
15602309404,1076.94405,17006965137,1088652341,17006958301,-6836,,
15602360031,1076.99468,17007015768,1088702966,17007008927,-6841,,
15602411097,1077.04574,17007066836,1088754029,17007059990,-6846,,
15602461643,1077.09629,17007117384,1088804573,17007110533,-6851,,
15602511877,1077.14653,17007167620,1088854803,17007160764,-6856,,
15602562438,1077.19709,17007218184,1088905363,17007211323,-6861,,
15602613027,1077.24768,17007268775,1088955949,17007261909,-6866,,
15602664067,1077.29871,17007319818,1089006985,17007312946,-6872,,
15602715056,1077.34970,17007370808,1089057971,17007363931,-6877,,
15602765926,1077.40057,17007421682,1089108841,17007414802,-6880,,
15602816997,1077.45165,17007472755,1089159908,17007465868,-6887,,
15602867893,1077.50254,17007523653,1089210801,17007516761,-6892,,
15602918424,1077.55307,17007574186,1089261329,17007567289,-6897,,
15602969474,1077.60412,17007625239,1089312376,17007618337,-6902,,
15603019996,1077.65464,17007675763,1089362896,17007668856,-6907,,
15603070215,1077.70486,17007725983,1089413111,17007719072,-6911,,
15603121186,1077.75583,17007776958,1089464080,17007770041,-6917,,
15603172232,1077.80688,17007828006,1089515123,17007821084,-6922,,
15603222851,1077.85750,17007878627,1089565739,17007871699,-6928,,
15603273754,1077.90840,17007929533,1089616651,17007922611,-6922,,
15603324328,1077.95898,17007980109,1089667211,17007973184,-6925,,
15603375376,1078.01002,17008031171,1089718268,17008024228,-6943,,
15603426464,1078.06111,17008082250,1089769342,17008075302,-6948,,
15603477246,1078.11189,17008133043,1089820131,17008126091,-6952,,
15603528096,1078.16274,17008183887,1089870969,17008176929,-6958,,
15603578665,1078.21331,17008234457,1089921544,17008227504,-6953,,
15603629342,1078.26399,17008285137,1089972209,17008278169,-6968,,
15603679962,1078.31461,17008335759,1090022825,17008328786,-6973,,
15603730729,1078.36538,17008386529,1090073590,17008379550,-6979,,
15603781323,1078.41597,17008437125,1090124182,17008430142,-6983,,
15603832331,1078.46698,17008488135,1090175187,17008481148,-6987,,
15603882932,1078.51758,17008538739,1090225796,17008531757,-6982,,
15603933478,1078.56813,17008589288,1090276339,17008582300,-6988,,
15603984606,1078.61925,17008640417,1090327453,17008633413,-7004,,
15604035205,1078.66985,17008691018,1090378050,17008684010,-7008,,
15604085825,1078.72047,17008741641,1090428667,17008734627,-7014,,
15604136716,1078.77136,17008792535,1090479556,17008785516,-7019,,
15604187333,1078.82198,17008843154,1090530170,17008836130,-7024,,
15604237913,1078.87256,17008893737,1090580747,17008886708,-7029,,
15604288518,1078.92317,17008944343,1090631349,17008937309,-7034,,
15604339134,1078.97378,17008994961,1090681962,17008987922,-7039,,
15604390179,1079.02483,17009046010,1090733005,17009038966,-7044,,
15604441203,1079.07585,17009097036,1090784026,17009089987,-7049,,
15604491776,1079.12642,17009147612,1090834596,17009140557,-7055,,
15604542846,1079.17749,17009198683,1090885663,17009191623,-7060,,
15604593462,1079.22811,17009249301,1090936277,17009242237,-7064,,
15604644510,1079.27916,17009300353,1090987322,17009293283,-7070,,
15604695589,1079.33024,17009351433,1091038398,17009344358,-7075,,
15604746667,1079.38132,17009402513,1091089474,17009395434,-7079,,
15604797718,1079.43237,17009453568,1091140522,17009446482,-7086,,
15604848763,1079.48341,17009504615,1091191564,17009497525,-7090,,
15604899307,1079.53396,17009555161,1091242106,17009548066,-7095,,
15604949857,1079.58451,17009605713,1091292653,17009598613,-7100,,
15605000418,1079.63507,17009656277,1091343212,17009649172,-7105,,
15605051446,1079.68609,17009707308,1091394236,17009700207,-7101,,
15605102155,1079.73680,17009758019,1091444944,17009750904,-7115,,
15605152721,1079.78737,17009808586,1091495506,17009801466,-7120,,
15605203251,1079.83790,17009859119,1091546033,17009852003,-7116,,
15605254347,1079.88900,17009910218,1091597126,17009903086,-7132,,
15605305396,1079.94004,17009961269,1091648173,17009954134,-7135,,
15605356448,1079.99110,17010012324,1091699222,17010005183,-7141,,
15605407495,1080.04214,17010063373,1091750266,17010056227,-7146,,
15605458522,1080.09317,17010114402,1091801302,17010107262,-7140,,
15605509593,1080.14424,17010165476,1091852359,17010158320,-7156,,
15605560641,1080.19529,17010216526,1091903405,17010209365,-7161,,
15605611643,1080.24629,17010267530,1091954403,17010260363,-7167,,
15605662213,1080.29686,17010318103,1092004972,17010310932,-7171,,
15605712377,1080.34703,17010368269,1092055133,17010361093,-7176,,
15605762934,1080.39758,17010418829,1092105686,17010411647,-7182,,
15605813566,1080.44821,17010469463,1092156316,17010462277,-7186,,
15605863751,1080.49840,17010519649,1092206498,17010512458,-7191,,
15605914803,1080.54945,17010570705,1092257548,17010563508,-7197,,
15605965746,1080.60039,17010621650,1092308487,17010614447,-7203,,
15606016355,1080.65100,17010672261,1092359095,17010665055,-7206,,
15606066957,1080.70160,17010722865,1092409693,17010715653,-7212,,
15606117506,1080.75215,17010773417,1092460240,17010766200,-7217,,
15606168527,1080.80318,17010824445,1092511264,17010817224,-7221,,
15606218893,1080.85354,17010874809,1092561622,17010867582,-7227,,
15606269898,1080.90455,17010925815,1092612623,17010918583,-7232,,
15606320518,1080.95517,17010976439,1092663240,17010969200,-7239,,
15606371068,1081.00572,17011026991,1092713788,17011019749,-7242,,
15606422065,1081.05671,17011077989,1092764782,17011070742,-7247,,
15606472663,1081.10731,17011128590,1092815377,17011121337,-7253,,
15606523727,1081.15837,17011179657,1092866439,17011172399,-7258,,
15606574824,1081.20947,17011230756,1092917534,17011223494,-7262,,
15606625850,1081.26050,17011281784,1092968556,17011274516,-7268,,
15606676331,1081.31098,17011332267,1093019034,17011324994,-7273,,
15606727352,1081.36200,17011383290,1093070053,17011376013,-7277,,
15606778437,1081.41308,17011434379,1093121136,17011427096,-7283,,
15606829441,1081.46409,17011485385,1093172137,17011478097,-7288,,
15606880029,1081.51468,17011535976,1093222721,17011528682,-7294,,
15606931147,1081.56579,17011587096,1093273838,17011579798,-7298,,
15606981310,1081.61596,17011637261,1093323998,17011629958,-7303,,
15607031880,1081.66653,17011687834,1093374565,17011680525,-7309,,
15607082908,1081.71756,17011738864,1093425591,17011731551,-7313,,
15607133934,1081.76858,17011789892,1093476613,17011782574,-7318,,
15607184578,1081.81923,17011840539,1093527255,17011833215,-7324,,
15607234942,1081.86959,17011890905,1093577615,17011883576,-7329,,
15607285989,1081.92064,17011941954,1093628671,17011934632,-7322,,
15607336401,1081.97105,17011992369,1093679070,17011985030,-7339,,
15607387308,1082.02196,17012043277,1093729973,17012035933,-7344,,
15607437912,1082.07256,17012093885,1093780576,17012086536,-7349,,
15607488477,1082.12313,17012144452,1093831137,17012137098,-7354,,
15607539553,1082.17420,17012195529,1093882210,17012188170,-7359,,
15607590570,1082.22522,17012246550,1093933225,17012239185,-7365,,
15607641615,1082.27626,17012297597,1093984267,17012290228,-7369,,
15607692199,1082.32685,17012348183,1094034848,17012340809,-7374,,
15607743217,1082.37786,17012399204,1094085864,17012391824,-7380,,
15607793389,1082.42804,17012449378,1094136034,17012441994,-7384,,
15607844451,1082.47910,17012500442,1094187093,17012493053,-7389,,
15607895116,1082.52976,17012551109,1094237754,17012543715,-7394,,
15607945896,1082.58054,17012601892,1094288532,17012594492,-7400,,
15607996512,1082.63116,17012652510,1094339145,17012645105,-7405,,
15608047600,1082.68225,17012703601,1094390231,17012696191,-7410,,
15608098145,1082.73279,17012754147,1094440772,17012746743,-7404,,
15608148776,1082.78342,17012804781,1094491401,17012797361,-7420,,
15608199821,1082.83447,17012855829,1094542444,17012848404,-7425,,
15608250032,1082.88468,17012906042,1094592651,17012898612,-7430,,
15608301079,1082.93573,17012957091,1094643695,17012949655,-7436,,
15608351723,1082.98637,17013007738,1094694338,17013000298,-7440,,
15608402773,1083.03742,17013058790,1094745385,17013051345,-7445,,
15608453800,1083.08845,17013109820,1094796408,17013102368,-7452,,
15608504339,1083.13899,17013160361,1094846946,17013152906,-7455,,
15608554921,1083.18957,17013210945,1094897524,17013203485,-7460,,
15608605970,1083.24062,17013261996,1094948570,17013254530,-7466,,
15608656592,1083.29124,17013312621,1094999190,17013305150,-7471,,
15608707237,1083.34189,17013363268,1095049832,17013355792,-7476,,
15608758248,1083.39290,17013414281,1095100840,17013406800,-7481,,
15608808350,1083.44300,17013464386,1095150940,17013456900,-7486,,
15608858952,1083.49360,17013514990,1095201539,17013507500,-7490,,
15608910012,1083.54466,17013566052,1095252596,17013558557,-7495,,
15608960901,1083.59555,17013616944,1095303483,17013609443,-7501,,
15609011379,1083.64603,17013667436,1095353969,17013659929,-7507,,
15609062420,1083.69707,17013718467,1095404996,17013710956,-7511,,
15609112557,1083.74720,17013768606,1095455130,17013761090,-7516,,
15609163610,1083.79826,17013819662,1095506180,17013812140,-7522,,
15609214653,1083.84930,17013870708,1095557221,17013863182,-7526,,
15609265702,1083.90035,17013921759,1095608267,17013914238,-7521,,
15609316776,1083.95142,17013972835,1095659338,17013965298,-7537,,
15609367824,1084.00247,17014023886,1095710383,17014016343,-7543,,
15609418872,1084.05352,17014074936,1095761429,17014067390,-7546,,
15609469894,1084.10454,17014125961,1095812449,17014118409,-7552,,
15609520505,1084.15515,17014176573,1095863056,17014169016,-7557,,
15609571523,1084.20617,17014227595,1095914071,17014220032,-7563,,
15609622135,1084.25678,17014278209,1095964681,17014270642,-7567,,
15609672758,1084.30741,17014328834,1096015301,17014321262,-7572,,
15609723296,1084.35794,17014379375,1096065837,17014371797,-7578,,
15609774341,1084.40899,17014430433,1096116891,17014422851,-7582,,
15610034347,1084.66899,17014690439,1096376870,17014682831,-7608,17014689139,
15610059889,1084.69454,17014715983,1096402411,17014708404,-7579,,
15610110471,1084.74512,17014766568,1096452992,17014759048,-7520,,
15610160625,1084.79527,17014816724,1096503143,17014809262,-7462,,
15610211147,1084.84579,17014867259,1096553673,17014859856,-7403,,
15610261711,1084.89636,17014917815,1096604224,17014910471,-7344,,
15610312708,1084.94736,17014968814,1096655218,17014961529,-7285,,
15610363627,1084.99827,17015019736,1096706133,17015012509,-7227,,
15610413747,1085.04840,17015069868,1096756261,17015062700,-7168,,
15610464770,1085.09942,17015120882,1096807271,17015113774,-7108,,
15610515320,1085.14997,17015171436,1096857819,17015164386,-7050,,
15610566427,1085.20107,17015222545,1096908923,17015215554,-6991,,
15610616995,1085.25164,17015273114,1096959488,17015266184,-6930,,
15610667547,1085.30219,17015323670,1097010037,17015316797,-6873,,
15610718136,1085.35278,17015374260,1097060623,17015367446,-6814,,
15610768713,1085.40336,17015424840,1097111197,17015418084,-6756,,
15610819715,1085.45436,17015475845,1097162198,17015469149,-6696,,
15610870419,1085.50507,17015526550,1097212898,17015519914,-6636,,
15610921113,1085.55576,17015577247,1097263589,17015570669,-6578,,
15610971640,1085.60629,17015627787,1097314125,17015621267,-6520,,
15611022293,1085.65694,17015678431,1097364764,17015671970,-6461,,
15611072870,1085.70752,17015729012,1097415338,17015722609,-6403,,
15611123107,1085.75776,17015779250,1097465572,17015772906,-6344,,
15611173583,1085.80823,17015829728,1097516046,17015823454,-6274,,
15611223763,1085.85841,17015879912,1097566224,17015873685,-6227,,
15611274784,1085.90943,17015930935,1097617242,17015924767,-6168,,
15611325426,1085.96007,17015981579,1097667881,17015975471,-6108,,
15611376013,1086.01066,17016032169,1097718465,17016026119,-6050,,
15611426595,1086.06124,17016082753,1097769044,17016076762,-5991,,
15611476728,1086.11138,17016132887,1097819175,17016126956,-5931,,
15611527242,1086.16189,17016183414,1097869696,17016177541,-5873,,
15611577886,1086.21253,17016234051,1097920328,17016228235,-5816,,
15611628323,1086.26297,17016284490,1097970761,17016278743,-5747,,
15611678985,1086.31363,17016335154,1098021421,17016329456,-5698,,
15611729511,1086.36416,17016385683,1098071954,17016380054,-5629,,
15611780093,1086.41474,17016436267,1098122524,17016430687,-5580,,
15611831164,1086.46581,17016487340,1098173592,17016481820,-5520,,
15611882008,1086.51666,17016538187,1098224433,17016532725,-5462,,
15611933056,1086.56770,17016589238,1098275478,17016583835,-5403,,
15611983634,1086.61828,17016639818,1098326054,17016634474,-5344,,
15612034717,1086.66936,17016690902,1098377134,17016685618,-5284,,
15612085766,1086.72041,17016741954,1098428180,17016736728,-5226,,
15612136790,1086.77144,17016792981,1098479201,17016787814,-5167,,
15612187863,1086.82251,17016844055,1098530271,17016838948,-5107,,
15612238881,1086.87353,17016895076,1098581287,17016890029,-5047,,
15612289463,1086.92411,17016945661,1098631866,17016940672,-4989,,
15612340511,1086.97516,17016996711,1098682911,17016991782,-4929,,
15612391560,1087.02621,17017047762,1098733958,17017042892,-4870,,
15612442611,1087.07726,17017098816,1098785006,17017094006,-4810,,
15612493126,1087.12777,17017149334,1098835518,17017144581,-4753,,
15612544207,1087.17886,17017200417,1098886597,17017195724,-4693,,
15612595278,1087.22993,17017251490,1098937676,17017246868,-4622,,
15612645881,1087.28053,17017302095,1098988265,17017297520,-4575,,
15612696772,1087.33142,17017352999,1099039164,17017348484,-4515,,
15612747717,1087.38236,17017403935,1099090096,17017399480,-4455,,
15612798264,1087.43291,17017454486,1099140640,17017450087,-4399,,
15612849314,1087.48396,17017505537,1099191687,17017501199,-4338,,
15612900360,1087.53501,17017556587,1099242731,17017552307,-4280,,
15612951020,1087.58567,17017607248,1099293388,17017603028,-4220,,
15613001569,1087.63622,17017657799,1099343934,17017653638,-4161,,
15613052117,1087.68676,17017708351,1099394479,17017704248,-4103,,
15613102213,1087.73686,17017758449,1099444573,17017754405,-4044,,
15613152725,1087.78737,17017808963,1099495083,17017804978,-3985,,
15613203802,1087.83845,17017860042,1099546156,17017856115,-3927,,
15613254847,1087.88949,17017911090,1099597198,17017907222,-3868,,
15613305918,1087.94057,17017962163,1099648267,17017958356,-3807,,
15613356531,1087.99118,17018012779,1099698877,17018009030,-3749,,
15613407094,1088.04174,17018063343,1099749437,17018059653,-3690,,
15613458100,1088.09275,17018114362,1099800452,17018110732,-3630,,
15613509168,1088.14382,17018165423,1099851507,17018161852,-3571,,
15613559680,1088.19433,17018215937,1099902016,17018212424,-3513,,
15613610229,1088.24488,17018266488,1099952561,17018263033,-3455,,
15613661314,1088.29596,17018317575,1100003644,17018314181,-3394,,
15613712363,1088.34701,17018368627,1100054690,17018365292,-3335,,
15613763397,1088.39804,17018419664,1100105721,17018416387,-3277,,
15613813954,1088.44860,17018470223,1100156276,17018467005,-3218,,
15613865007,1088.49966,17018521277,1100207326,17018518120,-3157,,
15613916057,1088.55071,17018572331,1100258373,17018569232,-3099,,
15613967105,1088.60175,17018623381,1100309418,17018620341,-3040,,
15614017655,1088.65230,17018673933,1100359967,17018670953,-2980,,
15614068703,1088.70335,17018724984,1100411012,17018722063,-2921,,
15614119753,1088.75440,17018776036,1100462058,17018773174,-2862,,
15614170306,1088.80495,17018826592,1100512608,17018823788,-2804,,
15614220943,1088.85559,17018877231,1100563243,17018874487,-2744,,
15614271976,1088.90662,17018928266,1100614273,17018925580,-2686,,
15614322572,1088.95722,17018978864,1100664866,17018976237,-2627,,
15614373100,1089.00775,17019029394,1100715392,17019026827,-2567,,
15614424134,1089.05878,17019080431,1100766423,17019077923,-2508,,
15614474932,1089.10958,17019131232,1100817218,17019128782,-2450,,
15614525241,1089.15989,17019181543,1100867524,17019179152,-2391,,
15614575853,1089.21050,17019232156,1100918134,17019229825,-2331,,
15614626921,1089.26157,17019283228,1100969199,17019280955,-2273,,
15614677450,1089.31210,17019333759,1101019725,17019331545,-2214,,
15614728477,1089.36313,17019384789,1101070751,17019382634,-2155,,
15614779104,1089.41375,17019435417,1101121374,17019433322,-2095,,
15614829727,1089.46438,17019486043,1101171995,17019484006,-2037,,
15614880532,1089.51518,17019536851,1101222797,17019534873,-1978,,
15614931110,1089.56576,17019587431,1101273372,17019585512,-1919,,
15614981689,1089.61634,17019638012,1101323948,17019636151,-1861,,
15615032249,1089.66690,17019688575,1101374517,17019686784,-1791,,
15615082851,1089.71750,17019739186,1101425113,17019737383,-1803,,
15615133908,1089.76856,17019790238,1101476159,17019788430,-1808,,
15615184962,1089.81961,17019841295,1101527211,17019839481,-1814,,
15615235938,1089.87059,17019892272,1101578183,17019890453,-1819,,
15615286969,1089.92162,17019943305,1101629212,17019941482,-1823,,
15615337088,1089.97174,17019993438,1101679339,17019991610,-1828,,
15615388133,1090.02278,17020044475,1101730371,17020042651,-1824,,
15615438666,1090.07331,17020095011,1101780902,17020093172,-1839,,
15615489505,1090.12415,17020145851,1101831737,17020144007,-1844,,
15615540368,1090.17502,17020196716,1101882597,17020194868,-1848,,
15615591416,1090.22606,17020247768,1101933643,17020245913,-1855,,
15615642465,1090.27711,17020298818,1101984689,17020296959,-1859,,
15615693008,1090.32766,17020349364,1102035230,17020347500,-1864,,
15615743185,1090.37783,17020399543,1102085403,17020397673,-1870,,
15615793773,1090.42842,17020450134,1102135989,17020448260,-1874,,
15615844313,1090.47896,17020500676,1102186526,17020498797,-1879,,
15615894886,1090.52953,17020551251,1102237096,17020549366,-1885,,
15615945363,1090.58001,17020601731,1102287570,17020599841,-1890,,
15615996357,1090.63100,17020652727,1102338562,17020650833,-1894,,
15616046959,1090.68161,17020703332,1102389161,17020701432,-1900,,
15616098004,1090.73265,17020754379,1102440203,17020752474,-1905,,
15616148554,1090.78320,17020804932,1102490752,17020803022,-1910,,
15616199603,1090.83425,17020855983,1102541797,17020854068,-1915,,
15616250649,1090.88530,17020907031,1102592852,17020905122,-1909,,
15616301724,1090.93637,17020958108,1102643912,17020956182,-1926,,
15616352348,1090.98700,17021008735,1102694535,17021006805,-1930,,
15616402902,1091.03755,17021059290,1102745085,17021057355,-1935,,
15616453910,1091.08856,17021110302,1102796090,17021108361,-1941,,
15616504953,1091.13960,17021161346,1102847131,17021159402,-1944,,
15616555010,1091.18966,17021211406,1102897185,17021209456,-1950,,
15616606090,1091.24074,17021262488,1102948262,17021260533,-1955,,
15616657138,1091.29179,17021313538,1102999307,17021311578,-1960,,
15616708068,1091.34272,17021364471,1103050235,17021362505,-1966,,
15616759139,1091.39379,17021415545,1103101303,17021413574,-1971,,
15616810213,1091.44486,17021466620,1103152374,17021464644,-1976,,
15616860322,1091.49497,17021516733,1103202481,17021514752,-1981,,
15616911354,1091.54600,17021567767,1103253510,17021565780,-1987,,
15616962244,1091.59689,17021618659,1103304398,17021616668,-1991,,
15617012815,1091.64746,17021669233,1103354966,17021667236,-1997,,
15617063424,1091.69807,17021719843,1103405572,17021717843,-2000,,
15617113560,1091.74821,17021769982,1103455717,17021767987,-1995,,
15617164165,1091.79881,17021820590,1103506307,17021818578,-2012,,
15617214730,1091.84938,17021871156,1103556870,17021869141,-2015,,
15617265341,1091.89999,17021921770,1103607479,17021919749,-2021,,
15617315984,1091.95063,17021972415,1103658118,17021970389,-2026,,
15617367009,1092.00166,17022023442,1103709140,17022021410,-2032,,
15617417668,1092.05232,17022074105,1103759797,17022072067,-2038,,
15617468725,1092.10337,17022125164,1103810851,17022123134,-2030,,
15617518853,1092.15350,17022175293,1103860976,17022173247,-2046,,
15617569434,1092.20408,17022225877,1103911555,17022223825,-2052,,
15617619560,1092.25421,17022276005,1103961677,17022273948,-2057,,
15617670244,1092.30489,17022326691,1104012359,17022324630,-2061,,
15617720952,1092.35560,17022377403,1104063064,17022375335,-2068,,
15617772000,1092.40665,17022428464,1104114122,17022426392,-2072,,
15617822646,1092.45729,17022479101,1104164753,17022477024,-2077,,
15617873629,1092.50828,17022530087,1104215733,17022528004,-2083,,
15617923790,1092.55844,17022580261,1104265903,17022578175,-2086,,
15617974370,1092.60902,17022630831,1104316469,17022628740,-2091,,
15618024522,1092.65917,17022680999,1104366630,17022678901,-2098,,
15618075593,1092.71024,17022732060,1104417687,17022729957,-2103,,
15618126152,1092.76080,17022782622,1104468243,17022780514,-2108,,
15618176826,1092.81147,17022833297,1104518914,17022831185,-2112,,
15618227411,1092.86206,17022883885,1104569508,17022881779,-2106,,
15618278452,1092.91310,17022934928,1104620534,17022932805,-2123,,
15618329502,1092.96415,17022985981,1104671583,17022983853,-2128,,
15618380136,1093.01478,17023036616,1104722213,17023034484,-2132,,
15618430719,1093.06537,17023087203,1104772793,17023085064,-2139,,
15618481290,1093.11594,17023137787,1104823374,17023135645,-2142,,
15618531855,1093.16650,17023188343,1104873924,17023186195,-2148,,
15618582471,1093.21712,17023238962,1104924537,17023236808,-2154,,
15618632902,1093.26755,17023289394,1104974966,17023287236,-2158,,
15618683509,1093.31816,17023340004,1105025571,17023337841,-2163,,
15618734107,1093.36875,17023390604,1105076165,17023388435,-2169,,
15618785184,1093.41983,17023441684,1105127240,17023439510,-2174,,
15618836266,1093.47091,17023492769,1105178319,17023490589,-2180,,
15618887325,1093.52197,17023543830,1105229375,17023541646,-2184,,
15618938322,1093.57297,17023594829,1105280369,17023592640,-2189,,
15618988514,1093.62316,17023645023,1105330569,17023642840,-2183,,
15619039139,1093.67379,17023695651,1105381181,17023693452,-2199,,
15619089653,1093.72430,17023746167,1105431702,17023743972,-2195,,
15619140721,1093.77537,17023797237,1105482758,17023795028,-2209,,
15619191770,1093.82642,17023848288,1105533803,17023846074,-2214,,
15619242786,1093.87743,17023899307,1105584817,17023897088,-2219,,
15619293837,1093.92848,17023950361,1105635865,17023948136,-2225,,
15619343918,1093.97857,17024000444,1105685944,17023998215,-2229,,
15619394943,1094.02959,17024051471,1105736966,17024049247,-2224,,
15619446015,1094.08066,17024102546,1105788035,17024100306,-2240,,
15619497057,1094.13171,17024153590,1105839075,17024151345,-2245,,
15619548115,1094.18276,17024204651,1105890131,17024202401,-2250,,
15619598651,1094.23330,17024255189,1105940664,17024252934,-2255,,
15619649708,1094.28436,17024306247,1105991717,17024303987,-2260,,
15619700778,1094.33543,17024357321,1106042785,17024355056,-2265,,
15619751372,1094.38602,17024407917,1106093376,17024405647,-2270,,
15619801951,1094.43660,17024458498,1106143952,17024456222,-2276,,
15619852539,1094.48719,17024509088,1106194536,17024506807,-2281,,
15619903529,1094.53818,17024560081,1106245525,17024557796,-2285,,
15619953651,1094.58830,17024610216,1106295654,17024607924,-2292,,
15620004717,1094.63936,17024661274,1106346708,17024658978,-2296,,
15620054864,1094.68951,17024711423,1106396852,17024709123,-2300,,
15620105530,1094.74018,17024762092,1106447515,17024759786,-2306,,
15620155957,1094.79060,17024812521,1106497940,17024810210,-2311,,
15620206481,1094.84113,17024863046,1106548460,17024860731,-2315,,
15620257529,1094.89218,17024914097,1106599506,17024911776,-2321,,
15620308603,1094.94325,17024965173,1106650577,17024962848,-2325,,
15620359651,1094.99430,17025016224,1106701622,17025013893,-2331,,
15620410693,1095.04534,17025067269,1106752662,17025064933,-2336,,
15620461749,1095.09640,17025118326,1106803715,17025115986,-2340,,
15620512308,1095.14696,17025168888,1106854271,17025166542,-2346,,
15620562860,1095.19751,17025219443,1106904820,17025217091,-2352,,
15620613344,1095.24799,17025269929,1106955302,17025267573,-2356,,
15620663938,1095.29859,17025320526,1107005894,17025318164,-2362,,
15620714987,1095.34964,17025371577,1107056939,17025369210,-2367,,
15620765570,1095.40022,17025422161,1107107520,17025419790,-2371,,
15620815709,1095.45036,17025472304,1107157656,17025469927,-2377,,
15620866151,1095.50080,17025522748,1107208095,17025520365,-2383,,
15620917028,1095.55168,17025573627,1107258969,17025571240,-2387,,
15620967996,1095.60264,17025624608,1107309946,17025622216,-2392,,
15621018666,1095.65331,17025675269,1107360602,17025672872,-2397,,
15621069514,1095.70416,17025726119,1107411458,17025723728,-2391,,
15621120141,1095.75479,17025776749,1107462072,17025774342,-2407,,
15621171216,1095.80586,17025827827,1107513144,17025825415,-2412,,
15621221968,1095.85662,17025878580,1107563893,17025876163,-2417,,
15621272516,1095.90716,17025929132,1107614438,17025926708,-2424,,
15621322616,1095.95726,17025979234,1107664536,17025976807,-2427,,
15621372765,1096.00741,17026029384,1107714682,17026026962,-2422,,
15621423335,1096.05798,17026079958,1107765249,17026077519,-2439,,
15621474442,1096.10909,17026131067,1107816354,17026128624,-2443,,
15621524519,1096.15917,17026181147,1107866429,17026178699,-2448,,
15621575117,1096.20977,17026231746,1107917023,17026229293,-2453,,
15621625680,1096.26033,17026282312,1107967584,17026279855,-2457,,
15621676737,1096.31138,17026333372,1108018639,17026330909,-2463,,
15621727314,1096.36196,17026383950,1108069212,17026381482,-2468,,
15621777434,1096.41208,17026434073,1108119329,17026431600,-2473,,
15621828049,1096.46270,17026484691,1108169943,17026482213,-2478,,
15621878524,1096.51317,17026535168,1108220414,17026532684,-2484,,
15621929288,1096.56394,17026585933,1108271175,17026583446,-2487,,
15621980368,1096.61502,17026637016,1108322253,17026634523,-2493,,
15622030896,1096.66554,17026687557,1108372789,17026685059,-2498,,
15622081592,1096.71624,17026738245,1108423471,17026735742,-2503,,
15622132195,1096.76684,17026788850,1108474071,17026786341,-2509,,
15622183244,1096.81789,17026839901,1108525118,17026837388,-2513,,
15622233857,1096.86850,17026890517,1108575728,17026887999,-2518,,
15622284893,1096.91954,17026941556,1108626762,17026939032,-2524,,
15622335432,1096.97008,17026992097,1108677299,17026989569,-2528,,
15622385546,1097.02019,17027042214,1108727421,17027039691,-2523,,
15622436157,1097.07081,17027092826,1108778017,17027090287,-2539,,
15622486809,1097.12146,17027143481,1108828667,17027140937,-2544,,
15622537328,1097.17198,17027194002,1108879183,17027191454,-2548,,
15622588361,1097.22301,17027245038,1108930214,17027242484,-2554,,
15622638936,1097.27358,17027295615,1108980796,17027293067,-2548,,
15622689546,1097.32419,17027346227,1109031393,17027343663,-2564,,
15622739630,1097.37428,17027396314,1109081474,17027393745,-2569,,
15622790243,1097.42489,17027446929,1109132085,17027444355,-2574,,
15622841240,1097.47589,17027497929,1109183079,17027495349,-2580,,
15622891338,1097.52599,17027548029,1109233174,17027545445,-2584,,
15622942166,1097.57681,17027598858,1109283999,17027596269,-2589,,
15622992758,1097.62741,17027649454,1109334589,17027646859,-2595,,
15623043549,1097.67820,17027700247,1109385377,17027697648,-2599,,
15623094122,1097.72877,17027750823,1109435947,17027748218,-2605,,
15623144717,1097.77937,17027801420,1109486539,17027798810,-2610,,
15623194781,1097.82943,17027851486,1109536602,17027848872,-2614,,
15623245397,1097.88005,17027902105,1109587214,17027899485,-2620,,
15623295548,1097.93020,17027952258,1109637362,17027949633,-2625,,
15623346123,1097.98077,17028002835,1109687935,17028000206,-2629,,
15623397168,1098.03182,17028053883,1109738978,17028051248,-2635,,
15623448225,1098.08287,17028104942,1109790031,17028102301,-2641,,
15623498765,1098.13341,17028155484,1109840569,17028152839,-2645,,
15623549363,1098.18401,17028206084,1109891164,17028203434,-2650,,
15623599946,1098.23459,17028256670,1109941745,17028254015,-2655,,
15623651012,1098.28566,17028307737,1109992807,17028305077,-2660,,
15623702013,1098.33666,17028358742,1110043806,17028356076,-2666,,
15623752575,1098.38722,17028409306,1110094365,17028406636,-2670,,
15623803614,1098.43826,17028460348,1110145402,17028457672,-2676,,
15623854188,1098.48884,17028510923,1110195972,17028508242,-2681,,
15623904771,1098.53942,17028561509,1110246554,17028558824,-2685,,
15623955356,1098.59000,17028612097,1110297135,17028609406,-2691,,
15624005870,1098.64052,17028662613,1110347646,17028659917,-2696,,
15624056725,1098.69137,17028713470,1110398499,17028710770,-2700,,
15624107274,1098.74192,17028764021,1110449045,17028761315,-2706,,
15624158102,1098.79275,17028814852,1110499871,17028812144,-2708,,
15624208426,1098.84307,17028865178,1110550192,17028862462,-2716,,
15624259493,1098.89414,17028916249,1110601258,17028913529,-2720,,
15624310454,1098.94510,17028967212,1110652216,17028964487,-2725,,
15624361513,1098.99616,17029018272,1110703271,17029015541,-2731,,
15624412132,1099.04678,17029068893,1110753886,17029066157,-2736,,
15624463151,1099.09780,17029119915,1110804904,17029117174,-2741,,
15624513257,1099.14791,17029170024,1110855007,17029167278,-2746,,
15624563844,1099.19849,17029220612,1110905590,17029217860,-2752,,
15624614421,1099.24907,17029271192,1110956166,17029268437,-2755,,
15624665027,1099.29967,17029321801,1111006768,17029319039,-2762,,
15624715623,1099.35027,17029372399,1111057362,17029369633,-2766,,
15624766175,1099.40082,17029422953,1111107912,17029420182,-2771,,
15624816248,1099.45090,17029473028,1111157981,17029470251,-2777,,
15624867301,1099.50195,17029524084,1111209031,17029521302,-2782,,
15624917380,1099.55203,17029574165,1111259108,17029571378,-2787,,
15624967515,1099.60216,17029624303,1111309250,17029621521,-2782,,
15625018587,1099.65323,17029675377,1111360309,17029672580,-2797,,
15625069134,1099.70378,17029725925,1111410853,17029723123,-2802,,
15625119683,1099.75433,17029776478,1111461401,17029773671,-2807,,
15625169768,1099.80442,17029826565,1111511483,17029823753,-2812,,
15625219940,1099.85459,17029876738,1111561651,17029873922,-2816,,
15625270460,1099.90511,17029927261,1111612168,17029924439,-2822,,
15625321134,1099.95578,17029977937,1111662840,17029975110,-2827,,
15625371637,1100.00628,17030028442,1111713340,17030025610,-2832,,
15625422270,1100.05692,17030079078,1111763970,17030076240,-2838,,
15625472848,1100.10750,17030129659,1111814546,17030126817,-2842,,
15625523354,1100.15800,17030180177,1111865060,17030177330,-2847,,
15625574379,1100.20903,17030231195,1111916071,17030228341,-2854,,
15625624519,1100.25917,17030281337,1111966209,17030278480,-2857,,
15625675507,1100.31015,17030332327,1112017194,17030329465,-2862,,
15625725645,1100.36029,17030382468,1112067329,17030379600,-2868,,
15625776174,1100.41082,17030432999,1112117856,17030430126,-2873,,
15625826838,1100.46149,17030483666,1112168517,17030480787,-2879,,
15625877410,1100.51206,17030534240,1112219086,17030531357,-2883,,
15625927540,1100.56219,17030584372,1112269213,17030581484,-2888,,
15625978239,1100.61289,17030635074,1112319910,17030632181,-2893,,
15626028831,1100.66348,17030685668,1112370500,17030682770,-2898,,
15626079803,1100.71445,17030736642,1112421468,17030733738,-2904,,
15626130856,1100.76550,17030787708,1112472530,17030784800,-2908,,
15626181028,1100.81568,17030837872,1112522689,17030834959,-2913,,
15626231906,1100.86655,17030888751,1112573563,17030885833,-2918,,
15626282120,1100.91677,17030938969,1112623774,17030936044,-2925,,
15626332432,1100.96708,17030989283,1112674084,17030986355,-2928,,
15626383021,1101.01767,17031039874,1112724670,17031036941,-2933,,
15626434046,1101.06869,17031090901,1112775692,17031087962,-2939,,
15626485111,1101.11976,17031141969,1112826755,17031139026,-2943,,
15626535769,1101.17042,17031192629,1112877410,17031189681,-2948,,
15626586336,1101.22098,17031243199,1112927974,17031240245,-2954,,
15626636429,1101.27108,17031293294,1112978064,17031290335,-2959,,
15626687400,1101.32205,17031344268,1113029033,17031341303,-2965,,
15626738449,1101.37310,17031395319,1113080079,17031392349,-2970,,
15626789528,1101.42418,17031446400,1113131155,17031443426,-2974,,
15626839911,1101.47456,17031496785,1113181536,17031493806,-2979,,
15626890471,1101.52512,17031547348,1113232093,17031544364,-2984,,
15626941551,1101.57620,17031598430,1113283170,17031595441,-2989,,
15626992589,1101.62724,17031649471,1113334216,17031646487,-2984,,
15627043643,1101.67829,17031700527,1113385257,17031697528,-2999,,
15627094707,1101.72935,17031751593,1113436318,17031748588,-3005,,
15627145725,1101.78037,17031802614,1113487333,17031799603,-3011,,
15627196804,1101.83145,17031853695,1113538410,17031850681,-3014,,
15627247853,1101.88250,17031904746,1113589456,17031901726,-3020,,
15627298919,1101.93357,17031955815,1113640519,17031952789,-3026,,
15627349503,1101.98415,17032006401,1113691101,17032003371,-3030,,
15627400135,1102.03478,17032057035,1113741730,17032054000,-3035,,
15627450744,1102.08539,17032107647,1113792336,17032104606,-3041,,
15627500885,1102.13553,17032157789,1113842474,17032154744,-3045,,
15627551469,1102.18612,17032208377,1113893057,17032205327,-3050,,
15627602018,1102.23667,17032258928,1113943602,17032255872,-3056,,
15627653034,1102.28768,17032309947,1113994616,17032306886,-3061,,
15627703616,1102.33826,17032360530,1114045194,17032357464,-3066,,
15627754676,1102.38932,17032411592,1114096252,17032408522,-3070,,
15627805269,1102.43992,17032462188,1114146842,17032459112,-3076,,
15627856349,1102.49100,17032513271,1114197919,17032510190,-3081,,
15627906544,1102.54119,17032563467,1114248112,17032560382,-3085,,
15627957131,1102.59178,17032614057,1114298696,17032610966,-3091,,
15628007683,1102.64233,17032664612,1114349246,17032661516,-3096,,
15628058304,1102.69295,17032715235,1114399864,17032712134,-3101,,
15628108884,1102.74353,17032765818,1114450441,17032762711,-3107,,
15628159412,1102.79406,17032816347,1114500966,17032813236,-3111,,
15628210100,1102.84475,17032867037,1114551651,17032863921,-3116,,
15628260720,1102.89537,17032917660,1114602269,17032914539,-3121,,
15628311801,1102.94645,17032968744,1114653348,17032965618,-3126,,
15628362351,1102.99700,17033019297,1114703906,17033016176,-3121,,
15628412885,1103.04753,17033069832,1114754425,17033066695,-3137,,
15628463507,1103.09815,17033120457,1114805045,17033117316,-3141,,
15628514580,1103.14923,17033171533,1114856115,17033168386,-3147,,
15628565093,1103.19974,17033222047,1114906625,17033218895,-3152,,
15628616128,1103.25078,17033273085,1114957658,17033269929,-3156,,
15628666190,1103.30084,17033323150,1115007717,17033319988,-3162,,
15628716772,1103.35142,17033373733,1115058295,17033370566,-3167,,
15628767342,1103.40199,17033424305,1115108863,17033421133,-3172,,
15628817936,1103.45258,17033474903,1115159455,17033471726,-3177,,
15628868485,1103.50313,17033525454,1115210001,17033522272,-3182,,
15628919526,1103.55417,17033576496,1115261039,17033573309,-3187,,
15628970580,1103.60523,17033627554,1115312092,17033624362,-3192,,
15629020710,1103.65536,17033677695,1115362228,17033674499,-3196,,
15629071756,1103.70640,17033728733,1115413272,17033725543,-3190,,
15629122796,1103.75744,17033779776,1115464298,17033776569,-3207,,
15629172930,1103.80758,17033829913,1115514430,17033826712,-3201,,
15629223097,1103.85775,17033880083,1115564594,17033876864,-3219,,
15629273693,1103.90834,17033930681,1115615187,17033927458,-3223,,
15629324726,1103.95937,17033981715,1115666218,17033978488,-3227,,
15629374887,1104.00953,17034031880,1115716376,17034028646,-3234,,
15629425480,1104.06013,17034082474,1115766966,17034079236,-3238,,
15629476046,1104.11069,17034133043,1115817530,17034129801,-3242,,
15629526543,1104.16119,17034183542,1115868024,17034180305,-3237,,
15629577150,1104.21180,17034234152,1115918629,17034230899,-3253,,
15629627680,1104.26233,17034284695,1115969167,17034281438,-3257,,
15629678332,1104.31298,17034335338,1116019805,17034332076,-3262,,
15629728460,1104.36311,17034385469,1116069931,17034382201,-3268,,
15629779116,1104.41376,17034436126,1116120583,17034432853,-3273,,
15629829712,1104.46436,17034486737,1116171188,17034483459,-3278,,
15629880782,1104.51543,17034537798,1116222244,17034534515,-3283,,
15629931810,1104.56646,17034588828,1116273270,17034585540,-3288,,
15629982443,1104.61709,17034639463,1116323899,17034636169,-3294,,
15630032992,1104.66764,17034690025,1116374457,17034686728,-3297,,
15630083577,1104.71823,17034740603,1116425029,17034737299,-3304,,
15630134141,1104.76879,17034791168,1116475589,17034787860,-3308,,
15630185189,1104.81984,17034842219,1116526636,17034838907,-3312,,
15630236229,1104.87088,17034893261,1116577672,17034889942,-3319,,
15630286816,1104.92146,17034943850,1116628256,17034940527,-3323,,
15630337422,1104.97207,17034994459,1116678859,17034991130,-3329,,
15630388248,1105.02290,17035045288,1116729694,17035041965,-3323,,
15630438477,1105.07312,17035095519,1116779910,17035092180,-3339,,
15630489077,1105.12372,17035146121,1116830506,17035142777,-3344,,
15630540009,1105.17466,17035197056,1116881436,17035193707,-3349,,
15630590118,1105.22477,17035247167,1116931542,17035243813,-3354,,
15630640629,1105.27528,17035297679,1116982050,17035294320,-3359,,
15630691174,1105.32582,17035348227,1117032593,17035344864,-3363,,
15630741791,1105.37644,17035398847,1117083208,17035395478,-3369,,
15630792352,1105.42700,17035449410,1117133766,17035446036,-3374,,
15630842967,1105.47762,17035500027,1117184377,17035496647,-3380,,
15630893956,1105.52860,17035551019,1117235364,17035547634,-3385,,
15630944566,1105.57921,17035601632,1117285972,17035598242,-3390,,
15630995487,1105.63014,17035652567,1117336902,17035649173,-3394,,
15631046074,1105.68072,17035703156,1117387486,17035699757,-3399,,
15631096454,1105.73110,17035753527,1117437851,17035750122,-3405,,
15631147007,1105.78166,17035804081,1117488401,17035800672,-3409,,
15631198055,1105.83270,17035855131,1117539446,17035851716,-3415,,
15631248656,1105.88330,17035905736,1117590045,17035902316,-3420,,
15631299685,1105.93433,17035956767,1117641071,17035953342,-3425,,
15631350762,1105.98541,17036007846,1117692145,17036004416,-3430,,
15631401567,1106.03622,17036058654,1117742960,17036055231,-3423,,
15631452135,1106.08678,17036109224,1117793514,17036105784,-3440,,
15631502724,1106.13737,17036159815,1117844099,17036156369,-3446,,
15631553624,1106.18827,17036210718,1117894997,17036207267,-3451,,
15631604159,1106.23881,17036261255,1117945529,17036257800,-3455,,
15631654319,1106.28897,17036311417,1117995686,17036307957,-3460,,
15631704994,1106.33964,17036362095,1118046359,17036358629,-3466,,
15631755571,1106.39022,17036412674,1118096933,17036409204,-3470,,
15631806165,1106.44081,17036463271,1118147524,17036459795,-3476,,
15631856690,1106.49134,17036513798,1118198046,17036510317,-3481,,
15631906813,1106.54146,17036563923,1118248167,17036560438,-3485,,
15631956874,1106.59152,17036613986,1118298225,17036610495,-3491,,
15632007810,1106.64246,17036664924,1118349158,17036661428,-3496,,
15632058371,1106.69302,17036715488,1118399717,17036711987,-3501,,
15632108952,1106.74360,17036766072,1118450295,17036762566,-3506,,
15632159461,1106.79411,17036816583,1118500801,17036813072,-3511,,
15632210469,1106.84512,17036867593,1118551806,17036864077,-3516,,
15632261546,1106.89619,17036918672,1118602881,17036915151,-3521,,
15632311660,1106.94631,17036968789,1118652992,17036965263,-3526,,
15632362709,1106.99736,17037019840,1118704038,17037016309,-3531,,
15632413703,1107.04835,17037070837,1118755029,17037067300,-3537,,
15632463860,1107.09851,17037120996,1118805184,17037117455,-3541,,
15632514319,1107.14897,17037171458,1118855640,17037167911,-3547,,
15632564881,1107.19953,17037222022,1118906199,17037218470,-3552,,
15632614993,1107.24964,17037272135,1118956309,17037268579,-3556,,
15632665543,1107.30019,17037322689,1119006857,17037319127,-3562,,
15632716111,1107.35076,17037373259,1119057422,17037369692,-3567,,
15632766668,1107.40132,17037423817,1119107976,17037420246,-3571,,
15632817256,1107.45190,17037474409,1119158561,17037470832,-3577,,
15632868311,1107.50296,17037525465,1119209613,17037521883,-3582,,
15632918635,1107.55328,17037575791,1119259934,17037572205,-3586,,
15632969663,1107.60431,17037626823,1119310961,17037623241,-3582,,
15633019793,1107.65444,17037676955,1119361087,17037673358,-3597,,
15633070416,1107.70506,17037727580,1119411707,17037723978,-3602,,
15633121168,1107.75582,17037778335,1119462457,17037774728,-3607,,
15633171285,1107.80593,17037828453,1119512571,17037824842,-3611,,
15633222349,1107.85700,17037879519,1119563631,17037875902,-3617,,
15633273052,1107.90770,17037930226,1119614333,17037926603,-3623,,
15633323564,1107.95821,17037980739,1119664842,17037977112,-3627,,
15633373709,1108.00836,17038030887,1119714984,17038027254,-3633,,
15633423806,1108.05845,17038080987,1119765079,17038077349,-3638,,
15633474355,1108.10900,17038131550,1119815638,17038127908,-3642,,
15633524839,1108.15949,17038182025,1119866118,17038178388,-3637,,
15633575463,1108.21011,17038232650,1119916727,17038228997,-3653,,
15633626511,1108.26116,17038283701,1119967774,17038280045,-3656,,
15633677608,1108.31226,17038334800,1120018867,17038331138,-3662,,
15633728145,1108.36279,17038385340,1120069403,17038381674,-3666,,
15633779196,1108.41384,17038436393,1120120450,17038432720,-3673,,
15633829692,1108.46434,17038486891,1120170955,17038483225,-3666,,
15633879806,1108.51445,17038537009,1120221055,17038533325,-3684,,
15633930913,1108.56556,17038588117,1120272158,17038584429,-3688,,
15633981024,1108.61567,17038638242,1120322279,17038634549,-3693,,
15634031589,1108.66624,17038688798,1120372829,17038685099,-3699,,
15634082027,1108.71667,17038739237,1120423264,17038735534,-3703,,
15634133061,1108.76771,17038790275,1120474296,17038786566,-3709,,
15634184077,1108.81873,17038841292,1120525309,17038837579,-3713,,
15634235170,1108.86982,17038892388,1120576399,17038888669,-3719,,
15634286164,1108.92081,17038943384,1120627390,17038939660,-3724,,
15634336747,1108.97140,17038993970,1120677972,17038990242,-3728,,
15634386961,1109.02161,17039044187,1120728182,17039040452,-3735,,
15634437523,1109.07217,17039094751,1120778741,17039091012,-3739,,
15634487746,1109.12239,17039144975,1120828961,17039141232,-3743,,
15634537861,1109.17251,17039195093,1120879074,17039191344,-3749,,
15634588653,1109.22330,17039245888,1120929864,17039242134,-3754,,
15634639233,1109.27388,17039296470,1120980441,17039292711,-3759,,
15634689872,1109.32452,17039347112,1121031077,17039343348,-3764,,
15634740870,1109.37552,17039398112,1121082072,17039394343,-3769,,
15634791526,1109.42617,17039448770,1121132726,17039444996,-3774,,
15634842590,1109.47724,17039499836,1121183786,17039496057,-3779,,
15634893515,1109.52816,17039550764,1121234709,17039546980,-3784,,
15634943716,1109.57836,17039600968,1121284908,17039597178,-3790,,
15634994354,1109.62900,17039651607,1121335542,17039647812,-3795,,
15635045153,1109.67980,17039702409,1121386340,17039698610,-3799,,
15635095759,1109.73041,17039753017,1121436942,17039749212,-3805,,
15635146592,1109.78124,17039803853,1121487773,17039800043,-3810,,
15635197146,1109.83179,17039854409,1121538324,17039850594,-3815,,
15635247942,1109.88259,17039905208,1121589117,17039901388,-3820,,
15635298066,1109.93271,17039955333,1121639238,17039951508,-3825,,
15635348917,1109.98356,17040006197,1121690097,17040002368,-3829,,
15635399536,1110.03418,17040056809,1121740703,17040052974,-3835,,
15635450086,1110.08473,17040107361,1121791251,17040103521,-3840,,
15635500296,1110.13494,17040157573,1121841458,17040153728,-3845,,
15635551326,1110.18597,17040208605,1121892485,17040204755,-3850,,
15635601513,1110.23616,17040258795,1121942669,17040254940,-3855,,
15635652128,1110.28678,17040309412,1121993282,17040305552,-3860,,
15635702739,1110.33739,17040360026,1122043889,17040356160,-3866,,
15635753347,1110.38800,17040410636,1122094495,17040406765,-3871,,
15635803908,1110.43856,17040461200,1122145053,17040457323,-3877,,
15635854985,1110.48963,17040512279,1122196127,17040508397,-3882,,
15635905912,1110.54056,17040563208,1122247052,17040559323,-3885,,
15635956506,1110.59115,17040613805,1122297644,17040609914,-3891,,
15636007062,1110.64171,17040664362,1122348196,17040660466,-3896,,
15636057628,1110.69228,17040714931,1122398760,17040711030,-3901,,
15636107771,1110.74242,17040765076,1122448900,17040761171,-3905,,
15636158836,1110.79348,17040816144,1122499962,17040812233,-3911,,
15636209542,1110.84419,17040866852,1122550665,17040862936,-3916,,
15636259751,1110.89440,17040917064,1122600872,17040913152,-3912,,
15636310807,1110.94546,17040968122,1122651926,17040964196,-3926,,
15636361340,1110.99599,17041018666,1122702465,17041014735,-3931,,
15636411942,1111.04659,17041069262,1122753054,17041065325,-3937,,
15636462488,1111.09714,17041119809,1122803598,17041115868,-3941,,
15636513570,1111.14822,17041170895,1122854678,17041166948,-3947,,
15636563668,1111.19832,17041220995,1122904772,17041217043,-3952,,
15636614647,1111.24930,17041271976,1122955750,17041268020,-3956,,
15636665158,1111.29981,17041322490,1123006258,17041318528,-3962,,
15636716194,1111.35084,17041373527,1123057290,17041369560,-3967,,
15636766379,1111.40103,17041423715,1123107473,17041419744,-3971,,
15636817368,1111.45202,17041474706,1123158459,17041470729,-3977,,
15636867817,1111.50247,17041525158,1123208905,17041521176,-3982,,
15636917905,1111.55255,17041575248,1123258990,17041571261,-3987,,
15636968469,1111.60312,17041625815,1123309552,17041621823,-3992,,
15637019034,1111.65368,17041676382,1123360115,17041672385,-3997,,
15637069983,1111.70463,17041727333,1123411060,17041723331,-4002,,
15637120600,1111.75525,17041777953,1123461675,17041773946,-4007,,
15637171157,1111.80580,17041828512,1123512241,17041824511,-4001,,
15637221289,1111.85594,17041878646,1123562359,17041874629,-4017,,
15637271893,1111.90654,17041929253,1123612959,17041925230,-4023,,
15637322602,1111.95725,17041979964,1123663666,17041975937,-4027,,
15637373686,1112.00833,17042031051,1123714747,17042027018,-4033,,
15637424315,1112.05896,17042081682,1123765374,17042077644,-4038,,
15637474991,1112.10964,17042132359,1123816047,17042128317,-4042,,
15637525080,1112.15973,17042182451,1123866133,17042178403,-4048,,
15637576110,1112.21076,17042233484,1123917161,17042229431,-4053,,
15637627009,1112.26166,17042284385,1123968057,17042280327,-4058,,
15637677358,1112.31201,17042334746,1124018413,17042330684,-4062,,
15637728379,1112.36303,17042385760,1124069422,17042381692,-4068,,
15637778991,1112.41364,17042436373,1124120030,17042432301,-4072,,
15637829578,1112.46423,17042486964,1124170616,17042482887,-4077,,
15637880216,1112.51486,17042537604,1124221250,17042533520,-4084,,
15637930806,1112.56545,17042588196,1124271837,17042584107,-4089,,
15637981881,1112.61653,17042639273,1124322910,17042635181,-4092,,
15638032914,1112.66756,17042690309,1124373941,17042686211,-4098,,
15638083748,1112.71840,17042741146,1124424771,17042737042,-4104,,
15638134771,1112.76942,17042792181,1124475802,17042788073,-4108,,
15638185840,1112.82049,17042843242,1124526858,17042839129,-4113,,
15638236369,1112.87102,17042893784,1124577395,17042889665,-4119,,
15638287039,1112.92169,17042944446,1124628051,17042940322,-4124,,
15638337621,1112.97227,17042995029,1124678630,17042990900,-4129,,
15638388665,1113.02331,17043046077,1124729672,17043041943,-4134,,
15638439203,1113.07385,17043096616,1124780207,17043092477,-4139,,
15638489806,1113.12445,17043147222,1124830808,17043143078,-4144,,
15638540734,1113.17538,17043198153,1124881733,17043194004,-4149,,
15638590885,1113.22553,17043248306,1124931881,17043244152,-4154,,
15638641357,1113.27600,17043298780,1124982351,17043294621,-4159,,
15638691422,1113.32607,17043348847,1125032413,17043344683,-4164,,
15638741973,1113.37662,17043399401,1125082961,17043395232,-4169,,
15638792518,1113.42717,17043449949,1125133503,17043445774,-4175,,
15638843364,1113.47801,17043500797,1125184346,17043496617,-4180,,
15638893945,1113.52859,17043551380,1125234926,17043547196,-4184,,
15638944556,1113.57920,17043602005,1125285545,17043597816,-4189,,
15638995205,1113.62985,17043652644,1125336179,17043648449,-4195,,
15639045827,1113.68047,17043703269,1125386799,17043699070,-4199,,
15639096742,1113.73139,17043754187,1125437712,17043749982,-4205,,
15639147765,1113.78241,17043805212,1125488731,17043801002,-4210,,
15639198376,1113.83302,17043855834,1125539349,17043851620,-4214,,
15639248977,1113.88362,17043906428,1125589938,17043902208,-4220,,
15639299596,1113.93424,17043957049,1125640554,17043952824,-4225,,
15639349980,1113.98463,17044007435,1125690935,17044003205,-4230,,
15639401055,1114.03570,17044058514,1125742009,17044054279,-4235,,
15639452075,1114.08672,17044109536,1125793026,17044105296,-4240,,
15639502228,1114.13688,17044159692,1125843175,17044155446,-4246,,
15639552809,1114.18746,17044210275,1125893753,17044206024,-4251,,
15639603750,1114.23840,17044261218,1125944704,17044256975,-4243,,
15639654317,1114.28896,17044311787,1125995256,17044307526,-4261,,
15639704899,1114.33955,17044362371,1126045835,17044358105,-4266,,
15639755531,1114.39018,17044413006,1126096466,17044408736,-4270,,
15639806569,1114.44122,17044464047,1126147512,17044459784,-4263,,
15639857201,1114.49185,17044514680,1126198129,17044510399,-4281,,
15639908233,1114.54288,17044565715,1126249158,17044561429,-4286,,
15639958812,1114.59346,17044616297,1126299735,17044612005,-4292,,
15640009815,1114.64446,17044667301,1126350735,17044663005,-4296,,
15640060384,1114.69503,17044717872,1126401301,17044713572,-4300,,
15640110997,1114.74564,17044768489,1126451912,17044764183,-4306,,
15640161415,1114.79606,17044818909,1126502327,17044814597,-4312,,
15640211482,1114.84613,17044868977,1126552391,17044864661,-4316,,
15640262101,1114.89675,17044919599,1126603008,17044915278,-4321,,
15640312715,1114.94736,17044970216,1126653620,17044965891,-4325,,
15640363297,1114.99795,17045020801,1126704198,17045016468,-4333,,
15640413912,1115.04856,17045071418,1126754810,17045067081,-4337,,
15640464463,1115.09911,17045121971,1126805360,17045117630,-4341,,
15640515020,1115.14967,17045172533,1126855915,17045168186,-4347,,
15640565615,1115.20026,17045223128,1126906506,17045218776,-4352,,
15640616668,1115.25132,17045274182,1126957556,17045269838,-4344,,
15640667751,1115.30240,17045325269,1127008636,17045320907,-4362,,
15640718736,1115.35338,17045376256,1127059618,17045371889,-4367,,
15640769297,1115.40395,17045426819,1127110176,17045422447,-4372,,
15640819622,1115.45427,17045477158,1127160510,17045472780,-4378,,
15640870695,1115.50534,17045528222,1127211570,17045523840,-4382,,
15640921292,1115.55594,17045578821,1127262164,17045574434,-4387,,
15640971880,1115.60653,17045629411,1127312749,17045625019,-4392,,
15641022019,1115.65667,17045679553,1127362886,17045675156,-4397,,
15641072549,1115.70720,17045730086,1127413412,17045725683,-4403,,
15641123160,1115.75781,17045780699,1127464020,17045776291,-4408,,
15641173296,1115.80794,17045830837,1127514154,17045826425,-4412,,
15641224321,1115.85897,17045881864,1127565176,17045877446,-4418,,
15641274793,1115.90944,17045932338,1127615645,17045927915,-4423,,
15641325318,1115.95997,17045982865,1127666168,17045978438,-4427,,
15641375908,1116.01056,17046033458,1127716755,17046029026,-4432,,
15641426951,1116.06160,17046084503,1127767805,17046080076,-4427,,
15641477949,1116.11260,17046135504,1127818791,17046131061,-4443,,
15641528586,1116.16323,17046186143,1127869425,17046181695,-4448,,
15641578723,1116.21337,17046236282,1127919559,17046231830,-4452,,
15641629756,1116.26440,17046287318,1127970590,17046282861,-4457,,
15641680381,1116.31503,17046337946,1128021212,17046333483,-4463,,
15641730538,1116.36519,17046388105,1128071367,17046383637,-4468,,
15641781308,1116.41596,17046438876,1128122133,17046434403,-4473,,
15641831848,1116.46650,17046489420,1128172672,17046484942,-4478,,
15641882790,1116.51744,17046540364,1128223611,17046535882,-4482,,
15641933339,1116.56799,17046590916,1128274157,17046586428,-4488,,
15641983509,1116.61816,17046641088,1128324323,17046636594,-4494,,
15642034547,1116.66919,17046692127,1128375359,17046687630,-4497,,
15642085670,1116.72032,17046743254,1128426480,17046738750,-4504,,
15642136222,1116.77087,17046793820,1128477041,17046789312,-4508,,
15642187295,1116.82194,17046844882,1128528099,17046840370,-4512,,
15642237935,1116.87258,17046895526,1128578736,17046891007,-4519,,
15642288503,1116.92315,17046946096,1128629302,17046941572,-4524,,
15642339123,1116.97377,17046996718,1128679919,17046992189,-4529,,
15642389600,1117.02425,17047047198,1128730393,17047042664,-4534,,
15642440195,1117.07484,17047097795,1128780985,17047093255,-4540,,
15642491275,1117.12592,17047148877,1128832062,17047144333,-4544,,
15642542313,1117.17696,17047199918,1128883098,17047195369,-4549,,
15642592901,1117.22755,17047250508,1128933683,17047245954,-4554,,
15642643680,1117.27833,17047301290,1128984460,17047296741,-4549,,
15642694285,1117.32893,17047351897,1129035062,17047347332,-4565,,
15642745377,1117.38002,17047402990,1129086151,17047398421,-4569,,
15642795881,1117.43053,17047453498,1129136653,17047448923,-4575,,
15642846957,1117.48160,17047504576,1129187725,17047499996,-4580,,
15642897996,1117.53264,17047555616,1129238761,17047551031,-4585,,
15642948442,1117.58309,17047606066,1129289205,17047601476,-4590,,
15642999060,1117.63371,17047656685,1129339820,17047652090,-4595,,
15643049610,1117.68426,17047707237,1129390367,17047702637,-4600,,
15643099799,1117.73445,17047757429,1129440554,17047752824,-4605,,
15643150819,1117.78547,17047808452,1129491572,17047803842,-4610,,
15643201356,1117.83600,17047858992,1129542105,17047854387,-4605,,
15643251975,1117.88662,17047909612,1129592722,17047904992,-4620,,
15643302983,1117.93763,17047960623,1129643728,17047955998,-4625,,
15643353848,1117.98850,17048011491,1129694589,17048006860,-4631,,
15643404885,1118.03953,17048062529,1129745623,17048057894,-4635,,
15643455873,1118.09052,17048113520,1129796610,17048108880,-4640,,
15643506481,1118.14113,17048164131,1129847214,17048159485,-4646,,
15643557032,1118.19168,17048214683,1129897762,17048210032,-4651,,
15643608058,1118.24271,17048265712,1129948786,17048261057,-4655,,
15643658599,1118.29325,17048316256,1129999324,17048311595,-4661,,
15643709116,1118.34376,17048366775,1130049838,17048362108,-4667,,
15643759225,1118.39387,17048416886,1130099945,17048412215,-4671,,
15643810218,1118.44487,17048467882,1130150936,17048463206,-4676,,
15643860377,1118.49502,17048518042,1130201091,17048513361,-4681,,
15643910952,1118.54560,17048568621,1130251664,17048563934,-4687,,
15643961916,1118.59656,17048619587,1130302626,17048614896,-4691,,
15644012471,1118.64712,17048670144,1130353177,17048665447,-4697,,
15644062805,1118.69745,17048720481,1130403509,17048715779,-4702,,
15644113752,1118.74840,17048771430,1130454453,17048766723,-4707,,
15644164353,1118.79900,17048822033,1130505052,17048817323,-4710,,
15644215397,1118.85004,17048873080,1130556093,17048868363,-4717,,
15644266064,1118.90071,17048923748,1130606756,17048919026,-4722,,
15644317043,1118.95169,17048974730,1130657733,17048970004,-4726,,
15644368068,1119.00272,17049025758,1130708755,17049021026,-4732,,
15644419144,1119.05379,17049076836,1130759828,17049072098,-4738,,
15644469685,1119.10433,17049127378,1130810366,17049122636,-4742,,
15644519997,1119.15465,17049177694,1130860676,17049172947,-4747,,
15644570306,1119.20495,17049228005,1130910982,17049223253,-4752,,
15644620892,1119.25554,17049278594,1130961565,17049273836,-4758,,
15644671445,1119.30609,17049329148,1131012116,17049324387,-4761,,
15644721979,1119.35663,17049379684,1131062647,17049374917,-4767,,
15644773022,1119.40767,17049430731,1131113687,17049425958,-4773,,
15644823586,1119.45823,17049481308,1131164260,17049476530,-4778,,
15644874191,1119.50884,17049531904,1131214851,17049527122,-4782,,
15644924751,1119.55940,17049582467,1131265409,17049577679,-4788,,
15644974922,1119.60957,17049632639,1131315576,17049627846,-4793,,
15645025514,1119.66016,17049683233,1131366166,17049678436,-4797,,
15645076545,1119.71119,17049734268,1131417195,17049729465,-4803,,
15645127555,1119.76220,17049785279,1131468201,17049780472,-4807,,
15645178455,1119.81310,17049836192,1131519108,17049831379,-4813,,
15645229502,1119.86415,17049887232,1131570144,17049882414,-4818,,
15645280082,1119.91473,17049937814,1131620721,17049932991,-4823,,
15645330196,1119.96484,17049987931,1131670831,17049983101,-4830,,
15645380760,1120.01541,17050038496,1131721393,17050033663,-4833,,
15645430856,1120.06550,17050088595,1131771487,17050083757,-4838,,
15645481939,1120.11659,17050139680,1131822566,17050134836,-4844,,
15645532966,1120.16761,17050190710,1131873591,17050185862,-4848,,
15645583155,1120.21780,17050240911,1131923788,17050236058,-4853,,
15645633799,1120.26845,17050291548,1131974419,17050286689,-4859,,
15645684390,1120.31904,17050342141,1132025007,17050337277,-4864,,
15645734805,1120.36945,17050392558,1132075420,17050387690,-4868,,
15645785330,1120.41998,17050443098,1132125954,17050438224,-4874,,
15645835916,1120.47056,17050493673,1132176524,17050488794,-4879,,
15645886049,1120.52070,17050543809,1132226656,17050538926,-4883,,
15645937112,1120.57176,17050594875,1132277716,17050589986,-4889,,
15645987702,1120.62235,17050645467,1132328302,17050640572,-4895,,
15646038750,1120.67340,17050696517,1132379347,17050691618,-4899,,
15646088895,1120.72354,17050746664,1132429490,17050741760,-4904,,
15646139955,1120.77460,17050797727,1132480547,17050792818,-4909,,
15646190507,1120.82515,17050848281,1132531096,17050843367,-4914,,
15646241556,1120.87620,17050899333,1132582143,17050894414,-4919,,
15646292606,1120.92725,17050950384,1132633190,17050945460,-4924,,
15646343652,1120.97830,17051001434,1132684234,17050996504,-4930,,
15646394702,1121.02935,17051052485,1132735280,17051047550,-4935,,
15646445751,1121.08040,17051103537,1132786339,17051098609,-4928,,
15646496821,1121.13147,17051154610,1132837395,17051149665,-4945,,
15646547404,1121.18205,17051205195,1132887986,17051200256,-4939,,
15646597553,1121.23220,17051255346,1132938122,17051250392,-4954,,
15646648080,1121.28273,17051305875,1132988645,17051300915,-4960,,
15646698431,1121.33308,17051356229,1133038993,17051351264,-4965,,
15646749234,1121.38388,17051407034,1133089794,17051402064,-4970,,
15646800236,1121.43488,17051458039,1133140794,17051453064,-4975,,
15646850854,1121.48550,17051508659,1133191409,17051503679,-4980,,
15646901896,1121.53654,17051559704,1133242447,17051554718,-4986,,
15646952786,1121.58743,17051610595,1133293335,17051605605,-4990,,
15647003804,1121.63845,17051661615,1133344350,17051656620,-4995,,
15647054883,1121.68953,17051712698,1133395427,17051707697,-5001,,
15647105383,1121.74003,17051763199,1133445923,17051758194,-5005,,
15647155444,1121.79009,17051813263,1133495983,17051808253,-5010,,
15647205517,1121.84017,17051863349,1133546063,17051858333,-5016,,
15647256090,1121.89074,17051913925,1133596634,17051908904,-5021,,
15647307183,1121.94183,17051965009,1133647713,17051959984,-5025,,
15647357997,1121.99265,17052015825,1133698524,17052010794,-5031,,
15647409021,1122.04367,17052066851,1133749545,17052061815,-5036,,
15647459554,1122.09420,17052117388,1133800076,17052112346,-5042,,
15647509674,1122.14432,17052167510,1133850193,17052162464,-5046,,
15647560659,1122.19531,17052218497,1133901175,17052213446,-5051,,
15647610774,1122.24542,17052268625,1133951297,17052263568,-5057,,
15647661556,1122.29620,17052319399,1134002067,17052314338,-5061,,
15647712023,1122.34667,17052369868,1134052532,17052364803,-5065,,
15647763036,1122.39768,17052420884,1134103542,17052415812,-5072,,
15647813703,1122.44835,17052471552,1134154206,17052466476,-5076,,
15647864258,1122.49891,17052522122,1134204770,17052517040,-5082,,
15647914910,1122.54956,17052572765,1134255408,17052567678,-5087,,
15647965029,1122.59968,17052622887,1134305525,17052617795,-5092,,
15648016076,1122.65072,17052673935,1134356569,17052668839,-5096,,
15648066137,1122.70078,17052723999,1134406627,17052718897,-5102,,
15648116732,1122.75138,17052774596,1134457218,17052769489,-5107,,
15648167333,1122.80198,17052825199,1134507818,17052820088,-5111,,
15648217980,1122.85263,17052875849,1134558462,17052870732,-5117,,
15648268581,1122.90323,17052926452,1134609060,17052921330,-5122,,
15648319445,1122.95409,17052977318,1134659920,17052972190,-5128,,
15648370277,1123.00492,17053028153,1134710750,17053023021,-5132,,
15648421328,1123.05598,17053079206,1134761798,17053074069,-5137,,
15648472344,1123.10699,17053130224,1134812811,17053125081,-5143,,
15648522588,1123.15724,17053180470,1134863053,17053175323,-5147,,
15648573640,1123.20829,17053231525,1134914103,17053226373,-5152,,
15648624224,1123.25887,17053282111,1134964683,17053276954,-5157,,
15648674765,1123.30941,17053332655,1135015222,17053327492,-5163,,
15648725439,1123.36009,17053383331,1135065894,17053378164,-5167,,
15648775493,1123.41014,17053433388,1135115944,17053428214,-5174,,
15648826103,1123.46075,17053483999,1135166551,17053478821,-5178,,
15648877161,1123.51181,17053535059,1135217607,17053529877,-5182,,
15648928178,1123.56283,17053586090,1135268631,17053580902,-5188,,
15648978747,1123.61340,17053636662,1135319198,17053631469,-5193,,
15649029783,1123.66443,17053687690,1135370220,17053682491,-5199,,
15649080394,1123.71504,17053738302,1135420829,17053733099,-5203,,
15649130945,1123.76559,17053788855,1135471377,17053783647,-5208,,
15649181555,1123.81620,17053839469,1135521984,17053834255,-5214,,
15649232633,1123.86728,17053890548,1135573060,17053885331,-5217,,
15649283234,1123.91788,17053941152,1135623658,17053935928,-5224,,
15649333909,1123.96856,17053991829,1135674330,17053986600,-5229,,
15649384536,1124.01918,17054042470,1135724966,17054037236,-5234,,
15649435107,1124.06975,17054093032,1135775524,17054087794,-5238,,
15649485734,1124.12038,17054143672,1135826158,17054138429,-5243,,
15649535944,1124.17059,17054193873,1135876354,17054188625,-5248,,
15649586576,1124.22122,17054244508,1135926985,17054239255,-5253,,
15649637675,1124.27232,17054295609,1135978080,17054290350,-5259,,
15649688291,1124.32294,17054346228,1136028693,17054340964,-5264,,
15649739369,1124.37402,17054397309,1136079769,17054392039,-5270,,
15649789908,1124.42456,17054447861,1136130317,17054442588,-5273,,
15649840960,1124.47561,17054498915,1136181365,17054493636,-5279,,
15649891541,1124.52619,17054549488,1136231933,17054544203,-5285,,
15649942579,1124.57723,17054600527,1136282968,17054595238,-5289,,
15649993626,1124.62827,17054651577,1136334013,17054646283,-5294,,
15650044134,1124.67878,17054702087,1136384517,17054696787,-5300,,
15650094674,1124.72932,17054752629,1136435054,17054747324,-5305,,
15650145261,1124.77991,17054803219,1136485640,17054797911,-5308,,
15650195810,1124.83046,17054853770,1136536185,17054848455,-5315,,
15650246437,1124.88108,17054904400,1136586810,17054899080,-5320,,
15650297047,1124.93169,17054955011,1136637417,17054949688,-5323,,
15650348162,1124.98281,17055006129,1136688529,17055000799,-5330,,
15650398400,1125.03305,17055056380,1136738775,17055051046,-5334,,
15650449096,1125.08374,17055107080,1136789469,17055101740,-5340,,
15650500170,1125.13482,17055158144,1136840529,17055152799,-5345,,
15650551204,1125.18585,17055209181,1136891560,17055203830,-5351,,
15650602221,1125.23687,17055260201,1136942575,17055254845,-5356,,
15650653290,1125.28794,17055311273,1136993642,17055305913,-5360,,
15650703818,1125.33847,17055361802,1137044166,17055356437,-5365,,
15650754507,1125.38916,17055412493,1137094852,17055407123,-5370,,
15650805056,1125.43970,17055463045,1137145399,17055457669,-5376,,
15650855195,1125.48984,17055513185,1137195535,17055507806,-5379,,
15650905379,1125.54003,17055563373,1137245716,17055557987,-5386,,
15650955959,1125.59061,17055613955,1137296295,17055608565,-5390,,
15651006056,1125.64070,17055664054,1137346388,17055658659,-5395,,
15651057088,1125.69174,17055715089,1137397418,17055709688,-5401,,
15651107635,1125.74228,17055765638,1137447961,17055760232,-5406,,
15651158200,1125.79285,17055816205,1137498524,17055810794,-5411,,
15651209020,1125.84367,17055867028,1137549342,17055861613,-5415,,
15651259653,1125.89430,17055917663,1137599971,17055912242,-5421,,
15651310689,1125.94534,17055968703,1137651006,17055963276,-5427,,
15651360788,1125.99544,17056018802,1137701101,17056013371,-5431,,
15651410881,1126.04553,17056068898,1137751191,17056063461,-5437,,
15651461692,1126.09634,17056119712,1137801999,17056114270,-5442,,
15651512277,1126.14693,17056170310,1137852594,17056164864,-5446,,
15651563306,1126.19795,17056221330,1137903608,17056215879,-5451,,
15651613912,1126.24856,17056271938,1137954211,17056266482,-5456,,
15651664933,1126.29958,17056322962,1138005229,17056317500,-5462,,
15651715476,1126.35012,17056373506,1138055770,17056368041,-5465,,
15651766186,1126.40083,17056424220,1138106478,17056418748,-5472,,
15651817190,1126.45184,17056475225,1138157478,17056469748,-5477,,
15651867743,1126.50239,17056525782,1138208029,17056520300,-5482,,
15651917854,1126.55250,17056575895,1138258138,17056570408,-5487,,
15651968891,1126.60354,17056626934,1138309172,17056621443,-5491,,
15652019878,1126.65453,17056677923,1138360155,17056672426,-5497,,
15652070463,1126.70511,17056728511,1138410738,17056723009,-5502,,
15652121084,1126.75573,17056779134,1138461356,17056773627,-5507,,
15652171695,1126.80634,17056829749,1138511965,17056824236,-5513,,
15652222727,1126.85738,17056880781,1138562994,17056875264,-5517,,
15652273754,1126.90840,17056931810,1138614018,17056926288,-5522,,
15652323815,1126.95846,17056981875,1138664077,17056976347,-5528,,
15652374374,1127.00902,17057032436,1138714633,17057026904,-5532,,
15652424899,1127.05955,17057082963,1138765155,17057077426,-5537,,
15652475426,1127.11007,17057133502,1138815689,17057127960,-5542,,
15652525990,1127.16064,17057184059,1138866240,17057178511,-5548,,
15652576573,1127.21122,17057234644,1138916821,17057229092,-5552,,
15652627125,1127.26177,17057285209,1138967380,17057279651,-5558,,
15652677314,1127.31196,17057335390,1139017557,17057329827,-5563,,
15652727868,1127.36252,17057385947,1139068108,17057380379,-5568,,
15652778878,1127.41353,17057436959,1139119115,17057431386,-5573,,
15652829877,1127.46453,17057487960,1139170112,17057482382,-5578,,
15652880425,1127.51507,17057538511,1139220657,17057532927,-5584,,
15652931503,1127.56615,17057589591,1139271733,17057584003,-5588,,
15652981612,1127.61626,17057639701,1139321838,17057634109,-5592,,
15653032135,1127.66678,17057690228,1139372358,17057684629,-5599,,
15653082283,1127.71693,17057740378,1139422504,17057734775,-5603,,
15653132837,1127.76749,17057790933,1139473055,17057785325,-5608,,
15653183459,1127.81811,17057841559,1139523675,17057835945,-5614,,
15653234006,1127.86865,17057892107,1139574219,17057886489,-5618,,
15653285032,1127.91968,17057943136,1139625242,17057937513,-5623,,
15653335694,1127.97034,17057993801,1139675901,17057988172,-5629,,
15653386239,1128.02089,17058044347,1139726443,17058038713,-5634,,
15653436862,1128.07151,17058094973,1139777064,17058089335,-5638,,
15653487456,1128.12210,17058145570,1139827656,17058139926,-5644,,
15653538070,1128.17272,17058196186,1139878266,17058190537,-5649,,
15653589119,1128.22377,17058247237,1139929312,17058241583,-5654,,
15653640149,1128.27480,17058298269,1139980340,17058292620,-5649,,
15653691185,1128.32583,17058349308,1140031373,17058343655,-5653,,
15653742258,1128.37691,17058400384,1140082444,17058394714,-5670,,
15653792792,1128.42744,17058450930,1140132985,17058445256,-5674,,
15653843406,1128.47805,17058501545,1140183596,17058495866,-5679,,
15653893990,1128.52864,17058552133,1140234178,17058546448,-5685,,
15653944615,1128.57926,17058602750,1140284790,17058597060,-5690,,
15653994744,1128.62939,17058652881,1140334917,17058647187,-5694,,
15654045023,1128.67967,17058703163,1140385192,17058697463,-5700,,
15654095464,1128.73011,17058753606,1140435630,17058747901,-5705,,
15654146198,1128.78085,17058804342,1140486363,17058798633,-5709,,
15654197240,1128.83189,17058855387,1140537402,17058849672,-5715,,
15654247826,1128.88247,17058905975,1140587995,17058900266,-5709,,
15654298438,1128.93309,17058956590,1140638594,17058950865,-5725,,
15654349021,1128.98367,17059007175,1140689174,17059001444,-5731,,
15654400024,1129.03467,17059058179,1140740174,17059052444,-5735,,
15654450146,1129.08479,17059108305,1140790293,17059102564,-5741,,
15654500227,1129.13487,17059158388,1140840373,17059152643,-5745,,
15654550793,1129.18544,17059208955,1140890935,17059203205,-5750,,
15654601398,1129.23605,17059259564,1140941537,17059253808,-5756,,
15654652457,1129.28711,17059310625,1140992594,17059304864,-5761,,
15654703541,1129.33819,17059361710,1141043675,17059355945,-5765,,
15654754055,1129.38870,17059412228,1141094186,17059406457,-5771,,
15654805088,1129.43974,17059463262,1141145216,17059457486,-5776,,
15654855163,1129.48981,17059513340,1141195299,17059507570,-5770,,
15654905807,1129.54046,17059563987,1141245931,17059558201,-5786,,
15654956356,1129.59100,17059614549,1141296487,17059608758,-5791,,
15655006752,1129.64140,17059664936,1141346870,17059659141,-5795,,
15655057312,1129.69196,17059715510,1141397438,17059709709,-5801,,
15655108320,1129.74297,17059766508,1141448432,17059760702,-5806,,
15655159229,1129.79388,17059817421,1141499339,17059811610,-5811,,
15655210222,1129.84487,17059868416,1141550329,17059862600,-5816,,
15655260806,1129.89545,17059919002,1141600911,17059913181,-5821,,
15655311851,1129.94650,17059970049,1141651952,17059964223,-5826,,
15655361989,1129.99664,17060020190,1141702088,17060014359,-5831,,
15655412911,1130.04756,17060071114,1141753008,17060065278,-5836,,
15655463097,1130.09775,17060121303,1141803190,17060115461,-5842,,
15655513719,1130.14837,17060171926,1141853810,17060166080,-5846,,
15655564308,1130.19896,17060222518,1141904396,17060216666,-5852,,
15655614898,1130.24955,17060273111,1141954983,17060267253,-5858,,
15655665421,1130.30007,17060323636,1142005504,17060317774,-5862,,
15655715970,1130.35062,17060374187,1142056051,17060368321,-5866,,
15655766378,1130.40103,17060424598,1142106456,17060418726,-5872,,
15655817413,1130.45206,17060475635,1142157488,17060469758,-5877,,
15655867987,1130.50264,17060526221,1142208069,17060520339,-5882,,
15655919048,1130.55370,17060577275,1142259118,17060571388,-5887,,
15655969662,1130.60431,17060627891,1142309729,17060621999,-5892,,
15656020294,1130.65494,17060678526,1142360357,17060672627,-5899,,
15656070918,1130.70557,17060729151,1142410979,17060723249,-5902,,
15656121969,1130.75662,17060780205,1142462028,17060774298,-5907,,
15656172893,1130.80754,17060831131,1142512948,17060825218,-5913,,
15656223398,1130.85805,17060881639,1142563452,17060875722,-5917,,
15656274447,1130.90909,17060932689,1142614497,17060926767,-5922,,
15656325477,1130.96013,17060983732,1142665534,17060977804,-5928,,
15656375653,1131.01030,17061033911,1142715707,17061027978,-5933,,
15656426614,1131.06126,17061084864,1142766657,17061078927,-5937,,
15656476793,1131.11144,17061135046,1142816832,17061129103,-5943,,
15656527129,1131.16178,17061185384,1142867165,17061179436,-5948,,
15656577920,1131.21257,17061236177,1142917954,17061230224,-5953,,
15656628049,1131.26270,17061286309,1142968080,17061280351,-5958,,
15656678152,1131.31280,17061336414,1143018180,17061330451,-5963,,
15656728776,1131.36342,17061387041,1143068803,17061381073,-5968,,
15656779786,1131.41443,17061438053,1143119819,17061432090,-5963,,
15656830818,1131.46547,17061489087,1143170839,17061483109,-5978,,
15656881394,1131.51604,17061539666,1143221412,17061533682,-5984,,
15656931942,1131.56659,17061590216,1143271958,17061584228,-5988,,
15656982516,1131.61716,17061640792,1143322529,17061634799,-5993,,
15657033558,1131.66821,17061691836,1143373567,17061685838,-5998,,
15657084610,1131.71926,17061742891,1143424618,17061736888,-6003,,
15657135163,1131.76981,17061793457,1143475179,17061787450,-6007,,
15657186189,1131.82084,17061844475,1143526190,17061838461,-6014,,
15657236284,1131.87093,17061894572,1143576282,17061888553,-6019,,
15657286760,1131.92141,17061945050,1143626757,17061939027,-6023,,
15657337341,1131.97199,17061995634,1143677334,17061989605,-6029,,
15657387893,1132.02254,17062046188,1143727883,17062040154,-6034,,
15657438837,1132.07348,17062097135,1143778825,17062091095,-6040,,
15657489919,1132.12457,17062148219,1143829904,17062142175,-6044,,
15657540966,1132.17561,17062199267,1143880948,17062193218,-6049,,
15657591496,1132.22614,17062249811,1143931486,17062243757,-6054,,
15657642100,1132.27675,17062300406,1143982077,17062294347,-6059,,
15657692719,1132.32737,17062351027,1144032693,17062344963,-6064,,
15657743740,1132.37839,17062402052,1144083712,17062395982,-6070,,
15657794757,1132.42941,17062453071,1144134727,17062446997,-6074,,
15657844888,1132.47954,17062503204,1144184854,17062497125,-6079,,
15657895842,1132.53049,17062554171,1144235816,17062548086,-6085,,
15657946925,1132.58157,17062605246,1144286885,17062599156,-6090,,
15657997533,1132.63218,17062655857,1144337491,17062649761,-6096,,
15658048598,1132.68325,17062706924,1144388554,17062700824,-6100,,
15658099630,1132.73428,17062757958,1144439583,17062751853,-6105,,
15658150677,1132.78533,17062809008,1144490627,17062802897,-6111,,
15658201719,1132.83637,17062860052,1144541666,17062853937,-6115,,
15658252319,1132.88697,17062910654,1144592263,17062904534,-6120,,
15658302432,1132.93708,17062960770,1144642373,17062954644,-6126,,
15658352672,1132.98732,17063011012,1144692611,17063004882,-6130,,
15658403290,1133.03794,17063061632,1144743226,17063055497,-6135,,
15658453893,1133.08854,17063112237,1144793826,17063106096,-6141,,
15658504543,1133.13919,17063162890,1144844474,17063156744,-6146,,
15658555090,1133.18974,17063213439,1144895018,17063207300,-6139,,
15658606113,1133.24076,17063264465,1144946038,17063258309,-6156,,
15658657162,1133.29181,17063315515,1144997084,17063309354,-6161,,
15658707222,1133.34187,17063365578,1145047142,17063359412,-6166,,
15658757815,1133.39246,17063416173,1145097732,17063410002,-6171,,
15658808402,1133.44305,17063466763,1145148317,17063460587,-6176,,
15658858987,1133.49364,17063517351,1145198899,17063511170,-6181,,
15658910015,1133.54466,17063568380,1145249924,17063562194,-6186,,
15658961076,1133.59572,17063619444,1145300982,17063613253,-6191,,
15659011666,1133.64631,17063670037,1145351569,17063663839,-6198,,
15659062609,1133.69726,17063720982,1145402511,17063714781,-6201,,
15659113147,1133.74779,17063771522,1145453046,17063765316,-6206,,
15659163204,1133.79785,17063821582,1145503099,17063815370,-6212,,
15659213743,1133.84839,17063872123,1145553636,17063865907,-6216,,
15659263839,1133.89849,17063922220,1145603729,17063916000,-6220,,
15659314363,1133.94901,17063972748,1145654250,17063966521,-6227,,
15659364928,1133.99958,17064023314,1145704812,17064017083,-6231,,
15659415959,1134.05061,17064074349,1145755842,17064068113,-6236,,
15659467017,1134.10166,17064125408,1145806896,17064119166,-6242,,
15659517637,1134.15228,17064176030,1145857525,17064169795,-6235,,
15659568118,1134.20277,17064226515,1145907993,17064220263,-6252,,
15659618762,1134.25341,17064277161,1145958634,17064270904,-6257,,
15659669852,1134.30450,17064328253,1146009720,17064321991,-6262,,
15659720891,1134.35554,17064379295,1146060757,17064373027,-6268,,
15659771437,1134.40609,17064429843,1146111300,17064423571,-6272,,
15659822001,1134.45665,17064480409,1146161862,17064474132,-6277,,
15659872556,1134.50720,17064530966,1146212413,17064524683,-6283,,
15659923061,1134.55771,17064581473,1146262916,17064575186,-6287,,
15659973722,1134.60837,17064632137,1146313574,17064625845,-6292,,
15660024370,1134.65902,17064682788,1146364220,17064676490,-6298,,
15660074887,1134.70953,17064733307,1146414735,17064727005,-6302,,
15660125937,1134.76058,17064784360,1146465782,17064778052,-6308,,
15660176960,1134.81161,17064835384,1146516801,17064829071,-6313,,
15660227586,1134.86223,17064886012,1146567424,17064879694,-6318,,
15660278259,1134.91291,17064936689,1146618095,17064930366,-6323,,
15660328808,1134.96346,17064987240,1146668642,17064980912,-6328,,
15660379358,1135.01401,17065037792,1146719189,17065031459,-6333,,
15660429905,1135.06455,17065088342,1146769734,17065082004,-6338,,
15660480498,1135.11515,17065138937,1146820323,17065132594,-6343,,
15660531011,1135.16566,17065189452,1146870833,17065183104,-6348,,
15660581422,1135.21607,17065239866,1146921241,17065233511,-6355,,
15660631496,1135.26614,17065289953,1146971325,17065283595,-6358,,
15660682557,1135.31721,17065341006,1147022373,17065334643,-6363,,
15660733100,1135.36775,17065391551,1147072912,17065385182,-6369,,
15660784161,1135.41881,17065442614,1147123971,17065436241,-6373,,
15660834757,1135.46941,17065493212,1147174564,17065486834,-6378,,
15660885079,1135.51973,17065543537,1147224882,17065537153,-6384,,
15660935352,1135.57000,17065593811,1147275152,17065587422,-6389,,
15660985945,1135.62059,17065644407,1147325743,17065638013,-6394,,
15661037023,1135.67167,17065695487,1147376818,17065689088,-6399,,
15661087890,1135.72254,17065746357,1147427683,17065739953,-6404,,
15661138440,1135.77309,17065796910,1147478231,17065790501,-6409,,
15661189485,1135.82413,17065847957,1147529272,17065841543,-6414,,
15661240438,1135.87509,17065898912,1147580222,17065892493,-6419,,
15661291017,1135.92566,17065949494,1147630798,17065943069,-6425,,
15661341423,1135.97607,17065999902,1147681202,17065993473,-6429,,
15661392425,1136.02707,17066050906,1147732201,17066044472,-6434,,
15661442976,1136.07762,17066101460,1147782750,17066095020,-6440,,
15661493518,1136.12817,17066152004,1147833290,17066145560,-6444,,
15661544545,1136.17919,17066203033,1147884314,17066196584,-6449,,
15661595561,1136.23021,17066254051,1147935326,17066247596,-6455,,
15661646093,1136.28074,17066304586,1147985855,17066298126,-6460,,
15661696663,1136.33131,17066355158,1148036423,17066348693,-6465,,
15661747221,1136.38187,17066405718,1148086978,17066399248,-6470,,
15661798010,1136.43266,17066456521,1148137776,17066450046,-6475,,
15661848565,1136.48321,17066507067,1148188317,17066500587,-6480,,
15661899648,1136.53430,17066558153,1148239397,17066551668,-6485,,
15661949882,1136.58453,17066608389,1148289629,17066601899,-6490,,
15662000528,1136.63518,17066659037,1148340271,17066652542,-6495,,
15662050927,1136.68557,17066709438,1148390668,17066702938,-6500,,
15662101958,1136.73661,17066760471,1148441696,17066753966,-6505,,
15662152095,1136.78674,17066810612,1148491841,17066804112,-6500,,
15662202385,1136.83703,17066860904,1148542118,17066854389,-6515,,
15662253435,1136.88808,17066911956,1148593166,17066905436,-6520,,
15662304496,1136.93914,17066963020,1148644223,17066956494,-6526,,
15662355519,1136.99017,17067014045,1148695245,17067007515,-6530,,
15662406584,1137.04123,17067065113,1148746307,17067058577,-6536,,
15662457633,1137.09228,17067116164,1148797353,17067109623,-6541,,
15662508206,1137.14285,17067166738,1148847922,17067160193,-6545,,
15662558882,1137.19353,17067217418,1148898596,17067210867,-6551,,
15662609932,1137.24458,17067268469,1148949643,17067261913,-6556,,
15662660975,1137.29562,17067319514,1149000683,17067312953,-6561,,
15662711557,1137.34621,17067370100,1149051262,17067363532,-6568,,
15662762181,1137.39683,17067420726,1149101885,17067414155,-6571,,
15662812788,1137.44744,17067471335,1149152488,17067464759,-6576,,
15662863790,1137.49844,17067522339,1149203487,17067515757,-6582,,
15662914382,1137.54903,17067572934,1149254077,17067566348,-6586,,
15662964974,1137.59962,17067623529,1149304666,17067616937,-6592,,
15663015107,1137.64975,17067673663,1149354796,17067667066,-6597,,
15663066120,1137.70077,17067724679,1149405806,17067718076,-6603,,
15663116313,1137.75096,17067774875,1149455997,17067768267,-6608,,
15663166907,1137.80156,17067825471,1149506588,17067818858,-6613,,
15663217546,1137.85219,17067876112,1149557224,17067869505,-6607,,
15663268617,1137.90326,17067927186,1149608293,17067920563,-6623,,
15663318819,1137.95347,17067977389,1149658492,17067970762,-6627,,
15663369469,1138.00412,17068028042,1149709139,17068021410,-6632,,
15663420321,1138.05497,17068078896,1149759989,17068072259,-6637,,
15663470664,1138.10531,17068129242,1149810329,17068122599,-6643,,
15663521240,1138.15589,17068179820,1149860903,17068173173,-6647,,
15663571405,1138.20605,17068229987,1149911064,17068223334,-6653,,
15663622013,1138.25666,17068280597,1149961670,17068273940,-6657,,
15663672154,1138.30680,17068330741,1150011808,17068324079,-6662,,
15663722303,1138.35695,17068380893,1150061954,17068374235,-6658,,
15663773362,1138.40801,17068431954,1150113012,17068425282,-6672,,
15663823972,1138.45862,17068482565,1150163618,17068475888,-6677,,
15663875122,1138.50977,17068533718,1150214765,17068527036,-6682,,
15663925628,1138.56028,17068584226,1150265269,17068577540,-6686,,
15663975790,1138.61044,17068634392,1150315428,17068627699,-6693,,
15664026346,1138.66099,17068684950,1150365982,17068678252,-6698,,
15664076970,1138.71162,17068735575,1150416602,17068728872,-6703,,
15664127681,1138.76233,17068786290,1150467311,17068779581,-6709,,
15664178635,1138.81328,17068837246,1150518262,17068830533,-6713,,
15664228861,1138.86351,17068887474,1150568486,17068880757,-6717,,
15664279926,1138.91457,17068938542,1150619549,17068931819,-6723,,
15664330510,1138.96516,17068989128,1150670129,17068982400,-6728,,
15664381124,1139.01577,17069039743,1150720740,17069033010,-6733,,
15664432181,1139.06683,17069090803,1150771793,17069084064,-6739,,
15664482834,1139.11748,17069141459,1150822445,17069134716,-6743,,
15664533855,1139.16850,17069192481,1150873463,17069185734,-6747,,
15664584415,1139.21906,17069243044,1150924020,17069236290,-6754,,
15664635283,1139.26993,17069293915,1150974887,17069287157,-6758,,
15664685376,1139.32002,17069344010,1151024976,17069337246,-6764,,
15664735893,1139.37054,17069394529,1151075490,17069387760,-6769,,
15664786460,1139.42111,17069445099,1151126054,17069438325,-6774,,
15664836586,1139.47123,17069495228,1151176179,17069488449,-6779,,
15664887142,1139.52179,17069545786,1151226731,17069539002,-6784,,
15664937692,1139.57234,17069596338,1151277278,17069589549,-6789,,
15664988293,1139.62294,17069646941,1151327877,17069640147,-6794,,
15665038878,1139.67353,17069697529,1151378460,17069690730,-6799,,
15665089926,1139.72457,17069748579,1151429505,17069741775,-6804,,
15665140974,1139.77562,17069799630,1151480550,17069792820,-6810,,
15665191991,1139.82664,17069850649,1151531564,17069843835,-6814,,
15665243049,1139.87770,17069901709,1151582619,17069894890,-6819,,
15665293663,1139.92831,17069952337,1151633242,17069945512,-6825,,
15665344281,1139.97893,17070002946,1151683847,17069996117,-6829,,
15665394845,1140.02949,17070053513,1151734408,17070046678,-6835,,
15665444952,1140.07960,17070103621,1151784511,17070096782,-6839,,
15665495607,1140.13026,17070154279,1151835165,17070147435,-6844,,
15665546137,1140.18079,17070204822,1151885701,17070197972,-6850,,
15665597178,1140.23183,17070255855,1151936729,17070249000,-6855,,
15665647311,1140.28196,17070305990,1151986859,17070299130,-6860,,
15665697919,1140.33257,17070356601,1152037466,17070349736,-6865,,
15665748421,1140.38307,17070407105,1152087964,17070400235,-6870,,
15665799358,1140.43401,17070458043,1152138898,17070451169,-6874,,
15665849980,1140.48463,17070508669,1152189518,17070501789,-6880,,
15665900495,1140.53514,17070559185,1152240030,17070552300,-6885,,
15665951066,1140.58571,17070609759,1152290598,17070602869,-6890,,
15666002051,1140.63670,17070660746,1152341580,17070653851,-6895,,
15666052542,1140.68719,17070711250,1152392080,17070704350,-6900,,
15666103080,1140.73773,17070761779,1152442604,17070754874,-6905,,
15666153648,1140.78830,17070812351,1152493169,17070805440,-6911,,
15666203741,1140.83839,17070862446,1152543260,17070855531,-6915,,
15666254376,1140.88902,17070913082,1152593892,17070906162,-6920,,
15666304454,1140.93910,17070963164,1152643968,17070956238,-6926,,
15666355504,1140.99015,17071014216,1152695016,17071007286,-6930,,
15666405902,1141.04055,17071064617,1152745422,17071057692,-6925,,
15666456472,1141.09112,17071115189,1152795977,17071108248,-6941,,
15666507033,1141.14168,17071165752,1152846535,17071158806,-6946,,
15666558070,1141.19272,17071216792,1152897571,17071209841,-6951,,
15666608666,1141.24331,17071267389,1152948163,17071260433,-6956,,
15666659727,1141.29437,17071318453,1152999222,17071311492,-6961,,
15666710301,1141.34495,17071369030,1153049794,17071362064,-6966,,
15666760817,1141.39547,17071419548,1153100307,17071412577,-6971,,
15666810894,1141.44554,17071469627,1153150381,17071462651,-6976,,
15666861476,1141.49612,17071520212,1153200959,17071513229,-6983,,
15666912507,1141.54715,17071571244,1153251988,17071564258,-6986,,
15666963032,1141.59768,17071621771,1153302510,17071614780,-6991,,
15667013346,1141.64799,17071672089,1153352822,17071665092,-6997,,
15667063959,1141.69861,17071722704,1153403433,17071715703,-7001,,
15667114855,1141.74950,17071773602,1153454325,17071766596,-7006,,
15667164950,1141.79960,17071823699,1153504417,17071816687,-7012,,
15667215539,1141.85019,17071874291,1153555005,17071867275,-7016,,
15667266075,1141.90072,17071924831,1153605538,17071917809,-7022,,
15667317125,1141.95177,17071975882,1153656585,17071968855,-7027,,
15667367779,1142.00243,17072026538,1153707235,17072019506,-7032,,
15667418825,1142.05347,17072077587,1153758279,17072070550,-7037,,
15667469888,1142.10454,17072128652,1153809339,17072121610,-7042,,
15667520067,1142.15471,17072178833,1153859515,17072171786,-7047,,
15667570615,1142.20526,17072229383,1153910061,17072222331,-7052,,
15667620762,1142.25541,17072279532,1153960205,17072272475,-7057,,
15667671309,1142.30596,17072330082,1154010750,17072323020,-7062,,
15667721381,1142.35603,17072380157,1154060819,17072373089,-7068,,
15667772028,1142.40668,17072430806,1154111463,17072423734,-7072,,
15667822853,1142.45750,17072481633,1154162286,17072474556,-7077,,
15667873131,1142.50778,17072531924,1154212571,17072524841,-7083,,
15667923782,1142.55843,17072582567,1154263209,17072575479,-7088,,
15667974817,1142.60947,17072633604,1154314242,17072626512,-7092,,
15668025810,1142.66046,17072684600,1154365232,17072677502,-7098,,
15668076395,1142.71104,17072735186,1154415813,17072728083,-7103,,
15668127461,1142.76211,17072786255,1154466877,17072779147,-7108,,
15668178472,1142.81312,17072837269,1154517885,17072830155,-7114,,
15668229054,1142.86370,17072887852,1154568464,17072880734,-7118,,
15668279634,1142.91428,17072938436,1154619042,17072931313,-7123,,
15668329754,1142.96440,17072988568,1154669170,17072981440,-7128,,
15668380729,1143.01538,17073039535,1154720131,17073032402,-7133,,
15668430904,1143.06555,17073089713,1154770303,17073082573,-7140,,
15668481059,1143.11571,17073139869,1154820456,17073132726,-7143,,
15668531613,1143.16626,17073190425,1154871007,17073183277,-7148,,
15668582492,1143.21714,17073241308,1154921883,17073234154,-7154,,
15668633053,1143.26770,17073291871,1154972443,17073284713,-7158,,
15668684088,1143.31874,17073342908,1155023474,17073335745,-7163,,
15668734650,1143.36930,17073393473,1155074034,17073386304,-7169,,
15668785199,1143.41985,17073444023,1155124580,17073436850,-7173,,
15668835759,1143.47041,17073494597,1155175147,17073487418,-7179,,
15668886804,1143.52145,17073545634,1155226180,17073538450,-7184,,
15668937841,1143.57249,17073596673,1155277213,17073589484,-7189,,
15668987928,1143.62258,17073646762,1155327298,17073639568,-7194,,
15669038955,1143.67360,17073697791,1155378322,17073690592,-7199,,
15669089999,1143.72465,17073748838,1155429363,17073741634,-7204,,
15669141039,1143.77569,17073799881,1155480400,17073792671,-7210,,
15669192089,1143.82674,17073850933,1155531448,17073843719,-7214,,
15669243142,1143.87779,17073901988,1155582499,17073894769,-7219,,
15669293957,1143.92861,17073952806,1155633310,17073945581,-7225,,
15669344456,1143.97910,17074003307,1155683808,17073996078,-7229,,
15669395037,1144.02968,17074053891,1155734385,17074046655,-7236,,
15669445584,1144.08023,17074104440,1155784930,17074097200,-7240,,
15669496194,1144.13084,17074155052,1155835546,17074147816,-7236,,
15669547056,1144.18170,17074205917,1155886397,17074198667,-7250,,
15669597576,1144.23222,17074256438,1155936913,17074249183,-7255,,
15669648196,1144.28284,17074307060,1155987530,17074299800,-7260,,
15669698866,1144.33351,17074357734,1156038199,17074350469,-7265,,
15669749884,1144.38453,17074408754,1156089213,17074401483,-7271,,
15669800005,1144.43465,17074458877,1156139332,17074451602,-7275,,
15669850639,1144.48529,17074509514,1156189963,17074502234,-7280,,
15669901139,1144.53579,17074560015,1156240460,17074552730,-7285,,
15669951921,1144.58657,17074610800,1156291240,17074603510,-7290,,
15670002489,1144.63714,17074661371,1156341805,17074654075,-7296,,
15670052780,1144.68743,17074711664,1156392093,17074704364,-7300,,
15670287770,1144.92242,17074946665,1156627070,17074939340,-7325,17074945173,
15670313179,1144.94783,17074972075,1156652478,17074964777,-7298,,
15670363749,1144.99840,17075022648,1156703046,17075015404,-7244,,
15670414816,1145.04946,17075073717,1156754110,17075066527,-7190,,
15670465405,1145.10005,17075124307,1156804696,17075117172,-7135,,
15670516009,1145.15066,17075174915,1156855298,17075167833,-7082,,
15670566618,1145.20127,17075225536,1156905914,17075218508,-7028,,
15670617230,1145.25188,17075276140,1156956513,17075269166,-6974,,
15670668231,1145.30288,17075327144,1157007511,17075320225,-6919,,
15670718401,1145.35305,17075377316,1157057679,17075370450,-6866,,
15670769015,1145.40366,17075427932,1157108289,17075421119,-6813,,
15670819747,1145.45439,17075478666,1157159019,17075471909,-6757,,
15670870160,1145.50481,17075529081,1157209429,17075522377,-6704,,
15670921057,1145.55570,17075579981,1157260324,17075573332,-6649,,
15670971128,1145.60578,17075630055,1157310393,17075623459,-6596,,
15671022201,1145.65685,17075681130,1157361463,17075674589,-6541,,
15671072701,1145.70735,17075731633,1157411959,17075725144,-6489,,
15671122862,1145.75751,17075781796,1157462118,17075775361,-6435,,
15671173467,1145.80812,17075832403,1157512720,17075826023,-6380,,
15671223634,1145.85828,17075882573,1157562884,17075876246,-6327,,
15671273719,1145.90837,17075932660,1157612966,17075926386,-6274,,
15671324299,1145.95895,17075983242,1157663544,17075977023,-6219,,
15671374883,1146.00953,17076033828,1157714125,17076027662,-6166,,
15671425450,1146.06010,17076084398,1157764690,17076078286,-6112,,
15671475537,1146.11019,17076134487,1157814775,17076128430,-6057,,
15671526179,1146.16083,17076185132,1157865414,17076179128,-6004,,
15671576849,1146.21150,17076235803,1157916080,17076229853,-5950,,
15671627425,1146.26207,17076286382,1157966654,17076280486,-5896,,
15671677993,1146.31264,17076336953,1158017220,17076331111,-5842,,
15671729021,1146.36367,17076387983,1158068255,17076382207,-5776,,
15671779996,1146.41464,17076438960,1158119216,17076433227,-5733,,
15671830648,1146.46530,17076489615,1158169867,17076483936,-5679,,
15671881231,1146.51588,17076540211,1158220458,17076534586,-5625,,
15671931771,1146.56642,17076590741,1158270983,17076585170,-5571,,
15671981958,1146.61661,17076640932,1158321168,17076635415,-5517,,
15672032636,1146.66728,17076691611,1158371843,17076686148,-5463,,
15672083234,1146.71788,17076742213,1158422438,17076736803,-5410,,
15672134144,1146.76879,17076793137,1158473357,17076787781,-5356,,
15672184708,1146.81936,17076843690,1158523907,17076838389,-5301,,
15672234817,1146.86946,17076893803,1158574014,17076888555,-5248,,
15672285319,1146.91997,17076944307,1158624512,17076939113,-5194,,
15672335612,1146.97026,17076994601,1158674803,17076989461,-5140,,
15672386180,1147.02083,17077045173,1158725368,17077040086,-5087,,
15672436774,1147.07142,17077095769,1158775960,17077090737,-5032,,
15672487824,1147.12247,17077146821,1158827007,17077141843,-4978,,
15672538868,1147.17352,17077197868,1158878048,17077192944,-4924,,
15672589435,1147.22408,17077248437,1158928613,17077243568,-4869,,
15672639974,1147.27462,17077298977,1158979148,17077294162,-4815,,
15672690536,1147.32518,17077349543,1159029708,17077344782,-4761,,
15672741074,1147.37572,17077400083,1159080243,17077395376,-4707,,
15672791656,1147.42630,17077450666,1159130822,17077446013,-4653,,
15672841838,1147.47649,17077500852,1159181002,17077496251,-4601,,
15672892395,1147.52704,17077551421,1159231567,17077546875,-4546,,
15672943430,1147.57808,17077602449,1159282588,17077597957,-4492,,
15672994502,1147.62915,17077653523,1159333657,17077649085,-4438,,
15673045541,1147.68019,17077704574,1159384705,17077700192,-4382,,
15673096554,1147.73120,17077755580,1159435704,17077751251,-4329,,
15673147571,1147.78222,17077806598,1159486717,17077802324,-4274,,
15673198131,1147.83278,17077857161,1159537275,17077852941,-4220,,
15673248685,1147.88333,17077907718,1159587827,17077903552,-4166,,
15673299210,1147.93386,17077958245,1159638350,17077954133,-4112,,
15673349313,1147.98396,17078008349,1159688449,17078004290,-4059,,
15673400041,1148.03469,17078059081,1159739176,17078055077,-4004,,
15673450844,1148.08549,17078109886,1159789975,17078105935,-3951,,
15673501818,1148.13647,17078160862,1159840946,17078156966,-3896,,
15673552455,1148.18710,17078211501,1159891580,17078207659,-3842,,
15673603603,1148.23825,17078262652,1159942726,17078258865,-3787,,
15673654057,1148.28870,17078313109,1159993178,17078309375,-3734,,
15673704119,1148.33877,17078363173,1160043237,17078359492,-3681,,
15673754732,1148.38938,17078413787,1160093847,17078410162,-3625,,
15673805321,1148.43997,17078464380,1160144434,17078460808,-3572,,
15673855884,1148.49053,17078514944,1160194993,17078511426,-3518,,
15673906924,1148.54157,17078565987,1160246031,17078562524,-3463,,
15673957515,1148.59216,17078616580,1160296619,17078613171,-3409,,
15674008080,1148.64273,17078667147,1160347181,17078663791,-3356,,
15674058180,1148.69283,17078717262,1160397290,17078713960,-3302,,
15674108798,1148.74345,17078767870,1160447894,17078764622,-3248,,
15674158884,1148.79353,17078817959,1160497978,17078814765,-3194,,
15674209423,1148.84407,17078868499,1160548513,17078865358,-3141,,
15674259951,1148.89460,17078919031,1160599039,17078915943,-3088,,
15674311031,1148.94568,17078970112,1160650116,17078967080,-3032,,
15674361567,1148.99621,17079020651,1160700650,17079017673,-2978,,
15674412450,1149.04710,17079071536,1160751529,17079068611,-2925,,
15674463488,1149.09814,17079122577,1160802565,17079119708,-2869,,
15674514051,1149.14870,17079173142,1160853125,17079170327,-2815,,
15674564574,1149.19922,17079223667,1160903645,17079220905,-2762,,
15674614716,1149.24936,17079273812,1160953786,17079271104,-2708,,
15674665754,1149.30040,17079324852,1161004820,17079322198,-2654,,
15674716304,1149.35095,17079375404,1161055367,17079372805,-2599,,
15674766870,1149.40152,17079425973,1161105931,17079423427,-2546,,
15674817939,1149.45259,17079477044,1161157002,17079474558,-2486,,
15674868950,1149.50360,17079528057,1161208005,17079525620,-2437,,
15674920098,1149.55475,17079579208,1161259150,17079576824,-2384,,
15674971059,1149.60571,17079630172,1161310109,17079627844,-2328,,
15675021595,1149.65624,17079680709,1161360642,17079678435,-2274,,
15675072146,1149.70679,17079731264,1161411190,17079729043,-2221,,
15675123702,1149.75835,17079782822,1161462743,17079780656,-2166,,
15675183129,1149.81778,17079842252,1161522167,17079840149,-2103,,
15675236871,1149.87152,17079895997,1161575907,17079893952,-2045,,
15675287861,1149.92251,17079946988,1161626894,17079944998,-1990,,
15675337900,1149.97255,17079997030,1161676931,17079995035,-1995,,
15675388468,1150.02312,17080047599,1161727495,17080045599,-2000,,
15675439494,1150.07414,17080098628,1161778519,17080096624,-2004,,
15675490136,1150.12478,17080149273,1161829158,17080147263,-2010,,
15675541113,1150.17576,17080200252,1161880133,17080198237,-2015,,
15675592163,1150.22681,17080251305,1161931180,17080249284,-2021,,
15675646866,1150.28151,17080306010,1161985879,17080303984,-2026,,
15675697876,1150.33252,17080357023,1162036887,17080354992,-2031,,
15675748523,1150.38317,17080407671,1162087531,17080405635,-2036,,
15675799122,1150.43377,17080458273,1162138128,17080456232,-2041,,
15675850676,1150.48532,17080509829,1162189679,17080507783,-2046,,
15675901692,1150.53634,17080560847,1162240692,17080558796,-2051,,
15675952729,1150.58738,17080611886,1162291726,17080609830,-2056,,
15676003263,1150.63791,17080662424,1162342257,17080660362,-2062,,
15676053380,1150.68803,17080712543,1162392373,17080710478,-2065,,
15676104442,1150.73909,17080763608,1162443432,17080761537,-2071,,
15676155457,1150.79011,17080814625,1162494444,17080812548,-2077,,
15676205753,1150.84040,17080864922,1162544737,17080862841,-2081,,
15676256799,1150.89145,17080915972,1162595780,17080913885,-2087,,
15676307847,1150.94250,17080967021,1162646825,17080964929,-2092,,
15676358290,1150.99294,17081017467,1162697266,17081015370,-2097,,
15676408916,1151.04356,17081068097,1162747891,17081065995,-2102,,
15676459384,1151.09403,17081118566,1162798354,17081116459,-2107,,
15676509539,1151.14419,17081168723,1162848507,17081166611,-2112,,
15676560016,1151.19466,17081219203,1162898981,17081217086,-2117,,
15676610568,1151.24522,17081269756,1162949530,17081267634,-2122,,
15676661461,1151.29611,17081320652,1163000420,17081318524,-2128,,
15676712478,1151.34713,17081371672,1163051434,17081369539,-2133,,
15676763013,1151.39766,17081422209,1163101968,17081420072,-2137,,
15676813940,1151.44859,17081473139,1163152892,17081470996,-2143,,
15676864589,1151.49924,17081523789,1163203537,17081521641,-2148,,
15676915135,1151.54978,17081574338,1163254081,17081572186,-2152,,
15676966162,1151.60081,17081625367,1163305105,17081623209,-2158,,
15677016213,1151.65086,17081675420,1163355153,17081673257,-2163,,
15677066745,1151.70139,17081725954,1163405682,17081723787,-2167,,
15677117118,1151.75177,17081776330,1163456053,17081774157,-2173,,
15677167215,1151.80186,17081826430,1163506147,17081824252,-2178,,
15677217330,1151.85198,17081876547,1163556259,17081874364,-2183,,
15677268297,1151.90295,17081927517,1163607224,17081925329,-2188,,
15677318407,1151.95305,17081977629,1163657332,17081975436,-2193,,
15677369451,1152.00410,17082028675,1163708373,17082026477,-2198,,
15677420051,1152.05470,17082079277,1163758970,17082077074,-2203,,
15677471096,1152.10574,17082130325,1163810012,17082128117,-2208,,
15677521172,1152.15582,17082180403,1163860085,17082178190,-2213,,
15677572007,1152.20665,17082231241,1163910917,17082229022,-2219,,
15677622285,1152.25693,17082281521,1163961193,17082279298,-2223,,
15677672870,1152.30752,17082332108,1164011775,17082329880,-2228,,
15677723477,1152.35812,17082382717,1164062379,17082380483,-2234,,
15677774232,1152.40888,17082433475,1164113132,17082431237,-2238,,
15677825002,1152.45965,17082484248,1164163900,17082482004,-2244,,
15677875987,1152.51064,17082535234,1164214881,17082532985,-2249,,
15677926546,1152.56119,17082585796,1164265437,17082583542,-2254,,
15677977039,1152.61169,17082636291,1164315928,17082634033,-2258,,
15678027632,1152.66228,17082686886,1164366518,17082684622,-2264,,
15678077735,1152.71238,17082736992,1164416618,17082734723,-2269,,
15678128531,1152.76318,17082787790,1164467412,17082785516,-2274,,
15678178635,1152.81328,17082837896,1164517513,17082835618,-2278,,
15678229445,1152.86409,17082888709,1164568321,17082886425,-2284,,
15678280264,1152.91491,17082939531,1164619138,17082937242,-2289,,
15678330442,1152.96509,17082989721,1164669323,17082987427,-2294,,
15678381539,1153.01619,17083040810,1164720406,17083038511,-2299,,
15678432131,1153.06678,17083091405,1164770995,17083089099,-2306,,
15678482660,1153.11731,17083141936,1164821522,17083139627,-2309,,
15678533195,1153.16784,17083192473,1164872054,17083190159,-2314,,
15678583296,1153.21794,17083242576,1164922152,17083240256,-2320,,
15678634300,1153.26895,17083293583,1164973154,17083291259,-2324,,
15678684849,1153.31950,17083344135,1165023701,17083341805,-2330,,
15678735331,1153.36998,17083394627,1165074188,17083392292,-2335,,
15678785964,1153.42061,17083445254,1165124810,17083442914,-2340,,
15678837011,1153.47166,17083496304,1165175855,17083493959,-2345,,
15678887350,1153.52200,17083546645,1165226190,17083544295,-2350,,
15678938374,1153.57302,17083597670,1165277211,17083595316,-2354,,
15678988565,1153.62321,17083647865,1165327401,17083645505,-2360,,
15679039099,1153.67375,17083698401,1165377932,17083696036,-2365,,
15679089240,1153.72389,17083748543,1165428069,17083746173,-2370,,
15679139493,1153.77414,17083798800,1165478321,17083796425,-2375,,
15679190502,1153.82515,17083849811,1165529326,17083847430,-2381,,
15679241101,1153.87575,17083900422,1165579933,17083898038,-2384,,
15679292033,1153.92668,17083951347,1165630851,17083948956,-2391,,
15679342276,1153.97692,17084001592,1165681092,17083999197,-2395,,
15679393334,1154.02798,17084052651,1165732147,17084050251,-2400,,
15679444367,1154.07902,17084103688,1165783177,17084101282,-2406,,
15679494930,1154.12958,17084154253,1165833739,17084151843,-2410,,
15679545560,1154.18021,17084204886,1165884366,17084202470,-2416,,
15679596626,1154.23127,17084255954,1165935428,17084253533,-2421,,
15679647671,1154.28232,17084307001,1165986470,17084304574,-2427,,
15679698229,1154.33288,17084357561,1166037026,17084355130,-2431,,
15679748415,1154.38306,17084407750,1166087210,17084405314,-2436,,
15679798989,1154.43364,17084458326,1166137780,17084455885,-2441,,
15679849883,1154.48453,17084509222,1166188672,17084506776,-2446,,
15679900434,1154.53508,17084559776,1166239221,17084557325,-2451,,
15679951509,1154.58616,17084610853,1166290293,17084608397,-2456,,
15680002120,1154.63677,17084661467,1166340901,17084659005,-2462,,
15680052703,1154.68735,17084712051,1166391481,17084709585,-2466,,
15680103736,1154.73838,17084763086,1166442511,17084760615,-2471,,
15680154745,1154.78939,17084814099,1166493517,17084811622,-2477,,
15680205271,1154.83992,17084864637,1166544053,17084862157,-2480,,
15680255876,1154.89052,17084915234,1166594643,17084912747,-2487,,
15680306665,1154.94131,17084966026,1166645429,17084963534,-2492,,
15680357726,1154.99237,17085017089,1166696488,17085014593,-2496,,
15680408297,1155.04294,17085067662,1166747056,17085065161,-2501,,
15680458853,1155.09350,17085118221,1166797610,17085115714,-2507,,
15680509904,1155.14455,17085169274,1166848658,17085166762,-2512,,
15680560489,1155.19514,17085219862,1166899241,17085217345,-2517,,
15680611562,1155.24621,17085270937,1166950311,17085268416,-2521,,
15680662609,1155.29726,17085321985,1167001354,17085319458,-2527,,
15680713654,1155.34830,17085373034,1167052397,17085370501,-2533,,
15680764061,1155.39871,17085423443,1167102801,17085420906,-2537,,
15680814674,1155.44932,17085474069,1167153422,17085471526,-2543,,
15680865744,1155.50039,17085525131,1167204478,17085522583,-2548,,
15680916406,1155.55105,17085575795,1167255138,17085573243,-2552,,
15680967413,1155.60206,17085626805,1167306152,17085624257,-2548,,
15681018073,1155.65272,17085677467,1167356800,17085674904,-2563,,
15681068894,1155.70354,17085728290,1167407618,17085725722,-2568,,
15681119605,1155.75425,17085779004,1167458327,17085776431,-2573,,
15681169775,1155.80442,17085829175,1167508493,17085826598,-2577,,
15681220316,1155.85496,17085879719,1167559031,17085877136,-2583,,
15681270902,1155.90555,17085930308,1167609615,17085927720,-2588,,
15681321482,1155.95613,17085980890,1167660192,17085978297,-2593,,
15681372525,1156.00717,17086031935,1167711233,17086029337,-2598,,
15681422591,1156.05724,17086082004,1167761296,17086079400,-2604,,
15681473172,1156.10782,17086132586,1167811873,17086129978,-2608,,
15681524234,1156.15888,17086183652,1167862934,17086181038,-2614,,
15681574808,1156.20946,17086234227,1167913504,17086231608,-2619,,
15681625288,1156.25994,17086284709,1167963982,17086282086,-2623,,
15681675386,1156.31003,17086334811,1168014078,17086332182,-2629,,
15681725980,1156.36063,17086385407,1168064668,17086382773,-2634,,
15681777020,1156.41167,17086436449,1168115705,17086433810,-2639,,
15681827664,1156.46231,17086487096,1168166358,17086484463,-2633,,
15681878701,1156.51335,17086538135,1168217382,17086535486,-2649,,
15681928767,1156.56342,17086588203,1168267444,17086585549,-2654,,
15681979795,1156.61444,17086639234,1168318471,17086636575,-2659,,
15682030365,1156.66501,17086689806,1168369040,17086687149,-2657,,
15682080970,1156.71562,17086740413,1168419640,17086737744,-2669,,
15682131668,1156.76632,17086791113,1168470334,17086788439,-2674,,
15682182253,1156.81690,17086841711,1168520927,17086839032,-2679,,
15682232404,1156.86705,17086891854,1168571065,17086889170,-2684,,
15682282805,1156.91745,17086942257,1168621463,17086939567,-2690,,
15682333403,1156.96805,17086992857,1168672059,17086990163,-2694,,
15682383506,1157.01815,17087042962,1168722159,17087040273,-2689,,
15682434592,1157.06924,17087094051,1168773242,17087091346,-2705,,
15682485185,1157.11983,17087144646,1168823833,17087141937,-2709,,
15682535702,1157.17035,17087195166,1168874347,17087192451,-2715,,
15682586807,1157.22146,17087246284,1168925460,17087243564,-2720,,
15682637378,1157.27203,17087296847,1168976017,17087294122,-2725,,
15682688461,1157.32311,17087347933,1169027098,17087345203,-2730,,
15682738930,1157.37358,17087398404,1169077574,17087395679,-2725,,
15682789287,1157.42394,17087448763,1169127918,17087446023,-2740,,
15682839914,1157.47456,17087499393,1169178544,17087496648,-2745,,
15682890362,1157.52501,17087549843,1169228988,17087547092,-2751,,
15682941441,1157.57609,17087600923,1169280064,17087598168,-2755,,
15682991838,1157.62649,17087651324,1169330458,17087648563,-2761,,
15683042858,1157.67751,17087702345,1169381476,17087699580,-2765,,
15683092960,1157.72761,17087752449,1169431575,17087749680,-2769,,
15683143525,1157.77817,17087803018,1169482138,17087800242,-2776,,
15683194600,1157.82925,17087854095,1169533211,17087851315,-2780,,
15683245127,1157.87978,17087904625,1169583734,17087901839,-2786,,
15683295685,1157.93033,17087955184,1169634289,17087952393,-2791,,
15683346653,1157.98130,17088006155,1169685255,17088003359,-2796,,
15683397185,1158.03183,17088056689,1169735784,17088053888,-2801,,
15683447732,1158.08238,17088107238,1169786328,17088104432,-2806,,
15683498321,1158.13297,17088157829,1169836914,17088155018,-2811,,
15683549147,1158.18379,17088208658,1169887738,17088205843,-2815,,
15683599629,1158.23428,17088259143,1169938217,17088256322,-2821,,
15683650164,1158.28481,17088309679,1169988749,17088306853,-2826,,
15683700804,1158.33545,17088360323,1170039387,17088357492,-2831,,
15683751830,1158.38648,17088411351,1170090411,17088408515,-2836,,
15683802899,1158.43755,17088462422,1170141476,17088459581,-2841,,
15683853896,1158.48854,17088513422,1170192471,17088510575,-2847,,
15683904455,1158.53910,17088563982,1170243027,17088561131,-2851,,
15683954763,1158.58941,17088614294,1170293332,17088611437,-2857,,
15684005785,1158.64043,17088665318,1170344352,17088662456,-2862,,
15684056398,1158.69105,17088715933,1170394963,17088713067,-2866,,
15684106827,1158.74148,17088766365,1170445388,17088763493,-2872,,
15684157422,1158.79207,17088816962,1170495981,17088814085,-2877,,
15684207586,1158.84223,17088867127,1170546141,17088864245,-2882,,
15684258620,1158.89327,17088918165,1170597174,17088915278,-2887,,
15684309714,1158.94436,17088969261,1170648264,17088966369,-2892,,
15684360293,1158.99494,17089019842,1170698840,17089016945,-2897,,
15684411339,1159.04599,17089070891,1170749884,17089067989,-2902,,
15684462096,1159.09674,17089121649,1170800638,17089118742,-2907,,
15684513059,1159.14771,17089172616,1170851598,17089169703,-2913,,
15684563657,1159.19830,17089223216,1170902194,17089220298,-2918,,
15684614618,1159.24927,17089274179,1170953152,17089271257,-2922,,
15684664741,1159.29939,17089324316,1171003284,17089321389,-2927,,
15684715673,1159.35032,17089375238,1171054201,17089372305,-2933,,
15684766685,1159.40133,17089426253,1171105211,17089423316,-2937,,
15684817759,1159.45241,17089477330,1171156283,17089474387,-2943,,
15684868351,1159.50300,17089527924,1171206871,17089524976,-2948,,
15684918719,1159.55337,17089578294,1171257237,17089575341,-2953,,
15684969737,1159.60439,17089629315,1171308253,17089626357,-2958,,
15685020540,1159.65519,17089680120,1171359053,17089677157,-2963,,
15685070601,1159.70525,17089730182,1171409110,17089727214,-2968,,
15685121186,1159.75583,17089780771,1171459693,17089777798,-2973,,
15685171252,1159.80590,17089830850,1171509768,17089827873,-2977,,
15685221824,1159.85647,17089881412,1171560325,17089878429,-2983,,
15685271963,1159.90661,17089931555,1171610461,17089928566,-2989,,
15685322257,1159.95691,17089981851,1171660753,17089978858,-2993,,
15685372643,1160.00729,17090032239,1171711136,17090029241,-2998,,
15685423235,1160.05788,17090082844,1171761736,17090079841,-3003,,
15685474128,1160.10878,17090133729,1171812616,17090130721,-3008,,
15685525177,1160.15982,17090184781,1171863662,17090181767,-3014,,
15685576478,1160.21113,17090236084,1171914961,17090233065,-3019,,
15685626771,1160.26142,17090286379,1171965251,17090283356,-3023,,
15685676868,1160.31152,17090336478,1172015345,17090333449,-3029,,
15685727531,1160.36218,17090387144,1172066006,17090384110,-3034,,
15685777927,1160.41258,17090437541,1172116398,17090434502,-3039,,
15685828505,1160.46315,17090488122,1172166974,17090485078,-3044,,
15685879116,1160.51376,17090538736,1172217582,17090535687,-3049,,
15685929619,1160.56427,17090589241,1172268082,17090586187,-3054,,
15685979715,1160.61436,17090639340,1172318176,17090636281,-3059,,
15686030763,1160.66541,17090690389,1172369221,17090687326,-3063,,
15686081293,1160.71594,17090740922,1172419748,17090737852,-3070,,
15686131832,1160.76648,17090791464,1172470285,17090788389,-3075,,
15686182270,1160.81692,17090841903,1172520720,17090838824,-3079,,
15686233237,1160.86788,17090892874,1172571685,17090889790,-3084,,
15686283799,1160.91845,17090943438,1172622243,17090940348,-3090,,
15686334333,1160.96898,17090993973,1172672775,17090990879,-3094,,
15686384875,1161.01952,17091044519,1172723314,17091041419,-3100,,
15686435947,1161.07059,17091095593,1172774384,17091092489,-3104,,
15686486762,1161.12141,17091146410,1172825195,17091143300,-3110,,
15686537795,1161.17244,17091197445,1172876226,17091194331,-3114,,
15686588848,1161.22350,17091248501,1172927277,17091245381,-3120,,
15686639893,1161.27454,17091299547,1172978318,17091296422,-3125,,
15686689939,1161.32459,17091349597,1173028362,17091346467,-3130,,
15686740494,1161.37514,17091400153,1173078914,17091397033,-3120,,
15686792614,1161.42726,17091452276,1173131031,17091449135,-3141,,
15686843578,1161.47823,17091503243,1173181993,17091500097,-3146,,
15686899389,1161.53404,17091559056,1173237800,17091555904,-3152,,
15686951793,1161.58644,17091611464,1173290204,17091608308,-3156,,
15687003386,1161.63803,17091663058,1173341792,17091659897,-3161,,
15687054290,1161.68894,17091713965,1173392693,17091710798,-3167,,
15687105328,1161.73998,17091765005,1173443729,17091761833,-3172,,
15687155516,1161.79016,17091815194,1173493913,17091812018,-3176,,
15687205923,1161.84057,17091865604,1173544318,17091862423,-3181,,
15687256471,1161.89112,17091916156,1173594865,17091912969,-3187,,
15687307039,1161.94169,17091966725,1173645429,17091963534,-3191,,
15687357092,1161.99174,17092016781,1173695480,17092013584,-3197,,
15687408129,1162.04278,17092067820,1173746514,17092064618,-3202,,
15687469340,1162.10399,17092129033,1173807721,17092125825,-3208,,
15687519630,1162.15428,17092179325,1173858008,17092176112,-3213,,
15687569926,1162.20457,17092229624,1173908302,17092226407,-3217,,
15687620217,1162.25487,17092279917,1173958590,17092276695,-3222,,
15687670492,1162.30514,17092330194,1174008862,17092326966,-3228,,
15687720867,1162.35551,17092380572,1174059234,17092377338,-3234,,
15687771202,1162.40585,17092430909,1174109567,17092427671,-3238,,
15687821501,1162.45615,17092481210,1174159863,17092477967,-3243,,
15687871995,1162.50664,17092531707,1174210354,17092528458,-3249,,
15687922300,1162.55695,17092582015,1174260658,17092578763,-3252,,
15687972876,1162.60752,17092632593,1174311230,17092629335,-3258,,
15688023159,1162.65781,17092682879,1174361510,17092679615,-3264,,
15688073779,1162.70843,17092733500,1174412128,17092730233,-3267,,
15688123922,1162.75857,17092783645,1174462268,17092780372,-3273,,
15688174052,1162.80870,17092833779,1174512396,17092830500,-3279,,
15688224990,1162.85964,17092884718,1174563330,17092881434,-3284,,
15688275084,1162.90973,17092934815,1174613422,17092931527,-3288,,
15688325399,1162.96005,17092985133,1174663735,17092981839,-3294,,
15688375701,1163.01035,17093035436,1174714033,17093032138,-3298,,
15688425976,1163.06062,17093085713,1174764305,17093082410,-3303,,
15688476989,1163.11164,17093136730,1174815316,17093133421,-3309,,
15688527718,1163.16237,17093187461,1174866042,17093184147,-3314,,
15688578291,1163.21294,17093238037,1174916613,17093234717,-3320,,
15688629028,1163.26368,17093288775,1174967347,17093285451,-3324,,
15688679338,1163.31399,17093339088,1175017655,17093335759,-3329,,
15688729979,1163.36463,17093389732,1175068292,17093386397,-3335,,
15688780246,1163.41489,17093440000,1175118557,17093436661,-3339,,
15688830826,1163.46547,17093490583,1175169135,17093487239,-3344,,
15688881444,1163.51609,17093541203,1175219749,17093537854,-3349,,
15688931720,1163.56637,17093591481,1175270023,17093588128,-3353,,
15688981962,1163.61661,17093641726,1175320263,17093638367,-3359,,
15689032263,1163.66691,17093692030,1175370560,17093688665,-3365,,
15689082583,1163.71723,17093742352,1175420878,17093738983,-3369,,
15689133342,1163.76799,17093793112,1175471634,17093789739,-3373,,
15689183690,1163.81834,17093843463,1175521979,17093840083,-3380,,
15689234560,1163.86921,17093894336,1175572847,17093890951,-3385,,
15689284873,1163.91952,17093944651,1175623157,17093941262,-3389,,
15689335501,1163.97015,17093995282,1175673782,17093991887,-3395,,
15689385651,1164.02030,17094045433,1175723929,17094042033,-3400,,
15689435985,1164.07063,17094095770,1175774261,17094092366,-3404,,
15689486288,1164.12094,17094146075,1175824561,17094142665,-3410,,
15689536517,1164.17116,17094196306,1175874787,17094192891,-3415,,
15689586829,1164.22148,17094246620,1175925097,17094243201,-3419,,
15689637242,1164.27189,17094297036,1175975507,17094293611,-3425,,
15689687745,1164.32239,17094347541,1176026007,17094344111,-3430,,
15689737985,1164.37263,17094397783,1176076245,17094394349,-3434,,
15689788282,1164.42293,17094448083,1176126539,17094444643,-3440,,
15689838920,1164.47357,17094498724,1176177174,17094495279,-3445,,
15689889228,1164.52388,17094549035,1176227480,17094545584,-3451,,
15689939965,1164.57461,17094599773,1176278214,17094596318,-3455,,
15689990090,1164.62474,17094649901,1176328336,17094646441,-3460,,
15690040373,1164.67502,17094700187,1176378616,17094696720,-3467,,
15690090625,1164.72527,17094750441,1176428866,17094746971,-3470,,
15690141135,1164.77578,17094800953,1176479373,17094797478,-3475,,
15690191823,1164.82647,17094851644,1176530058,17094848163,-3481,,
15690242401,1164.87705,17094902223,1176580634,17094898738,-3485,,
15690293313,1164.92796,17094953138,1176631544,17094949648,-3490,,
15690343751,1164.97840,17095003578,1176681978,17095000082,-3496,,
15690393883,1165.02853,17095053713,1176732107,17095050212,-3501,,
15690444092,1165.07874,17095103923,1176782314,17095100418,-3505,,
15690494574,1165.12922,17095154409,1176832794,17095150898,-3511,,
15690545050,1165.17970,17095204886,1176883266,17095201370,-3516,,
15690595334,1165.22998,17095255172,1176933548,17095251652,-3520,,
15690645856,1165.28050,17095305698,1176984068,17095302172,-3526,,
15690696592,1165.33124,17095356436,1177034800,17095352905,-3531,,
15690747022,1165.38167,17095406867,1177085228,17095403332,-3535,,
15690797447,1165.43209,17095457295,1177135650,17095453754,-3541,,
15690847961,1165.48261,17095507811,1177186161,17095504266,-3545,,
15690898438,1165.53309,17095558291,1177236635,17095554740,-3551,,
15690949169,1165.58382,17095609024,1177287364,17095605468,-3556,,
15690999693,1165.63434,17095659551,1177337885,17095655990,-3561,,
15691050426,1165.68507,17095710286,1177388616,17095706720,-3566,,
15691100744,1165.73539,17095760606,1177438931,17095757036,-3570,,
15691150977,1165.78562,17095810841,1177489161,17095807266,-3575,,
15691201221,1165.83587,17095861088,1177539402,17095857507,-3581,,
15691251582,1165.88623,17095911452,1177589762,17095907867,-3585,,
15691301964,1165.93661,17095961836,1177640140,17095958245,-3591,,
15691352513,1165.98716,17096012388,1177690686,17096008791,-3597,,
15691402788,1166.03744,17096062664,1177740958,17096059062,-3602,,
15691453219,1166.08787,17096113097,1177791387,17096109491,-3606,,
15691503485,1166.13813,17096163367,1177841650,17096159755,-3612,,
15691553882,1166.18853,17096213765,1177892044,17096210148,-3617,,
15691604756,1166.23940,17096264641,1177942916,17096261021,-3620,,
15691654872,1166.28952,17096314760,1177993029,17096311134,-3626,,
15691705624,1166.34027,17096365514,1178043778,17096361882,-3632,,
15691755861,1166.39051,17096415754,1178094013,17096412118,-3636,,
15691806867,1166.44151,17096466763,1178145017,17096463121,-3642,,
15691856987,1166.49164,17096516884,1178195143,17096513247,-3637,,
15691907467,1166.54211,17096567367,1178245611,17096563715,-3652,,
15691957614,1166.59226,17096617517,1178295755,17096613860,-3657,,
15692007873,1166.64252,17096667778,1178346012,17096664116,-3662,,
15692058902,1166.69355,17096718809,1178397038,17096715142,-3667,,
15692109486,1166.74413,17096769396,1178447619,17096765724,-3672,,
15692160204,1166.79485,17096820116,1178498334,17096816438,-3678,,
15692210449,1166.84510,17096870363,1178548577,17096866681,-3682,,
15692260933,1166.89558,17096920849,1178599058,17096917163,-3686,,
15692311181,1166.94583,17096971100,1178649303,17096967407,-3693,,
15692361740,1166.99639,17097021661,1178699860,17097017964,-3697,,
15692412717,1167.04736,17097072640,1178750833,17097068937,-3703,,
15692463777,1167.09842,17097123703,1178801892,17097119996,-3707,,
15692514328,1167.14898,17097174257,1178852440,17097170544,-3713,,
15692565322,1167.19997,17097225253,1178903430,17097221535,-3718,,
15692615912,1167.25056,17097275846,1178954020,17097272124,-3722,,
15692666959,1167.30161,17097326895,1179005063,17097323168,-3727,,
15692717499,1167.35215,17097377437,1179055600,17097373704,-3733,,
15692768058,1167.40271,17097427998,1179106155,17097424270,-3728,,
15692819082,1167.45373,17097479025,1179157177,17097475282,-3743,,
15692870135,1167.50478,17097530080,1179208228,17097526332,-3748,,
15692920895,1167.55554,17097580841,1179258984,17097577089,-3752,,
15692971472,1167.60612,17097631422,1179309560,17097627664,-3758,,
15693022554,1167.65720,17097682506,1179360639,17097678743,-3763,,
15693072667,1167.70732,17097732622,1179410749,17097728854,-3768,,
15693123191,1167.75784,17097783148,1179461269,17097779374,-3774,,
15693173740,1167.80839,17097833699,1179511816,17097829921,-3778,,
15693224650,1167.85930,17097884623,1179562735,17097880839,-3784,,
15693275222,1167.90987,17097935186,1179613293,17097931397,-3789,,
15693326234,1167.96088,17097986200,1179664302,17097982407,-3793,,
15693377170,1168.01182,17098037140,1179715236,17098033341,-3799,,
15693427859,1168.06251,17098087830,1179765921,17098084026,-3804,,
15693478371,1168.11302,17098138344,1179816442,17098134546,-3798,,
15693529331,1168.16398,17098189306,1179867388,17098185492,-3814,,
15693580413,1168.21506,17098240391,1179918468,17098236572,-3819,,
15693631473,1168.26612,17098291454,1179969525,17098287629,-3825,,
15693682531,1168.31718,17098342514,1180020581,17098338685,-3829,,
15693733604,1168.36825,17098393589,1180071660,17098389765,-3824,,
15693784702,1168.41935,17098444690,1180122746,17098440850,-3840,,
15693835609,1168.47026,17098495598,1180173649,17098491754,-3844,,
15693886657,1168.52130,17098546649,1180224695,17098542799,-3850,,
15693937685,1168.57233,17098597680,1180275721,17098593825,-3855,,
15693988693,1168.62334,17098648690,1180326726,17098644831,-3859,,
15694039213,1168.67386,17098699212,1180377242,17098695347,-3865,,
15694089589,1168.72424,17098749591,1180427616,17098745721,-3870,,
15694140164,1168.77481,17098800168,1180478188,17098796293,-3875,,
15694190768,1168.82542,17098850775,1180528790,17098846895,-3880,,
15694241373,1168.87602,17098901381,1180579392,17098897496,-3885,,
15694291467,1168.92611,17098951478,1180629495,17098947600,-3878,,
15694342472,1168.97712,17099002485,1180680485,17098998589,-3896,,
15694393543,1169.02819,17099053559,1180731554,17099049658,-3901,,
15694444615,1169.07926,17099104633,1180782624,17099100728,-3905,,
15694495637,1169.13028,17099155658,1180833643,17099151747,-3911,,
15694546676,1169.18132,17099206699,1180884678,17099202783,-3916,,
15694597244,1169.23189,17099257279,1180935255,17099253359,-3920,,
15694647793,1169.28244,17099307821,1180985791,17099303895,-3926,,
15694698380,1169.33303,17099358409,1181036374,17099354478,-3931,,
15694748490,1169.38314,17099408522,1181086482,17099404586,-3936,,
15694799040,1169.43369,17099459075,1181137029,17099455134,-3941,,
15694849621,1169.48427,17099509658,1181187608,17099505712,-3946,,
15694900205,1169.53485,17099560245,1181238188,17099556293,-3952,,
15694951195,1169.58584,17099611237,1181289176,17099607281,-3956,,
15695001750,1169.63640,17099661794,1181339729,17099657833,-3961,,
15695052824,1169.68747,17099712871,1181390800,17099708905,-3966,,
15695103876,1169.73852,17099763925,1181441848,17099759953,-3972,,
15695154915,1169.78956,17099814966,1181492886,17099810990,-3976,,
15695206033,1169.84068,17099866087,1181544000,17099862104,-3983,,
15695256609,1169.89126,17099916665,1181594573,17099912678,-3987,,
15695307157,1169.94180,17099967215,1181645120,17099963224,-3991,,
15695357978,1169.99263,17100018038,1181695937,17100014041,-3997,,
15695408597,1170.04325,17100068659,1181746553,17100064657,-4002,,
15695459639,1170.09429,17100119704,1181797592,17100115696,-4008,,
15695510437,1170.14509,17100170505,1181848388,17100166493,-4012,,
15695560951,1170.19560,17100221021,1181898900,17100217004,-4017,,
15695611741,1170.24639,17100271814,1181949687,17100267791,-4023,,
15695662286,1170.29693,17100322361,1182000229,17100318334,-4027,,
15695713322,1170.34797,17100373399,1182051263,17100369367,-4032,,
15695763777,1170.39843,17100423856,1182101714,17100419818,-4038,,
15695813919,1170.44857,17100474001,1182151853,17100469958,-4043,,
15695864955,1170.49960,17100525038,1182202887,17100520992,-4046,,
15695915623,1170.55027,17100575710,1182253553,17100571657,-4053,,
15695965703,1170.60035,17100625791,1182303629,17100621733,-4058,,
15696016315,1170.65096,17100676406,1182354239,17100672344,-4062,,
15696067298,1170.70195,17100727391,1182405219,17100723324,-4067,,
15696117911,1170.75256,17100778006,1182455829,17100773933,-4073,,
15696168927,1170.80357,17100829026,1182506842,17100824946,-4080,,
15696219953,1170.85460,17100880053,1182557866,17100875970,-4083,,
15696270500,1170.90515,17100930602,1182608410,17100926514,-4088,,
15696321533,1170.95618,17100981638,1182659440,17100977544,-4094,,
15696372570,1171.00722,17101032678,1182710475,17101028580,-4098,,
15696423141,1171.05779,17101083250,1182761043,17101079148,-4102,,
15696474216,1171.10886,17101134340,1182812127,17101130232,-4108,,
15696525288,1171.15994,17101185403,1182863184,17101181289,-4114,,
15696576105,1171.21075,17101236222,1182914000,17101232104,-4118,,
15696626400,1171.26105,17101286520,1182964292,17101282396,-4124,,
15696677448,1171.31210,17101337581,1183015348,17101333453,-4128,,
15696728509,1171.36316,17101388634,1183066396,17101384501,-4133,,
15696778715,1171.41336,17101438842,1183116599,17101434703,-4139,,
15696829236,1171.46388,17101489365,1183167116,17101485221,-4144,,
15696879945,1171.51459,17101540077,1183217822,17101535927,-4150,,
15696930994,1171.56564,17101591127,1183268869,17101586973,-4154,,
15696981892,1171.61654,17101642028,1183319765,17101637869,-4159,,
15697032831,1171.66748,17101692970,1183370701,17101688806,-4164,,
15697083066,1171.71771,17101743207,1183420933,17101739038,-4169,,
15697133426,1171.76807,17101793569,1183471290,17101789395,-4174,,
15697183510,1171.81816,17101843655,1183521371,17101839475,-4180,,
15697234558,1171.86921,17101894706,1183572416,17101890521,-4185,,
15697285103,1171.91975,17101945253,1183622959,17101941064,-4189,,
15697336150,1171.97080,17101996303,1183674003,17101992108,-4195,,
15697387229,1172.02188,17102047384,1183725079,17102043184,-4200,,
15697438279,1172.07293,17102098437,1183776128,17102094232,-4205,,
15697489091,1172.12374,17102149250,1183826936,17102145041,-4209,,
15697539601,1172.17425,17102199763,1183877444,17102195548,-4215,,
15697589817,1172.22447,17102249981,1183927656,17102245760,-4221,,
15697640361,1172.27501,17102300529,1183978200,17102296304,-4225,,
15697690736,1172.32538,17102350916,1184028582,17102346687,-4229,,
15697741285,1172.37593,17102401457,1184079117,17102397221,-4236,,
15697792199,1172.42685,17102452372,1184130040,17102448144,-4228,,
15697842454,1172.47710,17102502629,1184180280,17102498384,-4245,,
15697892998,1172.52765,17102553177,1184230821,17102548926,-4251,,
15697944026,1172.57867,17102604207,1184281848,17102599962,-4245,,
15697995063,1172.62971,17102655246,1184332881,17102650986,-4260,,
15698045664,1172.68031,17102705849,1184383479,17102701583,-4266,,
15698096171,1172.73082,17102756359,1184433984,17102752088,-4271,,
15698146289,1172.78094,17102806478,1184484099,17102802204,-4274,,
15698197371,1172.83202,17102857563,1184535178,17102853283,-4280,,
15698248407,1172.88306,17102908602,1184586212,17102904316,-4286,,
15698299468,1172.93412,17102959666,1184637270,17102955375,-4291,,
15698349643,1172.98429,17103009843,1184687443,17103005547,-4296,,
15698400623,1173.03527,17103060825,1184738419,17103056524,-4301,,
15698451674,1173.08632,17103111879,1184789467,17103107571,-4308,,
15698502271,1173.13692,17103162477,1184840062,17103158178,-4299,,
15698552895,1173.18754,17103213104,1184890683,17103208787,-4317,,
15698603955,1173.23860,17103264167,1184941741,17103259845,-4322,,
15698654785,1173.28943,17103314998,1184992568,17103310672,-4326,,
15698705834,1173.34048,17103366049,1185043614,17103361719,-4330,,
15698756881,1173.39153,17103417100,1185094658,17103412762,-4338,,
15698807415,1173.44206,17103467636,1185145189,17103463294,-4342,,
15698858480,1173.49313,17103518703,1185196251,17103514356,-4347,,
15698909020,1173.54367,17103569246,1185246800,17103564905,-4341,,
15698959624,1173.59427,17103619852,1185297390,17103615494,-4358,,
15699010231,1173.64488,17103670461,1185347994,17103666099,-4362,,
15699060848,1173.69550,17103721081,1185398620,17103716725,-4356,,
15699111472,1173.74612,17103771707,1185449241,17103767345,-4362,,
15699162009,1173.79666,17103822247,1185499765,17103817869,-4378,,
15699212619,1173.84727,17103872859,1185550373,17103868477,-4382,,
15699263667,1173.89831,17103923909,1185601418,17103919522,-4387,,
15699314294,1173.94894,17103974538,1185652041,17103970146,-4392,,
15699364726,1173.99937,17104024973,1185702471,17104020576,-4397,,
15699415008,1174.04966,17104075257,1185752750,17104070855,-4402,,
15699465648,1174.10030,17104125900,1185803387,17104121492,-4408,,
15699516210,1174.15086,17104176463,1185853946,17104172051,-4412,,
15699566738,1174.20139,17104226995,1185904472,17104222577,-4418,,
15699617033,1174.25168,17104277292,1185954765,17104272869,-4423,,
15699667315,1174.30196,17104327575,1186005043,17104323147,-4428,,
15699717580,1174.35223,17104377843,1186055306,17104373410,-4433,,
15699768571,1174.40322,17104428837,1186106294,17104424399,-4438,,
15699819158,1174.45381,17104479426,1186156889,17104474993,-4433,,
15699870213,1174.50486,17104530484,1186207930,17104526034,-4450,,
15699920800,1174.55545,17104581072,1186258515,17104576619,-4453,,
15699971355,1174.60600,17104631630,1186309068,17104627172,-4458,,
15700022160,1174.65681,17104682438,1186359869,17104677974,-4464,,
15700072941,1174.70759,17104733221,1186410648,17104728753,-4468,,
15700123420,1174.75807,17104783701,1186461124,17104779228,-4473,,
15700174472,1174.80912,17104834756,1186512173,17104830277,-4479,,
15700225346,1174.85999,17104885633,1186563044,17104881149,-4484,,
15700275959,1174.91061,17104936247,1186613655,17104931759,-4488,,
15700326505,1174.96115,17104986796,1186664198,17104982302,-4494,,
15700377431,1175.01208,17105037724,1186715121,17105033225,-4499,,
15700427509,1175.06216,17105087806,1186765197,17105083302,-4504,,
15700478146,1175.11279,17105138444,1186815843,17105133948,-4496,,
15700528339,1175.16299,17105188639,1186866021,17105184125,-4514,,
15700579335,1175.21398,17105239639,1186917015,17105235120,-4519,,
15700629997,1175.26464,17105290303,1186967675,17105285779,-4524,,
15700680880,1175.31553,17105341199,1187018566,17105336671,-4528,,
15700731951,1175.36660,17105392262,1187069623,17105387727,-4535,,
15700782972,1175.41762,17105443285,1187120642,17105438746,-4539,,
15700833584,1175.46823,17105493899,1187171262,17105489367,-4532,,
15700884656,1175.51930,17105544974,1187222319,17105540424,-4550,,
15700935440,1175.57009,17105595760,1187273101,17105591205,-4555,,
15700986044,1175.62069,17105646366,1187323702,17105641806,-4560,,
15701037096,1175.67174,17105697421,1187374751,17105692856,-4565,,
15701087812,1175.72246,17105748139,1187425464,17105743569,-4570,,
15701138362,1175.77301,17105798692,1187476012,17105794117,-4575,,
15701188861,1175.82351,17105849192,1187526508,17105844612,-4580,,
15701238935,1175.87358,17105899269,1187576579,17105894694,-4575,,
15701289936,1175.92458,17105950272,1187627578,17105945682,-4590,,
15701340969,1175.97562,17106001307,1187678608,17105996712,-4595,,
15701392017,1176.02667,17106052357,1187729653,17106047757,-4600,,
15701442636,1176.07728,17106102980,1187780269,17106098374,-4606,,
15701493714,1176.12836,17106154060,1187831346,17106149450,-4610,,
15701544310,1176.17896,17106204658,1187881938,17106200043,-4615,,
15701595361,1176.23001,17106255711,1187932986,17106251090,-4621,,
15701645989,1176.28064,17106306342,1187983611,17106301715,-4627,,
15701696539,1176.33119,17106356895,1188034159,17106352264,-4631,,
15701746738,1176.38139,17106407096,1188084355,17106402460,-4636,,
15701797791,1176.43244,17106458151,1188135405,17106453510,-4641,,
15701848345,1176.48299,17106508708,1188185957,17106504061,-4647,,
15701898895,1176.53354,17106559260,1188236504,17106554609,-4651,,
15701949492,1176.58414,17106609859,1188287099,17106605203,-4656,,
15701999977,1176.63462,17106660347,1188337581,17106655686,-4661,,
15702050509,1176.68516,17106710881,1188388110,17106706215,-4666,,
15702101052,1176.73570,17106761426,1188438650,17106756765,-4661,,
15702152124,1176.78677,17106812501,1188489719,17106807824,-4677,,
15702202767,1176.83741,17106863145,1188540360,17106858465,-4680,,
15702253331,1176.88798,17106913712,1188590921,17106909025,-4687,,
15702303918,1176.93857,17106964302,1188641506,17106959610,-4692,,
15702354544,1176.98919,17107014929,1188692129,17107010233,-4696,,
15702405561,1177.04021,17107065950,1188743143,17107061247,-4703,,
15702456511,1177.09116,17107116902,1188794091,17107112196,-4706,,
15702507050,1177.14170,17107167455,1188844638,17107162743,-4712,,
15702557628,1177.19228,17107218024,1188895203,17107213307,-4717,,
15702608041,1177.24269,17107268451,1188945624,17107263729,-4722,,
15702658879,1177.29353,17107319279,1188996447,17107314552,-4727,,
15702709961,1177.34461,17107370364,1189047527,17107365632,-4732,,
15702761010,1177.39566,17107421415,1189098574,17107416678,-4737,,
15702812059,1177.44671,17107472466,1189149620,17107467724,-4742,,
15702863109,1177.49776,17107523519,1189200667,17107518771,-4748,,
15702913632,1177.54828,17107574044,1189251187,17107569292,-4752,,
15702964707,1177.59936,17107625121,1189302259,17107620364,-4757,,
15703015719,1177.65037,17107676136,1189353268,17107671373,-4763,,
15703066726,1177.70137,17107727145,1189404273,17107722378,-4767,,
15703117258,1177.75191,17107777679,1189454802,17107772906,-4773,,
15703167834,1177.80248,17107828257,1189505375,17107823479,-4778,,
15703217893,1177.85254,17107878318,1189555431,17107873535,-4783,,
15703268502,1177.90315,17107928931,1189606038,17107924142,-4789,,
15703319383,1177.95403,17107979814,1189656916,17107975021,-4793,,
15703370436,1178.00508,17108030869,1189707966,17108026071,-4798,,
15703421510,1178.05616,17108081945,1189759037,17108077142,-4803,,
15703472557,1178.10721,17108132994,1189810093,17108128197,-4797,,
15703523158,1178.15781,17108183597,1189860680,17108178784,-4813,,
15703574210,1178.20886,17108234652,1189911729,17108229833,-4819,,
15703625218,1178.25987,17108285663,1189962735,17108280840,-4823,,
15703675272,1178.30992,17108335719,1190012786,17108330890,-4829,,
15703725828,1178.36048,17108386277,1190063339,17108381443,-4834,,
15703776905,1178.41155,17108437357,1190114414,17108432518,-4839,,
15703827953,1178.46260,17108488408,1190165459,17108483564,-4844,,
15703878467,1178.51311,17108538923,1190215970,17108534074,-4849,,
15703929512,1178.56416,17108589970,1190267012,17108585116,-4854,,
15703980109,1178.61476,17108640571,1190317607,17108635712,-4859,,
15704031136,1178.66578,17108691599,1190368631,17108686736,-4863,,
15704081752,1178.71640,17108742217,1190419244,17108737349,-4868,,
15704132314,1178.76696,17108792783,1190469804,17108787909,-4874,,
15704183373,1178.81802,17108843844,1190520861,17108838965,-4879,,
15704233903,1178.86855,17108894377,1190571387,17108889492,-4885,,
15704284537,1178.91918,17108945012,1190622018,17108940122,-4890,,
15704335148,1178.96980,17108995626,1190672628,17108990732,-4894,,
15704385688,1179.02034,17109046168,1190723164,17109041269,-4899,,
15704435810,1179.07046,17109096293,1190773284,17109091389,-4904,,
15704486815,1179.12146,17109147299,1190824285,17109142389,-4910,,
15704537240,1179.17189,17109197728,1190874708,17109192813,-4915,,
15704588287,1179.22294,17109248777,1190925752,17109243856,-4921,,
15704638438,1179.27309,17109298929,1190975900,17109294004,-4925,,
15704688571,1179.32322,17109349067,1191026032,17109344137,-4930,,
15704739651,1179.37430,17109400148,1191077108,17109395213,-4935,,
15704790276,1179.42492,17109450774,1191127730,17109445835,-4939,,
15704841303,1179.47595,17109501805,1191178755,17109496860,-4945,,
15704892314,1179.52696,17109552818,1191229764,17109547869,-4949,,
15704942557,1179.57721,17109603062,1191280003,17109598107,-4955,,
15704993123,1179.62777,17109653631,1191330565,17109648670,-4961,,
15705044197,1179.67884,17109704708,1191381638,17109699743,-4965,,
15705095234,1179.72988,17109755748,1191432672,17109750777,-4971,,
15705146250,1179.78090,17109806765,1191483685,17109801790,-4975,,
15705196807,1179.83146,17109857325,1191534240,17109852345,-4980,,
15705246943,1179.88159,17109907463,1191584384,17109902489,-4974,,
15705298028,1179.93268,17109958551,1191635455,17109953560,-4991,,
15705348922,1179.98357,17110009447,1191686346,17110004451,-4996,,
15705399054,1180.03370,17110059582,1191736476,17110054590,-4992,,
15705449614,1180.08426,17110110144,1191787033,17110105137,-5007,,
15705500642,1180.13529,17110161173,1191838058,17110156162,-5011,,
15705551241,1180.18589,17110211776,1191888655,17110206760,-5016,,
15705601851,1180.23650,17110262388,1191939273,17110257378,-5010,,
15705652901,1180.28755,17110313441,1191990309,17110308414,-5027,,
15705703026,1180.33767,17110363568,1192040432,17110358536,-5032,,
15705753499,1180.38815,17110414043,1192090903,17110409007,-5036,,
15705804050,1180.43870,17110464596,1192141450,17110459554,-5042,,
15705854628,1180.48928,17110515177,1192192026,17110510130,-5047,,
15705905243,1180.53989,17110565793,1192242638,17110560743,-5050,,
15705956291,1180.59094,17110616845,1192293684,17110611788,-5057,,
15706006916,1180.64156,17110667483,1192344316,17110662421,-5062,,
15706057982,1180.69263,17110718540,1192395368,17110713472,-5068,,
15706108172,1180.74282,17110768733,1192445556,17110763660,-5073,,
15706158721,1180.79337,17110819284,1192496112,17110814216,-5068,,
15706209789,1180.84444,17110870354,1192547167,17110865272,-5082,,
15706260334,1180.89498,17110920902,1192597711,17110915815,-5087,,
15706310904,1180.94555,17110971473,1192648277,17110966381,-5092,,
15706361939,1180.99659,17111022510,1192699309,17111017413,-5097,,
15706412542,1181.04719,17111073117,1192749909,17111068013,-5104,,
15706462647,1181.09730,17111123224,1192800012,17111118117,-5107,,
15706513669,1181.14832,17111174249,1192851032,17111169136,-5113,,
15706564714,1181.19936,17111225296,1192902073,17111220178,-5118,,
15706614807,1181.24945,17111275391,1192952164,17111270269,-5122,,
15706665425,1181.30007,17111326012,1193002780,17111320884,-5128,,
15706715506,1181.35015,17111376095,1193052857,17111370961,-5134,,
15706766086,1181.40073,17111426677,1193103436,17111421540,-5137,,
15706817078,1181.45173,17111477683,1193154435,17111472540,-5143,,
15706867700,1181.50235,17111528296,1193205044,17111523148,-5148,,
15706918746,1181.55339,17111579344,1193256086,17111574191,-5153,,
15706968887,1181.60353,17111629487,1193306225,17111624329,-5158,,
15707019864,1181.65451,17111680467,1193357199,17111675304,-5163,,
15707070873,1181.70552,17111731478,1193408206,17111726310,-5168,,
15707121390,1181.75604,17111781998,1193458720,17111776825,-5173,,
15707171943,1181.80659,17111832552,1193509270,17111827374,-5178,,
15707222453,1181.85710,17111883065,1193559777,17111877882,-5183,,
15707272996,1181.90764,17111933610,1193610317,17111928421,-5189,,
15707323613,1181.95826,17111984239,1193660942,17111979047,-5192,,
15707374253,1182.00890,17112034873,1193711569,17112029673,-5200,,
15707424874,1182.05952,17112085495,1193762187,17112080291,-5204,,
15707475393,1182.11004,17112136017,1193812705,17112130809,-5208,,
15707526283,1182.16093,17112186910,1193863591,17112181696,-5214,,
15707577364,1182.21201,17112237993,1193914669,17112232774,-5219,,
15707628226,1182.26287,17112288856,1193965528,17112283632,-5224,,
15707678776,1182.31342,17112339410,1194016077,17112334181,-5229,,
15707729387,1182.36404,17112390022,1194066684,17112384788,-5234,,
15707779571,1182.41422,17112440209,1194116865,17112434970,-5239,,
15707830149,1182.46480,17112490790,1194167441,17112485546,-5244,,
15707880766,1182.51541,17112541409,1194218055,17112536159,-5250,,
15707930908,1182.56556,17112591553,1194268194,17112586299,-5254,,
15707981982,1182.61663,17112642629,1194319266,17112637370,-5259,,
15708032988,1182.66764,17112693638,1194370269,17112688373,-5265,,
15708083342,1182.71799,17112743995,1194420621,17112738725,-5270,,
15708134371,1182.76902,17112795026,1194471646,17112789750,-5276,,
15708184914,1182.81956,17112845571,1194522187,17112840291,-5280,,
15708235928,1182.87058,17112896599,1194573209,17112891314,-5285,,
15708286085,1182.92073,17112946757,1194623363,17112941467,-5290,,
15708336941,1182.97159,17112997605,1194674206,17112992311,-5294,,
15708387076,1183.02172,17113047742,1194724338,17113042442,-5300,,
15708437971,1183.07262,17113098639,1194775230,17113093334,-5305,,
15708489015,1183.12366,17113149696,1194826282,17113144386,-5310,,
15708540052,1183.17470,17113200726,1194877306,17113195411,-5315,,
15708590671,1183.22532,17113251347,1194927922,17113246027,-5320,,
15708640792,1183.27544,17113301470,1194978041,17113296146,-5324,,
15708691377,1183.32603,17113352058,1195028623,17113346728,-5330,,
15708742382,1183.37703,17113403065,1195079625,17113397730,-5335,,
15708792504,1183.42715,17113453201,1195129756,17113447861,-5340,,
15708843073,1183.47772,17113503761,1195180311,17113498415,-5346,,
15708893684,1183.52833,17113554374,1195230919,17113549024,-5350,,
15708943884,1183.57853,17113604576,1195281116,17113599220,-5356,,
15708994934,1183.62958,17113655629,1195332164,17113650268,-5361,,
15709045993,1183.68064,17113706690,1195383220,17113701325,-5365,,
15709096559,1183.73121,17113757259,1195433783,17113751887,-5372,,
15709146641,1183.78129,17113807342,1195483862,17113801966,-5376,,
15709197254,1183.83190,17113857958,1195534472,17113852580,-5378,,
15709247749,1183.88240,17113908456,1195584966,17113903070,-5386,,
15709298800,1183.93345,17113959508,1195636013,17113954117,-5391,,
15709349778,1183.98443,17114010489,1195686989,17114005093,-5396,,
15709400802,1184.03545,17114061516,1195738011,17114056115,-5401,,
15709451314,1184.08596,17114112030,1195788520,17114106624,-5406,,
15709501865,1184.13651,17114162582,1195839067,17114157172,-5410,,
15709552427,1184.18708,17114213147,1195889626,17114207730,-5417,,
15709603061,1184.23771,17114263783,1195940257,17114258362,-5421,,
15709653645,1184.28829,17114314371,1195990840,17114308944,-5427,,
15709704197,1184.33884,17114364924,1196041388,17114359493,-5431,,
15709754835,1184.38948,17114415565,1196092024,17114410129,-5436,,
15709805480,1184.44013,17114466213,1196142667,17114460771,-5442,,
15709856564,1184.49121,17114517298,1196193747,17114511852,-5446,,
15709907554,1184.54220,17114568291,1196244734,17114562838,-5453,,
15709958143,1184.59279,17114618895,1196295334,17114613438,-5457,,
15710009229,1184.64388,17114669970,1196346404,17114664509,-5461,,
15710060002,1184.69465,17114720745,1196397174,17114715278,-5467,,
15710111005,1184.74565,17114771752,1196448176,17114766280,-5472,,
15710161481,1184.79613,17114822230,1196498649,17114816753,-5477,,
15710211884,1184.84653,17114872636,1196549048,17114867153,-5483,,
15710262604,1184.89725,17114923358,1196599765,17114917870,-5488,,
15710313768,1184.94842,17114974524,1196650928,17114969032,-5492,,
15710364716,1184.99936,17115025475,1196701873,17115019977,-5498,,
15710415794,1185.05044,17115076555,1196752948,17115071052,-5503,,
15710466434,1185.10108,17115127197,1196803585,17115121690,-5507,,
15710517029,1185.15168,17115177805,1196854188,17115172293,-5512,,
15710567586,1185.20223,17115228354,1196904732,17115222836,-5518,,
15710618642,1185.25329,17115279411,1196955784,17115273888,-5523,,
15710668734,1185.30338,17115329506,1197005874,17115323979,-5527,,
15710719279,1185.35393,17115380053,1197056416,17115374520,-5533,,
15710769924,1185.40457,17115430701,1197107059,17115425164,-5537,,
15710820986,1185.45563,17115481765,1197158118,17115476222,-5543,,
15710871524,1185.50617,17115532306,1197208654,17115526758,-5548,,
15710922266,1185.55691,17115583050,1197259392,17115577497,-5553,,
15710973294,1185.60794,17115634081,1197310418,17115628522,-5559,,
15711023875,1185.65852,17115684664,1197360996,17115679101,-5563,,
15711074403,1185.70905,17115735195,1197411522,17115729626,-5569,,
15711125504,1185.76015,17115786298,1197462619,17115780724,-5574,,
15711176087,1185.81074,17115836883,1197513201,17115831305,-5578,,
15711226597,1185.86125,17115887395,1197563707,17115881811,-5584,,
15711277640,1185.91229,17115938440,1197614747,17115932851,-5589,,
15711327732,1185.96238,17115988535,1197664837,17115982942,-5593,,
15711378758,1186.01341,17116039564,1197715860,17116033965,-5599,,
15711429311,1186.06396,17116090130,1197766421,17116084526,-5604,,
15711480344,1186.11499,17116141153,1197817440,17116135544,-5609,,
15711530782,1186.16543,17116191595,1197867876,17116185981,-5614,,
15711581326,1186.21597,17116242141,1197918418,17116236522,-5619,,
15711632372,1186.26702,17116293190,1197969461,17116287565,-5625,,
15711683444,1186.31809,17116344264,1198020530,17116338634,-5630,,
15711734484,1186.36913,17116395305,1198071567,17116389671,-5634,,
15711785079,1186.41973,17116445904,1198122160,17116440264,-5640,,
15711835260,1186.46991,17116496086,1198172337,17116490442,-5644,,
15711885448,1186.52010,17116546277,1198222523,17116540627,-5650,,
15711936499,1186.57115,17116597331,1198273571,17116591676,-5655,,
15711987564,1186.62221,17116648409,1198324645,17116642749,-5660,,
15712038200,1186.67285,17116699036,1198375267,17116693371,-5665,,
15712089147,1186.72380,17116749986,1198426212,17116744316,-5670,,
15712139833,1186.77448,17116800674,1198476894,17116794999,-5675,,
15712190431,1186.82508,17116851275,1198527489,17116845594,-5681,,
15712241358,1186.87601,17116902203,1198578414,17116896518,-5685,,
15712291880,1186.92653,17116952728,1198628934,17116947038,-5690,,
15712342489,1186.97714,17117003340,1198679539,17116997644,-5696,,
15712393555,1187.02820,17117054408,1198730602,17117048707,-5701,,
15712444050,1187.07870,17117104905,1198781095,17117099200,-5705,,
15712495084,1187.12973,17117155942,1198832126,17117150231,-5711,,
15712545729,1187.18038,17117206589,1198882769,17117200873,-5716,,
15712596309,1187.23096,17117257171,1198933357,17117251462,-5709,,
15712646945,1187.28159,17117307810,1198983980,17117302084,-5726,,
15712697518,1187.33217,17117358385,1199034549,17117352653,-5732,,
15712748142,1187.38279,17117409010,1199085171,17117403275,-5735,,
15712799087,1187.43374,17117459959,1199136114,17117454218,-5741,,
15712849692,1187.48434,17117510566,1199186715,17117504820,-5746,,
15712900319,1187.53497,17117561195,1199237339,17117555443,-5752,,
15712950889,1187.58554,17117611768,1199287908,17117606013,-5755,,
15713001913,1187.63656,17117662794,1199338928,17117657032,-5762,,
15713052545,1187.68719,17117713429,1199389558,17117707662,-5767,,
15713103052,1187.73770,17117763938,1199440062,17117758166,-5772,,
15713154107,1187.78876,17117814995,1199491114,17117809218,-5777,,
15713205135,1187.83978,17117866025,1199542139,17117860243,-5782,,
15713255226,1187.88987,17117916119,1199592228,17117910332,-5787,,
15713305764,1187.94041,17117966659,1199642764,17117960868,-5791,,
15713355870,1187.99052,17118016768,1199692866,17118010971,-5797,,
15713406431,1188.04108,17118067331,1199743425,17118061529,-5802,,
15713457476,1188.09212,17118118377,1199794467,17118112572,-5805,,
15713508081,1188.14273,17118168985,1199845069,17118163173,-5812,,
15713558599,1188.19325,17118219506,1199895584,17118213689,-5817,,
15713609205,1188.24385,17118270114,1199946187,17118264292,-5822,,
15713659764,1188.29441,17118320675,1199996744,17118314848,-5827,,
15713710312,1188.34496,17118371226,1200047290,17118365394,-5832,,
15713760993,1188.39564,17118421910,1200097968,17118416072,-5838,,
15713811555,1188.44620,17118472474,1200148528,17118466632,-5842,,
15713862037,1188.49669,17118522958,1200199018,17118517123,-5835,,
15713913071,1188.54772,17118573995,1200250037,17118568141,-5854,,
15713963623,1188.59827,17118624549,1200300587,17118618691,-5858,,
15714013915,1188.64856,17118674843,1200350877,17118668981,-5862,,
15714064475,1188.69912,17118725405,1200401433,17118719537,-5868,,
15714115082,1188.74973,17118776015,1200452037,17118770142,-5873,,
15714165676,1188.80032,17118826611,1200502630,17118820734,-5877,,
15714216240,1188.85089,17118877178,1200553191,17118871295,-5883,,
15714266874,1188.90152,17118927813,1200603821,17118921926,-5887,,
15714317897,1188.95255,17118978838,1200654842,17118972946,-5892,,
15714368949,1189.00360,17119029904,1200705902,17119024006,-5898,,
15714419130,1189.05378,17119080077,1200756070,17119074174,-5903,,
15714470178,1189.10483,17119131128,1200807115,17119125219,-5909,,
15714520709,1189.15536,17119181660,1200857643,17119175748,-5912,,
15714571325,1189.20597,17119232279,1200908257,17119226361,-5918,,
15714621917,1189.25656,17119282873,1200958845,17119276950,-5923,,
15714672498,1189.30715,17119333457,1201009425,17119327529,-5928,,
15714723112,1189.35776,17119384073,1201060036,17119378140,-5933,,
15714774148,1189.40880,17119435112,1201111069,17119429174,-5938,,
15714825192,1189.45984,17119486157,1201162109,17119480214,-5943,,
15714876270,1189.51092,17119537238,1201213185,17119531290,-5948,,
15714926387,1189.56103,17119587358,1201263300,17119581405,-5953,,
15714976582,1189.61123,17119637555,1201313491,17119631596,-5959,,
15715027622,1189.66227,17119688596,1201364529,17119682634,-5962,,
15715078647,1189.71330,17119739625,1201415552,17119733656,-5969,,
15715129212,1189.76386,17119790191,1201466113,17119784217,-5974,,
15715180236,1189.81488,17119841219,1201517135,17119835239,-5980,,
15715230872,1189.86552,17119891857,1201567769,17119885873,-5984,,
15715281861,1189.91651,17119942848,1201618755,17119936859,-5989,,
15715332435,1189.96708,17119993425,1201669326,17119987430,-5995,,
15715383008,1190.01766,17120044011,1201719908,17120038012,-5999,,
15715434060,1190.06871,17120095054,1201770946,17120089050,-6004,,
15715484212,1190.11886,17120145209,1201821094,17120139199,-6010,,
15715534420,1190.16907,17120195419,1201871299,17120189404,-6015,,
15715585455,1190.22010,17120246456,1201922332,17120240437,-6019,,
15715636533,1190.27118,17120297536,1201973407,17120291511,-6025,,
15715687064,1190.32171,17120348069,1202023935,17120342039,-6030,,
15715737491,1190.37214,17120398498,1202074360,17120392464,-6034,,
15715788028,1190.42268,17120449039,1202124895,17120442999,-6040,,
15715838674,1190.47332,17120499687,1202175538,17120493642,-6045,,
15715889203,1190.52385,17120550219,1202226074,17120544179,-6040,,
15715939802,1190.57445,17120600820,1202276661,17120594765,-6055,,
15715990360,1190.62501,17120651380,1202327215,17120645320,-6060,,
15716040930,1190.67558,17120701953,1202377782,17120695887,-6066,,
15716091999,1190.72665,17120753024,1202428849,17120746954,-6070,,
15716142627,1190.77727,17120803653,1202479474,17120797578,-6075,,
15716193230,1190.82788,17120854259,1202530074,17120848178,-6081,,
15716243759,1190.87841,17120904791,1202580600,17120898705,-6086,,
15716294384,1190.92903,17120955418,1202631224,17120949328,-6090,,
15716344948,1190.97960,17121005985,1202681785,17120999889,-6096,,
15716396061,1191.03071,17121057100,1202732894,17121050998,-6102,,
15716446652,1191.08130,17121107693,1202783483,17121101588,-6105,,
15716497326,1191.13197,17121158369,1202834154,17121152258,-6111,,
15716548289,1191.18294,17121209335,1202885114,17121203219,-6116,,
15716599334,1191.23398,17121260383,1202936157,17121254261,-6122,,
15716649912,1191.28456,17121310962,1202986732,17121304836,-6126,,
15716700157,1191.33480,17121361209,1203036974,17121355078,-6131,,
15716750731,1191.38538,17121411787,1203087546,17121405650,-6137,,
15716800956,1191.43560,17121462014,1203137769,17121455873,-6141,,
15716852003,1191.48665,17121513062,1203188812,17121506917,-6145,,
15716903054,1191.53770,17121564116,1203239860,17121557964,-6152,,
15716954103,1191.58875,17121615168,1203290906,17121609011,-6157,,
15717005151,1191.63980,17121666217,1203341952,17121660056,-6161,,
15717056197,1191.69085,17121717267,1203392996,17121711100,-6167,,
15717107246,1191.74189,17121768317,1203444041,17121762145,-6172,,
15717158296,1191.79294,17121819371,1203495090,17121813194,-6177,,
15717209345,1191.84399,17121870422,1203546135,17121864239,-6183,,
15717260393,1191.89504,17121921472,1203597181,17121915285,-6187,,
15717311408,1191.94606,17121972490,1203648193,17121966297,-6193,,
15717361491,1191.99614,17122022575,1203698274,17122016378,-6197,,
15717412543,1192.04719,17122073629,1203749323,17122067427,-6202,,
15717463550,1192.09820,17122124638,1203800326,17122118430,-6208,,
15717513963,1192.14861,17122175054,1203850739,17122168843,-6211,,
15717564108,1192.19876,17122225200,1203900889,17122218994,-6206,,
15717614691,1192.24934,17122275786,1203951459,17122269563,-6223,,
15717665062,1192.29971,17122326160,1204001827,17122319932,-6228,,
15717715692,1192.35034,17122376792,1204052456,17122370561,-6231,,
15717765960,1192.40061,17122427063,1204102721,17122420825,-6238,,
15717816985,1192.45163,17122478091,1204153743,17122471848,-6243,,
15717868046,1192.50269,17122529154,1204204802,17122522906,-6248,,
15717919047,1192.55370,17122580157,1204255800,17122573904,-6253,,
15717970143,1192.60479,17122631255,1204306893,17122624997,-6258,,
15718021213,1192.65586,17122682328,1204357959,17122676064,-6264,,
15718071742,1192.70639,17122732858,1204408486,17122726591,-6267,,
15718122795,1192.75744,17122783914,1204459536,17122777640,-6274,,
15718173371,1192.80802,17122834493,1204510109,17122828214,-6279,,
15718224372,1192.85902,17122885496,1204561108,17122879213,-6283,,
15718274959,1192.90961,17122936084,1204611692,17122929796,-6288,,
15718325538,1192.96019,17122986678,1204662280,17122980385,-6293,,
15718376580,1193.01123,17123037711,1204713308,17123031412,-6299,,
15718427627,1193.06227,17123088761,1204764352,17123082457,-6304,,
15718478688,1193.11334,17123139824,1204815410,17123133514,-6310,,
15718528876,1193.16352,17123190014,1204865596,17123183701,-6313,,
15718579500,1193.21415,17123240640,1204916217,17123234321,-6319,,
15718630222,1193.26487,17123291365,1204966937,17123285041,-6324,,
15718680768,1193.31542,17123341913,1205017480,17123335584,-6329,,
15718731816,1193.36646,17123392964,1205068525,17123386629,-6335,,
15718782635,1193.41728,17123443785,1205119341,17123437446,-6339,,
15718832935,1193.46758,17123494087,1205169638,17123487742,-6345,,
15718883517,1193.51816,17123544672,1205220218,17123538323,-6349,,
15718933673,1193.56832,17123594841,1205270383,17123588488,-6353,,
15718983831,1193.61848,17123644990,1205320526,17123638630,-6360,,
15719034419,1193.66907,17123695581,1205371112,17123689216,-6365,,
15719084740,1193.71939,17123745916,1205421443,17123739547,-6369,,
15719135405,1193.77005,17123796570,1205472092,17123790196,-6374,,
15719185562,1193.82021,17123846731,1205522247,17123840351,-6380,,
15719236228,1193.87088,17123897399,1205572909,17123891013,-6386,,
15719286745,1193.92139,17123947918,1205623424,17123941529,-6389,,
15719337319,1193.97197,17123998495,1205673996,17123992100,-6395,,
15719388195,1194.02284,17124049373,1205724869,17124042973,-6400,,
15719439132,1194.07378,17124100312,1205775803,17124093907,-6405,,
15719489611,1194.12426,17124150794,1205826279,17124144384,-6410,,
15719540150,1194.17480,17124201334,1205876815,17124194919,-6415,,
15719590769,1194.22542,17124251957,1205927431,17124245535,-6422,,
15719641807,1194.27645,17124302996,1205978467,17124296572,-6424,,
15719692350,1194.32700,17124353542,1206029007,17124347112,-6430,,
15719742948,1194.37760,17124404143,1206079602,17124397707,-6436,,
15719793541,1194.42819,17124454738,1206130193,17124448297,-6441,,
15719844116,1194.47876,17124505315,1206180766,17124498870,-6445,,
15719894689,1194.52934,17124555901,1206231345,17124549449,-6452,,
15719945710,1194.58036,17124606913,1206282353,17124600457,-6456,,
15719996244,1194.63089,17124657450,1206332885,17124650990,-6460,,
15720047290,1194.68194,17124708499,1206383929,17124702033,-6466,,
15720097870,1194.73252,17124759081,1206434505,17124752609,-6472,,
15720148625,1194.78327,17124809839,1206485258,17124803363,-6476,,
15720199028,1194.83368,17124860243,1206535658,17124853762,-6481,,
15720250053,1194.88470,17124911271,1206586681,17124904785,-6486,,
15720300617,1194.93527,17124961837,1206637241,17124955345,-6492,,
15720351190,1194.98584,17125012413,1206687813,17125005917,-6496,,
15720402238,1195.03689,17125063463,1206738858,17125056962,-6501,,
15720452594,1195.08724,17125113821,1206789210,17125107315,-6506,,
15720503619,1195.13827,17125164849,1206840233,17125158338,-6511,,
15720553717,1195.18836,17125214949,1206890329,17125208433,-6516,,
15720604776,1195.23942,17125266022,1206941396,17125259500,-6522,,
15720655848,1195.29050,17125317085,1206992465,17125310570,-6515,,
15720706904,1195.34155,17125368143,1207043507,17125361611,-6532,,
15720757953,1195.39260,17125419195,1207094554,17125412658,-6537,,
15720808542,1195.44319,17125469786,1207145140,17125463244,-6542,,
15720859008,1195.49366,17125520255,1207195603,17125513708,-6547,,
15720910012,1195.54466,17125571261,1207246605,17125564709,-6552,,
15720960138,1195.59479,17125621389,1207296727,17125614832,-6557,,
15721011186,1195.64583,17125672439,1207347772,17125665876,-6563,,
15721061743,1195.69639,17125722999,1207398327,17125716432,-6567,,
15721112355,1195.74700,17125773613,1207448936,17125767041,-6572,,
15721162501,1195.79715,17125823762,1207499079,17125817184,-6578,,
15721212916,1195.84756,17125874178,1207549492,17125867596,-6582,,
15721263487,1195.89813,17125924763,1207600071,17125918176,-6587,,
15721314447,1195.94909,17125975715,1207651017,17125969122,-6593,,
15721365022,1195.99967,17126026292,1207701591,17126019695,-6597,,
15721415302,1196.04995,17126076574,1207751867,17126069972,-6602,,
15721465894,1196.10054,17126127169,1207802456,17126120561,-6608,,
15721516548,1196.15120,17126177825,1207853107,17126171212,-6613,,
15721567150,1196.20180,17126228429,1207903707,17126221811,-6618,,
15721618239,1196.25289,17126279521,1207954794,17126272898,-6623,,
15721668529,1196.30318,17126329812,1208005080,17126323184,-6628,,
15721718713,1196.35336,17126380010,1208055273,17126373378,-6632,,
15721769299,1196.40395,17126430588,1208105845,17126423949,-6639,,
15721820344,1196.45499,17126481636,1208156889,17126474993,-6643,,
15721870530,1196.50518,17126531823,1208207070,17126525174,-6649,,
15721921061,1196.55571,17126582356,1208257599,17126575703,-6653,,
15721971689,1196.60634,17126632987,1208308224,17126626329,-6658,,
15722022798,1196.65745,17126684099,1208359330,17126677445,-6654,,
15722073433,1196.70808,17126734736,1208409963,17126728068,-6668,,
15722124027,1196.75868,17126785332,1208460554,17126778659,-6673,,
15722174154,1196.80880,17126835461,1208510678,17126828782,-6679,,
15722224478,1196.85913,17126885788,1208561001,17126879105,-6683,,
15722275527,1196.91017,17126936839,1208612046,17126930151,-6688,,
15722326580,1196.96123,17126987895,1208663096,17126981201,-6694,,
15722377167,1197.01182,17127038484,1208713680,17127031785,-6699,,
15722427638,1197.06229,17127088958,1208764149,17127082254,-6704,,
15722478611,1197.11326,17127139933,1208815119,17127133224,-6709,,
15722529242,1197.16389,17127190565,1208865747,17127183851,-6714,,
15722579809,1197.21446,17127241135,1208916312,17127234416,-6719,,
15722630351,1197.26500,17127291680,1208966851,17127284956,-6724,,
15722680998,1197.31565,17127342328,1209017495,17127335599,-6729,,
15722732045,1197.36669,17127393378,1209068539,17127386643,-6735,,
15722782674,1197.41732,17127444010,1209119167,17127437271,-6739,,
15722833276,1197.46792,17127494614,1209169765,17127487870,-6744,,
15722884304,1197.51895,17127545656,1209220801,17127538906,-6750,,
15722935343,1197.56999,17127596697,1209271837,17127589942,-6755,,
15722986423,1197.62107,17127647768,1209322903,17127641008,-6760,,
15723037439,1197.67209,17127698787,1209373917,17127692022,-6765,,
15723088520,1197.72317,17127749870,1209424995,17127743100,-6770,,
15723139587,1197.77424,17127800940,1209476060,17127794165,-6775,,
15723190168,1197.82482,17127851523,1209526638,17127844743,-6780,,
15723241214,1197.87586,17127902570,1209577681,17127895797,-6773,,
15723291802,1197.92645,17127953161,1209628266,17127946370,-6791,,
15723342869,1197.97752,17128004230,1209679331,17127997435,-6795,,
15723393357,1198.02800,17128054720,1209729816,17128047920,-6800,,
15723443930,1198.07858,17128105297,1209780397,17128098501,-6796,,
15723495003,1198.12965,17128156371,1209831457,17128149561,-6810,,
15723545935,1198.18058,17128207307,1209882387,17128200502,-6805,,
15723596564,1198.23121,17128257938,1209933013,17128251117,-6821,,
15723647146,1198.28179,17128308522,1209983591,17128301696,-6826,,
15723697262,1198.33191,17128358641,1210033705,17128351810,-6831,,
15723748319,1198.38297,17128409700,1210084760,17128402864,-6836,,
15723798562,1198.43321,17128459945,1210135000,17128453104,-6841,,
15723849449,1198.48410,17128510836,1210185885,17128503990,-6846,,
15723900044,1198.53469,17128561431,1210236476,17128554580,-6851,,
15723950628,1198.58528,17128612018,1210287057,17128605162,-6856,,
15724001669,1198.63632,17128663062,1210338096,17128656200,-6862,,
15724052229,1198.68688,17128713624,1210388654,17128706759,-6865,,
15724102829,1198.73748,17128764226,1210439250,17128757355,-6871,,
15724153442,1198.78809,17128814842,1210489860,17128807964,-6878,,
15724204214,1198.83886,17128865616,1210540630,17128858735,-6881,,
15724254353,1198.88900,17128915757,1210590766,17128908870,-6887,,
15724305137,1198.93979,17128966543,1210641547,17128959651,-6892,,
15724355985,1198.99063,17129017393,1210692392,17129010496,-6897,,
15724407067,1199.04172,17129068479,1210743473,17129061577,-6902,,
15724458088,1199.09274,17129119502,1210794491,17129112595,-6907,,
15724508815,1199.14346,17129170230,1210845214,17129163319,-6911,,
15724559427,1199.19408,17129220846,1210895825,17129213929,-6917,,
15724610486,1199.24513,17129271907,1210946880,17129264985,-6922,,
15724661086,1199.29573,17129322509,1210997477,17129315582,-6927,,
15724711573,1199.34622,17129372998,1211047961,17129366065,-6933,,
15724762171,1199.39682,17129423603,1211098561,17129416666,-6937,,
15724813247,1199.44790,17129474677,1211149631,17129467735,-6942,,
15724863814,1199.49846,17129525257,1211200205,17129518309,-6948,,
15724914380,1199.54903,17129575815,1211250759,17129568863,-6952,,
15724964942,1199.59959,17129626380,1211301318,17129619422,-6958,,
15725015805,1199.65045,17129677245,1211352177,17129670281,-6964,,
15725066381,1199.70103,17129727823,1211402751,17129720855,-6968,,
15725116468,1199.75112,17129777923,1211452845,17129770950,-6973,,
15725167041,1199.80169,17129828488,1211503406,17129821510,-6978,,
15725218081,1199.85273,17129879529,1211554442,17129872547,-6982,,
15725268657,1199.90331,17129930109,1211605017,17129923121,-6988,,
15725319173,1199.95382,17129980627,1211655529,17129973633,-6994,,
15725369732,1200.00438,17130031188,1211706085,17130024190,-6998,,
15725420809,1200.05546,17130082279,1211757171,17130075276,-7003,,
15725471395,1200.10604,17130132856,1211807743,17130125847,-7009,,
15725522445,1200.15709,17130183908,1211858790,17130176895,-7013,,
15725572902,1200.20755,17130234378,1211909255,17130227359,-7019,,
15725623939,1200.25859,17130285407,1211960280,17130278384,-7023,,
15725674027,1200.30867,17130335497,1212010365,17130328469,-7028,,
15725725025,1200.35967,17130386498,1212061359,17130379464,-7034,,
15725775673,1200.41032,17130437147,1212112005,17130430110,-7037,,
15725826335,1200.46098,17130487813,1212162664,17130480769,-7044,,
15725877305,1200.51195,17130538784,1212213631,17130531735,-7049,,
15725928347,1200.56300,17130589828,1212264670,17130582775,-7053,,
15725978891,1200.61354,17130640376,1212315213,17130633317,-7059,,
15726029951,1200.66460,17130691438,1212366270,17130684374,-7064,,
15726080978,1200.71563,17130742467,1212417293,17130735398,-7069,,
15726131526,1200.76617,17130793018,1212467839,17130785944,-7074,,
15726181589,1200.81624,17130843082,1212517899,17130836003,-7079,,
15726232672,1200.86732,17130894168,1212568979,17130887084,-7084,,
15726283680,1200.91833,17130945178,1212619984,17130938088,-7090,,
15726334260,1200.96891,17130995761,1212670562,17130988667,-7094,,
15726385270,1201.01992,17131046773,1212721569,17131039673,-7100,,
15726435820,1201.07047,17131097326,1212772117,17131090221,-7105,,
15726486854,1201.12150,17131148362,1212823147,17131141252,-7110,,
15726537454,1201.17210,17131198965,1212873745,17131191849,-7116,,
15726588097,1201.22275,17131249610,1212924385,17131242489,-7121,,
15726639115,1201.27376,17131300630,1212975400,17131293505,-7125,,
15726689198,1201.32385,17131350716,1213025482,17131343586,-7130,,
15726739780,1201.37443,17131401299,1213076060,17131394164,-7135,,
15726789908,1201.42456,17131451430,1213126186,17131444290,-7140,,
15726840932,1201.47558,17131502456,1213177207,17131495311,-7145,,
15726891510,1201.52616,17131553037,1213227783,17131545887,-7150,,
15726942394,1201.57704,17131603923,1213278663,17131596767,-7156,,
15726993460,1201.62811,17131654992,1213329726,17131647831,-7161,,
15727044012,1201.67866,17131705547,1213380278,17131698383,-7164,,
15727095067,1201.72971,17131756604,1213431328,17131749433,-7171,,
15727146120,1201.78077,17131807669,1213482389,17131800494,-7175,,
15727196657,1201.83130,17131858198,1213532914,17131851018,-7180,,
15727247219,1201.88187,17131908763,1213583472,17131901577,-7186,,
15727297488,1201.93214,17131959034,1213633748,17131951853,-7181,,
15727348074,1201.98272,17132009622,1213684322,17132002426,-7196,,
15727398623,1202.03327,17132060174,1213734868,17132052973,-7201,,
15727449200,1202.08385,17132110753,1213785443,17132103547,-7206,,
15727499296,1202.13394,17132160851,1213835536,17132153641,-7210,,
15727549916,1202.18456,17132211474,1213886153,17132204258,-7216,,
15727600477,1202.23512,17132262049,1213936724,17132254828,-7221,,
15727651120,1202.28577,17132312681,1213987351,17132305455,-7226,,
15727701717,1202.33636,17132363282,1214037945,17132356049,-7233,,
15727752288,1202.38694,17132413855,1214088514,17132406619,-7236,,
15727803291,1202.43794,17132464860,1214139514,17132457618,-7242,,
15727853927,1202.48858,17132515499,1214190147,17132508251,-7248,,
15727904768,1202.53942,17132566341,1214240986,17132559091,-7250,,
15727955354,1202.59000,17132616931,1214291569,17132609673,-7258,,
15728006402,1202.64105,17132667980,1214342614,17132660718,-7262,,
15728057450,1202.69210,17132719031,1214393660,17132711764,-7267,,
15728107997,1202.74265,17132769580,1214444204,17132762308,-7272,,
15728158561,1202.79321,17132820147,1214494766,17132812870,-7277,,
15728209642,1202.84429,17132871230,1214545843,17132863947,-7283,,
15728260691,1202.89534,17132922282,1214596890,17132914995,-7287,,
15728311713,1202.94636,17132973306,1214647910,17132966014,-7292,,
15728362752,1202.99740,17133024347,1214698945,17133017049,-7298,,
15728413335,1203.04798,17133074932,1214749525,17133067629,-7303,,
15728464384,1203.09903,17133125983,1214800572,17133118676,-7307,,
15728515414,1203.15006,17133177016,1214851599,17133169704,-7312,,
15728566237,1203.20088,17133227842,1214902419,17133220524,-7318,,
15728616298,1203.25095,17133277905,1214952478,17133270583,-7322,,
15728666862,1203.30151,17133328484,1215003051,17133321156,-7328,,
15728717416,1203.35206,17133379028,1215053591,17133371720,-7308,,
15728768461,1203.40311,17133430075,1215104632,17133422737,-7338,,
15728818575,1203.45322,17133480192,1215154744,17133472849,-7343,,
15728869122,1203.50377,17133530741,1215205288,17133523393,-7348,,
15728919626,1203.55427,17133581247,1215255790,17133573894,-7353,,
15728970691,1203.60534,17133632315,1215306852,17133624957,-7358,,
15729021714,1203.65636,17133683340,1215357873,17133675977,-7363,,
15729071775,1203.70642,17133733402,1215407930,17133726034,-7368,,
15729122424,1203.75707,17133784056,1215458577,17133776682,-7374,,
15729172867,1203.80751,17133834499,1215509017,17133827121,-7378,,
15729224124,1203.85877,17133885760,1215560271,17133878376,-7384,,
15729274954,1203.90960,17133936591,1215611098,17133929202,-7389,,
15729326014,1203.96066,17133987653,1215662156,17133980260,-7393,,
15729383072,1204.01772,17134044714,1215719211,17134037315,-7399,,
15729437076,1204.07172,17134098721,1215773212,17134091316,-7405,,
15729487271,1204.12192,17134148918,1215823404,17134141508,-7410,,
15729537319,1204.17197,17134198969,1215873449,17134191554,-7415,,
15729587379,1204.22203,17134249031,1215923507,17134241611,-7420,,
15729637916,1204.27256,17134299571,1215974042,17134292146,-7425,,
15729688010,1204.32266,17134349666,1216024132,17134342236,-7430,,
15729738533,1204.37318,17134400192,1216074653,17134392758,-7434,,
15729789581,1204.42423,17134451243,1216125699,17134443803,-7440,,
15729842275,1204.47692,17134503938,1216178389,17134496493,-7445,,
15729893017,1204.52767,17134554684,1216229128,17134547233,-7451,,
15729943282,1204.57793,17134604950,1216279391,17134597495,-7455,,
15729994076,1204.62872,17134655747,1216330182,17134648287,-7460,,
15730044487,1204.67914,17134706160,1216380590,17134698694,-7466,,
15730095408,1204.73006,17134757084,1216431509,17134749613,-7471,,
15730145822,1204.78047,17134807500,1216481920,17134800024,-7476,,
15730196868,1204.83152,17134858548,1216532963,17134851067,-7481,,
15730247343,1204.88199,17134909025,1216583435,17134901539,-7486,,
15730297819,1204.93247,17134959505,1216633909,17134952014,-7491,,
15730532551,1205.16720,17135194246,1216868628,17135186732,-7514,17135192497,
15730557994,1205.19264,17135219691,1216894070,17135212203,-7488,,
15730608620,1205.24327,17135270319,1216944693,17135262884,-7435,,
15730659546,1205.29419,17135321248,1216995616,17135313867,-7381,,
15730710128,1205.34478,17135371832,1217046196,17135364505,-7327,,
15730760725,1205.39537,17135422432,1217096790,17135415157,-7275,,
15730810854,1205.44550,17135472563,1217146916,17135465340,-7223,,
15730860979,1205.49563,17135522691,1217197038,17135515521,-7170,,
15730911886,1205.54653,17135573600,1217247944,17135566485,-7115,,
15730962422,1205.59707,17135624137,1217298476,17135617086,-7051,,
15731013508,1205.64816,17135675226,1217349559,17135668217,-7009,,
15731064071,1205.69872,17135725792,1217400121,17135718837,-6955,,
15731114968,1205.74962,17135776691,1217451014,17135769789,-6902,,
15731165543,1205.80019,17135827268,1217501586,17135820419,-6849,,
15731216036,1205.85068,17135877763,1217552076,17135870968,-6795,,
15731266574,1205.90122,17135928304,1217602612,17135921562,-6742,,
15731316942,1205.95159,17135978674,1217652977,17135971985,-6689,,
15731367956,1206.00260,17136029690,1217703988,17136023055,-6635,,
15731417999,1206.05265,17136079736,1217754029,17136073153,-6583,,
15731468693,1206.10334,17136130443,1217804731,17136123914,-6529,,
15731519794,1206.15444,17136181535,1217855818,17136175060,-6475,,
15731570839,1206.20549,17136232584,1217906860,17136226162,-6422,,
15731621860,1206.25651,17136283607,1217957879,17136277240,-6367,,
15731672501,1206.30715,17136334250,1218008517,17136327936,-6314,,
15731723072,1206.35772,17136384823,1218059085,17136378562,-6261,,
15731773799,1206.40845,17136435552,1218109810,17136429345,-6207,,
15731823945,1206.45859,17136485701,1218159953,17136479547,-6154,,
15731874666,1206.50931,17136536424,1218210671,17136530322,-6102,,
15731925246,1206.55989,17136587007,1218261250,17136580960,-6047,,
15731975823,1206.61047,17136637587,1218311823,17136631591,-5996,,
15732026861,1206.66151,17136688627,1218362858,17136682686,-5941,,
15732077912,1206.71256,17136739679,1218413906,17136733792,-5887,,
15732130029,1206.76468,17136791799,1218466021,17136785967,-5832,,
15732180998,1206.81565,17136842770,1218516987,17136836992,-5778,,
15732231583,1206.86623,17136893358,1218567571,17136887634,-5724,,
15732282615,1206.91726,17136944393,1218618599,17136938721,-5672,,
15732333165,1206.96781,17136994944,1218669146,17136989326,-5618,,
15732383701,1207.01835,17137045483,1218719679,17137039918,-5565,,
15732434286,1207.06893,17137096070,1218770261,17137090558,-5512,,
15732485373,1207.12002,17137147159,1218821346,17137141703,-5456,,
15732536370,1207.17102,17137198160,1218872340,17137192755,-5405,,
15732587395,1207.22204,17137249186,1218923362,17137243835,-5351,,
15732637981,1207.27263,17137299775,1218973946,17137294478,-5297,,
15732689006,1207.32365,17137350802,1219024968,17137345558,-5244,,
15732739581,1207.37423,17137401380,1219075541,17137396190,-5190,,
15732790091,1207.42474,17137451892,1219126047,17137446755,-5137,,
15732841137,1207.47579,17137502941,1219177092,17137497858,-5083,,
15732891675,1207.52632,17137553480,1219227626,17137548451,-5029,,
15732942273,1207.57692,17137604081,1219278221,17137599105,-4976,,
15732993320,1207.62797,17137655131,1219329266,17137650207,-4924,,
15733044331,1207.67898,17137706143,1219380274,17137701274,-4869,,
15733094871,1207.72952,17137756687,1219430812,17137751870,-4817,,
15733145420,1207.78007,17137807238,1219481358,17137802475,-4763,,
15733196017,1207.83066,17137857837,1219531953,17137853128,-4709,,
15733246614,1207.88126,17137908436,1219582546,17137903780,-4656,,
15733297642,1207.93229,17137959466,1219633571,17137954864,-4602,,
15733348689,1207.98334,17138010516,1219684615,17138005967,-4549,,
15733398747,1208.03339,17138060577,1219734672,17138056081,-4496,,
15733449799,1208.08445,17138111631,1219785721,17138107189,-4442,,
15733500344,1208.13499,17138162177,1219836262,17138157788,-4389,,
15733550943,1208.18559,17138212790,1219886870,17138208456,-4334,,
15733601517,1208.23617,17138263356,1219937430,17138259074,-4282,,
15733652068,1208.28672,17138313909,1219987978,17138309680,-4229,,
15733702612,1208.33726,17138364456,1220038519,17138360279,-4177,,
15733752696,1208.38734,17138414542,1220088601,17138410419,-4123,,
15733803681,1208.43833,17138465529,1220139583,17138461459,-4070,,
15733854240,1208.48889,17138516091,1220190140,17138512075,-4016,,
15733905275,1208.53992,17138567128,1220241172,17138563166,-3962,,
15733955844,1208.59049,17138617700,1220291738,17138613790,-3910,,
15734006481,1208.64113,17138668338,1220342372,17138664482,-3856,,
15734057095,1208.69174,17138718955,1220392983,17138715152,-3803,,
15734107568,1208.74222,17138769431,1220443455,17138765681,-3750,,
15734158105,1208.79275,17138819970,1220493988,17138816274,-3696,,
15734208651,1208.84330,17138870518,1220544531,17138866875,-3643,,
15734259188,1208.89384,17138921057,1220595066,17138917468,-3589,,
15734309225,1208.94387,17138971096,1220645100,17138967560,-3536,,
15734359286,1208.99393,17139021160,1220695158,17139017676,-3484,,
15734409822,1209.04447,17139071699,1220745692,17139068268,-3431,,
15734459901,1209.09455,17139121779,1220795768,17139118401,-3378,,
15734510430,1209.14508,17139172311,1220846295,17139168986,-3325,,
15734561027,1209.19567,17139222911,1220896889,17139219639,-3272,,
15734611618,1209.24627,17139273503,1220947477,17139270286,-3217,,
15734662118,1209.29677,17139324006,1220997975,17139320841,-3165,,
15734712379,1209.34703,17139374269,1221048232,17139371156,-3113,,
15734763399,1209.39805,17139425292,1221099250,17139422234,-3058,,
15734813942,1209.44859,17139475838,1221149791,17139472832,-3006,,
15734864510,1209.49916,17139526408,1221200355,17139523454,-2954,,
15734914973,1209.54962,17139576873,1221250817,17139573975,-2898,,
15734965939,1209.60059,17139627842,1221301779,17139624996,-2846,,
15735016924,1209.65157,17139678828,1221352761,17139676037,-2791,,
15735072491,1209.70714,17139734398,1221408325,17139731664,-2734,,
15735128802,1209.76345,17139790711,1221464632,17139788037,-2674,,
15735179576,1209.81422,17139841489,1221515405,17139838868,-2621,,
15735230115,1209.86476,17139892029,1221565941,17139889462,-2567,,
15735280183,1209.91483,17139942099,1221616006,17139939585,-2514,,
15735330864,1209.96551,17139992784,1221666684,17139990322,-2462,,
15735381456,1210.01610,17140043378,1221717275,17140040971,-2407,,
15735432453,1210.06710,17140094376,1221768268,17140092023,-2353,,
15735482994,1210.11764,17140144921,1221818807,17140142620,-2301,,
15735533078,1210.16773,17140195007,1221868889,17140192760,-2247,,
15735584624,1210.21927,17140246554,1221920431,17140244302,-2252,,
15735636667,1210.27131,17140298601,1221972471,17140296341,-2260,,
15735687189,1210.32184,17140349124,1222022990,17140346860,-2264,,
15735737735,1210.37238,17140399673,1222073534,17140397405,-2268,,
15735787804,1210.42245,17140449745,1222123601,17140447471,-2274,,
15735838848,1210.47350,17140500791,1222174641,17140498511,-2280,,
15735889883,1210.52453,17140551829,1222225673,17140549544,-2285,,
15735939942,1210.57459,17140601889,1222275729,17140599600,-2289,,
15735989989,1210.62464,17140651939,1222325774,17140649645,-2294,,
15736040556,1210.67520,17140702508,1222376337,17140700208,-2300,,
15736091069,1210.72572,17140753024,1222426849,17140750720,-2304,,
15736141140,1210.77579,17140803097,1222476917,17140800788,-2309,,
15736191690,1210.82634,17140853649,1222527464,17140851334,-2315,,
15736242428,1210.87708,17140904390,1222578200,17140902071,-2319,,
15736293016,1210.92766,17140954981,1222628787,17140952657,-2324,,
15736343539,1210.97819,17141005506,1222679305,17141003176,-2330,,
15736394609,1211.02926,17141056577,1222730372,17141054242,-2335,,
15736445681,1211.08033,17141107652,1222781442,17141105313,-2339,,
15736496262,1211.13091,17141158236,1222832021,17141155891,-2345,,
15736546657,1211.18131,17141208644,1222882424,17141206295,-2349,,
15736597735,1211.23238,17141259713,1222933488,17141257359,-2354,,
15736648330,1211.28298,17141310311,1222984080,17141307951,-2360,,
15736699328,1211.33398,17141361310,1223035075,17141358945,-2365,,
15736749392,1211.38404,17141411378,1223085137,17141409007,-2371,,
15736800441,1211.43509,17141462429,1223136184,17141460054,-2375,,
15736851483,1211.48613,17141513472,1223187222,17141511092,-2380,,
15736901524,1211.53617,17141563517,1223237260,17141561131,-2386,,
15736951633,1211.58628,17141613628,1223287368,17141611239,-2389,,
15737002711,1211.63736,17141664708,1223338442,17141662313,-2395,,
15737053744,1211.68839,17141715743,1223389472,17141713343,-2400,,
15737104794,1211.73944,17141766796,1223440519,17141764389,-2407,,
15737155305,1211.78995,17141817309,1223491029,17141814899,-2410,,
15737205862,1211.84051,17141867869,1223541583,17141865453,-2416,,
15737256924,1211.89157,17141918933,1223592642,17141916512,-2421,,
15737307414,1211.94206,17141969437,1223643141,17141967012,-2425,,
15737358023,1211.99267,17142020037,1223693736,17142017606,-2431,,
15737409083,1212.04373,17142071098,1223744792,17142068662,-2436,,
15737460087,1212.09473,17142122106,1223795794,17142119664,-2442,,
15737510183,1212.14483,17142172204,1223845887,17142169758,-2446,,
15737561179,1212.19583,17142223202,1223896881,17142220751,-2451,,
15737612232,1212.24688,17142274258,1223947930,17142271801,-2457,,
15737662775,1212.29742,17142324803,1223998472,17142322342,-2461,,
15737712921,1212.34757,17142374951,1224048614,17142372484,-2467,,
15737763954,1212.39860,17142425987,1224099644,17142423515,-2472,,
15737814535,1212.44918,17142476569,1224150222,17142474092,-2477,,
15737865520,1212.50017,17142527557,1224201205,17142525076,-2481,,
15737916137,1212.55078,17142578176,1224251819,17142575689,-2487,,
15737967199,1212.60185,17142629241,1224302878,17142626749,-2492,,
15738018263,1212.65291,17142680308,1224353941,17142677811,-2497,,
15738069253,1212.70390,17142731300,1224404928,17142728798,-2502,,
15738119337,1212.75399,17142781385,1224455008,17142778879,-2506,,
15738169892,1212.80454,17142831944,1224505561,17142829431,-2513,,
15738220888,1212.85554,17142882941,1224556554,17142880425,-2516,,
15738270940,1212.90559,17142932996,1224606603,17142930473,-2523,,
15738320993,1212.95564,17142983052,1224656653,17142980524,-2528,,
15738371562,1213.00621,17143033623,1224707220,17143031091,-2532,,
15738422618,1213.05727,17143084681,1224758274,17143082145,-2536,,
15738473187,1213.10784,17143135253,1224808839,17143132710,-2543,,
15738523532,1213.15818,17143185600,1224859183,17143183053,-2547,,
15738574614,1213.20926,17143236684,1224910262,17143234132,-2552,,
15738625664,1213.26031,17143287736,1224961308,17143285179,-2557,,
15738676457,1213.31110,17143338531,1225012098,17143335968,-2563,,
15738727069,1213.36172,17143389146,1225062709,17143386579,-2567,,
15738777620,1213.41227,17143439700,1225113256,17143437127,-2573,,
15738828295,1213.46294,17143490377,1225163929,17143487800,-2577,,
15738878843,1213.51349,17143540928,1225214474,17143538344,-2584,,
15738928968,1213.56362,17143591055,1225264597,17143588467,-2588,,
15738979513,1213.61416,17143641602,1225315138,17143639008,-2594,,
15739030081,1213.66473,17143692173,1225365703,17143689574,-2599,,
15739080191,1213.71484,17143742285,1225415811,17143739682,-2603,,
15739130340,1213.76499,17143792435,1225465957,17143789827,-2608,,
15739181304,1213.81595,17143843403,1225516918,17143840789,-2614,,
15739232356,1213.86700,17143894456,1225567968,17143891838,-2618,,
15739282383,1213.91703,17143944485,1225617992,17143941862,-2623,,
15739333033,1213.96768,17143995139,1225668640,17143992510,-2629,,
15739384095,1214.01874,17144046203,1225719698,17144043569,-2634,,
15739434627,1214.06928,17144096736,1225770228,17144094098,-2638,,
15739484703,1214.11935,17144146815,1225820301,17144144171,-2644,,
15739535728,1214.17038,17144197843,1225871324,17144195194,-2649,,
15739586298,1214.22095,17144248415,1225921891,17144245762,-2653,,
15739636751,1214.27140,17144298871,1225972341,17144296212,-2659,,
15739687243,1214.32189,17144349365,1226022831,17144346701,-2664,,
15739737813,1214.37246,17144399936,1226073398,17144397268,-2668,,
15739788383,1214.42303,17144450510,1226123966,17144447837,-2673,,
15739839413,1214.47406,17144501541,1226174992,17144498862,-2679,,
15739890480,1214.52513,17144552611,1226226056,17144549926,-2685,,
15739941514,1214.57616,17144603648,1226277088,17144600958,-2690,,
15739992034,1214.62668,17144654169,1226327605,17144651475,-2694,,
15740042601,1214.67725,17144704740,1226378169,17144702040,-2700,,
15740093624,1214.72827,17144755765,1226429190,17144753060,-2705,,
15740144674,1214.77932,17144806817,1226480238,17144804108,-2709,,
15740194725,1214.82937,17144856871,1226530286,17144854156,-2715,,
15740244770,1214.87942,17144906918,1226580328,17144904198,-2720,,
15740294829,1214.92948,17144956978,1226630384,17144954254,-2724,,
15740344879,1214.97953,17145007031,1226680431,17145004301,-2730,,
15740395428,1215.03008,17145057582,1226730977,17145054847,-2735,,
15740446974,1215.08162,17145109130,1226782521,17145106391,-2739,,
15740497013,1215.13166,17145159172,1226832569,17145156440,-2732,,
15740548074,1215.18272,17145210236,1226883616,17145207486,-2750,,
15740600123,1215.23477,17145262287,1226935661,17145259531,-2756,,
15740651179,1215.28583,17145313345,1226986715,17145310585,-2760,,
15740702229,1215.33688,17145364397,1227037762,17145361632,-2765,,
15740753293,1215.38794,17145415475,1227088834,17145412705,-2770,,
15740803842,1215.43849,17145466016,1227139371,17145463241,-2775,,
15740854884,1215.48953,17145517059,1227190409,17145514280,-2779,,
15740905932,1215.54058,17145568110,1227241454,17145565325,-2785,,
15740956464,1215.59111,17145618644,1227291983,17145615854,-2790,,
15741007032,1215.64168,17145669214,1227342549,17145666420,-2794,,
15741057560,1215.69221,17145719746,1227393075,17145716945,-2801,,
15741107715,1215.74236,17145769902,1227443226,17145767096,-2806,,
15741158271,1215.79292,17145820462,1227493781,17145817651,-2811,,
15741209312,1215.84396,17145871505,1227544818,17145868689,-2816,,
15741259831,1215.89448,17145922025,1227595334,17145919204,-2821,,
15741310109,1215.94476,17145972307,1227645609,17145969480,-2827,,
15741360784,1215.99543,17146022984,1227696282,17146020153,-2831,,
15741411290,1216.04594,17146073492,1227746785,17146070655,-2837,,
15741461440,1216.09609,17146123645,1227796933,17146120803,-2842,,
15741512467,1216.14711,17146174674,1227847957,17146171828,-2846,,
15741562516,1216.19716,17146224725,1227898003,17146221874,-2851,,
15741616481,1216.25113,17146278693,1227951966,17146275837,-2856,,
15741667624,1216.30227,17146329838,1228003106,17146326976,-2862,,
15741718666,1216.35331,17146380882,1228054145,17146378015,-2867,,
15741768714,1216.40336,17146430933,1228104190,17146428061,-2872,,
15741819279,1216.45393,17146481499,1228154752,17146478622,-2877,,
15741869848,1216.50450,17146532072,1228205318,17146529189,-2883,,
15741920915,1216.55556,17146583140,1228256383,17146580254,-2886,,
15741971918,1216.60657,17146634146,1228307383,17146631254,-2892,,
15742022469,1216.65712,17146684700,1228357932,17146681802,-2898,,
15742072648,1216.70730,17146734881,1228408108,17146731979,-2902,,
15742123226,1216.75787,17146785461,1228458683,17146782553,-2908,,
15742174276,1216.80892,17146836514,1228509731,17146833601,-2913,,
15742225310,1216.85996,17146887549,1228560761,17146884631,-2918,,
15742275883,1216.91053,17146938124,1228611332,17146935202,-2922,,
15742326913,1216.96156,17146989159,1228662360,17146986231,-2928,,
15742377832,1217.01248,17147040079,1228713276,17147037146,-2933,,
15742428495,1217.06314,17147090744,1228763936,17147087806,-2938,,
15742479098,1217.11375,17147141349,1228814536,17147138406,-2943,,
15742529618,1217.16427,17147191872,1228865053,17147188924,-2948,,
15742580676,1217.21532,17147242933,1228916108,17147239979,-2954,,
15742631709,1217.26636,17147293967,1228967139,17147291009,-2958,,
15742682297,1217.31695,17147344557,1229017724,17147341594,-2963,,
15742733295,1217.36794,17147395558,1229068719,17147392589,-2969,,
15742783868,1217.41852,17147446134,1229119291,17147443161,-2973,,
15742834900,1217.46955,17147497168,1229170319,17147494190,-2978,,
15742885933,1217.52058,17147548203,1229221349,17147545219,-2984,,
15742936498,1217.57115,17147598770,1229271911,17147595781,-2989,,
15742987041,1217.62169,17147649317,1229322452,17147646323,-2994,,
15743037135,1217.67178,17147699413,1229372544,17147696414,-2999,,
15743087731,1217.72238,17147750010,1229423136,17147747006,-3004,,
15743138333,1217.77298,17147800616,1229473736,17147797607,-3009,,
15743188956,1217.82360,17147851241,1229524356,17147848226,-3015,,
15743239494,1217.87414,17147901780,1229574891,17147898761,-3019,,
15743290088,1217.92474,17147952378,1229625483,17147949354,-3024,,
15743340240,1217.97489,17148002532,1229675633,17147999503,-3029,,
15743390809,1218.02546,17148053102,1229726198,17148050068,-3034,,
15743441417,1218.07606,17148103713,1229776803,17148100673,-3040,,
15743492300,1218.12695,17148154598,1229827684,17148151554,-3044,,
15743542874,1218.17752,17148205187,1229878267,17148202137,-3050,,
15743593502,1218.22815,17148255806,1229928881,17148252751,-3055,,
15743644531,1218.27918,17148306837,1229979907,17148303778,-3059,,
15743695104,1218.32975,17148357412,1230030478,17148354348,-3064,,
15743745684,1218.38033,17148407995,1230081055,17148404925,-3070,,
15743796698,1218.43135,17148459011,1230132066,17148455936,-3075,,
15743847278,1218.48193,17148509593,1230182643,17148506513,-3080,,
15743898315,1218.53296,17148560632,1230233677,17148557547,-3085,,
15743949349,1218.58400,17148611669,1230284708,17148608579,-3090,,
15744005582,1218.64023,17148667904,1230340938,17148664809,-3095,,
15744055948,1218.69060,17148718273,1230391303,17148715173,-3100,,
15744107055,1218.74170,17148769383,1230442406,17148766277,-3106,,
15744158107,1218.79275,17148820436,1230493455,17148817325,-3111,,
15744214744,1218.84939,17148877077,1230550090,17148873960,-3117,,
15744265915,1218.90056,17148928249,1230601257,17148925127,-3122,,
15744316733,1218.95138,17148979069,1230652073,17148975943,-3126,,
15744367904,1219.00255,17149030243,1230703241,17149027111,-3132,,
15744418812,1219.05346,17149081153,1230754146,17149078017,-3136,,
15744469355,1219.10400,17149131699,1230804686,17149128557,-3142,,
15744519933,1219.15458,17149182280,1230855262,17149179133,-3147,,
15744570972,1219.20562,17149233321,1230906299,17149230170,-3151,,
15744622045,1219.25669,17149284397,1230957369,17149281239,-3158,,
15744672665,1219.30731,17149335019,1231007986,17149331856,-3163,,
15744723452,1219.35810,17149385808,1231058770,17149382640,-3168,,
15744774456,1219.40910,17149436814,1231109771,17149433641,-3173,,
15744825019,1219.45967,17149487379,1231160331,17149484202,-3177,,
15744876068,1219.51072,17149538431,1231211379,17149535250,-3181,,
15744927120,1219.56177,17149589485,1231262427,17149586297,-3188,,
15744977635,1219.61228,17149640003,1231312939,17149636810,-3193,,
15745028681,1219.66333,17149691050,1231363983,17149687854,-3196,,
15745079226,1219.71387,17149741599,1231414525,17149738396,-3203,,
15745129773,1219.76442,17149792147,1231465069,17149788939,-3208,,
15745180374,1219.81502,17149842752,1231515667,17149839538,-3214,,
15745230899,1219.86555,17149893279,1231566190,17149890061,-3218,,
15745281759,1219.91641,17149944141,1231617048,17149940919,-3222,,
15745331853,1219.96650,17149994238,1231667139,17149991009,-3229,,
15745381957,1220.01661,17150044344,1231717240,17150041111,-3233,,
15745432264,1220.06691,17150094653,1231767544,17150091415,-3238,,
15745482557,1220.11721,17150144949,1231817835,17150141705,-3244,,
15745533589,1220.16824,17150195983,1231868863,17150192734,-3249,,
15745583652,1220.21830,17150246047,1231918924,17150242794,-3253,,
15745634233,1220.26888,17150296632,1231969503,17150293373,-3259,,
15745685288,1220.31994,17150347689,1232020555,17150344425,-3264,,
15745735829,1220.37048,17150398231,1232071093,17150394964,-3267,,
15745786182,1220.42083,17150448588,1232121443,17150445314,-3274,,
15745837230,1220.47188,17150499638,1232172488,17150496359,-3279,,
15745887763,1220.52241,17150550172,1232223019,17150546889,-3283,,
15745938270,1220.57292,17150600683,1232273524,17150597394,-3289,,
15745989330,1220.62398,17150651745,1232324580,17150648451,-3294,,
15746039893,1220.67454,17150702310,1232375140,17150699010,-3300,,
15746090929,1220.72558,17150753348,1232426174,17150750045,-3303,,
15746141496,1220.77614,17150803917,1232476738,17150800608,-3309,,
15746192119,1220.82677,17150854543,1232527357,17150851228,-3315,,
15746242304,1220.87695,17150904730,1232577540,17150901411,-3319,,
15746292859,1220.92751,17150955288,1232628093,17150951964,-3324,,
15746343490,1220.97814,17151005922,1232678722,17151002592,-3330,,
15746393708,1221.02836,17151056142,1232728936,17151052807,-3335,,
15746444636,1221.07928,17151107072,1232779862,17151103733,-3339,,
15746494824,1221.12947,17151157263,1232830047,17151153918,-3345,,
15746545872,1221.18052,17151208313,1232881092,17151204963,-3350,,
15746596937,1221.23158,17151259380,1232932155,17151256026,-3354,,
15746647920,1221.28257,17151310366,1232983136,17151307006,-3360,,
15746698517,1221.33317,17151360965,1233033729,17151357599,-3366,,
15746749043,1221.38369,17151411493,1233084252,17151408133,-3360,,
15746799626,1221.43427,17151462079,1233134834,17151458715,-3364,,
15746850447,1221.48510,17151512902,1233185651,17151509522,-3380,,
15746901497,1221.53615,17151563954,1233236698,17151560569,-3385,,
15746951602,1221.58625,17151614072,1233286812,17151610682,-3390,,
15747002319,1221.63697,17151664781,1233337515,17151661386,-3395,,
15747053274,1221.68792,17151715749,1233388478,17151712348,-3401,,
15747104311,1221.73896,17151766778,1233439501,17151763372,-3406,,
15747154907,1221.78956,17151817376,1233490095,17151813966,-3410,,
15747205944,1221.84059,17151868416,1233541130,17151865000,-3416,,
15747256954,1221.89160,17151919427,1233592136,17151916006,-3421,,
15747307501,1221.94215,17151969977,1233642681,17151966552,-3425,,
15747358603,1221.99325,17152021081,1233693780,17152017651,-3430,,
15747409587,1222.04424,17152072067,1233744761,17152068631,-3436,,
15747460162,1222.09481,17152122646,1233795333,17152119204,-3442,,
15747510883,1222.14553,17152173369,1233846053,17152169923,-3446,,
15747561914,1222.19656,17152224402,1233897080,17152220951,-3451,,
15747612238,1222.24689,17152274729,1233947402,17152271272,-3457,,
15747663109,1222.29776,17152325601,1233998270,17152322140,-3461,,
15747714123,1222.34877,17152376618,1234049281,17152373152,-3466,,
15747764666,1222.39931,17152427164,1234099855,17152423725,-3439,,
15747815743,1222.45039,17152478243,1234150895,17152474765,-3478,,
15747866299,1222.50095,17152528812,1234201461,17152525331,-3481,,
15747916893,1222.55154,17152579400,1234252042,17152575912,-3488,,
15747967027,1222.60167,17152629533,1234302171,17152626042,-3491,,
15748018085,1222.65273,17152680594,1234353228,17152677098,-3496,,
15748068621,1222.70327,17152731132,1234403760,17152727630,-3502,,
15748119215,1222.75386,17152781729,1234454352,17152778222,-3507,,
15748169344,1222.80399,17152831861,1234504477,17152828348,-3513,,
15748219430,1222.85408,17152881948,1234554561,17152878431,-3517,,
15748269543,1222.90419,17152932063,1234604671,17152928541,-3522,,
15748320569,1222.95522,17152983092,1234655694,17152979564,-3528,,
15748370727,1223.00537,17153033253,1234705851,17153029721,-3532,,
15748421342,1223.05599,17153083870,1234756463,17153080333,-3537,,
15748471824,1223.10647,17153134354,1234806941,17153130811,-3543,,
15748522817,1223.15747,17153185350,1234857933,17153181803,-3547,,
15748572919,1223.20757,17153235454,1234908032,17153231902,-3552,,
15748623979,1223.25863,17153286517,1234959088,17153282959,-3558,,
15748674505,1223.30915,17153337044,1235009621,17153333491,-3553,,
15748725575,1223.36022,17153388117,1235060680,17153384550,-3567,,
15748776578,1223.41123,17153439125,1235111682,17153435552,-3573,,
15748827170,1223.46182,17153489716,1235162268,17153486139,-3577,,
15748878197,1223.51284,17153540746,1235213293,17153537164,-3582,,
15748929238,1223.56389,17153591790,1235264332,17153588202,-3588,,
15748980265,1223.61491,17153642820,1235315356,17153639226,-3594,,
15749030838,1223.66549,17153693395,1235365925,17153689796,-3599,,
15749081428,1223.71608,17153743987,1235416513,17153740384,-3603,,
15749131943,1223.76659,17153794504,1235467026,17153790896,-3608,,
15749182987,1223.81764,17153845550,1235518066,17153841936,-3614,,
15749233542,1223.86819,17153896108,1235568620,17153892490,-3618,,
15749284047,1223.91870,17153946614,1235619121,17153942991,-3623,,
15749334597,1223.96925,17153997168,1235669668,17153993539,-3629,,
15749385134,1224.01978,17154047707,1235720203,17154044073,-3634,,
15749436188,1224.07084,17154098763,1235771254,17154095125,-3638,,
15749487222,1224.12187,17154149800,1235822285,17154146156,-3644,,
15749538776,1224.17342,17154201356,1235873836,17154197707,-3649,,
15749589807,1224.22446,17154252389,1235924864,17154248734,-3655,,
15749639881,1224.27453,17154302465,1235974936,17154298806,-3659,,
15749690405,1224.32505,17154352992,1236025457,17154349328,-3664,,
15749740470,1224.37512,17154403059,1236075518,17154399389,-3670,,
15749791024,1224.42567,17154453616,1236126071,17154449942,-3674,,
15749841576,1224.47622,17154504170,1236176621,17154500491,-3679,,
15749892609,1224.52726,17154555206,1236227650,17154551521,-3685,,
15749943167,1224.57782,17154605766,1236278207,17154602077,-3689,,
15749993730,1224.62838,17154656331,1236328766,17154652636,-3695,,
15750044259,1224.67891,17154706862,1236379292,17154703162,-3700,,
15750095125,1224.72977,17154757731,1236430155,17154754026,-3705,,
15750145353,1224.78000,17154807960,1236480381,17154804251,-3709,,
15750196390,1224.83104,17154859000,1236531415,17154855285,-3715,,
15750246453,1224.88110,17154909066,1236581475,17154905346,-3720,,
15750296988,1224.93164,17154959603,1236632008,17154955879,-3724,,
15750347558,1224.98221,17155010176,1236682575,17155006446,-3730,,
15750398587,1225.03324,17155061207,1236733602,17155057472,-3735,,
15750449652,1225.08430,17155112275,1236784664,17155108534,-3741,,
15750500684,1225.13533,17155163309,1236835694,17155159564,-3745,,
15750550739,1225.18539,17155213366,1236885745,17155209616,-3750,,
15750600789,1225.23544,17155263419,1236935793,17155259663,-3756,,
15750651329,1225.28598,17155313960,1236986330,17155310200,-3760,,
15750701887,1225.33653,17155364521,1237036886,17155360756,-3765,,
15750752402,1225.38705,17155415038,1237087397,17155411267,-3771,,
15750803046,1225.43769,17155465685,1237138040,17155461910,-3775,,
15750853542,1225.48819,17155516183,1237188533,17155512403,-3780,,
15750904446,1225.53909,17155567090,1237239433,17155563304,-3786,,
15750954683,1225.58933,17155617329,1237289668,17155613538,-3791,,
15751005463,1225.64011,17155668111,1237340446,17155664316,-3795,,
15751055920,1225.69057,17155718571,1237390900,17155714770,-3801,,
15751106423,1225.74107,17155769075,1237441399,17155765269,-3806,,
15751156563,1225.79121,17155819218,1237491538,17155815408,-3810,,
15751207350,1225.84200,17155870018,1237542331,17155866202,-3816,,
15751257763,1225.89241,17155920423,1237592731,17155916602,-3821,,
15751308637,1225.94329,17155971300,1237643604,17155967474,-3826,,
15751359065,1225.99371,17156021730,1237694029,17156017899,-3831,,
15751409640,1226.04429,17156072317,1237744611,17156068481,-3836,,
15751460231,1226.09488,17156122901,1237795188,17156119059,-3842,,
15751515209,1226.14986,17156177881,1237850163,17156174034,-3847,,
15751565746,1226.20039,17156228419,1237900698,17156224568,-3851,,
15751616535,1226.25118,17156279212,1237951484,17156275355,-3857,,
15751667540,1226.30219,17156330219,1238002487,17156326357,-3862,,
15751717703,1226.35235,17156380385,1238052648,17156376518,-3867,,
15751768320,1226.40297,17156431004,1238103261,17156427132,-3872,,
15751818692,1226.45334,17156481378,1238153631,17156477501,-3877,,
15751869256,1226.50390,17156531945,1238204192,17156528063,-3882,,
15751919831,1226.55448,17156582521,1238254764,17156578635,-3886,,
15751969970,1226.60462,17156632663,1238304900,17156628771,-3892,,
15752020970,1226.65562,17156683666,1238355898,17156679768,-3898,,
15752071453,1226.70610,17156734163,1238406390,17156730261,-3902,,
15752122201,1226.75685,17156784901,1238457123,17156780994,-3907,,
15752173271,1226.80792,17156835974,1238508191,17156832061,-3913,,
15752224092,1226.85874,17156886797,1238559010,17156882880,-3917,,
15752274835,1226.90948,17156937542,1238609750,17156933620,-3922,,
15752325754,1226.96040,17156988464,1238660666,17156984536,-3928,,
15752376367,1227.01102,17157039079,1238711275,17157035146,-3933,,
15752426663,1227.06131,17157089377,1238761569,17157085440,-3937,,
15752476782,1227.11143,17157139499,1238811685,17157135556,-3943,,
15752527218,1227.16187,17157189937,1238862118,17157185989,-3948,,
15752577920,1227.21257,17157240642,1238912819,17157236689,-3953,,
15752628035,1227.26268,17157290758,1238962930,17157286800,-3958,,
15752678682,1227.31333,17157341407,1239013574,17157337444,-3963,,
15752728804,1227.36345,17157391533,1239063695,17157387565,-3968,,
15752779435,1227.41408,17157442166,1239114322,17157438193,-3973,,
15752829577,1227.46422,17157492310,1239164461,17157488332,-3978,,
15752880101,1227.51475,17157542837,1239214982,17157538852,-3985,,
15752930742,1227.56539,17157593480,1239265622,17157589492,-3988,,
15752980855,1227.61550,17157643594,1239315731,17157639602,-3992,,
15753031426,1227.66607,17157694168,1239366299,17157690170,-3998,,
15753081937,1227.71658,17157744681,1239416808,17157740678,-4003,,
15753132315,1227.76696,17157795062,1239467183,17157791054,-4008,,
15753182500,1227.81715,17157845250,1239517370,17157841241,-4009,,
15753233039,1227.86769,17157895791,1239567903,17157891773,-4018,,
15753283563,1227.91821,17157946317,1239618423,17157942294,-4023,,
15753334122,1227.96877,17157996879,1239668979,17157992850,-4029,,
15753385271,1228.01992,17158048029,1239720125,17158043995,-4034,,
15753436315,1228.07096,17158099076,1239771168,17158095038,-4038,,
15753486863,1228.12151,17158149627,1239821712,17158145583,-4044,,
15753537414,1228.17206,17158200180,1239872261,17158196131,-4049,,
15753587996,1228.22264,17158250764,1239922841,17158246711,-4053,,
15753638657,1228.27330,17158301428,1239973498,17158297369,-4059,,
15753688801,1228.32345,17158351574,1240023640,17158347510,-4064,,
15753739721,1228.37437,17158402497,1240074557,17158398427,-4070,,
15753790395,1228.42504,17158453173,1240125229,17158449099,-4074,,
15753840710,1228.47536,17158503501,1240175551,17158499422,-4079,,
15753891231,1228.52588,17158554013,1240226058,17158549928,-4085,,
15753941901,1228.57655,17158604686,1240276727,17158600597,-4089,,
15753992259,1228.62691,17158655046,1240327082,17158650952,-4094,,
15754042850,1228.67750,17158705640,1240377669,17158701540,-4100,,
15754092982,1228.72763,17158755784,1240427810,17158751680,-4104,,
15754143410,1228.77806,17158806204,1240478225,17158802095,-4109,,
15754194418,1228.82907,17158857226,1240529240,17158853111,-4115,,
15754244588,1228.87924,17158907387,1240579396,17158903266,-4121,,
15754295453,1228.93010,17158958254,1240630259,17158954129,-4125,,
15754346012,1228.98066,17159008816,1240680827,17159004697,-4119,,
15754396168,1229.03082,17159058974,1240730969,17159054839,-4135,,
15754446342,1229.08099,17159109149,1240781140,17159105010,-4139,,
15754496994,1229.13164,17159159805,1240831789,17159155659,-4146,,
15754547087,1229.18173,17159209900,1240881891,17159205761,-4139,,
15754597472,1229.23212,17159260287,1240932263,17159256133,-4154,,
15754648240,1229.28289,17159311057,1240983027,17159306897,-4160,,
15754698811,1229.33346,17159361631,1241033595,17159357466,-4165,,
15754749295,1229.38394,17159412117,1241084077,17159407948,-4169,,
15754799892,1229.43454,17159462717,1241134672,17159458542,-4175,,
15754850081,1229.48473,17159512907,1241184857,17159508727,-4180,,
15754900644,1229.53529,17159563474,1241235417,17159559288,-4186,,
15754951230,1229.58588,17159614062,1241286002,17159609872,-4190,,
15755001440,1229.63609,17159664274,1241336209,17159660079,-4195,,
15755051871,1229.68652,17159714708,1241386636,17159710507,-4201,,
15755102933,1229.73758,17159765772,1241437700,17159761572,-4200,,
15755153421,1229.78807,17159816262,1241488182,17159812053,-4209,,
15755203938,1229.83859,17159866781,1241538695,17159862565,-4216,,
15755254512,1229.88916,17159917358,1241589266,17159913137,-4221,,
15755305136,1229.93978,17159967984,1241639889,17159963759,-4225,,
15755355716,1229.99036,17160018567,1241690466,17160014336,-4231,,
15755406343,1230.04099,17160069196,1241741090,17160064961,-4235,,
15755457375,1230.09202,17160120230,1241792119,17160115989,-4241,,
15755507915,1230.14256,17160170772,1241842656,17160166526,-4246,,
15755564040,1230.19869,17160226900,1241898778,17160222649,-4251,,
15755615327,1230.24997,17160278190,1241950062,17160273933,-4257,,
15755666228,1230.30088,17160329093,1242000960,17160324831,-4262,,
15755716763,1230.35141,17160379630,1242051494,17160375364,-4266,,
15755766818,1230.40147,17160429688,1242101546,17160425416,-4272,,
15755817379,1230.45203,17160480251,1242152103,17160475974,-4277,,
15755867916,1230.50256,17160530791,1242202638,17160526509,-4282,,
15755918473,1230.55312,17160581350,1242253193,17160577063,-4287,,
15755969008,1230.60366,17160631887,1242303725,17160627595,-4292,,
15756019550,1230.65420,17160682432,1242354263,17160678134,-4298,,
15756069600,1230.70425,17160732484,1242404312,17160728182,-4302,,
15756119662,1230.75431,17160782548,1242454371,17160778241,-4307,,
15756170209,1230.80486,17160833097,1242504914,17160828784,-4313,,
15756220747,1230.85540,17160883638,1242555451,17160879322,-4316,,
15756271295,1230.90594,17160934188,1242605996,17160929866,-4322,,
15756321861,1230.95651,17160984757,1242656558,17160980429,-4328,,
15756372632,1231.00728,17161035529,1242707327,17161031197,-4332,,
15756423691,1231.05834,17161086591,1242758384,17161082254,-4337,,
15756474254,1231.10890,17161137157,1242808944,17161132814,-4343,,
15756525283,1231.15993,17161188188,1242859970,17161183840,-4348,,
15756576331,1231.21098,17161239238,1242911016,17161234886,-4352,,
15756626954,1231.26160,17161289863,1242961635,17161285506,-4357,,
15756677133,1231.31178,17161340044,1243011811,17161335682,-4362,,
15756727325,1231.36197,17161390238,1243062001,17161385871,-4367,,
15756777916,1231.41256,17161440833,1243112589,17161436459,-4374,,
15756828497,1231.46314,17161491416,1243163168,17161487038,-4378,,
15756879074,1231.51372,17161541995,1243213742,17161537612,-4383,,
15756929631,1231.56428,17161592554,1243264296,17161588167,-4387,,
15756980193,1231.61484,17161643119,1243314856,17161638726,-4393,,
15757030414,1231.66506,17161693343,1243365074,17161688944,-4399,,
15757081091,1231.71574,17161744021,1243415748,17161739619,-4402,,
15757131665,1231.76631,17161794598,1243466320,17161790191,-4407,,
15757182239,1231.81689,17161845174,1243516890,17161840760,-4414,,
15757233243,1231.86789,17161896181,1243567892,17161891763,-4418,,
15757288351,1231.92300,17161951291,1243622997,17161946867,-4424,,
15757339431,1231.97408,17162002374,1243674075,17161997945,-4429,,
15757390481,1232.02513,17162053426,1243725121,17162048992,-4434,,
15757441530,1232.07618,17162104477,1243776167,17162100038,-4439,,
15757492537,1232.12719,17162155486,1243827172,17162151042,-4444,,
15757543073,1232.17772,17162206025,1243877705,17162201575,-4450,,
15757593626,1232.22827,17162256580,1243928255,17162252125,-4455,,
15757644198,1232.27885,17162307154,1243978824,17162302695,-4459,,
15757695243,1232.32989,17162358201,1244029867,17162353738,-4463,,
15757746289,1232.38094,17162409251,1244080910,17162404781,-4470,,
15757796868,1232.43152,17162459832,1244131487,17162455357,-4475,,
15757847439,1232.48209,17162510406,1244182056,17162505936,-4470,,
15757898038,1232.53269,17162561007,1244232651,17162556522,-4485,,
15757948638,1232.58329,17162611608,1244283248,17162607118,-4490,,
15757999545,1232.63419,17162662518,1244334153,17162658023,-4495,,
15758050069,1232.68472,17162713045,1244384674,17162708545,-4500,,
15758100613,1232.73526,17162763591,1244435216,17162759086,-4505,,
15758151671,1232.78632,17162814662,1244486281,17162810151,-4511,,
15758202742,1232.83739,17162865725,1244537339,17162861210,-4515,,
15758253803,1232.88845,17162916787,1244588397,17162912268,-4519,,
15758304322,1232.93897,17162967310,1244638913,17162962784,-4526,,
15758355394,1232.99004,17163018384,1244689983,17163013854,-4530,,
15758406442,1233.04109,17163069435,1244741028,17163064899,-4536,,
15758457460,1233.09211,17163120454,1244792043,17163115913,-4541,,
15758508004,1233.14265,17163171000,1244842584,17163166454,-4546,,
15758559062,1233.19371,17163222073,1244893652,17163217523,-4550,,
15758609641,1233.24429,17163272643,1244944216,17163268087,-4556,,
15758660607,1233.29525,17163323610,1244995179,17163319050,-4560,,
15758711194,1233.34584,17163374201,1245045763,17163369634,-4567,,
15758762182,1233.39683,17163425190,1245096748,17163420619,-4571,,
15758812709,1233.44736,17163475719,1245147273,17163471143,-4576,,
15758862808,1233.49746,17163525822,1245197370,17163521240,-4582,,
15758912919,1233.54757,17163575935,1245247478,17163571349,-4586,,
15758963998,1233.59865,17163627015,1245298554,17163622424,-4591,,
15759015084,1233.64973,17163678116,1245349649,17163673519,-4597,,
15759065535,1233.70018,17163728559,1245400088,17163723958,-4601,,
15759116597,1233.75124,17163779623,1245451146,17163775016,-4607,,
15759167645,1233.80229,17163830673,1245502190,17163826061,-4612,,
15759218158,1233.85281,17163881188,1245552700,17163876571,-4617,,
15759268722,1233.90337,17163931755,1245603263,17163927133,-4622,,
15759319343,1233.95399,17163982378,1245653880,17163977751,-4627,,
15759369953,1234.00460,17164032989,1245704487,17164028357,-4632,,
15759420379,1234.05503,17164083419,1245754911,17164078782,-4637,,
15759470965,1234.10561,17164134006,1245805494,17164129364,-4642,,
15759521574,1234.15622,17164184618,1245856101,17164179971,-4647,,
15759572597,1234.20725,17164235644,1245907120,17164230991,-4653,,
15759623527,1234.25817,17164286576,1245958048,17164281919,-4657,,
15759673992,1234.30864,17164337054,1246008521,17164332392,-4662,,
15759725030,1234.35968,17164388084,1246059546,17164383416,-4668,,
15759776015,1234.41066,17164439070,1246110528,17164434398,-4672,,
15759826559,1234.46121,17164489618,1246161069,17164484940,-4678,,
15759877583,1234.51223,17164540644,1246212090,17164535961,-4683,,
15759927654,1234.56230,17164590716,1246262158,17164586029,-4687,,
15759978238,1234.61289,17164641303,1246312740,17164636610,-4693,,
15760029287,1234.66394,17164692355,1246363787,17164687657,-4698,,
15760080364,1234.71501,17164743433,1246414860,17164738730,-4703,,
15760131412,1234.76606,17164794485,1246465906,17164789777,-4708,,
15760182430,1234.81708,17164845505,1246516921,17164840792,-4713,,
15760232610,1234.86726,17164895696,1246567108,17164890978,-4718,,
15760283156,1234.91780,17164946245,1246617651,17164941521,-4724,,
15760333725,1234.96837,17164996806,1246668208,17164992079,-4727,,
15760383924,1235.01857,17165047008,1246718414,17165042284,-4724,,
15760434961,1235.06961,17165098048,1246769439,17165093309,-4739,,
15760485543,1235.12019,17165148632,1246820018,17165143889,-4743,,
15760536063,1235.17071,17165199155,1246870535,17165194406,-4749,,
15760586605,1235.22125,17165249698,1246921074,17165244944,-4754,,
15760637140,1235.27179,17165300236,1246971607,17165295477,-4759,,
15760687740,1235.32239,17165350839,1247022204,17165346075,-4764,,
15760738261,1235.37291,17165401361,1247072722,17165396592,-4769,,
15760789300,1235.42395,17165452403,1247123758,17165447629,-4774,,
15760840336,1235.47498,17165503442,1247174793,17165498663,-4779,,
15760891699,1235.52635,17165554806,1247226152,17165550022,-4784,,
15760942348,1235.57700,17165605457,1247276798,17165600668,-4789,,
15760992898,1235.62755,17165656011,1247327346,17165651216,-4795,,
15761042934,1235.67758,17165706049,1247377380,17165701250,-4799,,
15761093507,1235.72816,17165756624,1247427949,17165751820,-4804,,
15761144049,1235.77870,17165807169,1247478489,17165802359,-4810,,
15761194735,1235.82938,17165857857,1247529172,17165853043,-4814,,
15761245282,1235.87993,17165908406,1247579716,17165903586,-4820,,
15761295320,1235.92997,17165958446,1247629751,17165953621,-4825,,
15761345378,1235.98003,17166008507,1247679807,17166003678,-4829,,
15761396270,1236.03092,17166059402,1247730696,17166054566,-4836,,
15761447125,1236.08177,17166110258,1247781548,17166105418,-4840,,
15761497679,1236.13233,17166160814,1247832099,17166155969,-4845,,
15761547721,1236.18237,17166210863,1247882143,17166206013,-4850,,
15761598264,1236.23291,17166261404,1247932679,17166256549,-4855,,
15761648485,1236.28313,17166311628,1247982898,17166306768,-4860,,
15761698787,1236.33344,17166361932,1248033197,17166357068,-4864,,
15761749356,1236.38400,17166412503,1248083763,17166407634,-4869,,
15761800424,1236.43507,17166463573,1248134828,17166458698,-4875,,
15761851029,1236.48568,17166514182,1248185431,17166509302,-4880,,
15761901090,1236.53574,17166564244,1248235489,17166559359,-4885,,
15761951662,1236.58631,17166614819,1248286059,17166609929,-4890,,
15762002165,1236.63681,17166665325,1248336559,17166660429,-4896,,
15762052727,1236.68737,17166715889,1248387118,17166710989,-4900,,
15762103784,1236.73843,17166766947,1248438172,17166762042,-4905,,
15762154611,1236.78926,17166817777,1248488995,17166812866,-4911,,
15762204840,1236.83949,17166868009,1248539224,17166863094,-4915,,
15762255863,1236.89051,17166919035,1248590244,17166914114,-4921,,
15762306437,1236.94108,17166969611,1248640815,17166964685,-4926,,
15762357449,1236.99210,17167020625,1248691823,17167015694,-4931,,
15762408000,1237.04265,17167071179,1248742373,17167066243,-4936,,
15762458548,1237.09320,17167121728,1248792917,17167116788,-4940,,
15762509096,1237.14374,17167172279,1248843462,17167167333,-4946,,
15762560158,1237.19481,17167223344,1248894523,17167218393,-4951,,
15762610691,1237.24534,17167273878,1248945052,17167268922,-4956,,
15762667155,1237.30180,17167330345,1249001513,17167325383,-4962,,
15762718089,1237.35274,17167381282,1249052444,17167376315,-4967,,
15762768814,1237.40346,17167432008,1249103166,17167427036,-4972,,
15762818948,1237.45360,17167482145,1249153298,17167477168,-4977,,
15762869456,1237.50410,17167532656,1249203804,17167527674,-4982,,
15762920490,1237.55514,17167583692,1249254845,17167578716,-4976,,
15762970830,1237.60548,17167634045,1249305183,17167629053,-4992,,
15763021125,1237.65577,17167684332,1249355465,17167679336,-4996,,
15763071677,1237.70633,17167734885,1249406013,17167729883,-5002,,
15763122397,1237.75705,17167785609,1249456730,17167780601,-5008,,
15763173342,1237.80799,17167836556,1249507673,17167831544,-5012,,
15763223890,1237.85854,17167887107,1249558218,17167882089,-5018,,
15763274933,1237.90958,17167938151,1249609258,17167933128,-5023,,
15763325486,1237.96013,17167988707,1249659810,17167983680,-5027,,
15763376062,1238.01071,17168039286,1249710382,17168034253,-5033,,
15763427128,1238.06178,17168090354,1249761446,17168085316,-5038,,
15763477634,1238.11228,17168140861,1249811948,17168135818,-5043,,
15763527721,1238.16237,17168190962,1249862044,17168185914,-5048,,
15763578762,1238.21341,17168241994,1249913071,17168236941,-5053,,
15763629313,1238.26396,17168292548,1249963619,17168287490,-5058,,
15763679934,1238.31458,17168343172,1250014239,17168338109,-5063,,
15763730460,1238.36511,17168393700,1250064762,17168388633,-5067,,
15763781531,1238.41618,17168444773,1250115830,17168439700,-5073,,
15763832543,1238.46719,17168495787,1250166838,17168490708,-5079,,
15763883183,1238.51783,17168546430,1250217477,17168541347,-5083,,
15763933788,1238.56844,17168597037,1250268078,17168591949,-5088,,
15763983903,1238.61855,17168647155,1250318191,17168642061,-5094,,
15764034450,1238.66910,17168697704,1250368735,17168692606,-5098,,
15764084769,1238.71942,17168748025,1250419051,17168742921,-5104,,
15764135319,1238.76997,17168798589,1250469609,17168793480,-5109,,
15764185855,1238.82050,17168849116,1250520133,17168844003,-5113,,
15764236741,1238.87139,17168900005,1250571016,17168894886,-5119,,
15764287780,1238.92243,17168951046,1250622051,17168945922,-5124,,
15764338325,1238.97297,17169001593,1250672593,17168996463,-5130,,
15764388412,1239.02306,17169051683,1250722678,17169046549,-5134,,
15764439474,1239.07412,17169102747,1250773737,17169097608,-5139,,
15764489985,1239.12463,17169153260,1250824245,17169148116,-5144,,
15764540870,1239.17552,17169204158,1250875139,17169199010,-5148,,
15764591490,1239.22614,17169254769,1250925745,17169249615,-5154,,
15764642076,1239.27672,17169305359,1250976329,17169300199,-5160,,
15764692200,1239.32685,17169355484,1251026460,17169350331,-5153,,
15764742778,1239.37743,17169406065,1251077026,17169400906,-5159,,
15764793348,1239.42800,17169456637,1251127592,17169451462,-5175,,
15764843667,1239.47832,17169506959,1251177909,17169501779,-5180,,
15764894638,1239.52929,17169557933,1251228878,17169552749,-5184,,
15764945389,1239.58004,17169608686,1251279625,17169603496,-5190,,
15764995938,1239.63059,17169659237,1251330171,17169654042,-5195,,
15765046324,1239.68097,17169709625,1251380556,17169704426,-5199,,
15765097076,1239.73172,17169760380,1251431305,17169755175,-5205,,
15765147636,1239.78228,17169810942,1251481861,17169805732,-5210,,
15765198183,1239.83283,17169861491,1251532406,17169856276,-5215,,
15765248713,1239.88336,17169912023,1251582933,17169906804,-5219,,
15765299770,1239.93442,17169963083,1251633987,17169957857,-5226,,
15765350348,1239.98500,17170013663,1251684563,17170008434,-5229,,
15765400903,1240.03555,17170064221,1251735115,17170058986,-5235,,
15765451956,1240.08660,17170115276,1251786166,17170110036,-5240,,
15765502980,1240.13763,17170166303,1251837197,17170161068,-5235,,
15765554022,1240.18867,17170217347,1251888225,17170212096,-5251,,
15765604569,1240.23922,17170267897,1251938771,17170262642,-5255,,
15765655414,1240.29006,17170318744,1251989612,17170313483,-5261,,
15765706004,1240.34065,17170369336,1252040200,17170364070,-5266,,
15765756752,1240.39140,17170420085,1252090945,17170414816,-5269,,
15765807772,1240.44242,17170471109,1252141962,17170465833,-5276,,
15765858325,1240.49297,17170521664,1252192512,17170516383,-5281,,
15765909367,1240.54401,17170572707,1252243551,17170567421,-5286,,
15765960409,1240.59506,17170623753,1252294592,17170618462,-5291,,
15766011475,1240.64612,17170674821,1252345654,17170669524,-5297,,
15766061584,1240.69623,17170724933,1252395761,17170719631,-5302,,
15766112623,1240.74727,17170775974,1252446798,17170770668,-5306,,
15766162753,1240.79740,17170826105,1252496924,17170820795,-5310,,
15766213241,1240.84789,17170876597,1252547409,17170871280,-5317,,
15766264266,1240.89891,17170927623,1252598431,17170922301,-5322,,
15766314848,1240.94950,17170978208,1252649011,17170972882,-5326,,
15766365340,1240.99999,17171028703,1252699501,17171023371,-5332,,
15766415913,1241.05056,17171079278,1252750070,17171073940,-5338,,
15766467978,1241.10263,17171131344,1252802132,17171126002,-5342,,
15766519128,1241.15378,17171182499,1252853282,17171177152,-5347,,
15766569568,1241.20422,17171232940,1252903717,17171227588,-5352,,
15766620137,1241.25479,17171283510,1252954283,17171278153,-5357,,
15766671073,1241.30572,17171334450,1253005217,17171329087,-5363,,
15766721934,1241.35658,17171385313,1253056075,17171379945,-5368,,
15766772971,1241.40762,17171436352,1253107109,17171430979,-5373,,
15766824014,1241.45866,17171487398,1253158150,17171482020,-5378,,
15766874568,1241.50922,17171537954,1253208702,17171532572,-5382,,
15766925605,1241.56025,17171588994,1253259736,17171583607,-5387,,
15766975702,1241.61035,17171639094,1253309831,17171633702,-5392,,
15767026549,1241.66120,17171689941,1253360674,17171684544,-5397,,
15767077545,1241.71219,17171740942,1253411668,17171735539,-5403,,
15767128150,1241.76280,17171791547,1253462269,17171786139,-5408,,
15767178722,1241.81337,17171842121,1253512838,17171836708,-5413,,
15767228814,1241.86346,17171892216,1253562928,17171886798,-5418,,
15767279859,1241.91451,17171943263,1253613970,17171937840,-5423,,
15767330490,1241.96514,17171993898,1253664599,17171988469,-5429,,
15767381474,1242.01612,17172044884,1253715580,17172039451,-5433,,
15767432526,1242.06717,17172095938,1253766629,17172090500,-5438,,
15767483911,1242.11856,17172147325,1253818011,17172141881,-5444,,
15767534613,1242.16926,17172198029,1253868710,17172192580,-5449,,
15767585756,1242.22040,17172249174,1253919850,17172243721,-5453,,
15767636184,1242.27083,17172299605,1253970276,17172294146,-5459,,
15767686237,1242.32089,17172349660,1254020326,17172344196,-5464,,
15767736283,1242.37093,17172399710,1254070371,17172394242,-5468,,
15767786861,1242.42151,17172450290,1254120946,17172444816,-5474,,
15767837665,1242.47231,17172501096,1254171746,17172495616,-5480,,
15767888453,1242.52310,17172551885,1254222532,17172546403,-5482,,
15767939507,1242.57416,17172602942,1254273583,17172597453,-5489,,
15767990025,1242.62467,17172653462,1254324098,17172647968,-5494,,
15768040072,1242.67472,17172703513,1254374142,17172698013,-5500,,
15768090779,1242.72543,17172754222,1254424847,17172748718,-5504,,
15768141170,1242.77582,17172804615,1254475236,17172799106,-5509,,
15768191262,1242.82591,17172854710,1254525325,17172849195,-5515,,
15768250564,1242.88521,17172914014,1254584623,17172908494,-5520,,
15768302339,1242.93699,17172965791,1254636395,17172960265,-5526,,
15768356490,1242.99114,17173019944,1254690543,17173014413,-5531,,
15768406621,1243.04127,17173070079,1254740673,17173064543,-5536,,
15768456911,1243.09156,17173120371,1254790959,17173114830,-5541,,
15768507675,1243.14232,17173171137,1254841720,17173165591,-5546,,
15768558033,1243.19268,17173221498,1254892076,17173215947,-5551,,
15768608282,1243.24293,17173271749,1254942322,17173266193,-5556,,
15768658542,1243.29319,17173322011,1254992579,17173316449,-5562,,
15768709321,1243.34397,17173372792,1255043356,17173367227,-5565,,
15768760034,1243.39468,17173423508,1255094066,17173417936,-5572,,
15768810269,1243.44492,17173473746,1255144299,17173468170,-5576,,
15768860732,1243.49538,17173524210,1255194758,17173518628,-5582,,
15768911484,1243.54613,17173574965,1255245508,17173569379,-5586,,
15768962241,1243.59689,17173625724,1255296262,17173620133,-5591,,
15769012497,1243.64714,17173675982,1255346514,17173670385,-5597,,
15769062674,1243.69732,17173726161,1255396690,17173720560,-5601,,
15769113455,1243.74810,17173776945,1255447468,17173771339,-5606,,
15769164357,1243.79901,17173827849,1255498367,17173822237,-5612,,
15769215483,1243.85013,17173878977,1255549491,17173873361,-5616,,
15769266022,1243.90067,17173929520,1255600027,17173923898,-5622,,
15769316215,1243.95086,17173979715,1255650217,17173974088,-5627,,
15769366367,1244.00102,17174029868,1255700365,17174024236,-5632,,
15769417043,1244.05169,17174080547,1255751040,17174074910,-5637,,
15769468553,1244.10320,17174132072,1255802561,17174126431,-5641,,
15769519007,1244.15366,17174182515,1255852998,17174176868,-5647,,
15769569537,1244.20419,17174233049,1255903526,17174227397,-5652,,
15769620194,1244.25484,17174283708,1255954180,17174278051,-5657,,
15769670752,1244.30540,17174334267,1256004735,17174328605,-5662,,
15769721303,1244.35595,17174384822,1256055284,17174379154,-5668,,
15769771868,1244.40652,17174435389,1256105846,17174429717,-5672,,
15769822410,1244.45706,17174485933,1256156385,17174480256,-5677,,
15769872955,1244.50760,17174536481,1256206927,17174530798,-5683,,
15769924002,1244.55865,17174587530,1256257973,17174581843,-5687,,
15769974583,1244.60923,17174638113,1256308551,17174632421,-5692,,
15770025634,1244.66028,17174689166,1256359597,17174683468,-5698,,
15770076680,1244.71133,17174740214,1256410641,17174734511,-5703,,
15770127221,1244.76187,17174790759,1256461181,17174785051,-5708,,
15770178278,1244.81293,17174841818,1256512235,17174836106,-5712,,
15770228830,1244.86348,17174892382,1256562794,17174886665,-5717,,
15770279734,1244.91438,17174943279,1256613685,17174937556,-5723,,
15770329872,1244.96452,17174993419,1256663821,17174987692,-5727,,
15770380891,1245.01554,17175044440,1256714836,17175038707,-5733,,
15770431147,1245.06579,17175094698,1256765089,17175088959,-5739,,
15770481233,1245.11588,17175144787,1256815174,17175139045,-5742,,
15770532266,1245.16691,17175195834,1256866215,17175190086,-5748,,
15770583341,1245.21799,17175246900,1256917276,17175241146,-5754,,
15770633956,1245.26860,17175297517,1256967888,17175291759,-5758,,
15770684528,1245.31918,17175348090,1257018457,17175342328,-5762,,
15770735572,1245.37022,17175399137,1257069498,17175393369,-5768,,
15770786498,1245.42115,17175450065,1257120421,17175444291,-5774,,
15770837151,1245.47180,17175500722,1257171073,17175494943,-5779,,
15770887604,1245.52225,17175551189,1257221535,17175545406,-5783,,
15770938655,1245.57330,17175602230,1257272570,17175596441,-5789,,
15770988964,1245.62361,17175652542,1257322878,17175646748,-5794,,
15771039121,1245.67377,17175702701,1257373032,17175696902,-5799,,
15771090154,1245.72480,17175753735,1257424061,17175747931,-5804,,
15771143072,1245.77772,17175806657,1257476976,17175800847,-5810,,
15771193654,1245.82830,17175857240,1257527556,17175851426,-5814,,
15771244705,1245.87935,17175908295,1257578605,17175902475,-5820,,
15771295567,1245.93022,17175959159,1257629463,17175953334,-5825,,
15771346189,1245.98084,17176009782,1257680083,17176003953,-5829,,
15771396729,1246.03138,17176060325,1257730620,17176054490,-5835,,
15771447750,1246.08240,17176111349,1257781639,17176105509,-5840,,
15771498257,1246.13290,17176161857,1257832142,17176156012,-5845,,
15771549151,1246.18380,17176212755,1257883034,17176206905,-5850,,
15771599254,1246.23390,17176262860,1257933134,17176257005,-5855,,
15771649796,1246.28444,17176313404,1257983673,17176307544,-5860,,
15771700354,1246.33500,17176363964,1258034229,17176358100,-5864,,
15771751265,1246.38591,17176414877,1258085137,17176409008,-5869,,
15771802282,1246.43693,17176465907,1258136162,17176460032,-5875,,
15771852861,1246.48751,17176516479,1258186727,17176510598,-5881,,
15771903413,1246.53806,17176567033,1258237278,17176561148,-5885,,
15771953658,1246.58831,17176617281,1258287519,17176611389,-5892,,
15772004190,1246.63884,17176667815,1258338059,17176661929,-5886,,
15772054975,1246.68962,17176718602,1258388831,17176712702,-5900,,
15772105999,1246.74065,17176769639,1258439863,17176763734,-5905,,
15772157073,1246.79172,17176820705,1258490923,17176814794,-5911,,
15772207622,1246.84227,17176871267,1258541481,17176865352,-5915,,
15772258655,1246.89330,17176922292,1258592500,17176916371,-5921,,
15772309723,1246.94437,17176973362,1258643566,17176967436,-5926,,
15772360325,1246.99497,17177023966,1258694164,17177018035,-5931,,
15772410897,1247.04554,17177074541,1258744735,17177068605,-5936,,
15772461897,1247.09655,17177125543,1258795732,17177119602,-5941,,
15772512525,1247.14717,17177176173,1258846356,17177170227,-5946,,
15772563569,1247.19822,17177227220,1258897398,17177221268,-5952,,
15772614599,1247.24925,17177278252,1258948425,17177272296,-5956,,
15772665143,1247.29979,17177328798,1258998966,17177322836,-5962,,
15772715676,1247.35032,17177379333,1259049496,17177373366,-5967,,
15772766260,1247.40091,17177429919,1259100078,17177423948,-5971,,
15772816361,1247.45101,17177480024,1259150176,17177474047,-5977,,
15772867390,1247.50204,17177531055,1259201202,17177525073,-5982,,
15772919088,1247.55374,17177582755,1259252897,17177576768,-5987,,
15772969525,1247.60417,17177633195,1259303332,17177627203,-5992,,
15773020573,1247.65522,17177684245,1259354378,17177678249,-5996,,
15773071076,1247.70572,17177734750,1259404878,17177728749,-6001,,
15773121141,1247.75579,17177784817,1259454940,17177778810,-6007,,
15773172192,1247.80684,17177835871,1259505988,17177829859,-6012,,
15773223232,1247.85788,17177886914,1259557026,17177880896,-6018,,
15773273785,1247.90843,17177937469,1259607575,17177931446,-6023,,
15773325346,1247.95999,17177989032,1259659134,17177983005,-6027,,
15773375861,1248.01051,17178039550,1259709646,17178033517,-6033,,
15773426425,1248.06107,17178090115,1259760207,17178084077,-6038,,
15773476958,1248.11161,17178140650,1259810738,17178134608,-6042,,
15773527523,1248.16217,17178191219,1259861300,17178185170,-6049,,
15773578627,1248.21328,17178242340,1259912417,17178236287,-6053,,
15773629651,1248.26430,17178293350,1259963422,17178287292,-6058,,
15773680165,1248.31481,17178343867,1260013934,17178337804,-6063,,
15773730831,1248.36548,17178394536,1260064597,17178388468,-6068,,
15773781754,1248.41640,17178445463,1260115518,17178439389,-6074,,
15773831823,1248.46647,17178495533,1260165584,17178489455,-6078,,
15773882864,1248.51751,17178546576,1260216622,17178540493,-6083,,
15773933428,1248.56808,17178597143,1260267183,17178591053,-6090,,
15773984461,1248.61911,17178648178,1260318213,17178642084,-6094,,
15774035505,1248.67015,17178699224,1260369256,17178693126,-6098,,
15774086541,1248.72119,17178750263,1260420289,17178744159,-6104,,
15774136611,1248.77126,17178800335,1260470355,17178794226,-6109,,
15774187658,1248.82231,17178851383,1260521399,17178845269,-6114,,
15774238712,1248.87336,17178902441,1260572451,17178896322,-6119,,
15774289240,1248.92389,17178952971,1260622977,17178946848,-6123,,
15774339791,1248.97444,17179003525,1260673525,17178997396,-6129,,
15774390782,1249.02543,17179054518,1260724514,17179048384,-6134,,
15774440870,1249.07552,17179104608,1260774599,17179098469,-6139,,
15774491409,1249.12606,17179155150,1260825135,17179149005,-6145,,
15774542322,1249.17697,17179206066,1260876046,17179199917,-6149,,
15774593369,1249.22802,17179257113,1260927089,17179250959,-6154,,
15774644013,1249.27866,17179307760,1260977730,17179301600,-6160,,
15774694954,1249.32960,17179358703,1261028668,17179352538,-6165,,
15774745884,1249.38053,17179409636,1261079596,17179403467,-6169,,
15774796585,1249.43123,17179460339,1261130294,17179454164,-6175,,
15774847644,1249.48229,17179511401,1261181351,17179505221,-6180,,
15774898741,1249.53339,17179562499,1261232444,17179556314,-6185,,
15774949728,1249.58438,17179613489,1261283429,17179607299,-6190,,
15775000776,1249.63542,17179664540,1261334474,17179658345,-6195,,
15775051836,1249.68648,17179715602,1261385531,17179709402,-6200,,
15775102892,1249.73754,17179766662,1261436586,17179760457,-6205,,
15775153910,1249.78856,17179817681,1261487600,17179811471,-6210,,
15775204832,1249.83948,17179868606,1261538519,17179862390,-6216,,
15775255649,1249.89030,17179919424,1261589333,17179913203,-6221,,
15775306173,1249.94082,17179969950,1261639855,17179963725,-6225,,
15775356710,1249.99136,17180020490,1261690389,17180014259,-6231,,
15775407005,1250.04165,17180070788,1261740681,17180064552,-6236,,
15775457554,1250.09220,17180121338,1261791228,17180115098,-6240,,
15775509045,1250.14369,17180172833,1261842716,17180166586,-6247,,
15775559803,1250.19445,17180223593,1261893471,17180217342,-6251,,
15775610735,1250.24538,17180274528,1261944401,17180268271,-6257,,
15775661762,1250.29641,17180325556,1261995425,17180319295,-6261,,
15775712832,1250.34748,17180376628,1262046492,17180370362,-6266,,
15775763855,1250.39850,17180427655,1262097512,17180421383,-6272,,
15775815956,1250.45060,17180479758,1262149610,17180473481,-6277,,
15775866639,1250.50129,17180530442,1262200291,17180524161,-6281,,
15775917189,1250.55184,17180580996,1262250838,17180574709,-6287,,
15775968149,1250.60280,17180631958,1262301795,17180625666,-6292,,
15776019159,1250.65381,17180682970,1262352803,17180676673,-6297,,
15776069731,1250.70438,17180733544,1262403372,17180727243,-6301,,
15776120501,1250.75515,17180784317,1262454139,17180778010,-6307,,
15776175577,1250.81022,17180839395,1262509212,17180833082,-6313,,
15776226570,1250.86122,17180890390,1262560202,17180884072,-6318,,
15776276632,1250.91128,17180940455,1262610261,17180934132,-6323,,
15776327669,1250.96232,17180991495,1262661297,17180985167,-6328,,
15776378216,1251.01286,17181042044,1262711840,17181035711,-6333,,
15776428404,1251.06305,17181092234,1262762026,17181085896,-6338,,
15776479073,1251.11372,17181142906,1262812693,17181136563,-6343,,
15776530106,1251.16475,17181193940,1262863721,17181187592,-6348,,
15776580530,1251.21518,17181244367,1262914143,17181238013,-6354,,
15776631186,1251.26583,17181295025,1262964796,17181288667,-6358,,
15776682462,1251.31711,17181346304,1263016071,17181339941,-6363,,
15776733258,1251.36791,17181397102,1263066863,17181390734,-6368,,
15776784027,1251.41867,17181447874,1263117631,17181441501,-6373,,
15776834267,1251.46891,17181498115,1263167867,17181491737,-6378,,
15776884426,1251.51907,17181548277,1263218023,17181541893,-6384,,
15776934544,1251.56919,17181598398,1263268180,17181592052,-6346,,
15776985216,1251.61986,17181649071,1263318808,17181642679,-6392,,
15777035510,1251.67016,17181699368,1263369099,17181692969,-6399,,
15777085945,1251.72059,17181749805,1263419531,17181743401,-6404,,
15777136513,1251.77116,17181800377,1263470098,17181793968,-6409,,
15777187043,1251.82169,17181850908,1263520624,17181844494,-6414,,
15777237096,1251.87174,17181900964,1263570674,17181894545,-6419,,
15777288131,1251.92278,17181952002,1263621707,17181945578,-6424,,
15777338193,1251.97284,17182002066,1263671767,17181995637,-6429,,
15777388743,1252.02339,17182052618,1263722314,17182046184,-6434,,
15777439284,1252.07393,17182103162,1263772853,17182096723,-6439,,
15777489826,1252.12447,17182153706,1263823392,17182147262,-6444,,
15777540366,1252.17501,17182204248,1263873928,17182197798,-6450,,
15777590933,1252.22558,17182254818,1263924493,17182248363,-6455,,
15777641974,1252.27662,17182305860,1263975531,17182299401,-6459,,
15777693015,1252.32766,17182356904,1264026569,17182350440,-6464,,
15777743070,1252.37772,17182406961,1264076621,17182400491,-6470,,
15777794116,1252.42876,17182458010,1264127666,17182451536,-6474,,
15777844680,1252.47933,17182508576,1264178226,17182502097,-6479,,
15777895721,1252.53037,17182559619,1264229264,17182553134,-6485,,
15777946769,1252.58142,17182610670,1264280309,17182604180,-6490,,
15777997818,1252.63247,17182661722,1264331356,17182655227,-6495,,
15778048876,1252.68352,17182712782,1264382412,17182706282,-6500,,
15778099916,1252.73456,17182763824,1264433449,17182757319,-6505,,
15778149970,1252.78462,17182813881,1264483500,17182807371,-6510,,
15778201014,1252.83566,17182864926,1264534541,17182858411,-6515,,
15778251780,1252.88643,17182915695,1264585305,17182909175,-6520,,
15778302052,1252.93670,17182965970,1264635573,17182959444,-6526,,
15778354997,1252.98965,17183018916,1264688516,17183012386,-6530,,
15778405676,1253.04032,17183069599,1264739193,17183063063,-6536,,
15778457593,1253.09224,17183121518,1264791106,17183114976,-6542,,
15778508280,1253.14293,17183172206,1264841790,17183165660,-6546,,
15778561405,1253.19605,17183225334,1264894913,17183218783,-6551,,
15778612352,1253.24700,17183276284,1264945857,17183269728,-6556,,
15778662885,1253.29753,17183326818,1264996387,17183320258,-6560,,
15778713949,1253.34860,17183377885,1265047448,17183371318,-6567,,
15778768075,1253.40272,17183432015,1265101572,17183425443,-6572,,
15778819046,1253.45369,17183482988,1265152541,17183476411,-6577,,
15778872044,1253.50669,17183535988,1265205535,17183529406,-6582,,
15778924993,1253.55964,17183588939,1265258481,17183582351,-6588,,
15778975731,1253.61038,17183639679,1265309216,17183633086,-6593,,
15779026227,1253.66088,17183690178,1265359710,17183683581,-6597,,
15779076811,1253.71146,17183740764,1265410291,17183734161,-6603,,
15779127837,1253.76248,17183791792,1265461314,17183785184,-6608,,
15779178897,1253.81354,17183842855,1265512371,17183836242,-6613,,
15779229546,1253.86419,17183893506,1265563018,17183886888,-6618,,
15779280528,1253.91518,17183944491,1265613997,17183937868,-6623,,
15779331579,1253.96623,17183995545,1265665045,17183988915,-6630,,
15779382611,1254.01726,17184046579,1265716075,17184039946,-6633,,
15779433659,1254.06831,17184097628,1265767119,17184090990,-6638,,
15779484705,1254.11935,17184148677,1265818163,17184142033,-6644,,
15779535233,1254.16988,17184199208,1265868689,17184192559,-6649,,
15779585787,1254.22043,17184249764,1265919240,17184243111,-6653,,
15779636836,1254.27148,17184300815,1265970285,17184294156,-6659,,
15779687862,1254.32251,17184351843,1266021309,17184345179,-6664,,
15779737912,1254.37256,17184401896,1266071357,17184395228,-6668,,
15779787967,1254.42261,17184451953,1266121409,17184445279,-6674,,
15779838497,1254.47314,17184502486,1266171937,17184495807,-6679,,
15779889542,1254.52419,17184553533,1266222978,17184546848,-6685,,
15779940867,1254.57551,17184604861,1266274302,17184598172,-6689,,
15779991631,1254.62628,17184655626,1266325062,17184648932,-6694,,
15780041680,1254.67633,17184705678,1266375107,17184698978,-6700,,
15780092183,1254.72683,17184756184,1266425609,17184749480,-6704,,
15780142434,1254.77708,17184806437,1266475857,17184799727,-6710,,
15780192968,1254.82762,17184856973,1266526388,17184850258,-6715,,
15780243275,1254.87792,17184907284,1266576694,17184900583,-6701,,
15780293666,1254.92831,17184957676,1266627081,17184950952,-6724,,
15780344171,1254.97882,17185008184,1266677583,17185001454,-6730,,
15780394503,1255.02915,17185058518,1266727912,17185051783,-6735,,
15780445036,1255.07968,17185109052,1266778443,17185102314,-6738,,
15780495487,1255.13014,17185159506,1266828890,17185152761,-6745,,
15780545884,1255.18053,17185209905,1266879285,17185203155,-6750,,
15780596532,1255.23118,17185260555,1266929931,17185253801,-6754,,
15780647245,1255.28189,17185311272,1266980641,17185304512,-6760,,
15780697561,1255.33221,17185361589,1267030954,17185354824,-6765,,
15780747887,1255.38253,17185411917,1267081278,17185405148,-6769,,
15780798266,1255.43291,17185462300,1267131655,17185455525,-6775,,
15780848813,1255.48346,17185512849,1267182198,17185506069,-6780,,
15780899105,1255.53375,17185563143,1267232488,17185556358,-6785,,
15780949801,1255.58445,17185613841,1267283181,17185607051,-6790,,
15781000400,1255.63505,17185664442,1267333776,17185657647,-6795,,
15781051260,1255.68591,17185715305,1267384634,17185708504,-6801,,
15781101965,1255.73661,17185766013,1267435338,17185759208,-6805,,
15781152434,1255.78708,17185816484,1267485803,17185809673,-6811,,
15781202869,1255.83752,17185866922,1267536235,17185860106,-6816,,
15781253581,1255.88823,17185917635,1267586944,17185910814,-6821,,
15781304270,1255.93892,17185968327,1267637632,17185961502,-6825,,
15781354999,1255.98965,17186019058,1267688357,17186012227,-6831,,
15781405962,1256.04061,17186070024,1267739317,17186063188,-6836,,
15781456474,1256.09112,17186120538,1267789827,17186113698,-6840,,
15781507497,1256.14215,17186171564,1267840847,17186164718,-6846,,
15781557939,1256.19259,17186222007,1267891286,17186215156,-6851,,
15781608956,1256.24360,17186273026,1267942300,17186266170,-6856,,
15781659179,1256.29383,17186323252,1267992521,17186316391,-6861,,
15781709906,1256.34455,17186373982,1268043245,17186367116,-6866,,
15781760256,1256.39490,17186424334,1268093592,17186417462,-6872,,
15781810429,1256.44508,17186474510,1268143764,17186467634,-6876,,
15781861129,1256.49578,17186525211,1268194460,17186518330,-6881,,
15781912186,1256.54683,17186576272,1268245515,17186569385,-6887,,
15781962543,1256.59719,17186626630,1268295869,17186619739,-6891,,
15782013249,1256.64790,17186677339,1268346572,17186670443,-6896,,
15782063843,1256.69849,17186727936,1268397163,17186721034,-6902,,
15782114885,1256.74953,17186778980,1268448202,17186772073,-6907,,
15782165205,1256.79985,17186829302,1268498520,17186822391,-6911,,
15782216491,1256.85114,17186880590,1268549803,17186873673,-6917,,
15782266624,1256.90127,17186930726,1268599933,17186923804,-6922,,
15782317331,1256.95198,17186981435,1268650638,17186974509,-6926,,
15782367647,1257.00230,17187031753,1268700951,17187024821,-6932,,
15782418650,1257.05330,17187082759,1268751952,17187075822,-6937,,
15782469180,1257.10383,17187133291,1268802478,17187126349,-6942,,
15782519909,1257.15456,17187184023,1268853205,17187177076,-6947,,
15782570230,1257.20488,17187234346,1268903524,17187227394,-6952,,
15782620683,1257.25533,17187284801,1268953973,17187277843,-6958,,
15782671129,1257.30578,17187335249,1269004417,17187328287,-6962,,
15782721749,1257.35640,17187385872,1269055035,17187378905,-6967,,
15782772512,1257.40716,17187436638,1269105794,17187429664,-6974,,
15782823242,1257.45789,17187487369,1269156521,17187480391,-6978,,
15782873680,1257.50833,17187537809,1269206957,17187530828,-6981,,
15782924051,1257.55870,17187588183,1269257325,17187581196,-6987,,
15782974455,1257.60910,17187638590,1269307726,17187631597,-6993,,
15783024662,1257.65931,17187688799,1269357931,17187681801,-6998,,
15783075412,1257.71006,17187739552,1269408678,17187732549,-7003,,
15783125787,1257.76043,17187789930,1269459052,17187782923,-7007,,
15783176832,1257.81148,17187840976,1269510093,17187833964,-7012,,
15783227466,1257.86211,17187891612,1269560724,17187884594,-7018,,
15783277871,1257.91252,17187942019,1269611126,17187934997,-7022,,
15783327984,1257.96263,17187992134,1269661236,17187985106,-7028,,
15783378283,1258.01293,17188042436,1269711533,17188035403,-7033,,
15783429068,1258.06372,17188093223,1269762315,17188086185,-7038,,
15783479611,1258.11426,17188143769,1269812866,17188136737,-7032,,
15783530271,1258.16492,17188194431,1269863513,17188187383,-7048,,
15783580997,1258.21564,17188245160,1269914236,17188238107,-7053,,
15783631770,1258.26642,17188295936,1269965006,17188288876,-7060,,
15783682194,1258.31684,17188346362,1270015428,17188339299,-7063,,
15783732785,1258.36743,17188396954,1270066016,17188389886,-7068,,
15783782868,1258.41752,17188447040,1270116096,17188439966,-7074,,
15783833418,1258.46807,17188497593,1270166644,17188490514,-7079,,
15783883619,1258.51827,17188547795,1270216842,17188540712,-7083,,
15783934365,1258.56901,17188598545,1270267585,17188591456,-7089,,
15783984968,1258.61962,17188649149,1270318185,17188642055,-7094,,
15784035486,1258.67013,17188699669,1270368700,17188692571,-7098,,
15784085747,1258.72040,17188749934,1270418959,17188742830,-7104,,
15784136132,1258.77078,17188800320,1270469341,17188793211,-7109,,
15784186660,1258.82131,17188850850,1270519867,17188843738,-7112,,
15784237298,1258.87195,17188901491,1270570502,17188894372,-7119,,
15784287874,1258.92252,17188952070,1270621076,17188944946,-7124,,
15784338101,1258.97275,17189002298,1270671299,17188995169,-7129,,
15784388215,1259.02286,17189052416,1270721412,17189045282,-7134,,
15784438963,1259.07361,17189103166,1270772156,17189096027,-7139,,
15784489145,1259.12379,17189153350,1270822335,17189146206,-7144,,
15784539888,1259.17454,17189204095,1270873076,17189196951,-7144,,
15784590236,1259.22488,17189254445,1270923421,17189247291,-7154,,
15784640633,1259.27528,17189304844,1270973815,17189297685,-7159,,
15784690903,1259.32555,17189355118,1271024083,17189347953,-7165,,
15784741724,1259.37637,17189405940,1271074901,17189398771,-7169,,
15784792331,1259.42698,17189456549,1271125505,17189449375,-7174,,
15784843209,1259.47786,17189507430,1271176380,17189500251,-7179,,
15784893356,1259.52800,17189557580,1271226525,17189550396,-7184,,
15784944014,1259.57866,17189608240,1271277180,17189601050,-7190,,
15784994163,1259.62881,17189658392,1271327327,17189651197,-7195,,
15785044454,1259.67910,17189708685,1271377616,17189701486,-7199,,
15785094861,1259.72951,17189759095,1271428020,17189751890,-7205,,
15785144980,1259.77963,17189809216,1271478136,17189802006,-7210,,
15785195780,1259.83043,17189860017,1271528933,17189852803,-7214,,
15785246337,1259.88099,17189910577,1271579487,17189903357,-7220,,
15785296492,1259.93114,17189960734,1271629638,17189953509,-7225,,
15785346838,1259.98149,17190011083,1271679982,17190003853,-7230,,
15785397269,1260.03192,17190061517,1271730411,17190054282,-7235,,
15785447701,1260.08235,17190111950,1271780840,17190104710,-7240,,
15785498429,1260.13308,17190162680,1271831565,17190155436,-7244,,
15785548896,1260.18354,17190213150,1271882029,17190205900,-7250,,
15785599158,1260.23381,17190263414,1271932289,17190256160,-7254,,
15785649557,1260.28420,17190313816,1271982685,17190306556,-7260,,
15785699826,1260.33447,17190364087,1272032952,17190356823,-7264,,
15785750094,1260.38474,17190414357,1272083217,17190407087,-7270,,
15785800706,1260.43535,17190464972,1272133827,17190457697,-7275,,
15785850803,1260.48545,17190515071,1272183921,17190507791,-7280,,
15785901833,1260.53648,17190566103,1272234947,17190558818,-7285,,
15785952399,1260.58705,17190616672,1272285512,17190609382,-7290,,
15786003480,1260.63813,17190667756,1272336589,17190660460,-7296,,
15786054473,1260.68912,17190718751,1272387581,17190711451,-7300,,
15786105543,1260.74019,17190769824,1272438647,17190762518,-7306,,
15786156590,1260.79124,17190820873,1272489691,17190813562,-7311,,
15786207111,1260.84176,17190871395,1272540209,17190864079,-7316,,
15786257671,1260.89232,17190921959,1272590768,17190914638,-7321,,
15786308272,1260.94292,17190972562,1272641366,17190965236,-7326,,
15786359362,1260.99401,17191023653,1272692452,17191016323,-7330,,
15786410398,1261.04505,17191074693,1272743487,17191067357,-7336,,
15786460499,1261.09515,17191124796,1272793584,17191117455,-7341,,
15786510679,1261.14533,17191174979,1272843762,17191167633,-7346,,
15786561634,1261.19628,17191225936,1272894713,17191218584,-7352,,
15786612683,1261.24733,17191276986,1272945760,17191269630,-7356,,
15786663731,1261.29838,17191328038,1272996806,17191320676,-7362,,
15786714253,1261.34890,17191378562,1273047324,17191371195,-7367,,
15786765282,1261.39993,17191429593,1273098352,17191422222,-7371,,
15786815817,1261.45046,17191480131,1273148884,17191472754,-7377,,
15786865892,1261.50054,17191530208,1273198955,17191522826,-7382,,
15786916933,1261.55158,17191581251,1273249993,17191573864,-7387,,
15786968022,1261.60267,17191632343,1273301080,17191624950,-7393,,
15787019045,1261.65369,17191683368,1273352100,17191675971,-7397,,
15787069586,1261.70423,17191733910,1273402638,17191726508,-7402,,
15787119683,1261.75433,17191784011,1273452734,17191776604,-7407,,
15787170740,1261.80539,17191835070,1273503788,17191827658,-7412,,
15787221769,1261.85642,17191886101,1273554814,17191878684,-7417,,
15787272340,1261.90699,17191936675,1273605382,17191929253,-7422,,
15787322433,1261.95708,17191986769,1273655472,17191979343,-7426,,
15787373017,1262.00767,17192037357,1273706054,17192029924,-7433,,
15787423608,1262.05826,17192087950,1273756641,17192080512,-7438,,
15787474188,1262.10884,17192138532,1273807220,17192131090,-7442,,
15787524739,1262.15939,17192189086,1273857767,17192181638,-7448,,
15787575296,1262.20994,17192239645,1273908321,17192232192,-7453,,
15787626324,1262.26097,17192290686,1273959359,17192283229,-7457,,
15787677383,1262.31203,17192341736,1274010403,17192334274,-7462,,
15787727748,1262.36240,17192392103,1274060765,17192384635,-7468,,
15787778795,1262.41344,17192443153,1274111810,17192435680,-7473,,
15787829354,1262.46400,17192493715,1274162367,17192486237,-7478,,
15787880415,1262.51506,17192544778,1274213425,17192537295,-7483,,
15787931463,1262.56611,17192595828,1274264470,17192588340,-7488,,
15787982506,1262.61715,17192646874,1274315510,17192639380,-7494,,
15788033561,1262.66821,17192697931,1274366563,17192690433,-7498,,
15788084650,1262.71930,17192749023,1274417649,17192741520,-7503,,
15788135417,1262.77006,17192799791,1274468412,17192792282,-7509,,
15788186478,1262.82113,17192850855,1274519471,17192843342,-7513,,
15788236990,1262.87164,17192901370,1274569980,17192893851,-7519,,
15788287529,1262.92218,17192951911,1274620516,17192944387,-7524,,
15788337676,1262.97232,17193002060,1274670660,17192994530,-7530,,
15788388376,1263.02302,17193052763,1274721358,17193045229,-7534,,
15788438888,1263.07354,17193103277,1274771868,17193095738,-7539,,
15788489527,1263.12417,17193153917,1274822503,17193146373,-7544,,
15788540041,1263.17469,17193204434,1274873015,17193196886,-7548,,
15788590589,1263.22524,17193254984,1274923560,17193247430,-7554,,
15788641534,1263.27618,17193305932,1274974502,17193298373,-7559,,
15788691610,1263.32626,17193356021,1275024587,17193348457,-7564,,
15788742644,1263.37729,17193407047,1275075607,17193399478,-7569,,
15788793193,1263.42784,17193457599,1275126153,17193450024,-7575,,
15788844227,1263.47888,17193508635,1275177184,17193501055,-7580,,
15788894821,1263.52947,17193559231,1275227776,17193551647,-7584,,
15788945346,1263.57999,17193609759,1275278299,17193602169,-7590,,
15788996373,1263.63102,17193660788,1275329323,17193653193,-7595,,
15789046957,1263.68160,17193711374,1275379905,17193703775,-7599,,
15789098016,1263.73266,17193762436,1275430960,17193754830,-7606,,
15789149023,1263.78367,17193813444,1275481964,17193805834,-7610,,
15789199423,1263.83407,17193863846,1275532361,17193856231,-7615,,
15789250007,1263.88466,17193914434,1275582944,17193906814,-7620,,
15789300063,1263.93471,17193964492,1275632996,17193956867,-7625,,
15789350615,1263.98526,17194015046,1275683545,17194007416,-7630,,
15789400701,1264.03535,17194065134,1275733629,17194057500,-7634,,
15789451736,1264.08638,17194116172,1275784661,17194108532,-7640,,
15789502306,1264.13695,17194166745,1275835229,17194159100,-7645,,
15789552424,1264.18707,17194216864,1275885343,17194209214,-7650,,
15789603449,1264.23810,17194267892,1275936366,17194260237,-7655,,
15789654017,1264.28867,17194318464,1275986932,17194310803,-7661,,
15789705045,1264.33969,17194369493,1276037956,17194361827,-7666,,
15789756104,1264.39075,17194420554,1276089013,17194412884,-7670,,
15789806648,1264.44130,17194471101,1276139555,17194463425,-7676,,
15789857212,1264.49186,17194521678,1276190127,17194513997,-7681,,
15789908254,1264.54290,17194572711,1276241155,17194565025,-7686,,
15789959308,1264.59396,17194623767,1276292206,17194616077,-7690,,
15790010335,1264.64498,17194674797,1276343230,17194667101,-7696,,
15790060882,1264.69553,17194725346,1276393774,17194717645,-7701,,
15790111943,1264.74659,17194776410,1276444833,17194768704,-7706,,
15790162413,1264.79706,17194826882,1276495300,17194819171,-7711,,
15790213013,1264.84766,17194877485,1276545897,17194869768,-7717,,
15790263546,1264.89819,17194928019,1276596427,17194920297,-7722,,
15790314468,1264.94912,17194978944,1276647348,17194971218,-7726,,
15790365499,1265.00015,17195029978,1276698375,17195022246,-7732,,
15790415958,1265.05061,17195080438,1276748831,17195072701,-7737,,
15790466561,1265.10121,17195131043,1276799432,17195123302,-7741,,
15790517487,1265.15214,17195181972,1276850355,17195174225,-7747,,
15790778065,1265.41271,17195442562,1277110919,17195434789,-7773,17195440936,
15790803463,1265.43811,17195467961,1277136316,17195460216,-7745,,
15790853731,1265.48838,17195518231,1277186581,17195510544,-7687,,
15790903787,1265.53843,17195568290,1277236634,17195560658,-7632,,
15790954066,1265.58871,17195618572,1277286911,17195610996,-7576,,
15791004216,1265.63886,17195668724,1277337058,17195661206,-7518,,
15791054958,1265.68961,17195719469,1277387797,17195712008,-7461,,
15791105946,1265.74059,17195770459,1277438783,17195763055,-7404,,
15791156146,1265.79079,17195820661,1277488980,17195813314,-7347,,
15791206589,1265.84124,17195871107,1277539420,17195863817,-7290,,
15791257156,1265.89180,17195921675,1277589984,17195914442,-7233,,
15791308193,1265.94284,17195972714,1277641019,17195965540,-7174,,
15791360282,1265.99493,17196024807,1277693105,17196017691,-7116,,
15791411295,1266.04594,17196075822,1277744116,17196068764,-7058,,
15791462339,1266.09699,17196126868,1277795156,17196119866,-7002,,
15791513371,1266.14802,17196177902,1277846186,17196170960,-6942,,
15791563439,1266.19809,17196227973,1277896251,17196221087,-6886,,
15791613585,1266.24823,17196278122,1277946395,17196271291,-6831,,
15791664636,1266.29928,17196329175,1277997442,17196322402,-6773,,
15791715042,1266.34969,17196379582,1278047846,17196372868,-6714,,
15791766469,1266.40112,17196431012,1278099269,17196424354,-6658,,
15791816633,1266.45128,17196481178,1278149431,17196474577,-6601,,
15791867323,1266.50197,17196531871,1278200120,17196525330,-6541,,
15791918079,1266.55273,17196582630,1278250872,17196576144,-6486,,
15791968982,1266.60363,17196633535,1278301773,17196627107,-6428,,
15792019443,1266.65409,17196683999,1278352231,17196677627,-6372,,
15792070178,1266.70483,17196734735,1278402963,17196728422,-6313,,
15792124083,1266.75873,17196788643,1278456866,17196782390,-6253,,
15792181354,1266.81600,17196845917,1278514133,17196839729,-6188,,
15792239140,1266.87379,17196903706,1278571916,17196897582,-6124,,
15792289957,1266.92460,17196954524,1278622730,17196948459,-6065,,
15792340389,1266.97504,17197004958,1278673159,17196998949,-6009,,
15792390673,1267.02532,17197055245,1278723441,17197049293,-5952,,
15792441243,1267.07589,17197105817,1278774008,17197099923,-5894,,
15792491522,1267.12617,17197156099,1278824284,17197150260,-5839,,
15792542197,1267.17684,17197206776,1278874957,17197200995,-5781,,
15792592472,1267.22712,17197257054,1278925229,17197251330,-5724,,
15792643133,1267.27778,17197307718,1278975887,17197302051,-5667,,
15792693354,1267.32800,17197357941,1279026105,17197352330,-5611,,
15792744239,1267.37889,17197408827,1279076988,17197403275,-5552,,
15792794524,1267.42917,17197459115,1279127270,17197453619,-5496,,
15792844625,1267.47927,17197509218,1279177368,17197503778,-5440,,
15792894940,1267.52959,17197559535,1279227681,17197554153,-5382,,
15792945114,1267.57976,17197609713,1279277852,17197604386,-5327,,
15792995424,1267.63007,17197660024,1279328159,17197654755,-5269,,
15793046080,1267.68073,17197710683,1279378813,17197705472,-5211,,
15793096428,1267.73108,17197761033,1279429158,17197755878,-5155,,
15793146996,1267.78164,17197811604,1279479723,17197806506,-5098,,
15793197296,1267.83194,17197861905,1279530020,17197856864,-5041,,
15793247877,1267.88252,17197912489,1279580599,17197907505,-4984,,
15793298641,1267.93329,17197963255,1279631360,17197958330,-4925,,
15793349228,1267.98388,17198013844,1279681944,17198008975,-4869,,
15793399602,1268.03425,17198064222,1279732316,17198059410,-4812,,
15793450399,1268.08505,17198115021,1279783110,17198110266,-4755,,
15793501000,1268.13565,17198165624,1279833708,17198160925,-4699,,
15793551281,1268.18593,17198215908,1279883987,17198211266,-4642,,
15793601463,1268.23611,17198266091,1279934166,17198261507,-4584,,
15793651753,1268.28640,17198316383,1279984453,17198311856,-4527,,
15793701890,1268.33654,17198366523,1280034587,17198362052,-4471,,
15793752477,1268.38712,17198417112,1280085172,17198412699,-4413,,
15793803039,1268.43769,17198467676,1280135731,17198463320,-4356,,
15793853342,1268.48799,17198517982,1280186031,17198513682,-4300,,
15793903657,1268.53831,17198568299,1280236344,17198564057,-4242,,
15793953973,1268.58862,17198618618,1280286657,17198614432,-4186,,
15794004399,1268.63905,17198669047,1280337080,17198664918,-4129,,
15794054732,1268.68938,17198719382,1280387411,17198715309,-4073,,
15794105121,1268.73977,17198769774,1280437798,17198765758,-4016,,
15794155714,1268.79036,17198820369,1280488387,17198816411,-3958,,
15794205864,1268.84051,17198870521,1280538536,17198866620,-3901,,
15794256983,1268.89163,17198921642,1280589651,17198917799,-3843,,
15794307205,1268.94185,17198971866,1280639870,17198968079,-3787,,
15794357645,1268.99229,17199022309,1280690307,17199018579,-3730,,
15794407960,1269.04261,17199072627,1280740621,17199068955,-3672,,
15794458265,1269.09291,17199122933,1280790922,17199119317,-3616,,
15794508705,1269.14335,17199173376,1280841359,17199169817,-3559,,
15794558924,1269.19357,17199223597,1280891576,17199220094,-3503,,
15794609180,1269.24383,17199273855,1280941829,17199270409,-3446,,
15794659491,1269.29414,17199324168,1280992137,17199320779,-3389,,
15794709827,1269.34448,17199374507,1281042471,17199371175,-3332,,
15794760310,1269.39496,17199424992,1281092951,17199421717,-3275,,
15794810537,1269.44519,17199475221,1281143175,17199472003,-3218,,
15794861046,1269.49569,17199525733,1281193680,17199522571,-3162,,
15794911268,1269.54592,17199575957,1281243901,17199572854,-3103,,
15794961598,1269.59625,17199626289,1281294228,17199623243,-3046,,
15795011702,1269.64635,17199676396,1281344329,17199673404,-2992,,
15795062088,1269.69674,17199726784,1281394713,17199723850,-2934,,
15795112603,1269.74725,17199777301,1281445225,17199774424,-2877,,
15795163283,1269.79793,17199827985,1281495902,17199825165,-2820,,
15795213616,1269.84826,17199878320,1281546233,17199875557,-2763,,
15795263901,1269.89855,17199928606,1281596515,17199925900,-2706,,
15795314868,1269.94952,17199979577,1281647480,17199976928,-2649,,
15795365478,1270.00013,17200030188,1281698086,17200027596,-2592,,
15795416336,1270.05098,17200081050,1281748943,17200078516,-2534,,
15795466946,1270.10159,17200131662,1281799550,17200129185,-2477,,
15795517176,1270.15182,17200181894,1281849777,17200179474,-2420,,
15795567307,1270.20195,17200232028,1281899905,17200229664,-2364,,
15795617575,1270.25222,17200282298,1281950170,17200279991,-2307,,
15795668032,1270.30268,17200332756,1282000624,17200330506,-2250,,
15795718315,1270.35296,17200383043,1282050905,17200380850,-2193,,
15795768932,1270.40358,17200433661,1282101519,17200431526,-2135,,
15795819139,1270.45379,17200483871,1282151723,17200481742,-2129,,
15795869400,1270.50405,17200534134,1282201982,17200532000,-2134,,
15795920472,1270.55512,17200585208,1282253051,17200583070,-2138,,
15795971456,1270.60610,17200636205,1282304043,17200634062,-2143,,
15796021659,1270.65631,17200686401,1282354233,17200684251,-2150,,
15796072529,1270.70718,17200737273,1282405100,17200735118,-2155,,
15796122609,1270.75726,17200787354,1282455177,17200785195,-2159,,
15796173653,1270.80830,17200838401,1282506218,17200836236,-2165,,
15796224280,1270.85893,17200889031,1282556843,17200886862,-2169,,
15796274903,1270.90955,17200939656,1282607463,17200937482,-2174,,
15796325479,1270.96013,17200990234,1282658036,17200988054,-2180,,
15796376099,1271.01075,17201040856,1282708653,17201038671,-2185,,
15796426961,1271.06161,17201091722,1282759513,17201089531,-2191,,
15796478042,1271.11269,17201142804,1282810591,17201140610,-2194,,
15796528566,1271.16321,17201193331,1282861112,17201191131,-2200,,
15796579141,1271.21379,17201243909,1282911696,17201241715,-2194,,
15796630190,1271.26484,17201294960,1282962731,17201292750,-2210,,
15796681264,1271.31591,17201346035,1283013802,17201343820,-2215,,
15796731883,1271.36653,17201396658,1283064418,17201394437,-2221,,
15796782449,1271.41710,17201447225,1283114982,17201445000,-2225,,
15796833037,1271.46769,17201497816,1283165568,17201495586,-2230,,
15796884047,1271.51869,17201548829,1283216574,17201546593,-2236,,
15796934184,1271.56883,17201598967,1283266709,17201596727,-2240,,
15796985018,1271.61967,17201649803,1283317540,17201647558,-2245,,
15797035412,1271.67006,17201700201,1283367942,17201697961,-2240,,
15797085622,1271.72027,17201750413,1283418139,17201748157,-2256,,
15797136166,1271.77081,17201800958,1283468680,17201798698,-2260,,
15797186348,1271.82100,17201851156,1283518872,17201848890,-2266,,
15797236577,1271.87123,17201901375,1283569085,17201899104,-2271,,
15797287605,1271.92225,17201952406,1283620112,17201950130,-2276,,
15797338650,1271.97330,17202003463,1283671164,17202001182,-2281,,
15797389697,1272.02435,17202054501,1283722197,17202052216,-2285,,
15797440769,1272.07542,17202105577,1283773267,17202103285,-2292,,
15797491784,1272.12643,17202156594,1283824279,17202154298,-2296,,
15797542868,1272.17752,17202207680,1283875361,17202205379,-2301,,
15797593102,1272.22775,17202257917,1283925592,17202255621,-2296,,
15797643774,1272.27842,17202308591,1283976261,17202306280,-2311,,
15797694526,1272.32917,17202359345,1284027010,17202357029,-2316,,
15797745113,1272.37976,17202409935,1284077594,17202407613,-2322,,
15797796089,1272.43074,17202460912,1284128567,17202458586,-2326,,
15797846597,1272.48124,17202511423,1284179073,17202509091,-2332,,
15797897652,1272.53230,17202562492,1284230137,17202560156,-2336,,
15797947844,1272.58249,17202612675,1284280314,17202610333,-2342,,
15797998417,1272.63306,17202663250,1284330885,17202660904,-2346,,
15798049016,1272.68366,17202713852,1284381481,17202711511,-2341,,
15798099588,1272.73424,17202764426,1284432051,17202762069,-2357,,
15798150575,1272.78522,17202815416,1284483034,17202813053,-2363,,
15798200749,1272.83540,17202865592,1284533206,17202863225,-2367,,
15798251401,1272.88605,17202916246,1284583855,17202913874,-2372,,
15798301521,1272.93617,17202966369,1284633973,17202963991,-2378,,
15798351879,1272.98653,17203016729,1284684328,17203014347,-2382,,
15798402363,1273.03701,17203067226,1284734820,17203064839,-2387,,
15798453107,1273.08776,17203117962,1284785550,17203115569,-2393,,
15798503751,1273.13840,17203168607,1284836192,17203166210,-2397,,
15798554397,1273.18905,17203219255,1284886835,17203216853,-2402,,
15798604520,1273.23917,17203269382,1284936955,17203266974,-2408,,
15798655101,1273.28975,17203319965,1284987533,17203317551,-2414,,
15798705691,1273.34034,17203370556,1285038121,17203368139,-2417,,
15798756252,1273.39090,17203421121,1285088680,17203418698,-2423,,
15798806868,1273.44152,17203471739,1285139292,17203469310,-2429,,
15798857405,1273.49205,17203522278,1285189827,17203519845,-2433,,
15798908416,1273.54306,17203573292,1285240835,17203570865,-2427,,
15798959501,1273.59415,17203624379,1285291917,17203621936,-2443,,
15799010078,1273.64473,17203674958,1285342491,17203672510,-2448,,
15799060208,1273.69486,17203725101,1285392630,17203722649,-2452,,
15799110642,1273.74529,17203775527,1285443051,17203773069,-2458,,
15799161256,1273.79590,17203826144,1285493661,17203823680,-2464,,
15799211862,1273.84651,17203876752,1285544265,17203874284,-2468,,
15799262580,1273.89723,17203927471,1285594980,17203924999,-2472,,
15799313630,1273.94828,17203978524,1285646027,17203976046,-2478,,
15799364678,1273.99933,17204029575,1285697074,17204027092,-2483,,
15799415704,1274.05035,17204080614,1285748108,17204078126,-2488,,
15799466781,1274.10143,17204131683,1285799170,17204129189,-2494,,
15799517328,1274.15198,17204182232,1285849715,17204179733,-2499,,
15799568339,1274.20299,17204233246,1285900723,17204230742,-2504,,
15799618925,1274.25357,17204283834,1285951306,17204281325,-2509,,
15799670016,1274.30466,17204334927,1286002394,17204332413,-2514,,
15799720576,1274.35522,17204385490,1286052951,17204382970,-2520,,
15799771113,1274.40576,17204436029,1286103487,17204433505,-2524,,
15799821231,1274.45588,17204486159,1286153612,17204483631,-2528,,
15799871478,1274.50613,17204536399,1286203845,17204533863,-2536,,
15799921626,1274.55627,17204586559,1286254002,17204584020,-2539,,
15799972279,1274.60693,17204637204,1286304641,17204634660,-2544,,
15800022887,1274.65754,17204687814,1286355246,17204685264,-2550,,
15800073497,1274.70815,17204738427,1286405854,17204735872,-2555,,
15800123617,1274.75826,17204788549,1286455971,17204785990,-2559,,
15800174646,1274.80929,17204839581,1286506997,17204837015,-2566,,
15800225229,1274.85988,17204890166,1286557577,17204887595,-2571,,
15800275802,1274.91045,17204940740,1286608148,17204938166,-2574,,
15800326363,1274.96101,17204991305,1286658706,17204988725,-2580,,
15800376985,1275.01163,17205041929,1286709325,17205039344,-2585,,
15800428025,1275.06267,17205092972,1286760364,17205090382,-2590,,
15800478564,1275.11321,17205143524,1286810910,17205140929,-2595,,
15800529634,1275.16428,17205194584,1286861966,17205191984,-2600,,
15800580680,1275.21533,17205245633,1286913009,17205243027,-2606,,
15800631729,1275.26638,17205296684,1286964056,17205294074,-2610,,
15800682777,1275.31742,17205347734,1287015101,17205345119,-2615,,
15800733794,1275.36844,17205398755,1287066115,17205396133,-2622,,
15800784166,1275.41881,17205449129,1287116485,17205446515,-2614,,
15800835167,1275.46981,17205500132,1287167484,17205497502,-2630,,
15800885812,1275.52046,17205550780,1287218125,17205548144,-2636,,
15800936249,1275.57090,17205601230,1287268570,17205598588,-2642,,
15800986888,1275.62154,17205651860,1287319196,17205649214,-2646,,
15801037707,1275.67235,17205702682,1287370013,17205700031,-2651,,
15801088732,1275.72338,17205753708,1287421034,17205751064,-2644,,
15801139803,1275.77445,17205804783,1287472103,17205802122,-2661,,
15801190827,1275.82548,17205855809,1287523125,17205853143,-2666,,
15801240950,1275.87560,17205905934,1287573245,17205903263,-2671,,
15801291577,1275.92622,17205956564,1287623869,17205953887,-2677,,
15801342589,1275.97724,17206007578,1287674879,17206004897,-2681,,
15801392677,1276.02733,17206057667,1287724963,17206054981,-2686,,
15801443248,1276.07790,17206108253,1287775542,17206105561,-2692,,
15801493812,1276.12846,17206158808,1287826094,17206156112,-2696,,
15801544277,1276.17892,17206209285,1287876565,17206206584,-2701,,
15801595255,1276.22990,17206260256,1287927530,17206257548,-2708,,
15801646304,1276.28095,17206311307,1287978576,17206308594,-2713,,
15801697373,1276.33202,17206362378,1288029643,17206359661,-2717,,
15801748423,1276.38307,17206413430,1288080690,17206410708,-2722,,
15801799430,1276.43408,17206464440,1288131694,17206461712,-2728,,
15801850456,1276.48510,17206515469,1288182718,17206512737,-2732,,
15801901049,1276.53570,17206566064,1288233308,17206563327,-2737,,
15801951628,1276.58628,17206616645,1288283885,17206613903,-2742,,
15802002357,1276.63701,17206667377,1288334611,17206664629,-2748,,
15802053267,1276.68791,17206718289,1288385518,17206715537,-2752,,
15802103872,1276.73852,17206768896,1288436120,17206766149,-2747,,
15802154954,1276.78960,17206819981,1288487200,17206817218,-2763,,
15802205073,1276.83972,17206870102,1288537326,17206867345,-2757,,
15802255670,1276.89032,17206920701,1288587910,17206917928,-2773,,
15802306259,1276.94091,17206971293,1288638496,17206968515,-2778,,
15802357313,1276.99196,17207022349,1288689548,17207019566,-2783,,
15802407638,1277.04229,17207072689,1288739882,17207069901,-2788,,
15802458269,1277.09292,17207123309,1288790498,17207120516,-2793,,
15802509338,1277.14399,17207174381,1288841564,17207171582,-2799,,
15802559451,1277.19410,17207224497,1288891676,17207221694,-2803,,
15802610500,1277.24515,17207275548,1288942721,17207272740,-2808,,
15802661036,1277.29568,17207326085,1288993254,17207323272,-2813,,
15802711887,1277.34653,17207376940,1289044102,17207374121,-2819,,
15802762472,1277.39712,17207427527,1289094685,17207424703,-2824,,
15802812590,1277.44724,17207477646,1289144800,17207474829,-2817,,
15802863553,1277.49820,17207528613,1289195761,17207525779,-2834,,
15802914603,1277.54925,17207579665,1289246809,17207576827,-2838,,
15802965158,1277.59981,17207630223,1289297360,17207627379,-2844,,
15803015310,1277.64996,17207680376,1289347509,17207677527,-2849,,
15803065823,1277.70047,17207730891,1289398020,17207728038,-2853,,
15803115941,1277.75059,17207781013,1289448135,17207778154,-2859,,
15803167001,1277.80165,17207832075,1289499192,17207829211,-2864,,
15803217599,1277.85225,17207882686,1289549799,17207879817,-2869,,
15803268592,1277.90324,17207933671,1289600778,17207930796,-2875,,
15803319136,1277.95378,17207984216,1289651319,17207981337,-2879,,
15803370165,1278.00481,17208035258,1289702356,17208032375,-2883,,
15803420277,1278.05492,17208085363,1289752455,17208082484,-2879,,
15803470400,1278.10505,17208135488,1289802586,17208132604,-2884,,
15803521369,1278.15602,17208186459,1289853541,17208183560,-2899,,
15803572147,1278.20680,17208237239,1289904316,17208234334,-2905,,
15803622277,1278.25692,17208287372,1289954445,17208284463,-2909,,
15803672909,1278.30756,17208338005,1290005073,17208335091,-2914,,
15803723502,1278.35815,17208388602,1290055663,17208385681,-2921,,
15803774123,1278.40877,17208439225,1290106282,17208436300,-2925,,
15803824706,1278.45935,17208489811,1290156862,17208486880,-2931,,
15803874814,1278.50946,17208539921,1290206967,17208536986,-2935,,
15803925367,1278.56002,17208590476,1290257518,17208587537,-2939,,
15803976474,1278.61112,17208641585,1290308622,17208638640,-2945,,
15804027525,1278.66217,17208692639,1290359670,17208689689,-2950,,
15804078592,1278.71324,17208743707,1290410734,17208740752,-2955,,
15804129561,1278.76421,17208794679,1290461701,17208791719,-2960,,
15804179761,1278.81441,17208844882,1290511898,17208841917,-2965,,
15804230319,1278.86497,17208895442,1290562453,17208892472,-2970,,
15804280953,1278.91560,17208946079,1290613086,17208943104,-2975,,
15804331547,1278.96619,17208996675,1290663676,17208993695,-2980,,
15804381711,1279.01636,17209046841,1290713838,17209043857,-2984,,
15804432268,1279.06692,17209097400,1290764391,17209094409,-2991,,
15804483158,1279.11781,17209148293,1290815279,17209145297,-2996,,
15804533304,1279.16795,17209198441,1290865422,17209195441,-3000,,
15804584270,1279.21892,17209249409,1290916385,17209246403,-3006,,
15804634868,1279.26952,17209300010,1290966982,17209297000,-3010,,
15804685469,1279.32012,17209350614,1291017580,17209347598,-3016,,
15804736524,1279.37117,17209401671,1291068632,17209398650,-3021,,
15804787086,1279.42173,17209452234,1291119190,17209449208,-3026,,
15804837676,1279.47232,17209502827,1291169778,17209499796,-3031,,
15804888221,1279.52287,17209553374,1291220320,17209550338,-3036,,
15804938835,1279.57348,17209603991,1291270931,17209600949,-3042,,
15804989471,1279.62412,17209654629,1291321565,17209651583,-3046,,
15805040060,1279.67471,17209705221,1291372151,17209702170,-3051,,
15805090664,1279.72531,17209755827,1291422752,17209752771,-3056,,
15805141205,1279.77585,17209806371,1291473290,17209803309,-3062,,
15805191840,1279.82649,17209857008,1291523923,17209853942,-3066,,
15805242860,1279.87751,17209908029,1291574940,17209904968,-3061,,
15805293380,1279.92803,17209958553,1291625469,17209955487,-3066,,
15805343999,1279.97865,17210009173,1291676074,17210006092,-3081,,
15805394602,1280.02925,17210059780,1291726675,17210056693,-3087,,
15805445659,1280.08031,17210110839,1291777728,17210107747,-3092,,
15805496227,1280.13088,17210161408,1291828293,17210158311,-3097,,
15805547198,1280.18185,17210212383,1291879262,17210209281,-3102,,
15805598283,1280.23293,17210263470,1291930344,17210260362,-3108,,
15805648862,1280.28351,17210314051,1291980921,17210310939,-3112,,
15805699452,1280.33410,17210364644,1292031508,17210361527,-3117,,
15805750057,1280.38470,17210415251,1292082111,17210412129,-3122,,
15805800656,1280.43530,17210465851,1292132706,17210462724,-3127,,
15805851187,1280.48583,17210516386,1292183234,17210513253,-3133,,
15805901726,1280.53637,17210566927,1292233771,17210563789,-3138,,
15805951879,1280.58653,17210617082,1292283921,17210613940,-3142,,
15806002932,1280.63758,17210668137,1292334971,17210664989,-3148,,
15806053979,1280.68863,17210719187,1292386016,17210716034,-3153,,
15806104529,1280.73918,17210769740,1292436563,17210766581,-3159,,
15806155125,1280.78977,17210820347,1292487166,17210817184,-3163,,
15806205696,1280.84034,17210870911,1292537725,17210867744,-3167,,
15806256270,1280.89092,17210921488,1292588296,17210918315,-3173,,
15806306828,1280.94148,17210972047,1292638851,17210968870,-3177,,
15806357387,1280.99203,17211022609,1292689407,17211019426,-3183,,
15806407583,1281.04223,17211072808,1292739602,17211069620,-3188,,
15806457891,1281.09254,17211123118,1292789906,17211119925,-3193,,
15806508492,1281.14314,17211173721,1292840504,17211170523,-3198,,
15806559559,1281.19421,17211224791,1292891569,17211221588,-3203,,
15806610602,1281.24525,17211275836,1292942609,17211272628,-3208,,
15806661194,1281.29584,17211326429,1292993198,17211323216,-3213,,
15806711764,1281.34641,17211377002,1293043765,17211373783,-3219,,
15806762372,1281.39702,17211427613,1293094383,17211424401,-3212,,
15806813435,1281.44808,17211478678,1293145431,17211475450,-3228,,
15806864015,1281.49866,17211529261,1293196008,17211526027,-3234,,
15806914555,1281.54920,17211579814,1293246558,17211576577,-3237,,
15806964990,1281.59964,17211630241,1293296978,17211626997,-3244,,
15807015916,1281.65056,17211681169,1293347901,17211677920,-3249,,
15807066339,1281.70099,17211731594,1293398322,17211728352,-3242,,
15807116945,1281.75159,17211782203,1293448926,17211778944,-3259,,
15807167555,1281.80220,17211832815,1293499533,17211829551,-3264,,
15807218146,1281.85279,17211883408,1293550120,17211880139,-3269,,
15807268264,1281.90291,17211933529,1293600236,17211930255,-3274,,
15807318859,1281.95351,17211984125,1293650828,17211980846,-3279,,
15807369897,1282.00455,17212035166,1293701864,17212031882,-3284,,
15807420956,1282.05560,17212086227,1293752920,17212082938,-3289,,
15807471843,1282.10649,17212137117,1293803816,17212133834,-3283,,
15807522395,1282.15704,17212187681,1293854364,17212184382,-3299,,
15807572548,1282.20720,17212237826,1293904503,17212234521,-3305,,
15807623003,1282.25765,17212288283,1293954956,17212284974,-3309,,
15807673635,1282.30828,17212338918,1294005586,17212335604,-3314,,
15807723773,1282.35842,17212389058,1294055720,17212385738,-3320,,
15807774847,1282.40950,17212440134,1294106792,17212436810,-3324,,
15807825865,1282.46051,17212491155,1294157818,17212487837,-3318,,
15807876011,1282.51066,17212541304,1294207950,17212537969,-3335,,
15807926508,1282.56116,17212591802,1294258444,17212588462,-3340,,
15807977231,1282.61188,17212642528,1294309165,17212639183,-3345,,
15808027652,1282.66230,17212692952,1294359583,17212689612,-3340,,
15808078589,1282.71324,17212743891,1294410517,17212740536,-3355,,
15808129203,1282.76385,17212794508,1294461129,17212791148,-3360,,
15808180241,1282.81489,17212845548,1294512175,17212842193,-3355,,
15808231315,1282.86596,17212896624,1294563236,17212893254,-3370,,
15808282363,1282.91701,17212947675,1294614280,17212944298,-3377,,
15808333413,1282.96806,17212998727,1294665328,17212995347,-3380,,
15808384435,1283.01908,17213049752,1294716347,17213046365,-3387,,
15808434986,1283.06963,17213100314,1294766905,17213096924,-3390,,
15808486042,1283.12069,17213151363,1294817949,17213147968,-3395,,
15808537108,1283.17176,17213202431,1294869012,17213199030,-3401,,
15808588155,1283.22280,17213253481,1294920057,17213250075,-3406,,
15808639215,1283.27386,17213304543,1294971114,17213301132,-3411,,
15808690223,1283.32487,17213355554,1295022120,17213352138,-3416,,
15808740813,1283.37546,17213406146,1295072707,17213402725,-3421,,
15808791830,1283.42648,17213457165,1295123720,17213453739,-3426,,
15808842485,1283.47713,17213507823,1295174372,17213504390,-3433,,
15808893087,1283.52773,17213558427,1295224972,17213554991,-3436,,
15808944162,1283.57881,17213609505,1295276045,17213606063,-3442,,
15808994710,1283.62936,17213660055,1295326590,17213656608,-3447,,
15809045758,1283.68041,17213711105,1295377635,17213707654,-3451,,
15809096807,1283.73146,17213762156,1295428681,17213758700,-3456,,
15809147857,1283.78250,17213813208,1295479728,17213809746,-3462,,
15809198905,1283.83355,17213864259,1295530774,17213860792,-3467,,
15809249926,1283.88457,17213915283,1295581793,17213911811,-3472,,
15809300526,1283.93517,17213965885,1295632389,17213962408,-3477,,
15809351149,1283.98580,17214016510,1295683010,17214013028,-3482,,
15809401826,1284.03647,17214067279,1295733774,17214063792,-3487,,
15809452436,1284.08708,17214117802,1295784291,17214114310,-3492,,
15809502999,1284.13765,17214168368,1295834852,17214164870,-3498,,
15809553641,1284.18829,17214219012,1295885500,17214215519,-3493,,
15809604191,1284.23884,17214269575,1295936049,17214266068,-3507,,
15809654794,1284.28944,17214320170,1295986639,17214316657,-3513,,
15809705875,1284.34052,17214371252,1296037716,17214367734,-3518,,
15809756461,1284.39111,17214421841,1296088300,17214418319,-3522,,
15809807061,1284.44171,17214472444,1296138897,17214468915,-3529,,
15809857681,1284.49233,17214523065,1296189514,17214519532,-3533,,
15809908293,1284.54294,17214573680,1296240124,17214570142,-3538,,
15809958846,1284.59349,17214624236,1296290675,17214620693,-3543,,
15810009956,1284.64460,17214675348,1296341782,17214671800,-3548,,
15810061035,1284.69568,17214726429,1296392857,17214722875,-3554,,
15810112063,1284.74671,17214777460,1296443884,17214773902,-3558,,
15810162651,1284.79730,17214828049,1296494468,17214824486,-3563,,
15810212833,1284.84748,17214878235,1296544647,17214874665,-3570,,
15810263374,1284.89802,17214928778,1296595186,17214925204,-3574,,
15810313983,1284.94863,17214979388,1296645792,17214975810,-3578,,
15810364154,1284.99880,17215029562,1296695960,17215025978,-3584,,
15810414720,1285.04937,17215080131,1296746523,17215076542,-3589,,
15810465362,1285.10001,17215130775,1296797163,17215127182,-3593,,
15810515979,1285.15063,17215181395,1296847778,17215177796,-3599,,
15810566613,1285.20126,17215232030,1296898408,17215228427,-3603,,
15810616771,1285.25142,17215282191,1296948564,17215278582,-3609,,
15810667357,1285.30201,17215332779,1296999147,17215329166,-3613,,
15810717890,1285.35254,17215383315,1297049677,17215379696,-3619,,
15810768047,1285.40269,17215433474,1297099831,17215429849,-3625,,
15810818673,1285.45332,17215484102,1297150454,17215480473,-3629,,
15810869721,1285.50437,17215535152,1297201500,17215531518,-3634,,
15810920236,1285.55488,17215585670,1297252013,17215582031,-3639,,
15810971271,1285.60592,17215636707,1297303045,17215633063,-3644,,
15811021419,1285.65607,17215686857,1297353190,17215683208,-3649,,
15811072331,1285.70698,17215737773,1297404100,17215734128,-3645,,
15811122654,1285.75730,17215788098,1297454420,17215784438,-3660,,
15811173093,1285.80774,17215838539,1297504857,17215834875,-3664,,
15811223242,1285.85789,17215888691,1297555002,17215885021,-3670,,
15811273780,1285.90843,17215939230,1297605549,17215935567,-3663,,
15811324407,1285.95906,17215989860,1297656162,17215986181,-3679,,
15811375048,1286.00970,17216040514,1297706811,17216036830,-3684,,
15811425950,1286.06060,17216091408,1297757700,17216087718,-3690,,
15811476313,1286.11096,17216141773,1297808061,17216138079,-3694,,
15811526750,1286.16140,17216192212,1297858494,17216188512,-3700,,
15811577767,1286.21241,17216243232,1297909509,17216239527,-3705,,
15811628379,1286.26303,17216293846,1297960118,17216290136,-3710,,
15811678773,1286.31342,17216344243,1298010509,17216340528,-3715,,
15811729410,1286.36406,17216394881,1298061143,17216391161,-3720,,
15811779976,1286.41462,17216445450,1298111706,17216441725,-3725,,
15811831052,1286.46570,17216496528,1298162780,17216492798,-3730,,
15811882100,1286.51675,17216547578,1298213825,17216543843,-3735,,
15811933125,1286.56777,17216598607,1298264848,17216594866,-3741,,
15811984164,1286.61881,17216649647,1298315883,17216645901,-3746,,
15812034251,1286.66890,17216699737,1298365968,17216695987,-3750,,
15812085264,1286.71991,17216750753,1298416978,17216746997,-3756,,
15812136325,1286.77097,17216801816,1298468046,17216798065,-3751,,
15812187397,1286.82204,17216852890,1298519107,17216849125,-3765,,
15812238445,1286.87309,17216903941,1298570151,17216900170,-3771,,
15812289033,1286.92368,17216954531,1298620736,17216950765,-3766,,
15812339831,1286.97448,17217005331,1298671531,17217001550,-3781,,
15812390884,1287.02553,17217056387,1298722583,17217052601,-3786,,
15812441672,1287.07632,17217107176,1298773367,17217103385,-3791,,
15812492720,1287.12737,17217158228,1298824412,17217154431,-3797,,
15812543766,1287.17841,17217209276,1298875455,17217205474,-3802,,
15812594257,1287.22890,17217259769,1298925944,17217255963,-3806,,
15812644865,1287.27951,17217310380,1298976549,17217306567,-3813,,
15812695948,1287.33060,17217361464,1299027629,17217357647,-3817,,
15812746459,1287.38111,17217411978,1299078138,17217408157,-3821,,
15812797022,1287.43167,17217462543,1299128697,17217458716,-3827,,
15812848093,1287.48274,17217513617,1299179766,17217509785,-3832,,
15812899154,1287.53380,17217564679,1299230824,17217560842,-3837,,
15812949985,1287.58463,17217615514,1299281653,17217611672,-3842,,
15813000505,1287.63515,17217666036,1299332170,17217662188,-3848,,
15813051552,1287.68620,17217717086,1299383214,17217713233,-3853,,
15813102640,1287.73729,17217768176,1299434300,17217764318,-3858,,
15813153287,1287.78794,17217818825,1299484944,17217814963,-3862,,
15813203849,1287.83850,17217869390,1299535504,17217865522,-3868,,
15813253974,1287.88862,17217919517,1299585625,17217915644,-3873,,
15813304120,1287.93877,17217969664,1299635769,17217965787,-3877,,
15813355147,1287.98979,17218020695,1299686793,17218016812,-3883,,
15813406215,1288.04086,17218071764,1299737858,17218067876,-3888,,
15813456878,1288.09153,17218122430,1299788520,17218118538,-3892,,
15813507491,1288.14214,17218173046,1299839129,17218169148,-3898,,
15813558114,1288.19276,17218223670,1299889749,17218219767,-3903,,
15813609162,1288.24381,17218274721,1299940795,17218270813,-3908,,
15813660211,1288.29486,17218325773,1299991841,17218321859,-3914,,
15813711235,1288.34588,17218376799,1300042862,17218372881,-3918,,
15813762129,1288.39678,17218427695,1300093752,17218423771,-3924,,
15813812715,1288.44736,17218478284,1300144337,17218474356,-3928,,
15813863347,1288.49799,17218528918,1300194966,17218524985,-3933,,
15813914361,1288.54901,17218579935,1300245977,17218575996,-3939,,
15813964915,1288.59956,17218630491,1300296529,17218626547,-3944,,
15814015970,1288.65062,17218681547,1300347581,17218677599,-3948,,
15814066546,1288.70119,17218732127,1300398154,17218728173,-3954,,
15814117595,1288.75224,17218783178,1300449200,17218779219,-3959,,
15814168643,1288.80329,17218834227,1300500246,17218830264,-3963,,
15814219252,1288.85390,17218884840,1300550852,17218880871,-3969,,
15814269811,1288.90446,17218935400,1300601407,17218931426,-3974,,
15814320400,1288.95505,17218985993,1300651994,17218982013,-3980,,
15814371087,1289.00573,17219036681,1300702679,17219032697,-3984,,
15814421693,1289.05634,17219087290,1300753283,17219083301,-3989,,
15814471874,1289.10652,17219137474,1300803460,17219133479,-3995,,
15814522887,1289.15754,17219188489,1300854472,17219184490,-3999,,
15814573947,1289.20860,17219239562,1300905539,17219235557,-4005,,
15814625008,1289.25966,17219290624,1300956596,17219286614,-4010,,
15814676075,1289.31072,17219341683,1301007650,17219337668,-4015,,
15814727123,1289.36177,17219392734,1301058696,17219388714,-4020,,
15814778172,1289.41282,17219443785,1301109742,17219439760,-4025,,
15814828687,1289.46333,17219494302,1301160254,17219490272,-4030,,
15814878789,1289.51344,17219544407,1301210354,17219540372,-4035,,
15814929870,1289.56452,17219595490,1301261432,17219591450,-4040,,
15814980919,1289.61557,17219646542,1301312478,17219642497,-4045,,
15815031533,1289.66618,17219697159,1301363090,17219693108,-4051,,
15815082180,1289.71683,17219747807,1301413734,17219743752,-4055,,
15815132776,1289.76742,17219798405,1301464327,17219794345,-4060,,
15815183778,1289.81843,17219849411,1301515326,17219845345,-4066,,
15815234350,1289.86900,17219899985,1301565895,17219895914,-4071,,
15815284990,1289.91964,17219950627,1301616533,17219946552,-4075,,
15815335888,1289.97054,17220001527,1301667427,17219997446,-4081,,
15815386437,1290.02109,17220052088,1301717984,17220048002,-4086,,
15815437524,1290.07217,17220103167,1301769059,17220099077,-4090,,
15815488120,1290.12277,17220153777,1301819663,17220149681,-4096,,
15815539152,1290.17380,17220204801,1301870681,17220200699,-4102,,
15815589824,1290.22447,17220255476,1301921351,17220251369,-4107,,
15815640392,1290.27504,17220306045,1301971916,17220301934,-4111,,
15815691393,1290.32604,17220357048,1302022914,17220352932,-4116,,
15815741889,1290.37654,17220407547,1302073407,17220403425,-4122,,
15815792956,1290.42760,17220458617,1302124472,17220454491,-4126,,
15815844005,1290.47865,17220509668,1302175518,17220505537,-4131,,
15815894560,1290.52921,17220560226,1302226070,17220556089,-4137,,
15815945581,1290.58023,17220611249,1302277088,17220607107,-4142,,
15815996614,1290.63126,17220662284,1302328119,17220658138,-4146,,
15816047202,1290.68185,17220712875,1302378705,17220708723,-4152,,
15816098252,1290.73290,17220763927,1302429752,17220759770,-4157,,
15816149300,1290.78395,17220814978,1302480798,17220810816,-4162,,
15816200346,1290.83499,17220866025,1302531840,17220861858,-4167,,
15816251395,1290.88604,17220917076,1302582886,17220912904,-4172,,
15816302214,1290.93686,17220967899,1302633702,17220963721,-4178,,
15816353298,1290.98795,17221018985,1302684784,17221014803,-4182,,
15816404344,1291.03899,17221070033,1302735827,17221065846,-4187,,
15816455410,1291.09006,17221121102,1302786891,17221116909,-4193,,
15816505996,1291.14064,17221171719,1302837502,17221167521,-4198,,
15816556624,1291.19127,17221222320,1302888110,17221218128,-4192,,
15816606829,1291.24148,17221272528,1302938302,17221268320,-4208,,
15816657879,1291.29253,17221323580,1302989348,17221319367,-4213,,
15816708922,1291.34357,17221374626,1303040389,17221370408,-4218,,
15816759491,1291.39414,17221425197,1303090965,17221420984,-4213,,
15816810486,1291.44513,17221476194,1303141957,17221471976,-4218,,
15816860661,1291.49531,17221526372,1303192119,17221522138,-4234,,
15816911825,1291.54647,17221577537,1303243281,17221573299,-4238,,
15816962241,1291.59689,17221627956,1303293695,17221623713,-4243,,
15817012299,1291.64695,17221678017,1303343749,17221673768,-4249,,
15817063322,1291.69797,17221729042,1303394770,17221724789,-4253,,
15817113404,1291.74805,17221779125,1303444849,17221774867,-4258,,
15817164029,1291.79868,17221829754,1303495472,17221825490,-4264,,
15817215118,1291.84977,17221880845,1303546558,17221876577,-4268,,
15817265236,1291.89988,17221930965,1303596673,17221926692,-4273,,
15817315385,1291.95003,17221981117,1303646829,17221976848,-4269,,
15817366451,1292.00110,17222032185,1303697883,17222027901,-4284,,
15817416909,1292.05156,17222082646,1303748338,17222078356,-4290,,
15817467934,1292.10258,17222133673,1303799361,17222129379,-4294,,
15817518526,1292.15317,17222184267,1303849949,17222179967,-4300,,
15817569066,1292.20371,17222234810,1303900488,17222230506,-4304,,
15817619626,1292.25427,17222285372,1303951044,17222281063,-4309,,
15817670675,1292.30532,17222336423,1304002090,17222332109,-4314,,
15817721218,1292.35587,17222386969,1304052630,17222382649,-4320,,
15817772266,1292.40691,17222438019,1304103676,17222433695,-4324,,
15817822876,1292.45752,17222488631,1304154283,17222484302,-4329,,
15817873328,1292.50798,17222539085,1304204732,17222534760,-4325,,
15817923955,1292.55860,17222589715,1304255357,17222585376,-4339,,
15817974469,1292.60912,17222640231,1304305868,17222635887,-4344,,
15818025022,1292.65967,17222690787,1304356419,17222686437,-4350,,
15818075555,1292.71020,17222741322,1304406958,17222736977,-4345,,
15818126149,1292.76080,17222791919,1304457541,17222787559,-4360,,
15818176665,1292.81131,17222842437,1304508054,17222838072,-4365,,
15818227711,1292.86236,17222893485,1304559096,17222889115,-4370,,
15818277759,1292.91241,17222943536,1304609142,17222939161,-4375,,
15818328808,1292.96346,17222994587,1304660188,17222990207,-4380,,
15818379357,1293.01400,17223045137,1304710734,17223040752,-4385,,
15818429451,1293.06410,17223095234,1304760837,17223090855,-4379,,
15818480038,1293.11469,17223145823,1304811410,17223141428,-4395,,
15818530531,1293.16518,17223196330,1304861912,17223191930,-4400,,
15818581561,1293.21621,17223247351,1304912927,17223242945,-4406,,
15818632187,1293.26683,17223297980,1304963551,17223293570,-4410,,
15818682722,1293.31737,17223348516,1305014083,17223344101,-4415,,
15818733316,1293.36796,17223399113,1305064674,17223394692,-4421,,
15818784364,1293.41901,17223450163,1305115720,17223445738,-4425,,
15818835412,1293.47006,17223501214,1305166765,17223496783,-4431,,
15818886473,1293.52112,17223552277,1305217822,17223547841,-4436,,
15818937084,1293.57173,17223602891,1305268431,17223598450,-4441,,
15818987668,1293.62232,17223653478,1305319013,17223649032,-4446,,
15819038740,1293.67339,17223704552,1305370083,17223700101,-4451,,
15819089755,1293.72440,17223755569,1305421094,17223751113,-4456,,
15819140753,1293.77540,17223806570,1305472090,17223802108,-4462,,
15819190902,1293.82555,17223856721,1305522237,17223852255,-4466,,
15819241264,1293.87591,17223907084,1305572595,17223902613,-4471,,
15819291812,1293.92646,17223957635,1305623140,17223953158,-4477,,
15819342847,1293.97750,17224008672,1305674173,17224004191,-4481,,
15819393411,1294.02806,17224059239,1305724734,17224054753,-4486,,
15819443995,1294.07864,17224109826,1305775315,17224105334,-4492,,
15819494493,1294.12914,17224160325,1305825811,17224155830,-4495,,
15819544589,1294.17924,17224210424,1305875904,17224205923,-4501,,
15819594736,1294.22938,17224260574,1305926048,17224256067,-4507,,
15819645786,1294.28043,17224311626,1305977095,17224307114,-4512,,
15819696833,1294.33148,17224362676,1306028140,17224358159,-4517,,
15819747884,1294.38253,17224413729,1306079189,17224409208,-4521,,
15819798922,1294.43357,17224464768,1306130234,17224460253,-4515,,
15819849984,1294.48463,17224515833,1306181283,17224511301,-4532,,
15819900197,1294.53484,17224566048,1306231493,17224561511,-4537,,
15819950291,1294.58494,17224616145,1306281584,17224611603,-4542,,
15820001315,1294.63596,17224667171,1306332605,17224662623,-4548,,
15820052399,1294.68705,17224718258,1306383687,17224713706,-4552,,
15820103445,1294.73809,17224769305,1306434730,17224764748,-4557,,
15820154067,1294.78871,17224819930,1306485349,17224815367,-4563,,
15820204828,1294.83948,17224870694,1306536108,17224866127,-4567,,
15820255365,1294.89001,17224921234,1306586642,17224916661,-4573,,
15820306450,1294.94110,17224972321,1306637725,17224967743,-4578,,
15820356980,1294.99163,17225022852,1306688251,17225018270,-4582,,
15820407549,1295.04220,17225073425,1306738818,17225068837,-4588,,
15820458303,1295.09295,17225124181,1306789570,17225119588,-4593,,
15820508706,1295.14335,17225174596,1306839980,17225169998,-4598,,
15820559751,1295.19440,17225225633,1306891012,17225221041,-4592,,
15820610355,1295.24500,17225276240,1306941613,17225271632,-4608,,
15820661090,1295.29574,17225326977,1306992345,17225322364,-4613,,
15820711986,1295.34663,17225377875,1307043238,17225373256,-4619,,
15820762594,1295.39724,17225428486,1307093844,17225423863,-4623,,
15820812715,1295.44736,17225478609,1307143962,17225473981,-4628,,
15820863294,1295.49794,17225529190,1307194538,17225524556,-4634,,
15820913426,1295.54807,17225579325,1307244679,17225574698,-4627,,
15820963848,1295.59850,17225629749,1307295087,17225625106,-4643,,
15821014476,1295.64912,17225680380,1307345713,17225675731,-4649,,
15821065067,1295.69971,17225730984,1307396312,17225726331,-4653,,
15821116138,1295.75079,17225782047,1307447370,17225777388,-4659,,
15821166327,1295.80098,17225832238,1307497556,17225827585,-4653,,
15821216929,1295.85158,17225882841,1307548153,17225878172,-4669,,
15821267536,1295.90218,17225933452,1307598759,17225928778,-4674,,
15821317643,1295.95229,17225983561,1307648863,17225978882,-4679,,
15821368192,1296.00284,17226034112,1307699409,17226029439,-4673,,
15821419264,1296.05391,17226085187,1307750479,17226080498,-4689,,
15821469905,1296.10455,17226135830,1307801117,17226131135,-4695,,
15821520432,1296.15508,17226186370,1307851653,17226181671,-4699,,
15821571481,1296.20613,17226237422,1307902699,17226232717,-4705,,
15821622554,1296.25720,17226288486,1307953759,17226283777,-4709,,
15821673634,1296.30828,17226339568,1308004836,17226334865,-4703,,
15821723796,1296.35844,17226389733,1308054995,17226385013,-4720,,
15821774402,1296.40905,17226440341,1308105599,17226435617,-4724,,
15821824549,1296.45920,17226490489,1308155742,17226485760,-4729,,
15821875117,1296.50977,17226541061,1308206307,17226536326,-4735,,
15821925207,1296.55985,17226591153,1308256396,17226586414,-4739,,
15821976072,1296.61072,17226642021,1308307258,17226637276,-4745,,
15822027085,1296.66173,17226693036,1308358267,17226688286,-4750,,
15822077682,1296.71233,17226743634,1308408861,17226738879,-4755,,
15822128730,1296.76338,17226794685,1308459907,17226789925,-4760,,
15822179345,1296.81399,17226845302,1308510519,17226840537,-4765,,
15822229932,1296.86458,17226895892,1308561103,17226891122,-4770,,
15822280950,1296.91560,17226946912,1308612119,17226942137,-4775,,
15822331605,1296.96625,17226997570,1308662772,17226992790,-4780,,
15822382393,1297.01704,17227048359,1308713556,17227043574,-4785,,
15822433481,1297.06813,17227099451,1308764641,17227094660,-4791,,
15822484014,1297.11866,17227149986,1308815172,17227145191,-4795,,
15822534501,1297.16915,17227200476,1308865657,17227195675,-4801,,
15822585070,1297.21972,17227251046,1308916222,17227246241,-4805,,
15822635681,1297.27033,17227301659,1308966831,17227296849,-4810,,
15822686372,1297.32102,17227352354,1309017519,17227347538,-4816,,
15822737095,1297.37174,17227403079,1309068240,17227398258,-4821,,
15822787829,1297.42248,17227453814,1309118970,17227448988,-4826,,
15822837965,1297.47261,17227503953,1309169104,17227499122,-4831,,
15822889015,1297.52366,17227555006,1309220151,17227550170,-4836,,
15822939635,1297.57428,17227605627,1309270768,17227600786,-4841,,
15822990649,1297.62530,17227656645,1309321780,17227651799,-4846,,
15823041243,1297.67589,17227707241,1309372372,17227702391,-4850,,
15823091786,1297.72643,17227757796,1309422922,17227752941,-4855,,
15823142698,1297.77735,17227808701,1309473821,17227803839,-4862,,
15823193272,1297.82792,17227859287,1309524403,17227854422,-4865,,
15823244339,1297.87899,17227910347,1309575456,17227905475,-4872,,
15823294904,1297.92955,17227960913,1309626018,17227956047,-4866,,
15823345996,1297.98064,17228012008,1309677108,17228007127,-4881,,
15823396123,1298.03077,17228062138,1309727232,17228057251,-4887,,
15823446252,1298.08090,17228112269,1309777359,17228107388,-4881,,
15823497320,1298.13197,17228163339,1309828423,17228158442,-4897,,
15823548348,1298.18300,17228214370,1309879460,17228209478,-4892,,
15823599000,1298.23365,17228265023,1309930098,17228260117,-4906,,
15823649586,1298.28423,17228315612,1309980682,17228310700,-4912,,
15823700664,1298.33531,17228366692,1310031757,17228361775,-4917,,
15823751199,1298.38585,17228417230,1310082289,17228412307,-4923,,
15823801862,1298.43651,17228467895,1310132950,17228462968,-4927,,
15823852930,1298.48758,17228518965,1310184014,17228514032,-4933,,
15823903502,1298.53815,17228569540,1310234584,17228564603,-4937,,
15823954572,1298.58922,17228620613,1310285651,17228615670,-4943,,
15824005582,1298.64023,17228671625,1310336658,17228666677,-4948,,
15824056614,1298.69126,17228722658,1310387688,17228717706,-4952,,
15824107211,1298.74186,17228773259,1310438282,17228768301,-4958,,
15824158260,1298.79291,17228824309,1310489328,17228819346,-4963,,
15824209306,1298.84395,17228875357,1310540371,17228870390,-4967,,
15824260325,1298.89497,17228926380,1310591388,17228921406,-4974,,
15824311404,1298.94605,17228977461,1310642464,17228972483,-4978,,
15824362424,1298.99707,17229028483,1310693481,17229023499,-4984,,
15824413018,1299.04767,17229079080,1310744072,17229074091,-4989,,
15824463652,1299.09830,17229129716,1310794705,17229124723,-4993,,
15824514488,1299.14914,17229180554,1310845537,17229175555,-4999,,
15824565075,1299.19972,17229231144,1310896121,17229226140,-5004,,
15824616029,1299.25068,17229282099,1310947073,17229277091,-5008,,
15824666192,1299.30084,17229332266,1310997234,17229327252,-5014,,
15824716701,1299.35135,17229382777,1311047739,17229377758,-5019,,
15824766835,1299.40148,17229432913,1311097872,17229427901,-5012,,
15824817447,1299.45210,17229483527,1311148480,17229478498,-5029,,
15824868025,1299.50267,17229534108,1311199055,17229529073,-5035,,
15824918648,1299.55330,17229584733,1311249675,17229579694,-5039,,
15824969227,1299.60388,17229635315,1311300252,17229630270,-5045,,
15825020238,1299.65489,17229686328,1311351260,17229681279,-5049,,
15825070786,1299.70543,17229736877,1311401805,17229731824,-5053,,
15825120915,1299.75556,17229787009,1311451932,17229781950,-5059,,
15825171901,1299.80655,17229837998,1311502916,17229832934,-5064,,
15825222511,1299.85716,17229888611,1311553523,17229883541,-5070,,
15825273539,1299.90819,17229939641,1311604548,17229934566,-5075,,
15825324624,1299.95927,17229990728,1311655631,17229985649,-5079,,
15825375529,1300.01018,17230041636,1311706544,17230036563,-5073,,
15825426184,1300.06083,17230092293,1311757184,17230087203,-5090,,
15825476760,1300.11141,17230142871,1311807758,17230137788,-5083,,
15825527093,1300.16174,17230193207,1311858089,17230188107,-5100,,
15825578123,1300.21277,17230244239,1311909116,17230239134,-5105,,
15825628251,1300.26290,17230294369,1311959240,17230289259,-5110,,
15825678903,1300.31355,17230345023,1312009900,17230339919,-5104,,
15825729087,1300.36373,17230395210,1312060081,17230390100,-5110,,
15825780153,1300.41480,17230446278,1312111134,17230441153,-5125,,
15825830801,1300.46545,17230496929,1312161780,17230491798,-5131,,
15825881292,1300.51594,17230547422,1312212268,17230542286,-5136,,
15825931436,1300.56608,17230597568,1312262409,17230592428,-5140,,
15825981581,1300.61623,17230647716,1312312552,17230642571,-5145,,
15826032586,1300.66723,17230698722,1312363554,17230693572,-5150,,
15826083145,1300.71779,17230749285,1312414110,17230744129,-5156,,
15826133739,1300.76839,17230799881,1312464701,17230794720,-5161,,
15826184333,1300.81898,17230850477,1312515293,17230845311,-5166,,
15826235336,1300.86998,17230901483,1312566294,17230896312,-5171,,
15826286322,1300.92097,17230952471,1312617276,17230947295,-5176,,
15826336466,1300.97111,17231002616,1312667418,17230997436,-5180,,
15826387554,1301.02220,17231053708,1312718503,17231048522,-5186,,
15826438178,1301.07283,17231104334,1312769124,17231099142,-5192,,
15826489226,1301.12387,17231155383,1312820169,17231150187,-5196,,
15826539364,1301.17401,17231205525,1312870306,17231200324,-5201,,
15826589955,1301.22460,17231256118,1312920893,17231250912,-5206,,
15826640578,1301.27523,17231306743,1312971513,17231301532,-5211,,
15826691108,1301.32576,17231357275,1313022041,17231352059,-5216,,
15826741719,1301.37637,17231407888,1313072649,17231402667,-5221,,
15826792768,1301.42742,17231458940,1313123695,17231453713,-5227,,
15826843817,1301.47846,17231509991,1313174741,17231504759,-5232,,
15826894380,1301.52903,17231560557,1313225302,17231555321,-5236,,
15826945408,1301.58006,17231611588,1313276327,17231606346,-5242,,
15826996038,1301.63069,17231662220,1313326954,17231656973,-5247,,
15827046143,1301.68079,17231712327,1313377057,17231707076,-5251,,
15827096850,1301.73150,17231763037,1313427762,17231757780,-5257,,
15827147616,1301.78226,17231813805,1313478524,17231808543,-5262,,
15827198563,1301.83321,17231864764,1313529479,17231859497,-5267,,
15827249671,1301.88432,17231915865,1313580574,17231910593,-5272,,
15827300257,1301.93491,17231966453,1313631157,17231961176,-5277,,
15827350774,1301.98542,17232016972,1313681671,17232011689,-5283,,
15827401380,1302.03603,17232067581,1313732275,17232062294,-5287,,
15827451913,1302.08656,17232118115,1313782805,17232112823,-5292,,
15827502529,1302.13718,17232168734,1313833418,17232163447,-5287,,
15827553575,1302.18822,17232219783,1313884461,17232214480,-5303,,
15827604182,1302.23883,17232270391,1313935066,17232265085,-5306,,
15827654729,1302.28938,17232320942,1313985611,17232315629,-5313,,
15827705679,1302.34033,17232371893,1314036557,17232366575,-5318,,
15827756287,1302.39093,17232422504,1314087163,17232417181,-5323,,
15827806873,1302.44152,17232473093,1314137747,17232467765,-5328,,
15827857016,1302.49166,17232523238,1314187886,17232517905,-5333,,
15827907159,1302.54181,17232573383,1314238028,17232568046,-5337,,
15827957730,1302.59238,17232623957,1314288595,17232618614,-5343,,
15828008779,1302.64343,17232675008,1314339641,17232669660,-5348,,
15828059803,1302.69445,17232726034,1314390662,17232720681,-5353,,
15828110352,1302.74500,17232776585,1314441209,17232771227,-5358,,
15828160913,1302.79556,17232827149,1314491777,17232821796,-5353,,
15828211519,1302.84617,17232877757,1314542371,17232872389,-5368,,
15828262571,1302.89722,17232928811,1314593418,17232923437,-5374,,
15828313627,1302.94827,17232979869,1314644484,17232974502,-5367,,
15828363834,1302.99848,17233030080,1314694678,17233024696,-5384,,
15828414891,1303.04954,17233081139,1314745732,17233075750,-5389,,
15828465436,1303.10008,17233131686,1314796274,17233126293,-5393,,
15828515727,1303.15037,17233181980,1314846563,17233176581,-5399,,
15828566341,1303.20099,17233232595,1314897173,17233227192,-5403,,
15828617386,1303.25203,17233283643,1314948216,17233278235,-5408,,
15828668406,1303.30305,17233334666,1314999234,17233329252,-5414,,
15828719484,1303.35413,17233385746,1315050308,17233380327,-5419,,
15828770078,1303.40473,17233436342,1315100899,17233430918,-5424,,
15828821122,1303.45577,17233487389,1315151941,17233481960,-5429,,
15828872183,1303.50683,17233538452,1315203000,17233533018,-5434,,
15828923221,1303.55787,17233589492,1315254034,17233584052,-5440,,
15828973713,1303.60836,17233639987,1315304523,17233634542,-5445,,
15829023908,1303.65856,17233690184,1315354717,17233684735,-5449,,
15829074947,1303.70960,17233741226,1315405753,17233735771,-5455,,
15829125986,1303.76063,17233792279,1315456801,17233786819,-5460,,
15829176651,1303.81130,17233842933,1315507451,17233837469,-5464,,
15829227246,1303.86189,17233893532,1315558043,17233888061,-5471,,
15829278348,1303.91300,17233944636,1315609142,17233939161,-5475,,
15829328945,1303.96359,17233995235,1315659736,17233989755,-5480,,
15829379548,1304.01420,17234045841,1315710338,17234040356,-5485,,
15829430462,1304.06511,17234096757,1315761249,17234091267,-5490,,
15829481508,1304.11616,17234147806,1315812292,17234142310,-5496,,
15829531661,1304.16631,17234197961,1315862443,17234192461,-5500,,
15829582721,1304.21737,17234249023,1315913499,17234243518,-5505,,
15829633767,1304.26842,17234300071,1315964542,17234294560,-5511,,
15829684617,1304.31927,17234350924,1316015389,17234345408,-5516,,
15829735376,1304.37002,17234401684,1316066156,17234396175,-5509,,
15829786027,1304.42068,17234452338,1316116794,17234446812,-5526,,
15829836634,1304.47128,17234502948,1316167399,17234497417,-5531,,
15829887266,1304.52191,17234553581,1316218028,17234548046,-5535,,
15829937813,1304.57246,17234604131,1316268572,17234598590,-5541,,
15829988311,1304.62296,17234654631,1316319067,17234649085,-5546,,
15830038686,1304.67333,17234705009,1316369440,17234699458,-5551,,
15830089181,1304.72383,17234755507,1316419933,17234749951,-5556,,
15830139742,1304.77439,17234806070,1316470491,17234800509,-5561,,
15830190304,1304.82495,17234856635,1316521049,17234851067,-5568,,
15830240447,1304.87510,17234906779,1316571190,17234901208,-5571,,
15830291058,1304.92571,17234957392,1316621798,17234951816,-5576,,
15830342102,1304.97675,17235008440,1316672840,17235002858,-5582,,
15830393166,1305.02781,17235059505,1316723901,17235053920,-5585,,
15830443730,1305.07838,17235110071,1316774462,17235104481,-5590,,
15830494328,1305.12898,17235160673,1316825057,17235155076,-5597,,
15830545012,1305.17966,17235211359,1316875738,17235205766,-5593,,
15830595394,1305.23004,17235261744,1316926120,17235256139,-5605,,
15830646307,1305.28095,17235312659,1316977028,17235307047,-5612,,
15830697389,1305.33204,17235363743,1317028107,17235358126,-5617,,
15830747997,1305.38264,17235414353,1317078714,17235408732,-5621,,
15830799003,1305.43365,17235465362,1317129717,17235459735,-5627,,
15830849621,1305.48427,17235515982,1317180332,17235510350,-5632,,
15830900717,1305.53536,17235567081,1317231424,17235561442,-5639,,
15830951305,1305.58595,17235617671,1317282011,17235612029,-5642,,
15831001810,1305.63646,17235668178,1317332512,17235662531,-5647,,
15831051969,1305.68662,17235718339,1317382668,17235712686,-5653,,
15831102519,1305.73717,17235768892,1317433216,17235763235,-5657,,
15831152719,1305.78737,17235819093,1317483413,17235813431,-5662,,
15831203282,1305.83793,17235869660,1317533974,17235863992,-5668,,
15831253451,1305.88810,17235919831,1317584139,17235914158,-5673,,
15831303828,1305.93848,17235970209,1317634514,17235964532,-5677,,
15831354091,1305.98874,17236020476,1317684774,17236014793,-5683,,
15831405096,1306.03974,17236071483,1317735776,17236065795,-5688,,
15831455675,1306.09032,17236122064,1317786353,17236116372,-5692,,
15831506723,1306.14137,17236173115,1317837399,17236167417,-5698,,
15831557310,1306.19196,17236223704,1317887982,17236218000,-5704,,
15831607475,1306.24212,17236273870,1317938145,17236268163,-5707,,
15831657978,1306.29263,17236324377,1317988645,17236318664,-5713,,
15831708633,1306.34328,17236375034,1318039298,17236369316,-5718,,
15831759223,1306.39387,17236425626,1318089885,17236419903,-5723,,
15831809438,1306.44409,17236475844,1318140098,17236470116,-5728,,
15831860026,1306.49467,17236526434,1318190682,17236520701,-5733,,
15831911075,1306.54572,17236577486,1318241728,17236571747,-5739,,
15831961244,1306.59589,17236627657,1318291895,17236621914,-5743,,
15832012293,1306.64694,17236678708,1318342941,17236672960,-5748,,
15832063344,1306.69799,17236729762,1318393990,17236724008,-5754,,
15832113858,1306.74851,17236780277,1318444500,17236774518,-5759,,
15832164902,1306.79955,17236831323,1318495542,17236825560,-5763,,
15832215967,1306.85062,17236882402,1318546615,17236876633,-5769,,
15832267035,1306.90168,17236933461,1318597669,17236927687,-5774,,
15832318073,1306.95272,17236984502,1318648706,17236978724,-5778,,
15832368256,1307.00290,17237034687,1318698885,17237028903,-5784,,
15832419305,1307.05395,17237085739,1318749931,17237079950,-5789,,
15832469880,1307.10453,17237136317,1318800504,17237130522,-5795,,
15832520454,1307.15510,17237186893,1318851076,17237181105,-5788,,
15832570850,1307.20550,17237237291,1318901469,17237231487,-5804,,
15832621540,1307.25619,17237287984,1318952156,17237282174,-5810,,
15832672088,1307.30674,17237338533,1319002701,17237332719,-5814,,
15832723091,1307.35774,17237389539,1319053702,17237383720,-5819,,
15832773746,1307.40839,17237440196,1319104353,17237434372,-5824,,
15832824751,1307.45940,17237491204,1319155367,17237485385,-5819,,
15832875276,1307.50992,17237541730,1319205878,17237535897,-5833,,
15832925919,1307.56057,17237592376,1319256518,17237586536,-5840,,
15832976505,1307.61115,17237642964,1319307101,17237637119,-5845,,
15833026707,1307.66135,17237693168,1319357301,17237687319,-5849,,
15833077726,1307.71237,17237744191,1319408318,17237738336,-5855,,
15833128327,1307.76298,17237794794,1319458915,17237788933,-5861,,
15833178945,1307.81359,17237845414,1319509530,17237839549,-5865,,
15833229553,1307.86420,17237896025,1319560136,17237890165,-5860,,
15833280198,1307.91485,17237946672,1319610779,17237940797,-5875,,
15833330337,1307.96499,17237996814,1319660914,17237990933,-5881,,
15833380915,1308.01556,17238047394,1319711491,17238041519,-5875,,
15833431494,1308.06614,17238097985,1319762077,17238092095,-5890,,
15833482094,1308.11674,17238148577,1319812663,17238142681,-5896,,
15833533058,1308.16771,17238199544,1319863626,17238193644,-5900,,
15833583633,1308.21828,17238250121,1319914197,17238244216,-5905,,
15833634266,1308.26891,17238300757,1319964827,17238294846,-5911,,
15833684660,1308.31931,17238351153,1320015219,17238345237,-5916,,
15833735286,1308.36993,17238401781,1320065842,17238395861,-5920,,
15833786338,1308.42099,17238452836,1320116891,17238446910,-5926,,
15833837360,1308.47201,17238503859,1320167910,17238497928,-5931,,
15833887952,1308.52260,17238554454,1320218500,17238548518,-5936,,
15833938861,1308.57351,17238605365,1320269406,17238599424,-5941,,
15833989408,1308.62406,17238655914,1320319950,17238649968,-5946,,
15834039775,1308.67442,17238706284,1320370314,17238700332,-5952,,
15834090388,1308.72504,17238756900,1320420926,17238750944,-5956,,
15834141161,1308.77581,17238807674,1320471695,17238801713,-5961,,
15834191970,1308.82662,17238858486,1320522501,17238852519,-5967,,
15834242362,1308.87701,17238908881,1320572891,17238902909,-5972,,
15834292972,1308.92762,17238959492,1320623497,17238953516,-5976,,
15834343562,1308.97821,17239010085,1320674084,17239004103,-5982,,
15834393719,1309.02837,17239060244,1320724239,17239054257,-5987,,
15834444325,1309.07897,17239110863,1320774854,17239104872,-5991,,
15834495392,1309.13004,17239161923,1320825908,17239155926,-5997,,
15834546441,1309.18109,17239212973,1320876953,17239206971,-6002,,
15834597447,1309.23210,17239263982,1320927957,17239257976,-6006,,
15834648043,1309.28269,17239314581,1320978550,17239308569,-6012,,
15834699093,1309.33374,17239365632,1321029597,17239359615,-6017,,
15834749698,1309.38435,17239416240,1321080199,17239410217,-6023,,
15834800757,1309.43540,17239467302,1321131257,17239461275,-6027,,
15834851367,1309.48601,17239517914,1321181863,17239511881,-6033,,
15834901914,1309.53656,17239568464,1321232408,17239562426,-6038,,
15834952136,1309.58678,17239618688,1321282627,17239612646,-6042,,
15835002730,1309.63738,17239669284,1321333218,17239663237,-6047,,
15835053287,1309.68793,17239719843,1321383772,17239713790,-6053,,
15835103872,1309.73852,17239770440,1321434364,17239764382,-6058,,
15835154930,1309.78958,17239821490,1321485410,17239815428,-6062,,
15835205397,1309.84004,17239871960,1321535874,17239865892,-6068,,
15835255960,1309.89061,17239922526,1321586434,17239916453,-6073,,
15835306563,1309.94121,17239973131,1321637035,17239967053,-6078,,
15835357396,1309.99204,17240023967,1321687865,17240017884,-6083,,
15835407600,1310.04225,17240074173,1321738066,17240068084,-6089,,
15835458194,1310.09284,17240124768,1321788657,17240118676,-6092,,
15835509245,1310.14389,17240175823,1321839706,17240169724,-6099,,
15835559823,1310.19447,17240226402,1321890280,17240220299,-6103,,
15835610415,1310.24506,17240276998,1321940870,17240270889,-6109,,
15835661119,1310.29577,17240327713,1321991582,17240321600,-6113,,
15835711611,1310.34626,17240378198,1322042062,17240372080,-6118,,
15835761894,1310.39654,17240428483,1322092352,17240422370,-6113,,
15835812887,1310.44754,17240479478,1322143332,17240473350,-6128,,
15835863044,1310.49769,17240529638,1322193486,17240523504,-6134,,
15835913593,1310.54824,17240580190,1322244033,17240574051,-6139,,
15835964071,1310.59872,17240630669,1322294507,17240624525,-6144,,
15836014678,1310.64933,17240681278,1322345112,17240675130,-6148,,
15836065205,1310.69985,17240731809,1322395637,17240725655,-6154,,
15836115819,1310.75047,17240782425,1322446248,17240776266,-6159,,
15836166317,1310.80096,17240832925,1322496743,17240826762,-6163,,
15836216924,1310.85157,17240883535,1322547347,17240877366,-6169,,
15836267997,1310.90264,17240934609,1322598417,17240928435,-6174,,
15836318621,1310.95327,17240985236,1322649038,17240979057,-6179,,
15836369244,1311.00389,17241035862,1322699659,17241029678,-6184,,
15836419407,1311.05406,17241086027,1322749819,17241079838,-6189,,
15836470436,1311.10508,17241137059,1322800855,17241130874,-6185,,
15836521508,1311.15616,17241188133,1322851915,17241181934,-6199,,
15836572107,1311.20675,17241238733,1322902521,17241232539,-6194,,
15836622784,1311.25743,17241289414,1322953186,17241283204,-6210,,
15836673327,1311.30797,17241339958,1323003726,17241333744,-6214,,
15836724374,1311.35902,17241391008,1323054770,17241384789,-6219,,
15836775390,1311.41004,17241442027,1323105784,17241435802,-6225,,
15836825537,1311.46018,17241492176,1323155927,17241485945,-6231,,
15836876583,1311.51123,17241543223,1323206971,17241536989,-6234,,
15836927514,1311.56216,17241594158,1323257899,17241587918,-6240,,
15836978073,1311.61272,17241644719,1323308455,17241638474,-6245,,
15837028687,1311.66333,17241695334,1323359067,17241689085,-6249,,
15837079297,1311.71394,17241745948,1323409675,17241739693,-6255,,
15837129414,1311.76406,17241796067,1323459789,17241789807,-6260,,
15837179556,1311.81420,17241846212,1323509927,17241839946,-6266,,
15837230177,1311.86483,17241896835,1323560547,17241890565,-6270,,
15837280491,1311.91514,17241947150,1323610857,17241940885,-6265,,
15837331140,1311.96579,17241997803,1323661503,17241991522,-6281,,
15837382179,1312.01683,17242048843,1323712540,17242042558,-6285,,
15837432749,1312.06740,17242099416,1323763108,17242093126,-6290,,
15837483381,1312.11803,17242150051,1323813736,17242143755,-6296,,
15837533991,1312.16864,17242200663,1323864344,17242194362,-6301,,
15837585010,1312.21966,17242251683,1323915371,17242245390,-6293,,
15837636078,1312.27073,17242302754,1323966425,17242296443,-6311,,
15837687061,1312.32171,17242353739,1324017405,17242347424,-6315,,
15837737657,1312.37231,17242404338,1324067999,17242398018,-6320,,
15837788260,1312.42291,17242454944,1324118599,17242448618,-6326,,
15837838856,1312.47350,17242505542,1324169192,17242499211,-6331,,
15837889917,1312.52456,17242556606,1324220250,17242550269,-6337,,
15837939999,1312.57465,17242606700,1324270340,17242600358,-6342,,
15837990602,1312.62525,17242657295,1324320930,17242650948,-6347,,
15838041227,1312.67587,17242707922,1324371552,17242701570,-6352,,
15838091645,1312.72629,17242758343,1324421968,17242751986,-6357,,
15838142170,1312.77682,17242808870,1324472491,17242802509,-6361,,
15838192223,1312.82687,17242858925,1324522540,17242852558,-6367,,
15838242343,1312.87699,17242909060,1324572671,17242902689,-6371,,
15838292950,1312.92760,17242959657,1324623263,17242953281,-6376,,
15838343086,1312.97773,17243009796,1324673395,17243003425,-6371,,
15838394157,1313.02880,17243060869,1324724464,17243054482,-6387,,
15838444785,1313.07943,17243111498,1324775089,17243105107,-6391,,
15838495350,1313.13000,17243162066,1324825661,17243155680,-6386,,
15838545990,1313.18064,17243212708,1324876288,17243206306,-6402,,
15838597066,1313.23171,17243263787,1324927362,17243257381,-6406,,
15838648104,1313.28275,17243314828,1324978398,17243308417,-6411,,
15838698750,1313.33340,17243365476,1325029041,17243359059,-6417,,
15838749246,1313.38389,17243415974,1325079534,17243409552,-6422,,
15838799781,1313.43443,17243466512,1325130067,17243460085,-6427,,
15838850423,1313.48507,17243517156,1325180706,17243510724,-6432,,
15838901471,1313.53612,17243568207,1325231751,17243561770,-6437,,
15838952502,1313.58715,17243619240,1325282780,17243612798,-6442,,
15839003553,1313.63820,17243670293,1325333827,17243663846,-6447,,
15839054558,1313.68921,17243721301,1325384830,17243714848,-6453,,
15839105616,1313.74026,17243772361,1325435885,17243765903,-6458,,
15839156674,1313.79132,17243823421,1325486940,17243816959,-6462,,
15839207697,1313.84235,17243874446,1325537960,17243867978,-6468,,
15839258143,1313.89279,17243924895,1325588404,17243918422,-6473,,
15839308727,1313.94338,17243975482,1325638986,17243969004,-6478,,
15839358846,1313.99349,17244025603,1325689102,17244019121,-6482,,
15839409455,1314.04410,17244076213,1325739707,17244069726,-6487,,
15839460543,1314.09519,17244127305,1325790792,17244120811,-6494,,
15839510961,1314.14561,17244177725,1325841209,17244171227,-6498,,
15839561121,1314.19577,17244227887,1325891365,17244221384,-6503,,
15839612183,1314.24683,17244278952,1325942424,17244272443,-6509,,
15839663087,1314.29774,17244329858,1325993327,17244323345,-6513,,
15839713338,1314.34799,17244380111,1326043575,17244373594,-6517,,
15839763964,1314.39861,17244430740,1326094197,17244424216,-6524,,
15839814111,1314.44876,17244480888,1326144341,17244474359,-6529,,
15839865189,1314.49984,17244531969,1326195418,17244525436,-6533,,
15839916054,1314.55070,17244582837,1326246279,17244576298,-6539,,
15839967102,1314.60175,17244633887,1326297324,17244627343,-6544,,
15840017693,1314.65234,17244684480,1326347913,17244677932,-6548,,
15840068646,1314.70329,17244735436,1326398863,17244728881,-6555,,
15840119189,1314.75384,17244785980,1326449403,17244779421,-6559,,
15840169750,1314.80440,17244836545,1326499962,17244829980,-6565,,
15840220333,1314.85498,17244887130,1326550543,17244880562,-6568,,
15840271325,1314.90597,17244938123,1326601531,17244931549,-6574,,
15840321951,1314.95660,17244988753,1326652154,17244982172,-6581,,
15840373002,1315.00765,17245039806,1326703203,17245033222,-6584,,
15840424053,1315.05870,17245090858,1326754251,17245084269,-6589,,
15840475087,1315.10974,17245141896,1326805283,17245135311,-6585,,
15840525571,1315.16022,17245192382,1326855764,17245185782,-6600,,
15840576378,1315.21103,17245243191,1326906568,17245236587,-6604,,
15840626929,1315.26158,17245293745,1326957117,17245287135,-6610,,
15840677486,1315.31213,17245344304,1327007671,17245337689,-6615,,
15840728074,1315.36272,17245394895,1327058256,17245388275,-6620,,
15840778491,1315.41314,17245445314,1327108670,17245438689,-6625,,
15840829050,1315.46370,17245495875,1327159226,17245489245,-6630,,
15840879655,1315.51430,17245546483,1327209828,17245539847,-6636,,
15840930257,1315.56490,17245597086,1327260428,17245590446,-6640,,
15840981306,1315.61595,17245648138,1327311475,17245641493,-6645,,
15841032215,1315.66686,17245699049,1327362380,17245692398,-6651,,
15841082763,1315.71741,17245749600,1327412927,17245742956,-6644,,
15841133582,1315.76823,17245800421,1327463743,17245793761,-6660,,
15841184651,1315.81930,17245851493,1327514809,17245844827,-6666,,
15841235255,1315.86990,17245902099,1327565409,17245895428,-6671,,
15841285912,1315.92056,17245952758,1327616064,17245946083,-6675,,
15841336960,1315.97161,17246003809,1327667109,17245997128,-6681,,
15841387974,1316.02262,17246054825,1327718120,17246048139,-6686,,
15841438582,1316.07323,17246105436,1327768727,17246098745,-6691,,
15841489575,1316.12422,17246156431,1327819717,17246149735,-6696,,
15841540089,1316.17474,17246206946,1327870227,17246200255,-6691,,
15841590212,1316.22486,17246257073,1327920348,17246250366,-6707,,
15841640832,1316.27548,17246307694,1327970965,17246300983,-6711,,
15841691759,1316.32641,17246358623,1328021889,17246351907,-6716,,
15841742451,1316.37710,17246409318,1328072578,17246402596,-6722,,
15841793044,1316.42769,17246459913,1328123169,17246453187,-6726,,
15841843676,1316.47832,17246510548,1328173798,17246503817,-6731,,
15841894097,1316.52875,17246560971,1328224216,17246554234,-6737,,
15841944640,1316.57929,17246611516,1328274756,17246604774,-6742,,
15841995671,1316.63032,17246662550,1328325785,17246655804,-6746,,
15842046291,1316.68094,17246713173,1328376402,17246706421,-6752,,
15842096859,1316.73151,17246763743,1328426968,17246756986,-6757,,
15842147505,1316.78215,17246814392,1328477612,17246807630,-6762,,
15842198006,1316.83265,17246864895,1328528110,17246858128,-6767,,
15842248568,1316.88322,17246915458,1328578667,17246908686,-6772,,
15842298717,1316.93337,17246965610,1328628826,17246958845,-6765,,
15842348829,1316.98348,17247015725,1328678924,17247008943,-6782,,
15842399433,1317.03408,17247066330,1328729525,17247059543,-6787,,
15842450024,1317.08467,17247116924,1328780113,17247110131,-6793,,
15842500627,1317.13528,17247167530,1328830714,17247160733,-6797,,
15842551225,1317.18587,17247218129,1328881309,17247211327,-6802,,
15842601366,1317.23601,17247268274,1328931448,17247261466,-6808,,
15842651513,1317.28616,17247318422,1328981592,17247311610,-6812,,
15842702119,1317.33677,17247369030,1329032195,17247362214,-6816,,
15842753133,1317.38778,17247420048,1329083206,17247413225,-6823,,
15842803266,1317.43791,17247470183,1329133338,17247463356,-6827,,
15842853911,1317.48856,17247520830,1329183979,17247513998,-6832,,
15842904483,1317.53913,17247571405,1329234549,17247564567,-6838,,
15842955363,1317.59001,17247622287,1329285425,17247615443,-6844,,
15843005944,1317.64059,17247672869,1329336004,17247666022,-6847,,
15843056551,1317.69120,17247723480,1329386609,17247716627,-6853,,
15843107173,1317.74182,17247774104,1329437227,17247767246,-6858,,
15843157797,1317.79245,17247824730,1329487849,17247817868,-6862,,
15843208398,1317.84305,17247875334,1329538448,17247868466,-6868,,
15843258522,1317.89317,17247925471,1329588580,17247918598,-6873,,
15843309129,1317.94378,17247976069,1329639172,17247969190,-6879,,
15843359247,1317.99390,17248026189,1329689288,17248019318,-6871,,
15843410053,1318.04470,17248076998,1329740091,17248070121,-6877,,
15843460653,1318.09530,17248127601,1329790699,17248120718,-6883,,
15843511277,1318.14593,17248178227,1329841310,17248171328,-6899,,
15843562324,1318.19697,17248229276,1329892355,17248222373,-6903,,
15843612914,1318.24756,17248279869,1329942941,17248272970,-6899,,
15843663566,1318.29821,17248330522,1329993591,17248323609,-6913,,
15843713935,1318.34858,17248380894,1330043958,17248373976,-6918,,
15843764914,1318.39956,17248431875,1330094933,17248424951,-6924,,
15843815529,1318.45018,17248482493,1330145546,17248475564,-6929,,
15843866394,1318.50104,17248533360,1330196409,17248526438,-6922,,
15843917439,1318.55209,17248584408,1330247450,17248577481,-6927,,
15843968054,1318.60270,17248635025,1330298074,17248628092,-6933,,
15844018566,1318.65321,17248685540,1330348572,17248678591,-6949,,
15844068655,1318.70330,17248735631,1330398658,17248728677,-6954,,
15844119318,1318.75397,17248786295,1330449318,17248779336,-6959,,
15844169842,1318.80449,17248836822,1330499839,17248829857,-6965,,
15844220347,1318.85499,17248887330,1330550342,17248880360,-6970,,
15844271074,1318.90572,17248938059,1330601066,17248931085,-6974,,
15844321206,1318.95585,17248988204,1330651206,17248981224,-6980,,
15844371360,1319.00601,17249038350,1330701347,17249031366,-6984,,
15844422438,1319.05709,17249089430,1330752422,17249082441,-6989,,
15844473053,1319.10770,17249140048,1330803034,17249133052,-6996,,
15844523676,1319.15832,17249190673,1330853655,17249183674,-6999,,
15844574293,1319.20894,17249241292,1330904270,17249234288,-7004,,
15844624831,1319.25948,17249291833,1330954805,17249284833,-7000,,
15844675438,1319.31009,17249342442,1331005408,17249335427,-7015,,
15844725615,1319.36026,17249392621,1331055583,17249385602,-7019,,
15844776513,1319.41116,17249443522,1331106478,17249436497,-7025,,
15844827078,1319.46173,17249494099,1331157051,17249487069,-7030,,
15844877243,1319.51189,17249544255,1331207203,17249537221,-7034,,
15844928291,1319.56294,17249595307,1331258249,17249588267,-7040,,
15844979284,1319.61393,17249646302,1331309238,17249639257,-7045,,
15845030332,1319.66498,17249697353,1331360283,17249690302,-7051,,
15845080455,1319.71510,17249747478,1331410404,17249740422,-7056,,
15845131050,1319.76570,17249798075,1331460996,17249791014,-7061,,
15845181628,1319.81628,17249848656,1331511572,17249841590,-7066,,
15845231747,1319.86640,17249898787,1331561699,17249891717,-7070,,
15845282374,1319.91702,17249949406,1331612312,17249942331,-7075,,
15845332899,1319.96755,17249999933,1331662834,17249992852,-7081,,
15845383512,1320.01816,17250050548,1331713445,17250043463,-7085,,
15845434115,1320.06876,17250101153,1331764045,17250094063,-7090,,
15845484699,1320.11935,17250151740,1331814626,17250144644,-7096,,
15845535364,1320.17001,17250202408,1331865288,17250195307,-7101,,
15845585952,1320.22060,17250252997,1331915874,17250245892,-7105,,
15845636397,1320.27104,17250303446,1331966317,17250296335,-7111,,
15845686519,1320.32117,17250353570,1332016435,17250346454,-7116,,
15845737150,1320.37180,17250404203,1332067064,17250397083,-7120,,
15845788166,1320.42281,17250455222,1332118078,17250448096,-7126,,
15845838794,1320.47344,17250505851,1332168702,17250498720,-7131,,
15845889379,1320.52403,17250556440,1332219284,17250549302,-7138,,
15845939945,1320.57459,17250607008,1332269849,17250599867,-7141,,
15845990431,1320.62508,17250657496,1332320332,17250650350,-7146,,
15846040594,1320.67524,17250707662,1332370492,17250700510,-7152,,
15846090740,1320.72539,17250757809,1332420634,17250750653,-7156,,
15846141369,1320.77602,17250808441,1332471262,17250801280,-7161,,
15846191981,1320.82663,17250859066,1332521881,17250851899,-7167,,
15846242515,1320.87716,17250909592,1332572402,17250902421,-7171,,
15846293598,1320.92825,17250960677,1332623482,17250953501,-7176,,
15846344158,1320.97881,17251011240,1332674040,17251004058,-7182,,
15846395133,1321.02978,17251062217,1332725011,17251055030,-7187,,
15846446139,1321.08079,17251113225,1332776015,17251106033,-7192,,
15846496780,1321.13143,17251163869,1332826653,17251156682,-7187,,
15846547396,1321.18204,17251214487,1332877266,17251207285,-7202,,
15846598109,1321.23276,17251265201,1332927977,17251257995,-7206,,
15846648746,1321.28339,17251315842,1332978611,17251308630,-7212,,
15846699792,1321.33444,17251366890,1333029655,17251359673,-7217,,
15846750399,1321.38505,17251417499,1333080258,17251410276,-7223,,
15846801019,1321.43567,17251468122,1333130876,17251460895,-7227,,
15846851649,1321.48630,17251518753,1333181503,17251511521,-7232,,
15846902631,1321.53728,17251569739,1333232482,17251562500,-7239,,
15846953372,1321.58802,17251620482,1333283221,17251613240,-7242,,
15847004308,1321.63896,17251671419,1333334154,17251664172,-7247,,
15847054392,1321.68904,17251721506,1333384235,17251714253,-7253,,
15847104991,1321.73964,17251772118,1333434842,17251764860,-7258,,
15847156056,1321.79070,17251823174,1333485894,17251815912,-7262,,
15847207105,1321.84175,17251874226,1333536940,17251866958,-7268,,
15847258156,1321.89280,17251925280,1333587988,17251918006,-7274,,
15847308708,1321.94336,17251975834,1333638538,17251968556,-7278,,
15847359757,1321.99440,17252026886,1333689584,17252019602,-7284,,
15847410805,1322.04545,17252077936,1333740630,17252070648,-7288,,
15847461350,1322.09600,17252128484,1333791172,17252121190,-7294,,
15847511832,1322.14648,17252178968,1333841652,17252171670,-7298,,
15847562380,1322.19703,17252229518,1333892197,17252222215,-7303,,
15847613350,1322.24800,17252280490,1333943163,17252273181,-7309,,
15847664023,1322.29867,17252331166,1333993834,17252323853,-7313,,
15847715055,1322.34970,17252382199,1334044863,17252374882,-7317,,
15847765716,1322.40036,17252432864,1334095522,17252425540,-7324,,
15847816185,1322.45083,17252483335,1334145988,17252476007,-7328,,
15847867136,1322.50178,17252534288,1334196936,17252526955,-7333,,
15847917829,1322.55248,17252584995,1334247638,17252577656,-7339,,
15847968411,1322.60306,17252635568,1334298205,17252628224,-7344,,
15848019035,1322.65368,17252686195,1334348827,17252678846,-7349,,
15848069996,1322.70464,17252737158,1334399785,17252729804,-7354,,
15848120612,1322.75526,17252787776,1334450398,17252780417,-7359,,
15848170989,1322.80564,17252838156,1334500772,17252830791,-7365,,
15848222031,1322.85668,17252889200,1334551812,17252881831,-7369,,
15848273086,1322.90773,17252940257,1334602864,17252932883,-7374,,
15848324123,1322.95877,17252991296,1334653898,17252983916,-7380,,
15848374270,1323.00892,17253041446,1334704053,17253034072,-7374,,
15848424819,1323.05947,17253091996,1334754599,17253084617,-7379,,
15848475857,1323.11051,17253143037,1334805624,17253135642,-7395,,
15848526462,1323.16111,17253193645,1334856227,17253186245,-7400,,
15848577012,1323.21166,17253244196,1334906774,17253236792,-7404,,
15848627555,1323.26220,17253294743,1334957315,17253287333,-7410,,
15848678149,1323.31280,17253345338,1335007905,17253337923,-7415,,
15848729153,1323.36380,17253396346,1335058907,17253388926,-7420,,
15848779481,1323.41413,17253446676,1335109243,17253439262,-7414,,
15848830078,1323.46473,17253497274,1335159826,17253489844,-7430,,
15848880685,1323.51533,17253547885,1335210430,17253540449,-7436,,
15848931759,1323.56641,17253598960,1335261502,17253591520,-7440,,
15848982351,1323.61700,17253649555,1335312091,17253642110,-7445,,
15849032952,1323.66760,17253700158,1335362689,17253692708,-7450,,
15849084038,1323.71869,17253751246,1335413773,17253743791,-7455,,
15849135066,1323.76971,17253802277,1335464799,17253794817,-7460,,
15849185645,1323.82029,17253852859,1335515375,17253845393,-7466,,
15849236641,1323.87129,17253903857,1335566368,17253896386,-7471,,
15849287712,1323.92236,17253954931,1335617436,17253947455,-7476,,
15849338178,1323.97283,17254005398,1335667899,17253997917,-7481,,
15849388626,1324.02327,17254055849,1335718345,17254048363,-7486,,
15849439692,1324.07434,17254106918,1335769408,17254099427,-7491,,
15849489874,1324.12452,17254157102,1335819587,17254149606,-7496,,
15849540922,1324.17557,17254208152,1335870632,17254200651,-7501,,
15849591941,1324.22659,17254259173,1335921647,17254251666,-7507,,
15849643015,1324.27766,17254310250,1335972720,17254302738,-7512,,
15849693534,1324.32818,17254360770,1336023236,17254353254,-7516,,
15849744119,1324.37877,17254411358,1336073818,17254403836,-7522,,
15849795123,1324.42977,17254462364,1336124819,17254454837,-7527,,
15849845712,1324.48036,17254512956,1336175407,17254505425,-7531,,
15849896763,1324.53141,17254564010,1336226454,17254556473,-7537,,
15849947809,1324.58246,17254615058,1336277498,17254607516,-7542,,
15849998859,1324.63351,17254666111,1336328545,17254658564,-7547,,
15850049386,1324.68403,17254716640,1336379070,17254709088,-7552,,
15850100419,1324.73507,17254767674,1336430099,17254760118,-7556,,
15850150971,1324.78562,17254818230,1336480648,17254810667,-7563,,
15850201560,1324.83621,17254868821,1336531236,17254861254,-7567,,
15850252562,1324.88721,17254919824,1336582234,17254912252,-7572,,
15850303127,1324.93778,17254970392,1336632796,17254962814,-7578,,
15850353706,1324.98835,17255020974,1336683374,17255013392,-7582,,
15850404718,1325.03937,17255071987,1336734382,17255064400,-7587,,
15850455270,1325.08992,17255122543,1336784931,17255114950,-7593,,
15850505840,1325.14049,17255173115,1336835498,17255165517,-7598,,
15850556396,1325.19104,17255223674,1336886053,17255216071,-7603,,
15850606981,1325.24163,17255274272,1336936646,17255266664,-7608,,
15850657721,1325.29237,17255325003,1336987372,17255317390,-7613,,
15850708290,1325.34294,17255375575,1337037938,17255367957,-7618,,
15850758381,1325.39303,17255425668,1337088026,17255418045,-7623,,
15851018669,1325.65332,17255685968,1337348300,17255678318,-7650,17255684145,
15851043752,1325.67840,17255711052,1337373382,17255703430,-7622,,
15851094786,1325.72943,17255762089,1337424414,17255754522,-7567,,
15851145847,1325.78049,17255813151,1337475471,17255805638,-7513,,
15851196396,1325.83104,17255863703,1337526018,17255856244,-7459,,
15851246945,1325.88159,17255914255,1337576564,17255906848,-7407,,
15851297599,1325.93225,17255964911,1337627215,17255957559,-7352,,
15851348143,1325.98279,17256015456,1337677756,17256008158,-7298,,
15851398717,1326.03337,17256066034,1337728329,17256058790,-7244,,
15851449324,1326.08397,17256116643,1337778932,17256109453,-7190,,
15851499955,1326.13460,17256167276,1337829561,17256160140,-7136,,
15851550099,1326.18475,17256217423,1337879703,17256210341,-7082,,
15851601178,1326.23583,17256268504,1337930778,17256261476,-7028,,
15851652205,1326.28685,17256319532,1337981802,17256312559,-6973,,
15851702773,1326.33742,17256370103,1338032366,17256363183,-6920,,
15851753350,1326.38800,17256420683,1338082943,17256413818,-6865,,
15851804345,1326.43899,17256471681,1338133934,17256464869,-6812,,
15851854922,1326.48957,17256522260,1338184509,17256515502,-6758,,
15851905549,1326.54020,17256572889,1338235134,17256566186,-6703,,
15851956537,1326.59118,17256623880,1338286119,17256617230,-6650,,
15852007171,1326.64182,17256674515,1338336749,17256667919,-6596,,
15852058123,1326.69277,17256725470,1338387698,17256718929,-6541,,
15852108700,1326.74335,17256776050,1338438273,17256769563,-6487,,
15852159734,1326.79438,17256827086,1338489305,17256820654,-6432,,
15852210647,1326.84530,17256878001,1338540214,17256871622,-6379,,
15852261131,1326.89578,17256928488,1338590697,17256922163,-6325,,
15852311702,1326.94635,17256979061,1338641264,17256972790,-6271,,
15852362068,1326.99672,17257029428,1338691627,17257023211,-6217,,
15852412608,1327.04726,17257079972,1338742164,17257073808,-6164,,
15852463669,1327.09832,17257131044,1338793233,17257124935,-6109,,
15852514385,1327.14903,17257181765,1338843948,17257175710,-6055,,
15852564992,1327.19964,17257232372,1338894550,17257226371,-6001,,
15852615537,1327.25019,17257282910,1338945084,17257276963,-5947,,
15852665659,1327.30031,17257333034,1338995202,17257327140,-5894,,
15852716207,1327.35085,17257383585,1339045748,17257377745,-5840,,
15852766778,1327.40143,17257434158,1339096317,17257428373,-5785,,
15852817831,1327.45248,17257485214,1339147367,17257479482,-5732,,
15852868388,1327.50304,17257535773,1339197920,17257530095,-5678,,
15852918907,1327.55355,17257586294,1339248437,17257580670,-5624,,
15852969987,1327.60463,17257637377,1339299515,17257631808,-5569,,
15853020562,1327.65521,17257687955,1339350088,17257682439,-5516,,
15853071165,1327.70581,17257738559,1339400686,17257733097,-5462,,
15853122206,1327.75685,17257789603,1339451725,17257784195,-5408,,
15853172266,1327.80691,17257839665,1339501782,17257834311,-5354,,
15853222862,1327.85751,17257890263,1339552375,17257884962,-5301,,
15853273912,1327.90856,17257941316,1339603422,17257936069,-5247,,
15853324483,1327.95913,17257991889,1339653991,17257986698,-5191,,
15853375555,1328.01020,17258042963,1339705060,17258037825,-5138,,
15853426562,1328.06121,17258093973,1339756064,17258088890,-5083,,
15853477305,1328.11195,17258144718,1339806805,17258139689,-5029,,
15853528179,1328.16283,17258195595,1339857676,17258190620,-4975,,
15853579231,1328.21388,17258246649,1339908725,17258241740,-4909,,
15853630158,1328.26481,17258297578,1339959649,17258292711,-4867,,
15853681183,1328.31583,17258348606,1340010672,17258343794,-4812,,
15853731735,1328.36638,17258399159,1340061221,17258394401,-4758,,
15853782549,1328.41720,17258449977,1340112032,17258445273,-4704,,
15853833446,1328.46809,17258500876,1340162927,17258496226,-4650,,
15853883996,1328.51864,17258551427,1340213474,17258546833,-4594,,
15853935052,1328.56970,17258602487,1340264527,17258597945,-4542,,
15853985691,1328.62034,17258653127,1340315163,17258648639,-4488,,
15854036233,1328.67088,17258703671,1340365703,17258699239,-4432,,
15854086782,1328.72143,17258754224,1340416250,17258749844,-4380,,
15854137569,1328.77222,17258805013,1340467034,17258800687,-4326,,
15854188768,1328.82342,17258856214,1340518230,17258851943,-4271,,
15854239660,1328.87431,17258907108,1340569119,17258902891,-4217,,
15854290634,1328.92528,17258958084,1340620089,17258953922,-4162,,
15854341267,1328.97591,17259008720,1340670719,17259004611,-4109,,
15854391804,1329.02645,17259059259,1340721255,17259055205,-4054,,
15854442363,1329.07701,17259109820,1340771810,17259105820,-4000,,
15854493452,1329.12810,17259160912,1340822896,17259156965,-3947,,
15854543989,1329.17864,17259211452,1340873432,17259207560,-3892,,
15854594315,1329.22896,17259261780,1340923756,17259257942,-3838,,
15854644493,1329.27914,17259311961,1340973931,17259308175,-3786,,
15854695028,1329.32968,17259362499,1341024463,17259358767,-3732,,
15854745321,1329.37997,17259412792,1341074753,17259409115,-3677,,
15854796061,1329.43071,17259463535,1341125490,17259459911,-3624,,
15854846710,1329.48136,17259514187,1341176137,17259510617,-3570,,
15854897291,1329.53194,17259564770,1341226715,17259561255,-3515,,
15854947949,1329.58260,17259615432,1341277371,17259611970,-3462,,
15854998577,1329.63323,17259666060,1341327995,17259662652,-3408,,
15855049573,1329.68422,17259717059,1341378988,17259713705,-3354,,
15855099957,1329.73461,17259767445,1341429370,17259764145,-3300,,
15855150693,1329.78534,17259818183,1341480103,17259814938,-3245,,
15855201014,1329.83566,17259868507,1341530421,17259865315,-3192,,
15855251311,1329.88596,17259918806,1341580715,17259915667,-3139,,
15855301624,1329.93627,17259969121,1341631026,17259966036,-3085,,
15855351986,1329.98663,17260019487,1341681385,17260016455,-3032,,
15855402473,1330.03712,17260069976,1341731871,17260066999,-2977,,
15855452895,1330.08754,17260120400,1341782289,17260117476,-2924,,
15855503291,1330.13794,17260170798,1341832682,17260167927,-2871,,
15855553900,1330.18855,17260221410,1341883288,17260218592,-2818,,
15855604222,1330.23887,17260271733,1341933608,17260268971,-2762,,
15855654585,1330.28923,17260322100,1341983968,17260319391,-2709,,
15855705293,1330.33994,17260372810,1342034673,17260370155,-2655,,
15855755588,1330.39024,17260423106,1342084966,17260420505,-2601,,
15855806038,1330.44069,17260473559,1342135413,17260471011,-2548,,
15855856424,1330.49107,17260523948,1342185796,17260521453,-2495,,
15855906688,1330.54134,17260574214,1342236058,17260571774,-2440,,
15855957200,1330.59185,17260624729,1342286568,17260622342,-2387,,
15856007589,1330.64224,17260675120,1342336954,17260672787,-2333,,
15856057813,1330.69246,17260725346,1342387174,17260723020,-2326,,
15856108463,1330.74311,17260775998,1342437822,17260773669,-2329,,
15856159266,1330.79391,17260826804,1342488623,17260824469,-2335,,
15856209605,1330.84425,17260877144,1342538958,17260874805,-2339,,
15856260274,1330.89492,17260927816,1342589625,17260925471,-2345,,
15856310885,1330.94553,17260978429,1342640233,17260976079,-2350,,
15856361458,1330.99611,17261029004,1342690803,17261026649,-2355,,
15856411644,1331.04629,17261079194,1342740987,17261076834,-2360,,
15856462208,1331.09686,17261129759,1342791548,17261127395,-2364,,
15856513292,1331.14794,17261180847,1342842629,17261178476,-2371,,
15856564211,1331.19886,17261231768,1342893545,17261229391,-2377,,
15856614983,1331.24963,17261282541,1342944314,17261280161,-2380,,
15856665988,1331.30064,17261333549,1342995317,17261331164,-2385,,
15856716935,1331.35158,17261384499,1343046262,17261382108,-2391,,
15856767808,1331.40246,17261435373,1343097131,17261432977,-2396,,
15856818050,1331.45270,17261485619,1343147371,17261483217,-2402,,
15856869124,1331.50377,17261536695,1343198442,17261534289,-2406,,
15856919716,1331.55436,17261587289,1343249031,17261584888,-2401,,
15856970314,1331.60496,17261637889,1343299627,17261635473,-2416,,
15857020904,1331.65555,17261688481,1343350214,17261686060,-2421,,
15857071942,1331.70659,17261739523,1343401261,17261737107,-2416,,
15857122549,1331.75720,17261790132,1343451853,17261787700,-2432,,
15857173120,1331.80777,17261840705,1343502423,17261838269,-2436,,
15857223233,1331.85788,17261890820,1343552532,17261888378,-2442,,
15857273388,1331.90804,17261940977,1343602684,17261938531,-2446,,
15857323931,1331.95858,17261991523,1343653225,17261989072,-2451,,
15857374517,1332.00916,17262042111,1343703808,17262039654,-2457,,
15857424980,1332.05963,17262092577,1343754269,17262090116,-2461,,
15857475237,1332.10989,17262142836,1343804523,17262140370,-2466,,
15857525348,1332.16000,17262192950,1343854631,17262190478,-2472,,
15857575899,1332.21055,17262243503,1343905179,17262241026,-2477,,
15857626928,1332.26158,17262294534,1343956205,17262292052,-2482,,
15857677369,1332.31202,17262344978,1344006644,17262342491,-2487,,
15857727952,1332.36260,17262395562,1344057224,17262393070,-2492,,
15857778713,1332.41336,17262446325,1344107982,17262443828,-2497,,
15857829251,1332.46390,17262496867,1344158518,17262494365,-2502,,
15857880280,1332.51493,17262547898,1344209545,17262545391,-2507,,
15857930341,1332.56499,17262597961,1344259602,17262595449,-2512,,
15857980888,1332.61554,17262648511,1344310147,17262645994,-2517,,
15858031944,1332.66659,17262699568,1344361200,17262697046,-2522,,
15858082979,1332.71763,17262750607,1344412232,17262748079,-2528,,
15858133522,1332.76817,17262801151,1344462772,17262798618,-2533,,
15858184078,1332.81873,17262851710,1344513327,17262849173,-2537,,
15858235120,1332.86977,17262902754,1344564365,17262900211,-2543,,
15858285711,1332.92036,17262953348,1344614954,17262950800,-2548,,
15858336258,1332.97091,17263003896,1344665498,17263001344,-2552,,
15858386825,1333.02147,17263054466,1344716062,17263051908,-2558,,
15858437859,1333.07251,17263105503,1344767094,17263102940,-2563,,
15858488454,1333.12310,17263156099,1344817685,17263153531,-2568,,
15858539020,1333.17367,17263206669,1344868250,17263204096,-2573,,
15858589163,1333.22381,17263256813,1344918389,17263254235,-2578,,
15858639736,1333.27438,17263307388,1344968959,17263304805,-2583,,
15858690267,1333.32491,17263357923,1345019488,17263355335,-2588,,
15858740446,1333.37509,17263408104,1345069664,17263405511,-2593,,
15858791509,1333.42616,17263459169,1345120725,17263456571,-2598,,
15858842080,1333.47673,17263509743,1345171292,17263507139,-2604,,
15858892869,1333.52752,17263560533,1345222079,17263557925,-2608,,
15858943421,1333.57807,17263611089,1345272628,17263608475,-2614,,
15858993520,1333.62817,17263661189,1345322724,17263658570,-2619,,
15859044073,1333.67872,17263711745,1345373276,17263709122,-2623,,
15859095093,1333.72974,17263762767,1345424292,17263760139,-2628,,
15859146126,1333.78077,17263813803,1345475322,17263811169,-2634,,
15859196683,1333.83133,17263864362,1345525877,17263861724,-2638,,
15859246788,1333.88144,17263914470,1345575979,17263911826,-2644,,
15859297859,1333.93251,17263965542,1345627047,17263962894,-2648,,
15859348569,1333.98322,17264016254,1345677754,17264013600,-2654,,
15859399100,1334.03375,17264066789,1345728284,17264064130,-2659,,
15859449730,1334.08438,17264117420,1345778910,17264114756,-2664,,
15859500317,1334.13496,17264168010,1345829494,17264165341,-2669,,
15859550917,1334.18556,17264218612,1345880092,17264215938,-2674,,
15859600999,1334.23565,17264268697,1345930172,17264266018,-2679,,
15859651669,1334.28632,17264319369,1345980839,17264316685,-2684,,
15859702220,1334.33687,17264369922,1346031386,17264367232,-2690,,
15859752773,1334.38742,17264420477,1346081937,17264417784,-2693,,
15859803465,1334.43811,17264471172,1346132626,17264468473,-2699,,
15859853987,1334.48863,17264521697,1346183146,17264518992,-2705,,
15859904582,1334.53923,17264572294,1346233739,17264569585,-2709,,
15859955364,1334.59001,17264623079,1346284517,17264620364,-2715,,
15860006428,1334.64108,17264674144,1346335578,17264671425,-2719,,
15860057471,1334.69212,17264725200,1346386629,17264722475,-2725,,
15860108513,1334.74316,17264776234,1346437658,17264773504,-2730,,
15860159555,1334.79420,17264827278,1346488697,17264824543,-2735,,
15860210608,1334.84526,17264878333,1346539747,17264875593,-2740,,
15860261164,1334.89581,17264928893,1346590301,17264926148,-2745,,
15860311703,1334.94635,17264979433,1346640837,17264976683,-2750,,
15860362736,1334.99738,17265030469,1346691867,17265027714,-2755,,
15860412788,1335.04744,17265080524,1346741916,17265077763,-2761,,
15860463350,1335.09800,17265131088,1346792476,17265128322,-2766,,
15860513955,1335.14860,17265181696,1346843078,17265178925,-2771,,
15860564574,1335.19922,17265232317,1346893695,17265229541,-2776,,
15860615631,1335.25028,17265283376,1346944750,17265280596,-2780,,
15860666603,1335.30125,17265334351,1346995719,17265331565,-2786,,
15860717148,1335.35180,17265384898,1347046261,17265382107,-2791,,
15860767729,1335.40238,17265435480,1347096838,17265432684,-2796,,
15860818263,1335.45291,17265486017,1347147370,17265483216,-2801,,
15860868861,1335.50351,17265536617,1347197965,17265533811,-2806,,
15860919083,1335.55373,17265586842,1347248184,17265584031,-2811,,
15860970044,1335.60469,17265637806,1347299143,17265634990,-2816,,
15861020589,1335.65524,17265688353,1347349685,17265685532,-2821,,
15861071600,1335.70625,17265739365,1347400693,17265736540,-2825,,
15861122318,1335.75697,17265790086,1347451408,17265787255,-2831,,
15861173372,1335.80802,17265841143,1347502460,17265838307,-2836,,
15861224012,1335.85866,17265891785,1347553097,17265888943,-2842,,
15861275047,1335.90970,17265942823,1347604130,17265939976,-2847,,
15861325575,1335.96022,17265993353,1347654655,17265990502,-2851,,
15861375834,1336.01048,17266043614,1347704911,17266040757,-2857,,
15861426872,1336.06152,17266094655,1347755946,17266091793,-2862,,
15861477946,1336.11259,17266145730,1347807016,17266142863,-2867,,
15861528613,1336.16326,17266196400,1347857682,17266193528,-2872,,
15861579160,1336.21381,17266246950,1347908227,17266244073,-2877,,
15861629752,1336.26440,17266297544,1347958815,17266294662,-2882,,
15861680316,1336.31496,17266348111,1348009377,17266345224,-2887,,
15861731331,1336.36598,17266399127,1348060389,17266396235,-2892,,
15861782369,1336.41702,17266450169,1348111424,17266447271,-2898,,
15861833298,1336.46795,17266501100,1348162350,17266498196,-2904,,
15861884338,1336.51899,17266552141,1348213388,17266549235,-2906,,
15861935158,1336.56981,17266602965,1348264206,17266600053,-2912,,
15861985767,1336.62042,17266653575,1348314811,17266650657,-2918,,
15862036730,1336.67138,17266704541,1348365772,17266701619,-2922,,
15862087787,1336.72243,17266755600,1348416826,17266752672,-2928,,
15862138693,1336.77334,17266806509,1348467730,17266803576,-2933,,
15862189326,1336.82397,17266857144,1348518359,17266854206,-2938,,
15862239938,1336.87459,17266907758,1348568969,17266904815,-2943,,
15862290534,1336.92518,17266958357,1348619562,17266955409,-2948,,
15862341050,1336.97570,17267008876,1348670075,17267005922,-2954,,
15862392125,1337.02677,17267059953,1348721149,17267056995,-2958,,
15862442690,1337.07734,17267110520,1348771711,17267107557,-2963,,
15862493274,1337.12792,17267161106,1348822291,17267158137,-2969,,
15862544026,1337.17867,17267211861,1348873040,17267208887,-2974,,
15862594605,1337.22925,17267262442,1348923617,17267259464,-2978,,
15862645607,1337.28025,17267313446,1348974616,17267310462,-2984,,
15862696656,1337.33130,17267364498,1349025662,17267361509,-2989,,
15862747687,1337.38234,17267415531,1349076692,17267412538,-2993,,
15862798304,1337.43295,17267466150,1349127305,17267463151,-2999,,
15862849357,1337.48401,17267517206,1349178356,17267514203,-3003,,
15862900408,1337.53506,17267568260,1349229403,17267565250,-3010,,
15862950961,1337.58561,17267618814,1349279954,17267615800,-3014,,
15863002008,1337.63666,17267669863,1349330998,17267666844,-3019,,
15863052538,1337.68719,17267720396,1349381525,17267717372,-3024,,
15863103009,1337.73766,17267770870,1349431994,17267767841,-3029,,
15863153578,1337.78823,17267821441,1349482560,17267818407,-3034,,
15863204737,1337.83938,17267872603,1349533717,17267869563,-3040,,
15863255641,1337.89029,17267923509,1349584618,17267920464,-3045,,
15863306203,1337.94085,17267974073,1349635177,17267971024,-3049,,
15863356918,1337.99157,17268024791,1349685889,17268021736,-3055,,
15863407055,1338.04170,17268074930,1349736023,17268071870,-3060,,
15863457635,1338.09228,17268125511,1349786601,17268122447,-3064,,
15863508632,1338.14328,17268176511,1349837595,17268173442,-3069,,
15863559158,1338.19381,17268227039,1349888118,17268223965,-3074,,
15863610233,1338.24488,17268278118,1349939191,17268275037,-3081,,
15863660819,1338.29547,17268328706,1349989775,17268325621,-3085,,
15863711405,1338.34605,17268379295,1350040359,17268376205,-3090,,
15863762462,1338.39711,17268430354,1350091411,17268427258,-3096,,
15863812569,1338.44722,17268480474,1350141528,17268477375,-3099,,
15863863814,1338.49846,17268531710,1350192758,17268528605,-3105,,
15863914536,1338.54918,17268582434,1350243476,17268579323,-3111,,
15863964826,1338.59947,17268632726,1350293764,17268629611,-3115,,
15864015075,1338.64972,17268682978,1350344011,17268679858,-3120,,
15864065544,1338.70019,17268733449,1350394477,17268730323,-3126,,
15864116130,1338.75078,17268784038,1350445061,17268780907,-3131,,
15864166399,1338.80105,17268834308,1350495327,17268831174,-3134,,
15864217451,1338.85210,17268885363,1350546376,17268882223,-3140,,
15864273980,1338.90863,17268941895,1350602903,17268938749,-3146,,
15864324055,1338.95870,17268991973,1350652974,17268988820,-3153,,
15864374589,1339.00924,17269042509,1350703505,17269039352,-3157,,
15864424699,1339.05935,17269092621,1350753613,17269089460,-3161,,
15864475248,1339.10990,17269143172,1350804169,17269140015,-3157,,
15864525395,1339.16004,17269193321,1350854303,17269190149,-3172,,
15864576429,1339.21108,17269244358,1350905335,17269241182,-3176,,
15864627042,1339.26169,17269294974,1350955945,17269291792,-3182,,
15864677517,1339.31217,17269345451,1351006418,17269342264,-3187,,
15864728568,1339.36322,17269396505,1351057466,17269393312,-3193,,
15864779582,1339.41423,17269447521,1351108477,17269444324,-3197,,
15864830013,1339.46466,17269497964,1351158916,17269494762,-3202,,
15864880609,1339.51526,17269548553,1351209499,17269545345,-3208,,
15864931217,1339.56587,17269599163,1351260104,17269595951,-3212,,
15864981775,1339.61642,17269649722,1351310659,17269646505,-3217,,
15865032349,1339.66700,17269700300,1351361240,17269697087,-3213,,
15865082780,1339.71743,17269750733,1351411659,17269747506,-3227,,
15865133326,1339.76797,17269801281,1351462203,17269798049,-3232,,
15865184376,1339.81902,17269852333,1351513249,17269849095,-3238,,
15865235426,1339.87007,17269903385,1351564296,17269900142,-3243,,
15865285548,1339.92020,17269953509,1351614416,17269950262,-3247,,
15865336108,1339.97076,17270004083,1351664984,17270000830,-3253,,
15865387175,1340.02182,17270055142,1351716038,17270051884,-3258,,
15865438123,1340.07277,17270106092,1351766983,17270102830,-3262,,
15865488681,1340.12333,17270156653,1351817549,17270153396,-3257,,
15865539757,1340.17440,17270207730,1351868611,17270204457,-3273,,
15865590342,1340.22499,17270258318,1351919193,17270255039,-3279,,
15865641388,1340.27604,17270309367,1351970238,17270306084,-3283,,
15865691979,1340.32663,17270359961,1352020826,17270356672,-3289,,
15865742539,1340.37719,17270410522,1352071382,17270407228,-3294,,
15865793064,1340.42771,17270461050,1352121905,17270457752,-3298,,
15865843145,1340.47779,17270511133,1352171983,17270507830,-3303,,
15865893730,1340.52838,17270561721,1352222565,17270558412,-3309,,
15865944337,1340.57899,17270612329,1352273170,17270609016,-3313,,
15865994826,1340.62947,17270662821,1352323656,17270659502,-3319,,
15866045217,1340.67987,17270713215,1352374044,17270709891,-3324,,
15866095702,1340.73035,17270763702,1352424527,17270760373,-3329,,
15866145830,1340.78048,17270813832,1352474652,17270810508,-3324,,
15866196884,1340.83153,17270864889,1352525703,17270861549,-3340,,
15866247492,1340.88214,17270915498,1352576308,17270912154,-3344,,
15866298536,1340.93318,17270966546,1352627351,17270963197,-3349,,
15866349534,1340.98418,17271017546,1352678346,17271014192,-3354,,
15866399593,1341.03424,17271067606,1352728401,17271064247,-3359,,
15866454487,1341.08913,17271122503,1352783292,17271119138,-3365,,
15866505488,1341.14014,17271173507,1352834290,17271170137,-3370,,
15866556244,1341.19089,17271224265,1352885044,17271220890,-3375,,
15866606770,1341.24142,17271274793,1352935567,17271271413,-3380,,
15866656825,1341.29147,17271324851,1352985619,17271321466,-3385,,
15866706876,1341.34152,17271374905,1353035669,17271371516,-3389,,
15866757461,1341.39211,17271425491,1353086250,17271422096,-3395,,
15866808486,1341.44313,17271476518,1353137272,17271473118,-3400,,
15866860473,1341.49512,17271528508,1353189263,17271525109,-3399,,
15866911107,1341.54576,17271579144,1353239888,17271575734,-3410,,
15866962132,1341.59678,17271630171,1353290910,17271626756,-3415,,
15867012680,1341.64733,17271680722,1353341455,17271677301,-3421,,
15867062741,1341.69739,17271730786,1353391515,17271727361,-3425,,
15867113764,1341.74841,17271781810,1353442533,17271778380,-3430,,
15867164333,1341.79898,17271832383,1353493100,17271828947,-3436,,
15867214860,1341.84951,17271882911,1353543625,17271879471,-3440,,
15867265208,1341.89986,17271933262,1353593970,17271929817,-3445,,
15867316254,1341.95090,17271984311,1353645013,17271980859,-3452,,
15867366795,1342.00144,17272034853,1353695551,17272031397,-3456,,
15867417352,1342.05200,17272085414,1353746106,17272081953,-3461,,
15867467939,1342.10259,17272136003,1353796690,17272132536,-3467,,
15867518987,1342.15363,17272187053,1353847735,17272183582,-3471,,
15867570035,1342.20468,17272238103,1353898781,17272234627,-3476,,
15867621102,1342.25575,17272289173,1353949845,17272285692,-3481,,
15867672130,1342.30678,17272340202,1354000870,17272336716,-3486,,
15867723168,1342.35782,17272391243,1354051905,17272387751,-3492,,
15867773721,1342.40837,17272441799,1354102456,17272438303,-3496,,
15867824759,1342.45941,17272492839,1354153491,17272489337,-3502,,
15867875808,1342.51046,17272543891,1354204537,17272540383,-3508,,
15867926895,1342.56154,17272594979,1354255621,17272591467,-3512,,
15867977922,1342.61257,17272646009,1354306656,17272642502,-3507,,
15868028989,1342.66364,17272697078,1354357710,17272693556,-3522,,
15868079580,1342.71423,17272747671,1354408298,17272744144,-3527,,
15868130624,1342.76527,17272798719,1354459340,17272795186,-3533,,
15868181661,1342.81631,17272849757,1354510374,17272846220,-3537,,
15868232691,1342.86734,17272900790,1354561402,17272897248,-3542,,
15868283741,1342.91839,17272951843,1354612449,17272948296,-3547,,
15868334284,1342.96893,17273002388,1354662989,17272998836,-3552,,
15868384825,1343.01947,17273052932,1354713527,17273049374,-3558,,
15868435403,1343.07005,17273103512,1354764102,17273099949,-3563,,
15868485534,1343.12018,17273153655,1354814241,17273150088,-3567,,
15868536139,1343.17079,17273204253,1354864833,17273200680,-3573,,
15868586231,1343.22088,17273254347,1354914922,17273250769,-3578,,
15868636348,1343.27100,17273304466,1354965036,17273300882,-3584,,
15868687411,1343.32206,17273355531,1355016097,17273351944,-3587,,
15868737968,1343.37262,17273406091,1355066651,17273402498,-3593,,
15868789032,1343.42368,17273457157,1355117712,17273453559,-3598,,
15868839591,1343.47424,17273507730,1355168281,17273504127,-3603,,
15868890128,1343.52478,17273558258,1355218803,17273554650,-3608,,
15868941050,1343.57570,17273609182,1355269723,17273605569,-3613,,
15868992066,1343.62671,17273660201,1355320735,17273656581,-3620,,
15869042742,1343.67739,17273710878,1355371409,17273707255,-3623,,
15869093353,1343.72800,17273761493,1355422019,17273757865,-3628,,
15869143983,1343.77863,17273812125,1355472644,17273808491,-3634,,
15869194544,1343.82919,17273862687,1355523203,17273859050,-3637,,
15869245044,1343.87969,17273913191,1355573700,17273909547,-3644,,
15869296008,1343.93066,17273964156,1355624661,17273960507,-3649,,
15869346595,1343.98124,17274014757,1355675257,17274011104,-3653,,
15869397423,1344.03207,17274065577,1355726071,17274061918,-3659,,
15869448440,1344.08309,17274116606,1355777096,17274112943,-3663,,
15869499516,1344.13416,17274167674,1355828158,17274164005,-3669,,
15869550603,1344.18525,17274218763,1355879243,17274215089,-3674,,
15869600757,1344.23540,17274268932,1355929406,17274265253,-3679,,
15869651044,1344.28569,17274319221,1355979691,17274315537,-3684,,
15869701604,1344.33625,17274369772,1356030236,17274366083,-3689,,
15869755321,1344.38997,17274423490,1356083950,17274419796,-3694,,
15869805638,1344.44029,17274473811,1356134265,17274470111,-3700,,
15869856794,1344.49144,17274524969,1356185418,17274521264,-3705,,
15869907728,1344.54238,17274575904,1356236348,17274572195,-3709,,
15869958772,1344.59342,17274626952,1356287390,17274623236,-3716,,
15870009810,1344.64446,17274677991,1356338425,17274674271,-3720,,
15870059915,1344.69456,17274728099,1356388528,17274724374,-3725,,
15870110513,1344.74516,17274778711,1356439135,17274774981,-3730,,
15870161110,1344.79576,17274829299,1356489718,17274825564,-3735,,
15870211644,1344.84629,17274879835,1356540249,17274876095,-3740,,
15870262197,1344.89684,17274930391,1356590800,17274926647,-3744,,
15870312798,1344.94745,17274980994,1356641397,17274977244,-3750,,
15870363779,1344.99843,17275031978,1356692375,17275028222,-3756,,
15870413837,1345.04849,17275082038,1356742430,17275078276,-3762,,
15870463894,1345.09854,17275132097,1356792485,17275128332,-3765,,
15870514822,1345.14947,17275183027,1356843410,17275179256,-3771,,
15870565818,1345.20047,17275234027,1356894404,17275230251,-3776,,
15870616450,1345.25110,17275284659,1356945033,17275280879,-3780,,
15870666876,1345.30152,17275335089,1356995457,17275331303,-3786,,
15870718000,1345.35265,17275386215,1357046577,17275382424,-3791,,
15870768874,1345.40352,17275437091,1357097449,17275433295,-3796,,
15870819875,1345.45452,17275488094,1357148447,17275484293,-3801,,
15870870500,1345.50515,17275538722,1357199070,17275534916,-3806,,
15870921328,1345.55598,17275589551,1357249894,17275585740,-3811,,
15870971913,1345.60656,17275640140,1357300477,17275636324,-3816,,
15871022670,1345.65732,17275690899,1357351231,17275687078,-3821,,
15871073291,1345.70794,17275741523,1357401849,17275737696,-3827,,
15871124367,1345.75902,17275792601,1357452923,17275788769,-3832,,
15871175409,1345.81006,17275843644,1357503962,17275839818,-3826,,
15871226443,1345.86109,17275894682,1357554994,17275890840,-3842,,
15871277056,1345.91170,17275945297,1357605603,17275941450,-3847,,
15871327681,1345.96233,17275995924,1357656227,17275992074,-3850,,
15871378698,1346.01335,17276046944,1357707241,17276043087,-3857,,
15871429235,1346.06388,17276097482,1357757774,17276093621,-3861,,
15871479873,1346.11452,17276148122,1357808409,17276144256,-3866,,
15871530925,1346.16557,17276199178,1357859460,17276195306,-3872,,
15871581020,1346.21567,17276249274,1357909551,17276245397,-3877,,
15871631603,1346.26625,17276299860,1357960131,17276295977,-3883,,
15871681769,1346.31642,17276350029,1358010296,17276346142,-3887,,
15871732464,1346.36711,17276400726,1358060987,17276396834,-3892,,
15871783056,1346.41770,17276451321,1358111577,17276447423,-3898,,
15871833543,1346.46819,17276501817,1358162071,17276497918,-3899,,
15871884554,1346.51920,17276552822,1358213069,17276548916,-3906,,
15871935078,1346.56973,17276603349,1358263590,17276599436,-3913,,
15871985127,1346.61977,17276653401,1358313637,17276649483,-3918,,
15872035696,1346.67034,17276703972,1358364204,17276700050,-3922,,
15872086271,1346.72092,17276754550,1358414776,17276750622,-3928,,
15872136797,1346.77145,17276805078,1358465299,17276801145,-3933,,
15872187834,1346.82248,17276856117,1358516333,17276852179,-3938,,
15872237909,1346.87256,17276906206,1358566417,17276902263,-3943,,
15872288955,1346.92360,17276957243,1358617449,17276953295,-3948,,
15872339034,1346.97368,17277007324,1358667524,17277003370,-3954,,
15872389559,1347.02421,17277057852,1358718048,17277053894,-3958,,
15872439632,1347.07428,17277107927,1358768117,17277103964,-3963,,
15872490217,1347.12486,17277158514,1358818699,17277154546,-3968,,
15872540789,1347.17544,17277209089,1358869270,17277205116,-3973,,
15872590894,1347.22554,17277259195,1358919371,17277255217,-3978,,
15872641409,1347.27606,17277309712,1358969883,17277305729,-3983,,
15872692444,1347.32709,17277360751,1359020915,17277356762,-3989,,
15872742518,1347.37717,17277410827,1359070987,17277406834,-3993,,
15872793042,1347.42769,17277461354,1359121509,17277457355,-3999,,
15872843098,1347.47775,17277511412,1359171561,17277507408,-4004,,
15872893656,1347.52830,17277561971,1359222117,17277557963,-4008,,
15872944570,1347.57922,17277612900,1359273040,17277608886,-4014,,
15872994754,1347.62940,17277663075,1359323209,17277659055,-4020,,
15873045318,1347.67997,17277713641,1359373772,17277709618,-4023,,
15873096364,1347.73101,17277764689,1359424814,17277760660,-4029,,
15873147340,1347.78199,17277815667,1359475787,17277811633,-4034,,
15873197859,1347.83251,17277866188,1359526303,17277862150,-4038,,
15873248182,1347.88283,17277916514,1359576624,17277912470,-4044,,
15873300003,1347.93465,17277968337,1359628442,17277964288,-4049,,
15873350280,1347.98493,17278018616,1359678716,17278014562,-4054,,
15873401303,1348.03595,17278069643,1359729738,17278065584,-4059,,
15873452353,1348.08700,17278120695,1359780785,17278116631,-4064,,
15873502399,1348.13705,17278170744,1359830827,17278166674,-4070,,
15873552451,1348.18710,17278220798,1359880876,17278216723,-4075,,
15873602602,1348.23725,17278270951,1359931025,17278266872,-4079,,
15873653064,1348.28771,17278321416,1359981485,17278317331,-4085,,
15873703602,1348.33825,17278371955,1360032019,17278367865,-4090,,
15873754138,1348.38879,17278422493,1360082553,17278418400,-4093,,
15873804201,1348.43885,17278472560,1360132614,17278468460,-4100,,
15873855269,1348.48992,17278523630,1360183678,17278519525,-4105,,
15873906298,1348.54095,17278574661,1360234706,17278570552,-4109,,
15873956834,1348.59148,17278625199,1360285238,17278621084,-4115,,
15874006896,1348.64154,17278675263,1360335297,17278671144,-4119,,
15874057443,1348.69209,17278725813,1360385841,17278721688,-4125,,
15874108004,1348.74265,17278776377,1360436400,17278772247,-4130,,
15874159335,1348.79398,17278827710,1360487729,17278823575,-4135,,
15874209550,1348.84420,17278877928,1360537941,17278873788,-4140,,
15874259598,1348.89425,17278927978,1360587986,17278923833,-4145,,
15874309644,1348.94429,17278978026,1360638030,17278973876,-4150,,
15874359700,1348.99435,17279028084,1360688083,17279023929,-4155,,
15874414520,1349.04917,17279082907,1360742900,17279078746,-4161,,
15874465291,1349.09994,17279133680,1360793669,17279129515,-4165,,
15874515844,1349.15049,17279184236,1360844219,17279180065,-4171,,
15874565891,1349.20054,17279234285,1360894263,17279230109,-4176,,
15874616435,1349.25108,17279284830,1360944804,17279280650,-4180,,
15874666532,1349.30118,17279334932,1360994900,17279330746,-4186,,
15874717545,1349.35219,17279385946,1361045908,17279381755,-4191,,
15874768382,1349.40303,17279436785,1361096743,17279432590,-4195,,
15874819397,1349.45404,17279487803,1361147756,17279483602,-4201,,
15874869945,1349.50459,17279538352,1361198300,17279534146,-4206,,
15874920989,1349.55564,17279589399,1361249342,17279585188,-4211,,
15874971539,1349.60619,17279639952,1361299890,17279635736,-4216,,
15875022575,1349.65722,17279690991,1361350923,17279686770,-4221,,
15875072644,1349.70729,17279741062,1361400989,17279736835,-4227,,
15875123683,1349.75833,17279792103,1361452024,17279787871,-4232,,
15875174240,1349.80889,17279842662,1361502580,17279838426,-4236,,
15875224425,1349.85907,17279892849,1361552761,17279888607,-4242,,
15875274992,1349.90964,17279943418,1361603325,17279939171,-4247,,
15875325587,1349.96024,17279994016,1361653919,17279989765,-4251,,
15875376622,1350.01127,17280045054,1361704951,17280040797,-4257,,
15875427311,1350.06196,17280095745,1361755637,17280091483,-4262,,
15875477360,1350.11201,17280145796,1361805683,17280141529,-4267,,
15875527661,1350.16231,17280196100,1361855982,17280191829,-4271,,
15875578344,1350.21299,17280246785,1361906662,17280242508,-4277,,
15875628904,1350.26355,17280297347,1361957219,17280293065,-4282,,
15875679592,1350.31424,17280348038,1362007904,17280343751,-4287,,
15875730149,1350.36480,17280398597,1362058459,17280394305,-4292,,
15875780678,1350.41533,17280449128,1362108985,17280444831,-4297,,
15875830798,1350.46545,17280499250,1362159102,17280494948,-4302,,
15875881329,1350.51598,17280549783,1362209630,17280545477,-4306,,
15875932103,1350.56675,17280600560,1362260402,17280596248,-4312,,
15875982686,1350.61733,17280651145,1362310981,17280646828,-4317,,
15876033282,1350.66793,17280701744,1362361576,17280697423,-4321,,
15876083661,1350.71831,17280752126,1362411951,17280747798,-4328,,
15876133714,1350.76836,17280802181,1362462001,17280797848,-4333,,
15876184250,1350.81890,17280852719,1362512536,17280848382,-4337,,
15876234919,1350.86957,17280903391,1362563201,17280899048,-4343,,
15876285931,1350.92058,17280954404,1362614210,17280950056,-4348,,
15876336466,1350.97111,17281004941,1362664743,17281000589,-4352,,
15876386517,1351.02117,17281054996,1362714791,17281050638,-4358,,
15876437065,1351.07171,17281105545,1362765336,17281101182,-4363,,
15876487600,1351.12225,17281156082,1362815868,17281151714,-4368,,
15876537693,1351.17234,17281206178,1362865959,17281201805,-4373,,
15876588210,1351.22286,17281256697,1362916473,17281252319,-4378,,
15876639245,1351.27389,17281307735,1362967505,17281303352,-4383,,
15876689306,1351.32395,17281357799,1363017564,17281353411,-4388,,
15876739852,1351.37450,17281408347,1363068107,17281403954,-4393,,
15876790403,1351.42505,17281458900,1363118655,17281454502,-4398,,
15876840442,1351.47509,17281508942,1363168693,17281504539,-4403,,
15876890499,1351.52515,17281559001,1363218746,17281554593,-4408,,
15876941545,1351.57619,17281610049,1363269789,17281605636,-4413,,
15876992586,1351.62723,17281661092,1363320827,17281656673,-4419,,
15877043624,1351.67827,17281712133,1363371863,17281707710,-4423,,
15877093680,1351.72833,17281762192,1363421916,17281757763,-4429,,
15877143728,1351.77838,17281812241,1363471961,17281807807,-4434,,
15877193764,1351.82841,17281862280,1363521995,17281857842,-4438,,
15877243837,1351.87848,17281912354,1363572065,17281907911,-4443,,
15877294386,1351.92903,17281962906,1363622611,17281958457,-4449,,
15877345433,1351.98008,17282013956,1363673656,17282009503,-4453,,
15877395980,1352.03063,17282064505,1363724200,17282060046,-4459,,
15877446518,1352.08117,17282115046,1363774736,17282110582,-4464,,
15877496579,1352.13123,17282165109,1363824793,17282160639,-4470,,
15877547123,1352.18177,17282215655,1363875335,17282211181,-4474,,
15877597173,1352.23182,17282265708,1363925383,17282261229,-4479,,
15877647199,1352.28185,17282315736,1363975406,17282311252,-4484,,
15877697758,1352.33241,17282366297,1364025962,17282361808,-4489,,
15877748817,1352.38346,17282417359,1364077018,17282412864,-4495,,
15877799366,1352.43401,17282467909,1364127564,17282463410,-4499,,
15877850015,1352.48466,17282518562,1364178211,17282514058,-4504,,
15877900575,1352.53522,17282569124,1364228768,17282564615,-4509,,
15877951613,1352.58626,17282620163,1364279803,17282615649,-4514,,
15878002159,1352.63681,17282670712,1364330346,17282666192,-4520,,
15878052562,1352.68721,17282721118,1364380747,17282716594,-4524,,
15878102632,1352.73728,17282771189,1364430814,17282766660,-4529,,
15878153183,1352.78783,17282821744,1364481362,17282817209,-4535,,
15878203707,1352.83836,17282872270,1364531884,17282867731,-4539,,
15878253748,1352.88840,17282922312,1364581922,17282917768,-4544,,
15878303812,1352.93846,17282972380,1364631984,17282967830,-4550,,
15878354357,1352.98900,17283022926,1364682526,17283018373,-4553,,
15878404403,1353.03905,17283072975,1364732569,17283068416,-4559,,
15878454570,1353.08922,17283123145,1364782734,17283118580,-4565,,
15878505034,1353.13968,17283173610,1364833195,17283169041,-4569,,
15878555558,1353.19021,17283224137,1364883716,17283219563,-4574,,
15878606119,1353.24077,17283274700,1364934274,17283270120,-4580,,
15878656622,1353.29127,17283325206,1364984774,17283320620,-4586,,
15878707171,1353.34182,17283375758,1365035321,17283371168,-4590,,
15878757724,1353.39237,17283426313,1365085872,17283421718,-4595,,
15878807776,1353.44242,17283476367,1365135920,17283471766,-4601,,
15878858802,1353.49345,17283527396,1365186945,17283522791,-4605,,
15878908875,1353.54352,17283577476,1365237020,17283572866,-4610,,
15878959747,1353.59440,17283628345,1365287884,17283623730,-4615,,
15879010283,1353.64493,17283678883,1365338416,17283674262,-4621,,
15879060824,1353.69547,17283729426,1365388955,17283724801,-4625,,
15879111420,1353.74607,17283780025,1365439548,17283775395,-4630,,
15879161488,1353.79614,17283830096,1365489613,17283825460,-4636,,
15879211539,1353.84619,17283880149,1365539663,17283875509,-4640,,
15879262577,1353.89722,17283931188,1365590697,17283926543,-4645,,
15879313134,1353.94778,17283981749,1365641252,17283977098,-4651,,
15879363186,1353.99783,17284031802,1365691301,17284027148,-4654,,
15879413734,1354.04838,17284082353,1365741846,17284077693,-4660,,
15879464774,1354.09942,17284133396,1365792883,17284128729,-4667,,
15879514832,1354.14948,17284183456,1365842939,17284178785,-4671,,
15879565365,1354.20001,17284233991,1365893469,17284229316,-4675,,
15879616367,1354.25102,17284284996,1365944468,17284280315,-4681,,
15879666858,1354.30151,17284335489,1365994957,17284330803,-4686,,
15879717922,1354.35257,17284386555,1366046018,17284381864,-4691,,
15879768455,1354.40310,17284437090,1366096548,17284432395,-4695,,
15879819503,1354.45415,17284488141,1366147594,17284483440,-4701,,
15879869629,1354.50428,17284538269,1366197717,17284533563,-4706,,
15879919688,1354.55434,17284588331,1366247774,17284583620,-4711,,
15879970217,1354.60487,17284638861,1366298299,17284634145,-4716,,
15880020293,1354.65494,17284688940,1366348372,17284684218,-4722,,
15880070860,1354.70551,17284739511,1366398939,17284734785,-4726,,
15880121884,1354.75653,17284790536,1366449959,17284785805,-4731,,
15880172471,1354.80712,17284841126,1366500543,17284836389,-4737,,
15880223520,1354.85817,17284892177,1366551589,17284887436,-4741,,
15880274569,1354.90922,17284943227,1366602635,17284938481,-4746,,
15880325596,1354.96024,17284994257,1366653659,17284989505,-4752,,
15880376666,1355.01131,17285045330,1366704726,17285040573,-4757,,
15880427226,1355.06187,17285095893,1366755284,17285091131,-4762,,
15880478213,1355.11286,17285146881,1366806268,17285142114,-4767,,
15880528763,1355.16341,17285197433,1366856815,17285192661,-4772,,
15880579298,1355.21395,17285247971,1366907348,17285243194,-4777,,
15880629402,1355.26405,17285298078,1366957450,17285293297,-4781,,
15880680013,1355.31466,17285348691,1367008058,17285343904,-4787,,
15880731050,1355.36570,17285399731,1367059091,17285394938,-4793,,
15880782129,1355.41678,17285450812,1367110168,17285446015,-4797,,
15880832757,1355.46741,17285501442,1367160794,17285496652,-4790,,
15880883801,1355.51845,17285552488,1367211834,17285547680,-4808,,
15880934465,1355.56911,17285603154,1367262496,17285598342,-4812,,
15880985137,1355.61979,17285653829,1367313166,17285649012,-4817,,
15881036221,1355.67087,17285704915,1367364246,17285700092,-4823,,
15881086392,1355.72104,17285755099,1367414425,17285750271,-4828,,
15881136966,1355.77161,17285805665,1367464986,17285800832,-4833,,
15881187376,1355.82202,17285856077,1367515393,17285851240,-4837,,
15881237937,1355.87259,17285906641,1367565952,17285901798,-4843,,
15881288059,1355.92271,17285956765,1367616071,17285951918,-4847,,
15881338637,1355.97329,17286007346,1367666646,17286002493,-4853,,
15881388926,1356.02357,17286057637,1367716932,17286052779,-4858,,
15881439951,1356.07460,17286108665,1367767955,17286103801,-4864,,
15881490503,1356.12515,17286159218,1367818504,17286154350,-4868,,
15881541612,1356.17626,17286210331,1367869612,17286205458,-4873,,
15881592117,1356.22676,17286260838,1367920113,17286255959,-4879,,
15881642645,1356.27729,17286311367,1367970638,17286306484,-4883,,
15881693220,1356.32787,17286361944,1368021210,17286357056,-4888,,
15881743913,1356.37856,17286412652,1368071912,17286407758,-4894,,
15881794980,1356.42963,17286463709,1368122965,17286458811,-4898,,
15881846024,1356.48067,17286514756,1368174007,17286509853,-4903,,
15881896650,1356.53130,17286565384,1368224629,17286560475,-4909,,
15881947265,1356.58191,17286616002,1368275241,17286611088,-4914,,
15881998258,1356.63291,17286666998,1368326232,17286662079,-4919,,
15882048554,1356.68320,17286717296,1368376525,17286712372,-4924,,
15882099076,1356.73372,17286767821,1368427046,17286762892,-4929,,
15882149326,1356.78397,17286818073,1368477292,17286813139,-4934,,
15882199939,1356.83459,17286868688,1368527902,17286863749,-4939,,
15882250588,1356.88524,17286919339,1368578548,17286914395,-4944,,
15882301061,1356.93571,17286969815,1368629018,17286964865,-4950,,
15882351653,1356.98630,17287020409,1368679608,17287015455,-4954,,
15882402222,1357.03687,17287070980,1368730174,17287066021,-4959,,
15882452860,1357.08751,17287121621,1368780810,17287116656,-4965,,
15882503868,1357.13852,17287172630,1368831815,17287167662,-4968,,
15882554412,1357.18906,17287223177,1368882356,17287218203,-4974,,
15882605459,1357.24011,17287274227,1368933401,17287269247,-4980,,
15882655605,1357.29025,17287324386,1368983554,17287319401,-4985,,
15882706188,1357.34084,17287374960,1369034125,17287369971,-4989,,
15882756692,1357.39134,17287425467,1369084626,17287420472,-4995,,
15882807280,1357.44193,17287476057,1369135210,17287471056,-5001,,
15882857858,1357.49251,17287526638,1369185787,17287521633,-5005,,
15882908879,1357.54353,17287577660,1369236804,17287572651,-5009,,
15882959404,1357.59405,17287628188,1369287327,17287623173,-5015,,
15883009923,1357.64457,17287678710,1369337844,17287673690,-5020,,
15883060463,1357.69511,17287729252,1369388381,17287724227,-5025,,
15883110997,1357.74564,17287779798,1369438922,17287774769,-5029,,
15883162052,1357.79670,17287830846,1369489963,17287825809,-5037,,
15883212624,1357.84727,17287881419,1369540533,17287876379,-5040,,
15883263648,1357.89830,17287932445,1369591554,17287927400,-5045,,
15883314283,1357.94893,17287983083,1369642186,17287978033,-5050,,
15883365304,1357.99995,17288034107,1369693204,17288029051,-5056,,
15883415866,1358.05051,17288084670,1369743764,17288079610,-5060,,
15883466932,1358.10158,17288135750,1369794838,17288130684,-5066,,
15883517957,1358.15260,17288186767,1369845850,17288181696,-5071,,
15883568756,1358.20340,17288237570,1369896647,17288232494,-5076,,
15883619032,1358.25368,17288287847,1369946921,17288282767,-5080,,
15883669622,1358.30427,17288338439,1369997507,17288333354,-5085,,
15883720662,1358.35531,17288389481,1370048543,17288384389,-5092,,
15883771223,1358.40587,17288440045,1370099103,17288434949,-5096,,
15883822224,1358.45687,17288491048,1370150100,17288485947,-5101,,
15883873270,1358.50792,17288542097,1370201143,17288536990,-5107,,
15883923844,1358.55849,17288592673,1370251715,17288587561,-5112,,
15883974683,1358.60933,17288643514,1370302552,17288638398,-5116,,
15884025723,1358.66037,17288694557,1370353588,17288689435,-5122,,
15884076728,1358.71138,17288745564,1370404590,17288740437,-5127,,
15884127801,1358.76245,17288796640,1370455661,17288791508,-5132,,
15884178845,1358.81349,17288847686,1370506702,17288842548,-5138,,
15884229895,1358.86454,17288898737,1370557749,17288893595,-5142,,
15884280016,1358.91466,17288948861,1370607868,17288943714,-5147,,
15884330548,1358.96520,17288999396,1370658398,17288994244,-5152,,
15884381543,1359.01619,17289050392,1370709389,17289045235,-5157,,
15884445653,1359.08030,17289114505,1370773496,17289109342,-5163,,
15884499741,1359.13439,17289168597,1370827581,17289163428,-5169,,
15884550155,1359.18480,17289219012,1370877992,17289213838,-5174,,
15884600212,1359.23486,17289269072,1370928046,17289263892,-5180,,
15884650872,1359.28552,17289319735,1370978704,17289314551,-5184,,
15884701300,1359.33595,17289370165,1371029129,17289364976,-5189,,
15884752336,1359.38698,17289421204,1371080162,17289416009,-5195,,
15884802398,1359.43705,17289471268,1371130223,17289466069,-5199,,
15884852935,1359.48758,17289521812,1371180768,17289516614,-5198,,
15884903494,1359.53814,17289572369,1371231313,17289567159,-5210,,
15884954036,1359.58868,17289622912,1371281851,17289617697,-5215,,
15885005435,1359.64008,17289674313,1371333248,17289669094,-5219,,
15885055641,1359.69029,17289724522,1371383450,17289719297,-5225,,
15885106330,1359.74098,17289775213,1371434137,17289769983,-5230,,
15885157381,1359.79203,17289826267,1371485187,17289821033,-5234,,
15885207832,1359.84248,17289876720,1371535634,17289871480,-5240,,
15885258621,1359.89327,17289927512,1371586420,17289922267,-5245,,
15885308927,1359.94358,17289977821,1371636724,17289972571,-5250,,
15885359811,1359.99446,17290028707,1371687606,17290023452,-5255,,
15885410822,1360.04547,17290079720,1371738614,17290074461,-5259,,
15885461377,1360.09603,17290130278,1371789166,17290125012,-5266,,
15885513531,1360.14818,17290182433,1371841317,17290177163,-5270,,
15885563738,1360.19839,17290232642,1371891521,17290227367,-5275,,
15885615080,1360.24973,17290283987,1371942860,17290278706,-5281,,
15885665426,1360.30007,17290334335,1371993202,17290329049,-5286,,
15885718565,1360.35321,17290387478,1372046340,17290382187,-5291,,
15885769441,1360.40409,17290438355,1372097213,17290433059,-5296,,
15885820471,1360.45512,17290489388,1372148240,17290484087,-5301,,
15885872535,1360.50718,17290541454,1372200301,17290536147,-5307,,
15885923049,1360.55770,17290591970,1372250813,17290586659,-5311,,
15885973622,1360.60827,17290642546,1372301383,17290637229,-5317,,
15886024644,1360.65929,17290693570,1372352402,17290688248,-5322,,
15886074710,1360.70936,17290743639,1372402466,17290738313,-5326,,
15886125251,1360.75990,17290794181,1372453004,17290788850,-5331,,
15886175802,1360.81045,17290844735,1372503552,17290839398,-5337,,
15886226325,1360.86097,17290895261,1372554072,17290889919,-5342,,
15886277434,1360.91208,17290946372,1372605179,17290941025,-5347,,
15886327938,1360.96259,17290996878,1372655680,17290991527,-5351,,
15886378518,1361.01317,17291047461,1372706258,17291042104,-5357,,
15886429033,1361.06368,17291097979,1372756771,17291092617,-5362,,
15886480101,1361.11475,17291149049,1372807835,17291143682,-5367,,
15886531118,1361.16577,17291200067,1372858849,17291194695,-5372,,
15886581175,1361.21582,17291250127,1372908903,17291244749,-5378,,
15886631249,1361.26590,17291300203,1372958975,17291294822,-5381,,
15886681776,1361.31642,17291350732,1373009499,17291345345,-5387,,
15886731823,1361.36647,17291400783,1373059544,17291395390,-5393,,
15886783409,1361.41806,17291452370,1373111127,17291446973,-5397,,
15886833978,1361.46863,17291502942,1373161694,17291497540,-5402,,
15886884990,1361.51964,17291553957,1373212702,17291548549,-5408,,
15886936043,1361.57069,17291605011,1373263752,17291599598,-5413,,
15886987078,1361.62173,17291656050,1373314785,17291650631,-5419,,
15887038117,1361.67277,17291707090,1373365821,17291701667,-5423,,
15887088686,1361.72333,17291757661,1373416387,17291752233,-5428,,
15887139735,1361.77438,17291808714,1373467434,17291803281,-5433,,
15887190773,1361.82542,17291859754,1373518469,17291854316,-5438,,
15887241271,1361.87592,17291910254,1373568964,17291904811,-5443,,
15887292289,1361.92694,17291961274,1373619979,17291955826,-5448,,
15887342363,1361.97701,17292011350,1373670051,17292005897,-5453,,
15887392929,1362.02758,17292061918,1373720614,17292056461,-5457,,
15887443784,1362.07843,17292112778,1373771467,17292107314,-5464,,
15887494854,1362.12950,17292163848,1373822534,17292158380,-5468,,
15887545903,1362.18055,17292214900,1373873580,17292209426,-5474,,
15887596121,1362.23077,17292265120,1373923795,17292259641,-5479,,
15887646220,1362.28087,17292315222,1373973891,17292309738,-5484,,
15887696790,1362.33144,17292365795,1374024470,17292360316,-5479,,
15887747467,1362.38212,17292416474,1374075134,17292410980,-5494,,
15887797941,1362.43259,17292466950,1374125615,17292461461,-5489,,
15887848559,1362.48321,17292517571,1374176220,17292512067,-5504,,
15887899118,1362.53377,17292568132,1374226776,17292562623,-5509,,
15887949657,1362.58431,17292618672,1374277311,17292613158,-5514,,
15888000252,1362.63490,17292669270,1374327905,17292663751,-5519,,
15888051331,1362.68598,17292720352,1374378982,17292714828,-5524,,
15888101847,1362.73650,17292770870,1374429494,17292765341,-5529,,
15888152395,1362.78704,17292821421,1374480040,17292815886,-5535,,
15888203432,1362.83808,17292872460,1374531075,17292866921,-5539,,
15888253767,1362.88841,17292922799,1374581409,17292917255,-5544,,
15888304296,1362.93894,17292973328,1374631932,17292967778,-5550,,
15888354899,1362.98955,17293023933,1374682533,17293018379,-5554,,
15888405919,1363.04057,17293074957,1374733550,17293069397,-5560,,
15888456581,1363.09123,17293125621,1374784210,17293120056,-5565,,
15888507567,1363.14222,17293176609,1374835192,17293171039,-5570,,
15888557665,1363.19231,17293226710,1374885288,17293221135,-5575,,
15888608212,1363.24286,17293277259,1374935832,17293271679,-5580,,
15888658931,1363.29358,17293327980,1374986549,17293322395,-5585,,
15888709813,1363.34446,17293378864,1375037427,17293373274,-5590,,
15888760339,1363.39499,17293429392,1375087951,17293423797,-5595,,
15888810394,1363.44504,17293479450,1375138003,17293473850,-5600,,
15888860976,1363.49562,17293530035,1375188582,17293524429,-5606,,
15888911588,1363.54624,17293580649,1375239192,17293575038,-5611,,
15888962048,1363.59670,17293631110,1375289649,17293625495,-5615,,
15889012210,1363.64686,17293681276,1375339808,17293675655,-5621,,
15889062788,1363.69744,17293731855,1375390384,17293726230,-5625,,
15889113314,1363.74796,17293782383,1375440907,17293776753,-5630,,
15889163499,1363.79815,17293832572,1375491089,17293826936,-5636,,
15889214557,1363.84920,17293883632,1375542145,17293877992,-5640,,
15889265159,1363.89981,17293934236,1375592745,17293928592,-5644,,
15889319558,1363.95421,17293988638,1375647140,17293982987,-5651,,
15889370228,1364.00488,17294039309,1375697807,17294033653,-5656,,
15889424779,1364.05943,17294093864,1375752356,17294088202,-5662,,
15889475617,1364.11027,17294144704,1375803192,17294139038,-5666,,
15889526373,1364.16102,17294195463,1375853945,17294189791,-5672,,
15889576956,1364.21160,17294246048,1375904524,17294240371,-5677,,
15889627968,1364.26262,17294297062,1375955534,17294291380,-5682,,
15889678020,1364.31267,17294347116,1376005583,17294341429,-5687,,
15889728570,1364.36322,17294397669,1376056131,17294391977,-5692,,
15889779106,1364.41375,17294448207,1376106663,17294442510,-5697,,
15889829169,1364.46382,17294498273,1376156725,17294492571,-5702,,
15889880735,1364.51538,17294549841,1376208288,17294544134,-5707,,
15889931290,1364.56594,17294600398,1376258839,17294594685,-5713,,
15889981890,1364.61654,17294651001,1376309437,17294645284,-5717,,
15890035411,1364.67006,17294704523,1376362955,17294698801,-5722,,
15890085913,1364.72056,17294755029,1376413454,17294749300,-5729,,
15890136448,1364.77110,17294805565,1376463986,17294799832,-5733,,
15890186509,1364.82116,17294855629,1376514045,17294849891,-5738,,
15890236885,1364.87153,17294906008,1376564419,17294900266,-5742,,
15890319479,1364.95413,17294988606,1376647008,17294982854,-5752,,
15890378551,1365.01320,17295047680,1376706076,17295041923,-5757,,
15890433001,1365.06765,17295102133,1376760523,17295096370,-5763,,
15890500035,1365.13468,17295169169,1376827554,17295163400,-5769,,
15890553799,1365.18845,17295222936,1376881315,17295217162,-5774,,
15890604398,1365.23905,17295273538,1376931911,17295267758,-5780,,
15890655397,1365.29004,17295324538,1376982907,17295318753,-5785,,
15890706172,1365.34082,17295375315,1377033680,17295369526,-5789,,
15890756425,1365.39107,17295425571,1377083930,17295419776,-5795,,
15890806827,1365.44148,17295475975,1377134329,17295470175,-5800,,
15890907241,1365.54189,17295576394,1377234738,17295570584,-5810,,
15890961797,1365.59644,17295630952,1377289291,17295625137,-5815,,
15891012450,1365.64710,17295681608,1377339941,17295675787,-5821,,
15891063281,1365.69793,17295732442,1377390770,17295726617,-5825,,
15891133047,1365.76770,17295802211,1377460533,17295796379,-5832,,
15891186409,1365.82106,17295855576,1377513891,17295849737,-5839,,
15891239152,1365.87380,17295908320,1377566631,17295902477,-5843,,
15891289763,1365.92441,17295958934,1377617239,17295953086,-5848,,
15891341618,1365.97627,17296010791,1377669092,17296004939,-5852,,
15891392804,1366.02745,17296061979,1377720275,17296056121,-5858,,
15891443015,1366.07766,17296112193,1377770482,17296106329,-5864,,
15891493198,1366.12785,17296162379,1377820664,17296156511,-5868,,
15891543583,1366.17823,17296212765,1377871046,17296206893,-5872,,
15891619744,1366.25439,17296288930,1377947203,17296283049,-5881,,
15891672858,1366.30751,17296342047,1378000315,17296336161,-5886,,
15891739042,1366.37369,17296408235,1378066494,17296402341,-5894,,
15891798667,1366.43331,17296467861,1378126116,17296461962,-5899,,
15891850879,1366.48553,17296520077,1378178326,17296514173,-5904,,
15891901500,1366.53615,17296570699,1378228944,17296564790,-5909,,
15891953689,1366.58834,17296622891,1378281130,17296616976,-5915,,
15892004389,1366.63904,17296673593,1378331826,17296667673,-5920,,
15892054939,1366.68959,17296724146,1378382376,17296718222,-5924,,
15892105647,1366.74030,17296774856,1378433080,17296768926,-5930,,
15892156006,1366.79065,17296825217,1378483436,17296819282,-5935,,
15892206699,1366.84135,17296875913,1378534126,17296869973,-5940,,
15892257209,1366.89186,17296926425,1378584634,17296920480,-5945,,
15892319398,1366.95405,17296988617,1378646818,17296982665,-5952,,
15892380910,1367.01556,17297050132,1378708328,17297044175,-5957,,
15892431789,1367.06644,17297101013,1378759204,17297095050,-5963,,
15892482430,1367.11708,17297151656,1378809843,17297145689,-5967,,
15892532980,1367.16763,17297202209,1378860390,17297196237,-5972,,
15892583512,1367.21816,17297252743,1378910919,17297246765,-5978,,
15892635369,1367.27002,17297304602,1378962773,17297298620,-5982,,
15892685860,1367.32051,17297355097,1379013262,17297349109,-5988,,
15892736255,1367.37090,17297405493,1379063653,17297399500,-5993,,
15892802994,1367.43764,17297472235,1379130390,17297466236,-5999,,
15892869378,1367.50403,17297538622,1379196770,17297532616,-6006,,
15892919754,1367.55440,17297589000,1379247143,17297582989,-6011,,
15892982019,1367.61667,17297651269,1379309405,17297645252,-6017,,
15893033005,1367.66765,17297702257,1379360388,17297696235,-6022,,
15893083667,1367.71832,17297752922,1379411049,17297746895,-6027,,
15893133862,1367.76851,17297803118,1379461240,17297797086,-6032,,
15893184209,1367.81886,17297853468,1379511584,17297847430,-6038,,
15893234647,1367.86929,17297903908,1379562019,17297897866,-6042,,
15893285308,1367.91996,17297954571,1379612678,17297948524,-6047,,
15893335725,1367.97037,17298004992,1379663092,17297998938,-6054,,
15893386039,1368.02069,17298055308,1379713403,17298049250,-6058,,
15893437168,1368.07182,17298106439,1379764530,17298100377,-6062,,
15893487451,1368.12210,17298156725,1379814811,17298150657,-6068,,
15893537686,1368.17233,17298206961,1379865042,17298200889,-6072,,
15893588774,1368.22342,17298258053,1379916128,17298251975,-6078,,
15893639635,1368.27428,17298308915,1379966986,17298302832,-6083,,
15893690120,1368.32477,17298359402,1380017468,17298353314,-6088,,
15893740970,1368.37562,17298410256,1380068315,17298404162,-6094,,
15893791272,1368.42592,17298460559,1380118615,17298454461,-6098,,
15893841690,1368.47634,17298510980,1380169031,17298504877,-6103,,
15893892066,1368.52671,17298561358,1380219403,17298555250,-6108,,
15893943087,1368.57774,17298612382,1380270422,17298606268,-6114,,
15893993572,1368.62822,17298662868,1380320904,17298656751,-6117,,
15894043630,1368.67828,17298712930,1380370959,17298706806,-6124,,
15894094677,1368.72933,17298763979,1380422004,17298757850,-6129,,
15894145736,1368.78038,17298815040,1380473061,17298808907,-6133,,
15894196775,1368.83142,17298866082,1380524097,17298859943,-6139,,
15894247312,1368.88196,17298916621,1380574631,17298910477,-6144,,
15894297908,1368.93256,17298967220,1380625225,17298961071,-6149,,
15894348491,1368.98314,17299017804,1380675804,17299011650,-6154,,
15894399547,1369.03419,17299068862,1380726857,17299062704,-6158,,
15894449800,1369.08445,17299119118,1380777107,17299112953,-6165,,
15894500838,1369.13549,17299170159,1380828143,17299163990,-6169,,
15894551381,1369.18603,17299220703,1380878683,17299214529,-6174,,
15894601910,1369.23656,17299271236,1380929209,17299265056,-6180,,
15894652464,1369.28711,17299321791,1380979761,17299315608,-6183,,
15894703006,1369.33765,17299372336,1381030300,17299366147,-6189,,
15894753107,1369.38775,17299422440,1381080399,17299416245,-6195,,
15894803722,1369.43837,17299473057,1381131011,17299466858,-6199,,
15894854766,1369.48941,17299524102,1381182052,17299517899,-6203,,
15894905400,1369.54005,17299574740,1381232693,17299568540,-6200,,
15894956462,1369.59111,17299625804,1381283743,17299619589,-6215,,
15895007087,1369.64173,17299676430,1381334365,17299670212,-6218,,
15895058133,1369.69278,17299727480,1381385409,17299721255,-6225,,
15895109184,1369.74383,17299778532,1381436456,17299772302,-6230,,
15895160232,1369.79488,17299829584,1381487501,17299823348,-6236,,
15895211273,1369.84592,17299880626,1381538539,17299874386,-6240,,
15895262313,1369.89696,17299931669,1381589578,17299925424,-6245,,
15895313365,1369.94801,17299982723,1381640626,17299976473,-6250,,
15895364378,1369.99903,17300033738,1381691637,17300027483,-6255,,
15895414436,1370.04908,17300083798,1381741692,17300077538,-6260,,
15895464927,1370.09957,17300134292,1381792180,17300128026,-6266,,
15895515586,1370.15023,17300184953,1381842836,17300178682,-6271,,
15895566092,1370.20074,17300235462,1381893341,17300229187,-6275,,
15895617065,1370.25171,17300286437,1381944310,17300280156,-6281,,
15895667531,1370.30218,17300336906,1381994774,17300330620,-6286,,
15895718573,1370.35322,17300387950,1382045813,17300381659,-6291,,
15895769103,1370.40375,17300438483,1382096340,17300432187,-6296,,
15895819714,1370.45436,17300489096,1382146948,17300482795,-6301,,
15895869966,1370.50461,17300539351,1382197198,17300533044,-6307,,
15895920706,1370.55535,17300590092,1382247935,17300583781,-6311,,
15895970843,1370.60549,17300640231,1382298069,17300633916,-6315,,
15896021916,1370.65656,17300691308,1382349140,17300684986,-6322,,
15896072689,1370.70734,17300742082,1382399910,17300735756,-6326,,
15896123113,1370.75776,17300792509,1382450332,17300786178,-6331,,
15896173409,1370.80806,17300842808,1382500625,17300836471,-6337,,
15896223973,1370.85862,17300893374,1382551187,17300887033,-6341,,
15896274761,1370.90941,17300944164,1382601971,17300937818,-6346,,
15896325157,1370.95980,17300994563,1382652364,17300988211,-6352,,
15896375234,1371.00988,17301044642,1382702438,17301038285,-6357,,
15896425786,1371.06043,17301095196,1382752989,17301088835,-6361,,
15896476428,1371.11108,17301145841,1382803628,17301139474,-6367,,
15896527490,1371.16214,17301196904,1382854686,17301190533,-6371,,
15896578093,1371.21274,17301247510,1382905287,17301241133,-6377,,
15896628604,1371.26325,17301298023,1382955795,17301291642,-6381,,
15896679158,1371.31381,17301348580,1383006346,17301342193,-6387,,
15896729325,1371.36397,17301398750,1383056512,17301392359,-6391,,
15896779892,1371.41454,17301449319,1383107075,17301442922,-6397,,
15896830425,1371.46507,17301499864,1383157616,17301493463,-6401,,
15896880954,1371.51560,17301550386,1383208131,17301543978,-6408,,
15896931494,1371.56614,17301600927,1383258669,17301594515,-6412,,
15896981564,1371.61621,17301651000,1383308736,17301644582,-6418,,
15897032415,1371.66706,17301701865,1383359596,17301695442,-6423,,
15897082950,1371.71760,17301752391,1383410117,17301745964,-6427,,
15897134009,1371.76866,17301803451,1383461173,17301797020,-6431,,
15897185012,1371.81966,17301854457,1383512173,17301848019,-6438,,
15897235585,1371.87023,17301905033,1383562743,17301898589,-6444,,
15897286631,1371.92128,17301956080,1383613787,17301949634,-6446,,
15897337219,1371.97187,17302006672,1383664372,17302000219,-6453,,
15897388228,1372.02288,17302057683,1383715378,17302051225,-6458,,
15897439243,1372.07389,17302108701,1383766391,17302102237,-6464,,
15897489362,1372.12401,17302158821,1383816507,17302152353,-6468,,
15897540378,1372.17503,17302209840,1383867521,17302203367,-6473,,
15897591415,1372.22606,17302260880,1383918554,17302254401,-6479,,
15897641557,1372.27620,17302311024,1383968695,17302304541,-6483,,
15897692249,1372.32690,17302361718,1384019383,17302355230,-6488,,
15897742914,1372.37756,17302412386,1384070046,17302405892,-6494,,
15897793455,1372.42810,17302462929,1384120584,17302456431,-6498,,
15897844056,1372.47870,17302513531,1384171182,17302507028,-6503,,
15897894620,1372.52927,17302564098,1384221743,17302557589,-6509,,
15897945490,1372.58014,17302614971,1384272610,17302608457,-6514,,
15897996513,1372.63116,17302665996,1384323631,17302659478,-6518,,
15898046646,1372.68129,17302716131,1384373761,17302709607,-6524,,
15898097736,1372.73238,17302767223,1384424848,17302760694,-6529,,
15898148288,1372.78294,17302817789,1384475409,17302811255,-6534,,
15898198406,1372.83305,17302867899,1384525513,17302861359,-6540,,
15898249044,1372.88369,17302918539,1384576148,17302911995,-6544,,
15898300081,1372.93473,17302969578,1384627182,17302963028,-6550,,
15898350608,1372.98526,17303020107,1384677707,17303013554,-6553,,
15898401135,1373.03578,17303070636,1384728231,17303064077,-6559,,
15898451555,1373.08620,17303121060,1384778649,17303114495,-6565,,
15898502097,1373.13675,17303171604,1384829189,17303165035,-6569,,
15898553144,1373.18779,17303222653,1384880232,17303216078,-6575,,
15898603207,1373.23786,17303272718,1384930292,17303266138,-6580,,
15898654232,1373.28888,17303323745,1384981315,17303317162,-6583,,
15898704290,1373.33894,17303373805,1385031370,17303367216,-6589,,
15898754415,1373.38906,17303423934,1385081493,17303417339,-6595,,
15898805016,1373.43966,17303474537,1385132090,17303467937,-6600,,
15898856025,1373.49067,17303525548,1385183097,17303518943,-6605,,
15898906585,1373.54123,17303576111,1385233654,17303569501,-6610,,
15898957645,1373.59229,17303627172,1385284711,17303620557,-6615,,
15899008659,1373.64331,17303678190,1385335723,17303671569,-6621,,
15899059217,1373.69386,17303728750,1385386278,17303722125,-6625,,
15899109754,1373.74440,17303779289,1385436813,17303772659,-6630,,
15899160309,1373.79496,17303829847,1385487365,17303823211,-6636,,
15899211389,1373.84604,17303880929,1385538443,17303874289,-6640,,
15899261885,1373.89653,17303931427,1385588936,17303924782,-6645,,
15899311938,1373.94659,17303981483,1385638986,17303974832,-6651,,
15899362485,1373.99713,17304032032,1385689531,17304025377,-6655,,
15899413033,1374.04768,17304082582,1385740075,17304075922,-6660,,
15899463579,1374.09823,17304133131,1385790619,17304126465,-6666,,
15899514139,1374.14879,17304183693,1385841176,17304177023,-6670,,
15899564677,1374.19933,17304234232,1385891711,17304227557,-6675,,
15899615239,1374.24989,17304284797,1385942270,17304278116,-6681,,
15899665793,1374.30044,17304335354,1385992822,17304328668,-6686,,
15899716872,1374.35152,17304386434,1386043898,17304379745,-6689,,
15899767374,1374.40202,17304436940,1386094398,17304430245,-6695,,
15899817922,1374.45257,17304487490,1386144943,17304480789,-6701,,
15899868982,1374.50363,17304538553,1386196000,17304531847,-6706,,
15899920077,1374.55472,17304589649,1386247092,17304582939,-6710,,
15899971075,1374.60572,17304640649,1386298087,17304633933,-6716,,
15900021614,1374.65626,17304691192,1386348624,17304684470,-6722,,
15900072182,1374.70683,17304741762,1386399190,17304735036,-6726,,
15900122730,1374.75738,17304792312,1386449734,17304785581,-6731,,
15900173276,1374.80792,17304842860,1386500277,17304836123,-6737,,
15900224321,1374.85897,17304893907,1386551320,17304887166,-6741,,
15900274870,1374.90952,17304944459,1386601866,17304937713,-6746,,
15900325403,1374.96005,17304994995,1386652397,17304988243,-6752,,
15900375988,1375.01064,17305045582,1386702978,17305038825,-6757,,
15900426516,1375.06116,17305096111,1386753503,17305089350,-6761,,
15900477081,1375.11173,17305146679,1386804066,17305139912,-6767,,
15900528096,1375.16274,17305197696,1386855078,17305190925,-6771,,
15900578592,1375.21324,17305248195,1386905572,17305241418,-6777,,
15900628675,1375.26332,17305298280,1386955652,17305291498,-6782,,
15900679205,1375.31385,17305348813,1387006179,17305342025,-6788,,
15900729743,1375.36439,17305399354,1387056715,17305392561,-6793,,
15900779794,1375.41444,17305449407,1387106764,17305442610,-6797,,
15900830861,1375.46551,17305500476,1387157828,17305493674,-6802,,
15900881946,1375.51659,17305551564,1387208909,17305544756,-6808,,
15900932481,1375.56713,17305602101,1387259442,17305595289,-6812,,
15900983056,1375.61770,17305652678,1387310014,17305645861,-6817,,
15901034113,1375.66876,17305703737,1387361068,17305696914,-6823,,
15901085149,1375.71980,17305754776,1387412102,17305747948,-6828,,
15901136355,1375.77100,17305805984,1387463305,17305799152,-6832,,
15901187240,1375.82189,17305856871,1387514187,17305850033,-6838,,
15901238276,1375.87292,17305907909,1387565220,17305901066,-6843,,
15901288853,1375.92350,17305958490,1387615795,17305951641,-6849,,
15901339895,1375.97454,17306009533,1387666834,17306002680,-6853,,
15901390436,1376.02508,17306060077,1387717372,17306053219,-6858,,
15901441488,1376.07614,17306111131,1387768421,17306104267,-6864,,
15901492045,1376.12669,17306161691,1387818977,17306154823,-6868,,
15901542589,1376.17724,17306212236,1387869517,17306205363,-6873,,
15901593127,1376.22778,17306262778,1387920053,17306255899,-6879,,
15901643699,1376.27835,17306313352,1387970622,17306306469,-6883,,
15901694509,1376.32916,17306364164,1388021429,17306357276,-6888,,
15901745549,1376.38020,17306415207,1388072466,17306408313,-6894,,
15901796103,1376.43075,17306465763,1388123017,17306458864,-6899,,
15901846639,1376.48129,17306516302,1388173552,17306509398,-6904,,
15901897724,1376.53237,17306567389,1388224633,17306560479,-6910,,
15901948735,1376.58338,17306618402,1388275641,17306611487,-6915,,
15902000797,1376.63544,17306670466,1388327700,17306663547,-6919,,
15902051351,1376.68600,17306721022,1388378252,17306714098,-6924,,
15902103117,1376.73777,17306772790,1388430015,17306765861,-6929,,
15902153418,1376.78807,17306823094,1388480313,17306816160,-6934,,
15902203482,1376.83813,17306873161,1388530376,17306866222,-6939,,
15902254516,1376.88916,17306924196,1388581406,17306917252,-6944,,
15902304564,1376.93921,17306974248,1388631452,17306967298,-6950,,
15902354822,1376.98947,17307024508,1388681708,17307017554,-6954,,
15902405347,1377.04000,17307075036,1388732230,17307068076,-6960,,
15902485671,1377.12032,17307155363,1388812549,17307148396,-6967,,
15902537036,1377.17168,17307206731,1388863912,17307199758,-6973,,
15902587756,1377.22240,17307257453,1388914628,17307250474,-6979,,
15902638075,1377.27272,17307307773,1388964944,17307300790,-6983,,
15902688943,1377.32359,17307358645,1389015811,17307351657,-6988,,
15902739524,1377.37417,17307409227,1389066388,17307402235,-6992,,
15902790187,1377.42484,17307459893,1389117048,17307452895,-6998,,
15902840729,1377.47538,17307510438,1389167588,17307503435,-7003,,
15902890774,1377.52542,17307560485,1389217630,17307553477,-7008,,
15902940818,1377.57547,17307610531,1389267672,17307603518,-7013,,
15902990875,1377.62552,17307660590,1389317726,17307653572,-7018,,
15903040924,1377.67557,17307710641,1389367772,17307703618,-7023,,
15903091474,1377.72612,17307761193,1389418319,17307754165,-7028,,
15903142542,1377.77719,17307812265,1389469384,17307805231,-7034,,
15903192736,1377.82738,17307862461,1389519576,17307855423,-7038,,
15903243026,1377.87767,17307912752,1389569863,17307905710,-7042,,
15903293240,1377.92789,17307962969,1389620074,17307955920,-7049,,
15903343627,1377.97827,17308013358,1389670459,17308006305,-7053,,
15903393900,1378.02855,17308063634,1389720730,17308056576,-7058,,
15903444342,1378.07899,17308114079,1389771168,17308107015,-7064,,
15903495061,1378.12971,17308164800,1389821885,17308157732,-7068,,
15903545281,1378.17993,17308215022,1389872101,17308207948,-7074,,
15903595634,1378.23028,17308265377,1389922452,17308258299,-7078,,
15903645936,1378.28058,17308315681,1389972751,17308308597,-7084,,
15903696221,1378.33087,17308365970,1390023034,17308358881,-7089,,
15903746471,1378.38112,17308416222,1390073282,17308409128,-7094,,
15903798733,1378.43338,17308468486,1390125540,17308461387,-7099,,
15903848950,1378.48360,17308518706,1390175755,17308511602,-7104,,
15903899282,1378.53393,17308569041,1390226085,17308561932,-7109,,
15903949621,1378.58427,17308619381,1390276421,17308612267,-7114,,
15904000258,1378.63491,17308670021,1390327056,17308662902,-7119,,
15904050580,1378.68523,17308720344,1390377374,17308713221,-7123,,
15904101003,1378.73565,17308770770,1390427794,17308763641,-7129,,
15904151504,1378.78615,17308821273,1390478292,17308814138,-7135,,
15904202007,1378.83666,17308871778,1390528793,17308864640,-7138,,
15904252584,1378.88723,17308922357,1390579367,17308915213,-7144,,
15904302988,1378.93764,17308972764,1390629768,17308965615,-7149,,
15904353362,1378.98801,17309023141,1390680141,17309015987,-7154,,
15904403685,1379.03833,17309073466,1390730460,17309066307,-7159,,
15904454279,1379.08893,17309124063,1390781051,17309116898,-7165,,
15904504764,1379.13941,17309174549,1390831534,17309167381,-7168,,
15904555303,1379.18995,17309225091,1390882070,17309217917,-7174,,
15904605932,1379.24058,17309275722,1390932696,17309268542,-7180,,
15904656235,1379.29088,17309326028,1390982996,17309318842,-7186,,
15904706556,1379.34120,17309376352,1391033315,17309369162,-7190,,
15904756929,1379.39158,17309426727,1391083686,17309419532,-7195,,
15904807375,1379.44202,17309477174,1391134128,17309469974,-7200,,
15904857682,1379.49233,17309527484,1391184433,17309520280,-7204,,
15904908053,1379.54270,17309577857,1391234801,17309570648,-7209,,
15904958345,1379.59299,17309628151,1391285090,17309620937,-7214,,
15905009069,1379.64372,17309678879,1391335812,17309671659,-7220,,
15905059364,1379.69401,17309729176,1391386104,17309721951,-7225,,
15905110225,1379.74487,17309780039,1391436962,17309772809,-7230,,
15905160424,1379.79507,17309830241,1391487159,17309823005,-7236,,
15905211096,1379.84574,17309880915,1391537829,17309873675,-7240,,
15905261271,1379.89592,17309931092,1391588001,17309923847,-7245,,
15905311598,1379.94625,17309981421,1391638324,17309974170,-7251,,
15905362224,1379.99687,17310032049,1391688948,17310024795,-7254,,
15905413484,1380.04813,17310083311,1391740205,17310076051,-7260,,
15905464376,1380.09902,17310134207,1391791095,17310126941,-7266,,
15905514597,1380.14925,17310184429,1391841313,17310177159,-7270,,
15905565272,1380.19992,17310235106,1391891985,17310227832,-7274,,
15905615966,1380.25061,17310285803,1391942676,17310278522,-7281,,
15905681701,1380.31635,17310351542,1392008408,17310344255,-7287,,
15905732125,1380.36677,17310401968,1392058830,17310394676,-7292,,
15905782715,1380.41736,17310452560,1392109416,17310445262,-7298,,
15905833318,1380.46797,17310503166,1392160016,17310495863,-7303,,
15905883932,1380.51858,17310553782,1392210629,17310546475,-7307,,
15905934516,1380.56916,17310604369,1392261209,17310597056,-7313,,
15905984969,1380.61962,17310654824,1392311660,17310647506,-7318,,
15906035523,1380.67017,17310705380,1392362211,17310698057,-7323,,
15906086287,1380.72094,17310756146,1392412971,17310748818,-7328,,
15906136694,1380.77134,17310806556,1392463377,17310799223,-7333,,
15906187706,1380.82235,17310857570,1392514386,17310850232,-7338,,
15906238021,1380.87267,17310907888,1392564698,17310900545,-7343,,
15906288308,1380.92296,17310958176,1392614982,17310950828,-7348,,
15906338713,1380.97336,17311008584,1392665384,17311001231,-7353,,
15906389558,1381.02421,17311059431,1392716227,17311052073,-7358,,
15906440079,1381.07473,17311109954,1392766745,17311102592,-7362,,
15906490871,1381.12552,17311160749,1392817534,17311153381,-7368,,
15906541548,1381.17620,17311211429,1392868210,17311204056,-7373,,
15906591775,1381.22642,17311261658,1392918434,17311254280,-7378,,
15906642017,1381.27667,17311311903,1392968672,17311304519,-7384,,
15906692232,1381.32688,17311362120,1393018886,17311354732,-7388,,
15906742384,1381.37703,17311412274,1393069035,17311404882,-7392,,
15906792547,1381.42719,17311462440,1393119195,17311455041,-7399,,
15906843226,1381.47787,17311513121,1393169871,17311505717,-7404,,
15906894553,1381.52920,17311564450,1393221195,17311557042,-7408,,
15906945106,1381.57975,17311615006,1393271745,17311607592,-7414,,
15906995401,1381.63005,17311665303,1393322037,17311657884,-7419,,
15907045728,1381.68038,17311715632,1393372363,17311708209,-7423,,
15907096107,1381.73076,17311766013,1393422738,17311758585,-7428,,
15907146536,1381.78118,17311816446,1393473165,17311809012,-7434,,
15907196852,1381.83150,17311866763,1393523478,17311859325,-7438,,
15907247137,1381.88179,17311917051,1393573761,17311909607,-7444,,
15907297442,1381.93209,17311967358,1393624063,17311959909,-7449,,
15907347971,1381.98262,17312017889,1393674589,17312010435,-7454,,
15907398260,1382.03291,17312068182,1393724876,17312060723,-7459,,
15907449384,1382.08403,17312119307,1393775997,17312111843,-7464,,
15907500134,1382.13478,17312170059,1393826743,17312162590,-7469,,
15907550436,1382.18508,17312220363,1393877043,17312212889,-7474,,
15907601791,1382.23644,17312271720,1393928395,17312264241,-7479,,
15907652189,1382.28684,17312322120,1393978790,17312314636,-7484,,
15907702822,1382.33747,17312372757,1394029420,17312365267,-7490,,
15907753439,1382.38809,17312423375,1394080035,17312415881,-7494,,
15907803703,1382.43835,17312473643,1394130297,17312466143,-7500,,
15907854039,1382.48869,17312523982,1394180631,17312516477,-7505,,
15907904445,1382.53909,17312574389,1394231034,17312566881,-7508,,
15907955018,1382.58967,17312624965,1394281603,17312617450,-7515,,
15908005347,1382.63999,17312675295,1394331929,17312667775,-7520,,
15908055735,1382.69038,17312725686,1394382316,17312718162,-7524,,
15908106043,1382.74069,17312775997,1394432620,17312768466,-7531,,
15908156336,1382.79098,17312826291,1394482910,17312818756,-7535,,
15908206601,1382.84125,17312876558,1394533172,17312869018,-7540,,
15908256808,1382.89146,17312926769,1394583378,17312919224,-7545,,
15908307154,1382.94180,17312977116,1394633720,17312969566,-7550,,
15908357443,1382.99209,17313027408,1394684007,17313019853,-7555,,
15908407763,1383.04241,17313077730,1394734324,17313070171,-7559,,
15908458483,1383.09313,17313128453,1394785042,17313120888,-7565,,
15908508852,1383.14350,17313178823,1394835407,17313171254,-7569,,
15908559208,1383.19386,17313229182,1394885761,17313221607,-7575,,
15908609528,1383.24418,17313279505,1394936078,17313271924,-7581,,
15908659728,1383.29438,17313329707,1394986275,17313322122,-7585,,
15908710367,1383.34502,17313380348,1395036912,17313372759,-7589,,
15908760666,1383.39531,17313430649,1395087208,17313423054,-7595,,
15908810840,1383.44549,17313480826,1395137380,17313473226,-7600,,
15908861533,1383.49618,17313531522,1395188070,17313523916,-7606,,
15908912084,1383.54673,17313582074,1395238618,17313574464,-7610,,
15908962612,1383.59726,17313632605,1395289143,17313624990,-7615,,
15909013179,1383.64783,17313683175,1395339708,17313675554,-7621,,
15909063851,1383.69850,17313733849,1395390377,17313726223,-7626,,
15909114884,1383.74953,17313784884,1395441407,17313777254,-7630,,
15909164958,1383.79961,17313834961,1395491479,17313827325,-7636,,
15909215983,1383.85063,17313885988,1395542501,17313878348,-7640,,
15909266564,1383.90121,17313936572,1395593079,17313928926,-7646,,
15909317606,1383.95225,17313987615,1395644118,17313979964,-7651,,
15909368636,1384.00328,17314038647,1395695145,17314030991,-7656,,
15909419206,1384.05385,17314089220,1395745713,17314081560,-7660,,
15909470241,1384.10489,17314140257,1395796745,17314132592,-7665,,
15909521293,1384.15594,17314191311,1395847794,17314183641,-7670,,
15909572348,1384.20700,17314242370,1395898846,17314234693,-7677,,
15909622878,1384.25753,17314292901,1395949373,17314285220,-7681,,
15909672938,1384.30759,17314342963,1395999431,17314335278,-7685,,
15909724015,1384.35866,17314394043,1396050505,17314386352,-7691,,
15909775037,1384.40969,17314445068,1396101525,17314437372,-7696,,
15909825090,1384.45974,17314495123,1396151575,17314487421,-7702,,
15909876124,1384.51077,17314546160,1396202607,17314538453,-7707,,
15909926675,1384.56132,17314596712,1396253154,17314589001,-7711,,
15909977729,1384.61238,17314647770,1396304206,17314640053,-7717,,
15910028768,1384.66342,17314698811,1396355242,17314691089,-7722,,
15910078821,1384.71347,17314748866,1396405293,17314741139,-7727,,
15910129357,1384.76400,17314799405,1396455826,17314791672,-7733,,
15910179423,1384.81407,17314849473,1396505889,17314841736,-7737,,
15910230469,1384.86512,17314900520,1396556932,17314892778,-7742,,
15910281012,1384.91566,17314951066,1396607473,17314943319,-7747,,
15910332058,1384.96671,17315002114,1396658516,17314994362,-7752,,
15910382617,1385.01726,17315052675,1396709072,17315044919,-7756,,
15910433152,1385.06780,17315103214,1396759604,17315095450,-7764,,
15910483712,1385.11836,17315153776,1396810163,17315146010,-7766,,
15910534244,1385.16889,17315204309,1396860691,17315196537,-7772,,
15910584794,1385.21944,17315254863,1396911238,17315247085,-7778,,
15910635382,1385.27003,17315305453,1396961825,17315297671,-7782,,
15910686387,1385.32103,17315356460,1397012825,17315348672,-7788,,
15910737413,1385.37206,17315407488,1397063849,17315399695,-7793,,
15910787462,1385.42211,17315457540,1397113895,17315449742,-7798,,
15910837545,1385.47219,17315507625,1397163976,17315499823,-7802,,
15910888558,1385.52321,17315558641,1397214986,17315550832,-7809,,
15910939113,1385.57376,17315609198,1397265538,17315601385,-7813,,
15910989182,1385.62383,17315659270,1397315605,17315651452,-7818,,
15911040225,1385.67487,17315710314,1397366645,17315702491,-7823,,
15911275369,1385.91002,17315945469,1397601776,17315937622,-7847,17315943445,
15911300760,1385.93541,17315970862,1397627166,17315963042,-7820,,
15911350823,1385.98547,17316020926,1397677226,17316013161,-7765,,
15911401416,1386.03606,17316071523,1397727817,17316063811,-7712,,
15911452411,1386.08706,17316122520,1397778809,17316114861,-7659,,
15911502990,1386.13764,17316173102,1397829385,17316165497,-7605,,
15911554020,1386.18867,17316224133,1397880412,17316216584,-7549,,
15911605057,1386.23970,17316275173,1397931448,17316267678,-7495,,
15911655612,1386.29026,17316325730,1397981999,17316318288,-7442,,
15911705770,1386.34042,17316375891,1398032154,17316368502,-7389,,
15911756808,1386.39146,17316426931,1398083191,17316419598,-7333,,
15911807843,1386.44249,17316477969,1398134223,17316470689,-7280,,
15911858589,1386.49324,17316528716,1398184965,17316521490,-7226,,
15911908866,1386.54351,17316578995,1398235239,17316571823,-7172,,
15911959363,1386.59401,17316629496,1398285734,17316622378,-7118,,
15912010305,1386.64495,17316680439,1398336672,17316673375,-7064,,
15912060747,1386.69539,17316730884,1398387112,17316723874,-7010,,
15912111682,1386.74633,17316781821,1398438045,17316774866,-6955,,
15912162185,1386.79683,17316832327,1398488546,17316825425,-6902,,
15912212378,1386.84703,17316882522,1398538735,17316875674,-6848,,
15912262907,1386.89756,17316933054,1398589261,17316926257,-6797,,
15912313465,1386.94811,17316983613,1398639817,17316976873,-6740,,
15912364519,1386.99917,17317034670,1398690868,17317027983,-6687,,
15912415558,1387.05021,17317085711,1398741904,17317079078,-6633,,
15912466604,1387.10125,17317136759,1398792948,17317130183,-6576,,
15912517647,1387.15230,17317187806,1398843989,17317181283,-6523,,
15912568183,1387.20283,17317238343,1398894521,17317231873,-6470,,
15912618250,1387.25290,17317288413,1398944585,17317281996,-6417,,
15912669340,1387.30399,17317339505,1398995673,17317333143,-6362,,
15912719841,1387.35449,17317390009,1399046172,17317383701,-6308,,
15912770389,1387.40504,17317440559,1399096716,17317434304,-6255,,
15912821442,1387.45609,17317491614,1399147767,17317485414,-6200,,
15912872474,1387.50712,17317542649,1399198796,17317536504,-6145,,
15912923042,1387.55769,17317593220,1399249361,17317587128,-6092,,
15912973082,1387.60773,17317643261,1399299398,17317637222,-6039,,
15913023117,1387.65776,17317693298,1399349431,17317687313,-5985,,
15913073178,1387.70783,17317743363,1399399489,17317737430,-5933,,
15913123728,1387.75838,17317793915,1399450036,17317788035,-5880,,
15913174322,1387.80897,17317844511,1399500628,17317838687,-5824,,
15913224822,1387.85947,17317895014,1399551125,17317889243,-5771,,
15913274858,1387.90951,17317945052,1399601158,17317939334,-5718,,
15913324930,1387.95958,17317995126,1399651229,17317989463,-5663,,
15913374978,1388.00963,17318045177,1399701273,17318039566,-5611,,
15913425027,1388.05967,17318095228,1399751320,17318089670,-5558,,
15913476325,1388.11097,17318146527,1399802615,17318141025,-5502,,
15913526607,1388.16125,17318196813,1399852894,17318191364,-5449,,
15913577157,1388.21180,17318247365,1399903442,17318241970,-5395,,
15913627209,1388.26186,17318297419,1399953490,17318292077,-5342,,
15913677284,1388.31193,17318347497,1400003564,17318342208,-5289,,
15913727853,1388.36250,17318398068,1400054129,17318392833,-5235,,
15913778902,1388.41355,17318449119,1400105175,17318443938,-5181,,
15913829925,1388.46457,17318500145,1400156196,17318495019,-5126,,
15913881010,1388.51566,17318551231,1400207278,17318546159,-5072,,
15913931860,1388.56651,17318602084,1400258126,17318597067,-5017,,
15913982376,1388.61702,17318652603,1400308638,17318647639,-4964,,
15914032939,1388.66759,17318703167,1400359199,17318698257,-4910,,
15914083941,1388.71859,17318754173,1400410199,17318749317,-4856,,
15914134537,1388.76919,17318804771,1400460792,17318799969,-4802,,
15914185551,1388.82020,17318855786,1400511803,17318851040,-4746,,
15914236578,1388.87123,17318906817,1400562828,17318902124,-4693,,
15914287055,1388.92170,17318957296,1400613302,17318952656,-4640,,
15914338109,1388.97276,17319008352,1400664352,17319003767,-4585,,
15914388733,1389.02338,17319058979,1400714974,17319054448,-4531,,
15914439755,1389.07440,17319110003,1400765994,17319105526,-4477,,
15914490290,1389.12494,17319160539,1400816525,17319156116,-4423,,
15914541362,1389.17601,17319211614,1400867595,17319207246,-4368,,
15914592375,1389.22702,17319262630,1400918605,17319258316,-4314,,
15914642436,1389.27708,17319312694,1400968663,17319308432,-4262,,
15914695794,1389.33044,17319366053,1401022018,17319361849,-4204,,
15914746032,1389.38068,17319416294,1401072254,17319412144,-4150,,
15914796082,1389.43073,17319466346,1401122301,17319462248,-4098,,
15914846127,1389.48077,17319516394,1401172344,17319512350,-4044,,
15914896175,1389.53082,17319566443,1401222389,17319562453,-3990,,
15914946752,1389.58140,17319617024,1401272964,17319613087,-3937,,
15914997800,1389.63245,17319668074,1401324009,17319664191,-3883,,
15915048751,1389.68340,17319719027,1401374956,17319715199,-3828,,
15915099256,1389.73390,17319769535,1401425459,17319765761,-3774,,
15915149835,1389.78448,17319820115,1401476035,17319816395,-3720,,
15915200887,1389.83553,17319871169,1401527084,17319867503,-3666,,
15915251924,1389.88657,17319922210,1401578119,17319918599,-3611,,
15915302018,1389.93667,17319972306,1401628210,17319968748,-3558,,
15915353056,1389.98770,17320023347,1401679245,17320019842,-3505,,
15915403142,1390.03779,17320073435,1401729328,17320069984,-3451,,
15915454253,1390.08890,17320124549,1401780439,17320121153,-3396,,
15915509767,1390.14441,17320180065,1401835948,17320176728,-3337,,
15915561277,1390.19592,17320231577,1401887455,17320228295,-3282,,
15915612344,1390.24699,17320282646,1401938519,17320279417,-3229,,
15915663387,1390.29804,17320333692,1401989560,17320330519,-3173,,
15915714436,1390.34908,17320384743,1402040606,17320381624,-3119,,
15915764985,1390.39963,17320435295,1402091152,17320432229,-3066,,
15915815509,1390.45016,17320485821,1402141673,17320482809,-3012,,
15915865562,1390.50021,17320535876,1402191724,17320532918,-2958,,
15915915626,1390.55027,17320585943,1402241786,17320583038,-2905,,
15915966665,1390.60131,17320636983,1402292821,17320634132,-2851,,
15916017223,1390.65187,17320687544,1402343377,17320684748,-2796,,
15916068021,1390.70267,17320738345,1402394173,17320735602,-2743,,
15916118625,1390.75327,17320788952,1402444775,17320786263,-2689,,
15916169278,1390.80393,17320839606,1402495423,17320836970,-2636,,
15916220264,1390.85491,17320890595,1402546408,17320888015,-2580,,
15916270775,1390.90542,17320941108,1402596916,17320938581,-2527,,
15916321822,1390.95647,17320992158,1402647960,17320989631,-2527,,
15916372904,1391.00755,17321043242,1402699040,17321040711,-2531,,
15916423955,1391.05860,17321094294,1402750087,17321091758,-2536,,
15916474953,1391.10960,17321145296,1402801082,17321142754,-2542,,
15916525017,1391.15966,17321195361,1402851143,17321192814,-2547,,
15916576053,1391.21070,17321246400,1402902177,17321243848,-2552,,
15916626622,1391.26127,17321296972,1402952744,17321294415,-2557,,
15916677652,1391.31230,17321348003,1403003770,17321345441,-2562,,
15916728707,1391.36335,17321399061,1403054823,17321396494,-2567,,
15916779753,1391.41440,17321450109,1403105866,17321447537,-2572,,
15916830332,1391.46498,17321500690,1403156442,17321498113,-2577,,
15916880854,1391.51550,17321551215,1403206961,17321548633,-2582,,
15916931478,1391.56613,17321601841,1403257583,17321599255,-2586,,
15916982422,1391.61707,17321652787,1403308524,17321650196,-2591,,
15917032967,1391.66762,17321703335,1403359066,17321700738,-2597,,
15917083095,1391.71774,17321753465,1403409192,17321750863,-2602,,
15917134141,1391.76879,17321804514,1403460236,17321801907,-2607,,
15917184736,1391.81938,17321855112,1403510827,17321852498,-2614,,
15917235392,1391.87004,17321905770,1403561481,17321903153,-2617,,
15917285938,1391.92059,17321956317,1403612024,17321953695,-2622,,
15917336848,1391.97150,17322007230,1403662931,17322004602,-2628,,
15917387133,1392.02178,17322057518,1403713213,17322054885,-2633,,
15917437326,1392.07197,17322107713,1403763406,17322105077,-2636,,
15917487859,1392.12251,17322158260,1403813946,17322155617,-2643,,
15917538446,1392.17309,17322208838,1403864518,17322206190,-2648,,
15917588585,1392.22323,17322258980,1403914656,17322256327,-2653,,
15917639643,1392.27429,17322310040,1403965710,17322307382,-2658,,
15917690596,1392.32524,17322360995,1404016660,17322358332,-2663,,
15917741155,1392.37580,17322411557,1404067217,17322408888,-2669,,
15917791781,1392.42643,17322462185,1404117840,17322459512,-2673,,
15917842398,1392.47705,17322512804,1404168454,17322510126,-2678,,
15917893407,1392.52805,17322563815,1404219460,17322561131,-2684,,
15917944043,1392.57869,17322614454,1404270094,17322611765,-2689,,
15917995099,1392.62975,17322665511,1404321147,17322662818,-2693,,
15918046154,1392.68080,17322716570,1404372199,17322713871,-2699,,
15918096577,1392.73122,17322766995,1404422619,17322764291,-2704,,
15918147158,1392.78181,17322817578,1404473198,17322814870,-2708,,
15918197755,1392.83240,17322868178,1404523793,17322865464,-2714,,
15918248256,1392.88290,17322918680,1404574290,17322915961,-2719,,
15918306513,1392.94116,17322976940,1404632544,17322974215,-2725,,
15918362081,1392.99673,17323032510,1404688109,17323029780,-2730,,
15918419214,1393.05386,17323089646,1404745238,17323086910,-2736,,
15918469982,1393.10463,17323140417,1404796003,17323137675,-2742,,
15918524152,1393.15880,17323194589,1404850171,17323191842,-2747,,
15918574819,1393.20947,17323245259,1404900836,17323242507,-2752,,
15918625292,1393.25994,17323295734,1404951306,17323292977,-2757,,
15918675575,1393.31022,17323346020,1405001586,17323343258,-2762,,
15918726271,1393.36092,17323396717,1405052280,17323393951,-2766,,
15918776800,1393.41145,17323447249,1405102806,17323444477,-2772,,
15918827430,1393.46208,17323497881,1405153433,17323495105,-2776,,
15918877809,1393.51246,17323548262,1405203810,17323545481,-2781,,
15918928469,1393.56312,17323598926,1405254467,17323596139,-2787,,
15918978943,1393.61359,17323649401,1405304938,17323646609,-2792,,
15919029661,1393.66431,17323700122,1405355653,17323697324,-2798,,
15919079974,1393.71462,17323750437,1405405964,17323747635,-2802,,
15919131044,1393.76569,17323801510,1405457032,17323798703,-2807,,
15919182106,1393.81675,17323852575,1405508091,17323849762,-2813,,
15919232204,1393.86685,17323902675,1405558186,17323899858,-2817,,
15919283225,1393.91787,17323953698,1405609205,17323950876,-2822,,
15919334284,1393.96893,17324004759,1405660260,17324001931,-2828,,
15919384324,1394.01897,17324054801,1405710297,17324051968,-2833,,
15919434856,1394.06950,17324105336,1405760827,17324102499,-2837,,
15919484934,1394.11958,17324155416,1405810902,17324152573,-2843,,
15919535469,1394.17012,17324205954,1405861435,17324203106,-2848,,
15919586504,1394.22115,17324256991,1405912467,17324254139,-2852,,
15919636599,1394.27125,17324307089,1405962560,17324304232,-2857,,
15919687104,1394.32175,17324357596,1406013061,17324354733,-2863,,
15919737183,1394.37183,17324407677,1406063139,17324404811,-2866,,
15919787743,1394.42239,17324458239,1406113695,17324455366,-2873,,
15919838781,1394.47343,17324509280,1406164733,17324506406,-2874,,
15919889731,1394.52438,17324560233,1406215677,17324557349,-2884,,
15919940314,1394.57496,17324610818,1406266259,17324607931,-2887,,
15919991337,1394.62598,17324661842,1406317278,17324658950,-2892,,
15920042388,1394.67704,17324712897,1406368327,17324709998,-2899,,
15920095465,1394.73011,17324765975,1406421400,17324763071,-2904,,
15920146510,1394.78116,17324817022,1406472443,17324814114,-2908,,
15920197028,1394.83168,17324867543,1406522958,17324864629,-2914,,
15920247574,1394.88222,17324918091,1406573501,17324915172,-2919,,
15920298627,1394.93328,17324969147,1406624552,17324966223,-2924,,
15920348700,1394.98335,17325019223,1406674622,17325016294,-2929,,
15920399756,1395.03440,17325070280,1406725674,17325067346,-2934,,
15920449926,1395.08457,17325120453,1406775841,17325117513,-2940,,
15920500969,1395.13562,17325171499,1406826884,17325168555,-2944,,
15920551082,1395.18573,17325221613,1406876993,17325218665,-2948,,
15920601609,1395.23626,17325272144,1406927518,17325269189,-2955,,
15920652347,1395.28699,17325322884,1406978253,17325319925,-2959,,
15920703385,1395.33803,17325373924,1407029289,17325370960,-2964,,
15920753984,1395.38863,17325424525,1407079884,17325421555,-2970,,
15920804972,1395.43962,17325475516,1407130870,17325472541,-2975,,
15920855548,1395.49020,17325526094,1407181443,17325523115,-2979,,
15920906079,1395.54073,17325576628,1407231971,17325573643,-2985,,
15920956664,1395.59131,17325627215,1407282553,17325624225,-2990,,
15921007243,1395.64189,17325677796,1407333131,17325674802,-2994,,
15921057787,1395.69243,17325728343,1407383671,17325725343,-3000,,
15921108897,1395.74355,17325779455,1407434778,17325776450,-3005,,
15921159451,1395.79410,17325830022,1407485341,17325827012,-3010,,
15921210040,1395.84469,17325880603,1407535916,17325877588,-3015,,
15921260645,1395.89529,17325931209,1407586518,17325928189,-3020,,
15921311393,1395.94604,17325981961,1407637263,17325978934,-3027,,
15921362426,1395.99707,17326032996,1407688295,17326029966,-3030,,
15921413491,1396.04814,17326084063,1407739357,17326081028,-3035,,
15921464035,1396.09868,17326134610,1407789898,17326131569,-3041,,
15921515087,1396.14973,17326185663,1407840946,17326182618,-3045,,
15921566092,1396.20074,17326236671,1407891950,17326233622,-3049,,
15921617147,1396.25179,17326287729,1407943002,17326284673,-3056,,
15921667749,1396.30240,17326338332,1407993600,17326335271,-3061,,
15921718766,1396.35341,17326389352,1408044614,17326386286,-3066,,
15921768930,1396.40358,17326439519,1408094776,17326436448,-3071,,
15921819991,1396.45464,17326490581,1408145834,17326487506,-3075,,
15921870153,1396.50480,17326540747,1408195993,17326537665,-3082,,
15921920730,1396.55538,17326591326,1408246568,17326588240,-3086,,
15921971265,1396.60591,17326641862,1408297100,17326638771,-3091,,
15922021860,1396.65651,17326692461,1408347692,17326689364,-3097,,
15922072859,1396.70751,17326743462,1408398689,17326740361,-3101,,
15922123389,1396.75804,17326793994,1408449217,17326790888,-3106,,
15922174443,1396.80909,17326845051,1408500268,17326841939,-3112,,
15922225021,1396.85967,17326895630,1408550842,17326892513,-3117,,
15922276060,1396.91071,17326946672,1408601879,17326943550,-3122,,
15922327090,1396.96174,17326997705,1408652906,17326994577,-3128,,
15922377919,1397.01257,17327048535,1408703732,17327045404,-3131,,
15922428462,1397.06311,17327099082,1408754274,17327095945,-3137,,
15922479364,1397.11401,17327149996,1408805183,17327146854,-3142,,
15922529882,1397.16453,17327200506,1408855688,17327197359,-3147,,
15922579956,1397.21460,17327250582,1408905759,17327247430,-3152,,
15922630992,1397.26564,17327301620,1408956792,17327298463,-3157,,
15922681542,1397.31619,17327352173,1409007340,17327349011,-3162,,
15922732577,1397.36722,17327403211,1409058371,17327400043,-3168,,
15922782635,1397.41728,17327453271,1409108427,17327450099,-3172,,
15922832684,1397.46733,17327503321,1409158473,17327500144,-3177,,
15922882732,1397.51738,17327553373,1409208518,17327550190,-3183,,
15922933280,1397.56793,17327603922,1409259064,17327600735,-3187,,
15922983329,1397.61798,17327653974,1409309110,17327650782,-3192,,
15923033880,1397.66853,17327704528,1409359658,17327701330,-3198,,
15923084424,1397.71907,17327755074,1409410200,17327751872,-3202,,
15923134484,1397.76913,17327805136,1409460258,17327801929,-3207,,
15923185031,1397.81968,17327855686,1409510802,17327852473,-3213,,
15923235578,1397.87023,17327906235,1409561345,17327903017,-3218,,
15923286614,1397.92126,17327957272,1409612379,17327954051,-3221,,
15923336671,1397.97132,17328007333,1409662434,17328004105,-3228,,
15923386726,1398.02137,17328057390,1409712486,17328054157,-3233,,
15923437276,1398.07192,17328107941,1409763033,17328104704,-3237,,
15923488310,1398.12296,17328158979,1409814065,17328155736,-3243,,
15923538870,1398.17352,17328209540,1409864621,17328206293,-3247,,
15923589918,1398.22457,17328260591,1409915665,17328257337,-3254,,
15923640470,1398.27512,17328311146,1409966216,17328307888,-3258,,
15923691533,1398.32618,17328362210,1410017276,17328358948,-3262,,
15923742567,1398.37721,17328413247,1410068307,17328409978,-3269,,
15923793103,1398.42775,17328463785,1410118841,17328460513,-3272,,
15923843643,1398.47829,17328514328,1410169378,17328511049,-3279,,
15923893882,1398.52853,17328564569,1410219614,17328561285,-3284,,
15923943973,1398.57862,17328614662,1410269703,17328611374,-3288,,
15923994040,1398.62869,17328664731,1410319767,17328661438,-3293,,
15924045084,1398.67973,17328715778,1410370808,17328712479,-3299,,
15924095152,1398.72980,17328765848,1410420873,17328762544,-3304,,
15924145226,1398.77987,17328815925,1410470946,17328812617,-3308,,
15924195276,1398.82992,17328865978,1410520993,17328862664,-3314,,
15924245825,1398.88047,17328916528,1410571538,17328913209,-3319,,
15924296023,1398.93067,17328966729,1410621735,17328963406,-3323,,
15924346330,1398.98098,17329017039,1410672038,17329013710,-3329,,
15924396636,1399.03128,17329067346,1410722341,17329064012,-3334,,
15924446940,1399.08159,17329117653,1410772644,17329114315,-3338,,
15924497194,1399.13184,17329167910,1410822894,17329164566,-3344,,
15924547489,1399.18214,17329218206,1410873186,17329214857,-3349,,
15924597762,1399.23241,17329268482,1410923457,17329265128,-3354,,
15924648347,1399.28300,17329319070,1410974039,17329315711,-3359,,
15924698846,1399.33349,17329369570,1411024535,17329366206,-3364,,
15924749254,1399.38390,17329419981,1411074940,17329416612,-3369,,
15924799578,1399.43423,17329470308,1411125262,17329466933,-3375,,
15924849899,1399.48455,17329520631,1411175581,17329517252,-3379,,
15924900206,1399.53485,17329570940,1411225884,17329567555,-3385,,
15924950297,1399.58495,17329621033,1411275972,17329617644,-3389,,
15925000849,1399.63550,17329671588,1411326522,17329668194,-3394,,
15925051178,1399.68583,17329721920,1411376848,17329718520,-3400,,
15925101877,1399.73653,17329772621,1411427545,17329769217,-3404,,
15925152501,1399.78715,17329823247,1411478166,17329819838,-3409,,
15925202821,1399.83747,17329873570,1411528483,17329870155,-3415,,
15925253070,1399.88772,17329923821,1411578729,17329920400,-3421,,
15925303854,1399.93850,17329974607,1411629512,17329971183,-3424,,
15925354192,1399.98884,17330024947,1411679845,17330021516,-3431,,
15925404989,1400.03964,17330075747,1411730640,17330072312,-3435,,
15925455314,1400.08996,17330126073,1411780963,17330122634,-3439,,
15925505769,1400.14042,17330176532,1411831416,17330173087,-3445,,
15925556111,1400.19076,17330226875,1411881753,17330223425,-3450,,
15925606893,1400.24154,17330277660,1411932534,17330274206,-3454,,
15925657122,1400.29177,17330327891,1411982759,17330324431,-3460,,
15925707312,1400.34196,17330378084,1412032947,17330374619,-3465,,
15925757637,1400.39228,17330428410,1412083270,17330424941,-3469,,
15925807810,1400.44246,17330478586,1412133440,17330475111,-3475,,
15925857927,1400.49257,17330528705,1412183554,17330525225,-3480,,
15925908203,1400.54285,17330578984,1412233827,17330575499,-3485,,
15925958437,1400.59308,17330629220,1412284059,17330625731,-3489,,
15926009184,1400.64383,17330679970,1412334803,17330676474,-3496,,
15926059272,1400.69392,17330730060,1412384889,17330726560,-3500,,
15926109377,1400.74402,17330780167,1412434991,17330776662,-3505,,
15926159721,1400.79437,17330830513,1412485332,17330827004,-3509,,
15926210379,1400.84503,17330881174,1412535987,17330877658,-3516,,
15926260700,1400.89535,17330931498,1412586306,17330927978,-3520,,
15926311361,1400.94601,17330982161,1412636964,17330978636,-3525,,
15926361633,1400.99628,17331032435,1412687234,17331028905,-3530,,
15926411825,1401.04647,17331082630,1412737423,17331079095,-3535,,
15926462577,1401.09722,17331133384,1412788172,17331129844,-3540,,
15926513095,1401.14774,17331183905,1412838687,17331180359,-3546,,
15926564155,1401.19880,17331234966,1412889744,17331231415,-3551,,
15926614884,1401.24953,17331285698,1412940471,17331282153,-3545,,
15926665484,1401.30013,17331336301,1412991069,17331332740,-3561,,
15926715860,1401.35051,17331386678,1413041441,17331383112,-3566,,
15926766187,1401.40083,17331437007,1413091766,17331433437,-3570,,
15926816839,1401.45149,17331487663,1413142415,17331484086,-3577,,
15926867161,1401.50181,17331537987,1413192734,17331534405,-3582,,
15926917860,1401.55251,17331588699,1413243442,17331585113,-3586,,
15926968369,1401.60302,17331639199,1413293937,17331635608,-3591,,
15927018997,1401.65365,17331689830,1413344563,17331686234,-3596,,
15927069649,1401.70430,17331740484,1413395211,17331736882,-3602,,
15927119952,1401.75460,17331790790,1413445513,17331787184,-3606,,
15927170431,1401.80508,17331841271,1413495988,17331837660,-3611,,
15927220688,1401.85534,17331891530,1413546242,17331887925,-3605,,
15927270929,1401.90558,17331941774,1413596481,17331938153,-3621,,
15927321225,1401.95587,17331992072,1413646775,17331988446,-3626,,
15927371463,1402.00611,17332042312,1413697016,17332038688,-3624,,
15927422018,1402.05667,17332092870,1413747562,17332089233,-3637,,
15927472735,1402.10738,17332143588,1413798276,17332139947,-3641,,
15927523003,1402.15765,17332193859,1413848542,17332190213,-3646,,
15927573308,1402.20796,17332244167,1413898843,17332240515,-3652,,
15927623463,1402.25811,17332294323,1413948996,17332290668,-3655,,
15927673584,1402.30823,17332344446,1413999114,17332340785,-3661,,
15927724476,1402.35912,17332395342,1414050003,17332391674,-3668,,
15927774752,1402.40940,17332445620,1414100278,17332441949,-3671,,
15927825620,1402.46027,17332496491,1414151143,17332492814,-3677,,
15927876031,1402.51068,17332546904,1414201550,17332543222,-3682,,
15927926119,1402.56077,17332596994,1414251636,17332593307,-3687,,
15927976339,1402.61099,17332647217,1414301854,17332643525,-3692,,
15928026773,1402.66142,17332697653,1414352285,17332693956,-3697,,
15928077332,1402.71198,17332748213,1414402840,17332744511,-3702,,
15928127728,1402.76238,17332798612,1414453234,17332794905,-3707,,
15928178027,1402.81267,17332848913,1414503530,17332845201,-3712,,
15928228549,1402.86320,17332899437,1414554049,17332895721,-3716,,
15928278768,1402.91342,17332949660,1414604266,17332945938,-3722,,
15928329222,1402.96387,17333000116,1414654718,17332996389,-3727,,
15928379338,1403.01399,17333050233,1414704830,17333046502,-3731,,
15928429906,1403.06455,17333100805,1414755409,17333097080,-3725,,
15928480634,1403.11528,17333151534,1414806121,17333147792,-3742,,
15928531300,1403.16595,17333202202,1414856784,17333198455,-3747,,
15928582207,1403.21685,17333253113,1414907688,17333249360,-3753,,
15928632314,1403.26696,17333303222,1414957793,17333299465,-3757,,
15928682912,1403.31756,17333353821,1415008388,17333350059,-3762,,
15928733221,1403.36787,17333404133,1415058693,17333400365,-3768,,
15928784023,1403.41867,17333454938,1415109494,17333451166,-3772,,
15928834355,1403.46900,17333505272,1415159823,17333501495,-3777,,
15928885017,1403.51967,17333555936,1415210482,17333552154,-3782,,
15928935292,1403.56994,17333606214,1415260754,17333602426,-3788,,
15928985861,1403.62051,17333656785,1415311321,17333652993,-3792,,
15929035997,1403.67064,17333706924,1415361455,17333703126,-3798,,
15929086753,1403.72140,17333757682,1415412207,17333753879,-3803,,
15929136897,1403.77155,17333807828,1415462349,17333804020,-3808,,
15929187179,1403.82183,17333858112,1415512628,17333854300,-3812,,
15929237883,1403.87253,17333908819,1415563329,17333905001,-3818,,
15929288551,1403.92320,17333959490,1415613995,17333955667,-3823,,
15929339773,1403.97442,17334010714,1415665214,17334006886,-3828,,
15929390471,1404.02512,17334061414,1415715910,17334057581,-3833,,
15929440548,1404.07520,17334111494,1415765983,17334107655,-3839,,
15929491168,1404.12582,17334162116,1415816601,17334158273,-3843,,
15929541717,1404.17637,17334212666,1415867147,17334208818,-3848,,
15929592323,1404.22697,17334263276,1415917751,17334259422,-3854,,
15929643370,1404.27802,17334314325,1415968796,17334310467,-3858,,
15929694370,1404.32902,17334365327,1416019793,17334361464,-3863,,
15929744917,1404.37956,17334415877,1416070336,17334412008,-3869,,
15929795035,1404.42968,17334465997,1416120452,17334462124,-3873,,
15929845974,1404.48062,17334516938,1416171388,17334513060,-3878,,
15929897035,1404.53168,17334568001,1416222446,17334564117,-3884,,
15929947628,1404.58228,17334618606,1416273046,17334614717,-3889,,
15929998195,1404.63284,17334669166,1416323601,17334665282,-3884,,
15930048757,1404.68340,17334719731,1416374161,17334715832,-3899,,
15930099609,1404.73426,17334770585,1416425009,17334766681,-3904,,
15930150043,1404.78469,17334821021,1416475441,17334817112,-3909,,
15930200611,1404.83526,17334871592,1416526007,17334867678,-3914,,
15930251127,1404.88577,17334922109,1416576519,17334918191,-3918,,
15930301869,1404.93652,17334972855,1416627259,17334968930,-3925,,
15930352415,1404.98706,17335023403,1416677802,17335019474,-3929,,
15930402964,1405.03761,17335073955,1416728350,17335070021,-3934,,
15930453532,1405.08818,17335124535,1416778924,17335120596,-3939,,
15930504076,1405.13872,17335175071,1416829456,17335171127,-3944,,
15930555139,1405.18979,17335226136,1416880516,17335222188,-3948,,
15930606170,1405.24082,17335277170,1416931544,17335273215,-3955,,
15930656740,1405.29139,17335327742,1416982110,17335323782,-3960,,
15930707325,1405.34197,17335378329,1417032693,17335374364,-3965,,
15930757830,1405.39248,17335428837,1417083195,17335424866,-3971,,
15930808914,1405.44356,17335479923,1417134276,17335475948,-3975,,
15930859423,1405.49407,17335530434,1417184783,17335526454,-3980,,
15930909961,1405.54461,17335580975,1417235318,17335576990,-3985,,
15930960055,1405.59470,17335631071,1417285409,17335627081,-3990,,
15931010619,1405.64527,17335681638,1417335980,17335677652,-3986,,
15931061360,1405.69601,17335732380,1417386708,17335728380,-4000,,
15931111479,1405.74613,17335782502,1417436836,17335778507,-3995,,
15931162541,1405.79719,17335833567,1417487884,17335829555,-4012,,
15931213590,1405.84824,17335884617,1417538931,17335880602,-4015,,
15931264607,1405.89926,17335935636,1417589945,17335931616,-4020,,
15931315239,1405.94989,17335986272,1417640574,17335982246,-4026,,
15931366272,1406.00092,17336037317,1417691615,17336033287,-4030,,
15931417132,1406.05178,17336088170,1417742463,17336084135,-4035,,
15931467216,1406.10186,17336138255,1417792543,17336134215,-4040,,
15931517540,1406.15219,17336188581,1417842864,17336184535,-4046,,
15931568589,1406.20324,17336239633,1417893911,17336235582,-4051,,
15931618698,1406.25335,17336289745,1417944018,17336285689,-4056,,
15931668812,1406.30346,17336339860,1417994128,17336335800,-4060,,
15931719344,1406.35399,17336390396,1418044659,17336386330,-4066,,
15931769617,1406.40426,17336440682,1418094940,17336436611,-4071,,
15931819766,1406.45441,17336490822,1418145074,17336486746,-4076,,
15931870785,1406.50543,17336541844,1418196090,17336537761,-4083,,
15931920921,1406.55557,17336591982,1418246225,17336587896,-4086,,
15931971514,1406.60616,17336642578,1418296815,17336638486,-4092,,
15932022048,1406.65670,17336693114,1418347346,17336689017,-4097,,
15932072888,1406.70754,17336743957,1418398184,17336739856,-4101,,
15932123633,1406.75828,17336794703,1418448926,17336790597,-4106,,
15932174714,1406.80936,17336845787,1418500004,17336841675,-4112,,
15932224809,1406.85946,17336895884,1418550097,17336891768,-4116,,
15932275873,1406.91052,17336946950,1418601158,17336942829,-4121,,
15932326895,1406.96154,17336997974,1418652176,17336993848,-4126,,
15932377476,1407.01212,17337048558,1418702754,17337044426,-4132,,
15932428478,1407.06313,17337099563,1418753754,17337095426,-4137,,
15932479514,1407.11416,17337150601,1418804788,17337146459,-4142,,
15932529873,1407.16452,17337200962,1418855143,17337196815,-4147,,
15932580539,1407.21519,17337251631,1418905806,17337247477,-4154,,
15932630684,1407.26533,17337301778,1418955949,17337297621,-4157,,
15932681733,1407.31638,17337352829,1419006995,17337348666,-4163,,
15932732781,1407.36743,17337403880,1419058040,17337399712,-4168,,
15932783831,1407.41848,17337454932,1419109088,17337450759,-4173,,
15932834653,1407.46930,17337505756,1419159908,17337501580,-4176,,
15932884725,1407.51937,17337555830,1419209976,17337551647,-4183,,
15932935778,1407.57043,17337606886,1419261026,17337602698,-4188,,
15932986822,1407.62147,17337657932,1419312068,17337653739,-4193,,
15933037402,1407.67205,17337708515,1419362645,17337704316,-4199,,
15933088454,1407.72310,17337759568,1419413694,17337755365,-4203,,
15933139424,1407.77407,17337810542,1419464662,17337806334,-4208,,
15933189977,1407.82462,17337861097,1419515212,17337856883,-4214,,
15933240554,1407.87520,17337911676,1419565787,17337907458,-4218,,
15933291618,1407.92627,17337962744,1419616848,17337958519,-4225,,
15933342701,1407.97735,17338013832,1419667932,17338009604,-4228,,
15933393725,1408.02837,17338064854,1419718949,17338060621,-4233,,
15933444740,1408.07939,17338115871,1419769961,17338111632,-4239,,
15933495297,1408.12994,17338166432,1419820517,17338162189,-4243,,
15933545529,1408.18018,17338216666,1419870746,17338212417,-4249,,
15933596118,1408.23077,17338267257,1419921332,17338263003,-4254,,
15933646690,1408.28134,17338317831,1419971900,17338313571,-4260,,
15933696814,1408.33146,17338367957,1420022022,17338363693,-4264,,
15933747826,1408.38247,17338418972,1420073031,17338414703,-4269,,
15933798465,1408.43311,17338469612,1420123666,17338465338,-4274,,
15933849016,1408.48366,17338520167,1420174216,17338515888,-4279,,
15933899584,1408.53423,17338570737,1420224781,17338566452,-4285,,
15933949736,1408.58438,17338620891,1420274930,17338616602,-4289,,
15934000262,1408.63491,17338671420,1420325455,17338667126,-4294,,
15934050809,1408.68546,17338721969,1420375998,17338717670,-4299,,
15934101380,1408.73603,17338772542,1420426567,17338768238,-4304,,
15934152455,1408.78710,17338823620,1420477638,17338819310,-4310,,
15934203523,1408.83817,17338874701,1420528716,17338870388,-4313,,
15934254170,1408.88882,17338925338,1420579348,17338921020,-4318,,
15934304977,1408.93962,17338976148,1420630152,17338971824,-4324,,
15934355999,1408.99065,17339027173,1420681171,17339022843,-4330,,
15934406588,1409.04124,17339077765,1420731758,17339073430,-4335,,
15934456710,1409.09136,17339127889,1420781877,17339123548,-4341,,
15934507210,1409.14186,17339178391,1420832374,17339174046,-4345,,
15934557358,1409.19201,17339228553,1420882532,17339224203,-4350,,
15934607946,1409.24259,17339279132,1420933106,17339274777,-4355,,
15934658588,1409.29324,17339329776,1420983744,17339325415,-4361,,
15934709581,1409.34423,17339380772,1421034735,17339376407,-4365,,
15934759923,1409.39457,17339431117,1421085076,17339426747,-4370,,
15934810438,1409.44509,17339481633,1421135587,17339477258,-4375,,
15934861005,1409.49565,17339532213,1421186160,17339527832,-4381,,
15934911832,1409.54648,17339583033,1421236977,17339578648,-4385,,
15934962088,1409.59674,17339633290,1421287229,17339628900,-4390,,
15935012636,1409.64728,17339683841,1421337773,17339679445,-4396,,
15935063186,1409.69783,17339734393,1421388321,17339729993,-4400,,
15935113777,1409.74842,17339784987,1421438910,17339780582,-4405,,
15935164285,1409.79893,17339835497,1421489415,17339831087,-4410,,
15935214824,1409.84947,17339886038,1421539951,17339881623,-4415,,
15935265847,1409.90050,17339937063,1421590971,17339932642,-4421,,
15935316397,1409.95105,17339987616,1421641518,17339983190,-4426,,
15935366951,1410.00160,17340038172,1421692070,17340033741,-4431,,
15935417540,1410.05219,17340088764,1421742656,17340084328,-4436,,
15935468475,1410.10312,17340139702,1421793589,17340135261,-4441,,
15935519390,1410.15404,17340190618,1421844500,17340186172,-4446,,
15935569985,1410.20463,17340241215,1421895093,17340236764,-4451,,
15935620989,1410.25564,17340292222,1421946094,17340287766,-4456,,
15935672083,1410.30673,17340343318,1421997186,17340338857,-4461,,
15935723132,1410.35778,17340394370,1422048231,17340389903,-4467,,
15935773629,1410.40828,17340444869,1422098726,17340440398,-4471,,
15935824170,1410.45882,17340495411,1422149264,17340490936,-4475,,
15935874472,1410.50912,17340545717,1422199564,17340541235,-4482,,
15935925103,1410.55975,17340596349,1422250192,17340591864,-4485,,
15935976159,1410.61081,17340647409,1422301245,17340642917,-4492,,
15936026652,1410.66130,17340697904,1422351736,17340693407,-4497,,
15936076784,1410.71143,17340748038,1422401865,17340743536,-4502,,
15936127378,1410.76203,17340798635,1422452456,17340794127,-4508,,
15936177989,1410.81264,17340849248,1422503064,17340844736,-4512,,
15936228605,1410.86325,17340899866,1422553677,17340895349,-4517,,
15936279247,1410.91389,17340950511,1422604318,17340945989,-4522,,
15936330304,1410.96495,17341001582,1422655383,17340997055,-4527,,
15936381378,1411.01603,17341052646,1422706442,17341048114,-4532,,
15936431951,1411.06660,17341103221,1422757012,17341098683,-4538,,
15936482854,1411.11750,17341154127,1422807914,17341149585,-4542,,
15936533441,1411.16809,17341204727,1422858509,17341200180,-4547,,
15936584510,1411.21916,17341255788,1422909563,17341251235,-4553,,
15936635588,1411.27024,17341306868,1422960640,17341302311,-4557,,
15936686218,1411.32087,17341357500,1423011266,17341352937,-4563,,
15936736764,1411.37141,17341408048,1423061809,17341403480,-4568,,
15936787771,1411.42242,17341459058,1423112814,17341454485,-4573,,
15936837819,1411.47247,17341509109,1423162860,17341504531,-4578,,
15936888858,1411.52351,17341560150,1423213896,17341555567,-4583,,
15936939452,1411.57410,17341610747,1423264487,17341606159,-4588,,
15936991025,1411.62567,17341662322,1423316058,17341657729,-4593,,
15937041499,1411.67615,17341712797,1423366528,17341708199,-4598,,
15937091545,1411.72619,17341762845,1423416571,17341758242,-4603,,
15937141605,1411.77625,17341812909,1423466628,17341808300,-4609,,
15937192157,1411.82680,17341863463,1423517179,17341858850,-4613,,
15937242730,1411.87738,17341914038,1423567749,17341909420,-4618,,
15937293241,1411.92789,17341964552,1423618257,17341959928,-4624,,
15937343349,1411.97800,17342014662,1423668363,17342010034,-4628,,
15937393837,1412.02849,17342065153,1423718848,17342060519,-4634,,
15937443882,1412.07853,17342115200,1423768889,17342110560,-4640,,
15937493931,1412.12858,17342165251,1423818936,17342160608,-4643,,
15937545558,1412.18021,17342216883,1423870562,17342212246,-4637,,
15937596537,1412.23119,17342267861,1423921536,17342263208,-4653,,
15937647122,1412.28177,17342318448,1423972118,17342313789,-4659,,
15937698192,1412.33284,17342369521,1424023186,17342364857,-4664,,
15937749309,1412.38396,17342420640,1424074300,17342415971,-4669,,
15937803108,1412.43776,17342474441,1424128096,17342469767,-4674,,
15937853294,1412.48794,17342524630,1424178279,17342519950,-4680,,
15937903836,1412.53848,17342575175,1424228820,17342570491,-4684,,
15937954385,1412.58903,17342625727,1424279366,17342621037,-4690,,
15938005458,1412.64011,17342676801,1424330435,17342672106,-4695,,
15938055981,1412.69063,17342727327,1424380957,17342722628,-4699,,
15938107048,1412.74170,17342778397,1424432020,17342773692,-4705,,
15938157602,1412.79225,17342828953,1424482572,17342824243,-4710,,
15938208022,1412.84267,17342879375,1424532988,17342874660,-4715,,
15938258121,1412.89277,17342929477,1424583085,17342924757,-4720,,
15938308226,1412.94287,17342979584,1424633187,17342974859,-4725,,
15938359324,1412.99397,17343030683,1424684282,17343025954,-4729,,
15938409884,1413.04453,17343081247,1424734840,17343076512,-4735,,
15938460384,1413.09503,17343131749,1424785337,17343127009,-4740,,
15938510938,1413.14559,17343182305,1424835888,17343177560,-4745,,
15938561481,1413.19613,17343232851,1424886429,17343228100,-4751,,
15938611969,1413.24662,17343283341,1424936914,17343278586,-4755,,
15938662523,1413.29717,17343333896,1424987465,17343329136,-4760,,
15938713108,1413.34776,17343384485,1425038047,17343379719,-4766,,
15938763750,1413.39840,17343435129,1425088688,17343430359,-4770,,
15938814941,1413.44959,17343486322,1425139875,17343481546,-4776,,
15938865350,1413.50000,17343536734,1425190282,17343531953,-4781,,
15938916392,1413.55104,17343587778,1425241321,17343582992,-4786,,
15938967432,1413.60208,17343638820,1425292358,17343634029,-4791,,
15939017484,1413.65213,17343688875,1425342408,17343684079,-4796,,
15939068522,1413.70317,17343739915,1425393443,17343735114,-4801,,
15939119594,1413.75424,17343791002,1425444525,17343786197,-4805,,
15939170174,1413.80482,17343841572,1425495090,17343836761,-4811,,
15939221218,1413.85587,17343892618,1425546130,17343887802,-4816,,
15939271841,1413.90649,17343943243,1425596750,17343938421,-4822,,
15939321983,1413.95663,17343993388,1425646890,17343988562,-4826,,
15939372566,1414.00721,17344043973,1425697470,17344039141,-4832,,
15939423616,1414.05826,17344095025,1425748517,17344090188,-4837,,
15939474665,1414.10931,17344146077,1425799564,17344141236,-4841,,
15939525665,1414.16031,17344197079,1425850561,17344192232,-4847,,
15939576263,1414.21091,17344247680,1425901157,17344242828,-4852,,
15939627311,1414.26196,17344298729,1425952201,17344293872,-4857,,
15939678359,1414.31301,17344349781,1426003247,17344344918,-4863,,
15939729407,1414.36406,17344400831,1426054293,17344395964,-4867,,
15939780423,1414.41507,17344451849,1426105305,17344446977,-4872,,
15939831504,1414.46615,17344502933,1426156385,17344498056,-4877,,
15939882557,1414.51721,17344553987,1426207434,17344549106,-4881,,
15939933090,1414.56774,17344604524,1426257965,17344599636,-4888,,
15939984129,1414.61878,17344655575,1426309011,17344650683,-4892,,
15940035202,1414.66985,17344706640,1426360072,17344701743,-4897,,
15940085726,1414.72037,17344757178,1426410604,17344752275,-4903,,
15940136804,1414.77145,17344808246,1426461667,17344803338,-4908,,
15940187848,1414.82250,17344859293,1426512708,17344854380,-4913,,
15940238861,1414.87351,17344910308,1426563719,17344905390,-4918,,
15940289444,1414.92409,17344960894,1426614300,17344955971,-4923,,
15940339986,1414.97463,17345011438,1426664838,17345006509,-4929,,
15940390133,1415.02478,17345061588,1426714984,17345056655,-4933,,
15940440683,1415.07533,17345112140,1426765531,17345107213,-4927,,
15940491299,1415.12595,17345162759,1426816143,17345157815,-4944,,
15940542071,1415.17672,17345213533,1426866913,17345208585,-4948,,
15940592223,1415.22687,17345263697,1426917073,17345258744,-4953,,
15940643307,1415.27796,17345314773,1426968143,17345309814,-4959,,
15940693867,1415.32851,17345365335,1427018700,17345360371,-4964,,
15940743997,1415.37865,17345415468,1427068828,17345410499,-4969,,
15940794606,1415.42925,17345466080,1427119434,17345461106,-4974,,
15940845651,1415.48030,17345517126,1427170476,17345512147,-4979,,
15940896152,1415.53080,17345567630,1427220975,17345562647,-4983,,
15940946217,1415.58086,17345617698,1427271038,17345612709,-4989,,
15940996329,1415.63098,17345667811,1427321146,17345662817,-4994,,
15941047416,1415.68206,17345718900,1427372230,17345713901,-4999,,
15941098016,1415.73266,17345769514,1427422839,17345764510,-5004,,
15941148532,1415.78318,17345820021,1427473341,17345815012,-5009,,
15941199069,1415.83372,17345870560,1427523875,17345865546,-5014,,
15941249184,1415.88383,17345920679,1427573988,17345915659,-5020,,
15941300255,1415.93490,17345971751,1427625056,17345966727,-5024,,
15941350830,1415.98548,17346022328,1427675628,17346017299,-5029,,
15941401354,1416.03600,17346072855,1427726150,17346067821,-5034,,
15941451478,1416.08613,17346122982,1427776271,17346117943,-5039,,
15941502527,1416.13718,17346174034,1427827318,17346168989,-5045,,
15941553080,1416.18773,17346224588,1427877867,17346219538,-5050,,
15941604101,1416.23875,17346275612,1427928886,17346270558,-5054,,
15941655174,1416.28982,17346326688,1427979956,17346321628,-5060,,
15941706207,1416.34085,17346377734,1428030998,17346372669,-5065,,
15941756767,1416.39142,17346428285,1428081544,17346423216,-5069,,
15941807201,1416.44185,17346478721,1428131975,17346473646,-5075,,
15941857771,1416.49242,17346529293,1428182542,17346524213,-5080,,
15941908844,1416.54349,17346580368,1428233612,17346575283,-5085,,
15941959478,1416.59413,17346631005,1428284244,17346625915,-5090,,
15942010007,1416.64466,17346681536,1428334770,17346676441,-5095,,
15942060628,1416.69528,17346732160,1428385389,17346727060,-5100,,
15942111284,1416.74593,17346782819,1428436042,17346777713,-5106,,
15942161864,1416.79651,17346833401,1428486620,17346828291,-5110,,
15942212007,1416.84666,17346883547,1428536759,17346878431,-5116,,
15942262924,1416.89757,17346934466,1428587674,17346929345,-5121,,
15942313540,1416.94819,17346985083,1428638287,17346979959,-5124,,
15942364619,1416.99927,17347036166,1428689363,17347031035,-5131,,
15942415211,1417.04986,17347086760,1428739953,17347081624,-5136,,
15942466210,1417.10086,17347137761,1428790949,17347132621,-5140,,
15942516542,1417.15119,17347188096,1428841278,17347182950,-5146,,
15942566684,1417.20133,17347238240,1428891417,17347233089,-5151,,
15942617281,1417.25193,17347288839,1428942013,17347283684,-5155,,
15942667874,1417.30252,17347339435,1428992614,17347334286,-5149,,
15942717989,1417.35264,17347389551,1429042714,17347384385,-5166,,
15942768597,1417.40324,17347440162,1429093319,17347434990,-5172,,
15942819669,1417.45432,17347491237,1429144390,17347486061,-5176,,
15942870694,1417.50534,17347542264,1429195411,17347537082,-5182,,
15942921731,1417.55638,17347593304,1429246445,17347588117,-5187,,
15942972769,1417.60742,17347644343,1429297480,17347639152,-5191,,
15943023308,1417.65796,17347694885,1429348018,17347689689,-5196,,
15943073912,1417.70856,17347745492,1429398618,17347740290,-5202,,
15943124961,1417.75961,17347796543,1429449664,17347791335,-5208,,
15943176010,1417.81066,17347847593,1429500711,17347842401,-5192,,
15943226556,1417.86120,17347898142,1429551254,17347892925,-5217,,
15943277607,1417.91225,17347949196,1429602302,17347943974,-5222,,
15943328656,1417.96330,17348000247,1429653348,17347995019,-5228,,
15943379705,1418.01435,17348051299,1429704396,17348046067,-5232,,
15943430766,1418.06541,17348102362,1429755453,17348097125,-5237,,
15943481432,1418.11608,17348153031,1429806116,17348147788,-5243,,
15943532040,1418.16669,17348203640,1429856722,17348198393,-5247,,
15943582103,1418.21675,17348253716,1429906794,17348248465,-5251,,
15943632337,1418.26698,17348303943,1429957013,17348298685,-5258,,
15943683411,1418.31806,17348355019,1430008085,17348349756,-5263,,
15943734403,1418.36905,17348406013,1430059085,17348400757,-5256,,
15943784813,1418.41946,17348456425,1430109481,17348451153,-5272,,
15943835173,1418.46982,17348506788,1430159839,17348501510,-5278,,
15943885523,1418.52017,17348557139,1430210186,17348551857,-5282,,
15943936104,1418.57075,17348607724,1430260764,17348602436,-5288,,
15943986224,1418.62087,17348657846,1430310882,17348652553,-5293,,
15944036807,1418.67145,17348708430,1430361462,17348703133,-5297,,
15944087437,1418.72209,17348759076,1430412102,17348753773,-5303,,
15944138496,1418.77314,17348810125,1430463145,17348804817,-5308,,
15944189421,1418.82407,17348861052,1430514068,17348855739,-5313,,
15944239619,1418.87427,17348911252,1430564263,17348905934,-5318,,
15944290508,1418.92516,17348962144,1430615149,17348956821,-5323,,
15944341055,1418.97570,17349012693,1430665693,17349007364,-5329,,
15944392052,1419.02670,17349063692,1430716688,17349058360,-5332,,
15944442519,1419.07717,17349114161,1430767152,17349108823,-5338,,
15944493143,1419.12779,17349164789,1430817773,17349159445,-5344,,
15944544146,1419.17879,17349215793,1430868773,17349210444,-5349,,
15944594315,1419.22896,17349265964,1430918940,17349260611,-5353,,
15944645391,1419.28004,17349317044,1430970013,17349311685,-5359,,
15944695705,1419.33035,17349367360,1431020325,17349362008,-5352,,
15944746723,1419.38137,17349418379,1431071339,17349413011,-5368,,
15944797312,1419.43196,17349468972,1431121938,17349463609,-5363,,
15944848360,1419.48301,17349520022,1431172983,17349514655,-5367,,
15944899447,1419.53409,17349571111,1431224056,17349565727,-5384,,
15944950370,1419.58502,17349622037,1431274977,17349616648,-5389,,
15945000430,1419.63508,17349672099,1431325033,17349666705,-5394,,
15945051486,1419.68613,17349723158,1431376086,17349717758,-5400,,
15945101931,1419.73658,17349773604,1431426529,17349768200,-5404,,
15945152310,1419.78696,17349823997,1431476916,17349818588,-5409,,
15945202979,1419.83763,17349874658,1431527571,17349869243,-5415,,
15945253764,1419.88841,17349925445,1431578365,17349920036,-5409,,
15945304452,1419.93910,17349976134,1431629039,17349970710,-5424,,
15945354593,1419.98924,17350026279,1431679177,17350020860,-5419,,
15945405593,1420.04024,17350077280,1431730174,17350071845,-5435,,
15945456652,1420.09130,17350128342,1431781232,17350122903,-5439,,
15945507657,1420.14231,17350179350,1431832234,17350173905,-5445,,
15945558705,1420.19335,17350230400,1431883279,17350224950,-5450,,
15945608861,1420.24351,17350280567,1431933441,17350275113,-5454,,
15945658996,1420.29364,17350330696,1431983564,17350325236,-5460,,
15945709549,1420.34420,17350381251,1432034115,17350375786,-5465,,
15945760346,1420.39499,17350432061,1432084918,17350426590,-5471,,
15945810801,1420.44545,17350482508,1432135361,17350477032,-5476,,
15945860956,1420.49560,17350532665,1432185514,17350527185,-5480,,
15945911518,1420.54617,17350583230,1432236072,17350577744,-5486,,
15945961839,1420.59649,17350633552,1432286391,17350628062,-5490,,
15946012428,1420.64708,17350684143,1432336977,17350678648,-5495,,
15946063095,1420.69774,17350734814,1432387642,17350729313,-5501,,
15946113666,1420.74831,17350785387,1432438220,17350779891,-5496,,
15946163833,1420.79848,17350835556,1432488375,17350830046,-5510,,
15946214883,1420.84953,17350886609,1432539421,17350881093,-5516,,
15946265347,1420.89999,17350937075,1432589892,17350931564,-5511,,
15946316338,1420.95099,17350988068,1432640871,17350982543,-5525,,
15946366440,1421.00109,17351038172,1432690981,17351032652,-5520,,
15946417508,1421.05216,17351089243,1432742035,17351083706,-5537,,
15946468116,1421.10276,17351139853,1432792640,17351134312,-5541,,
15946518979,1421.15363,17351190719,1432843501,17351185173,-5546,,
15946569829,1421.20448,17351241571,1432894349,17351236020,-5551,,
15946619967,1421.25462,17351291710,1432944483,17351286164,-5546,,
15946670091,1421.30474,17351341838,1432994606,17351336277,-5561,,
15946720693,1421.35534,17351392441,1433045204,17351386875,-5566,,
15946771249,1421.40590,17351443001,1433095757,17351437429,-5572,,
15946821851,1421.45650,17351493616,1433146369,17351488040,-5576,,
15946872496,1421.50714,17351544251,1433196999,17351538670,-5581,,
15946923086,1421.55773,17351594845,1433247586,17351589257,-5588,,
15946973647,1421.60829,17351645408,1433298144,17351639816,-5592,,
15947024246,1421.65889,17351696009,1433348742,17351690413,-5596,,
15947074312,1421.70896,17351746078,1433398804,17351740475,-5603,,
15947125383,1421.76003,17351797151,1433449872,17351791543,-5608,,
15947175930,1421.81058,17351847700,1433500417,17351842089,-5611,,
15947226442,1421.86109,17351898214,1433550926,17351892597,-5617,,
15947277167,1421.91181,17351948942,1433601649,17351943320,-5622,,
15947327749,1421.96240,17351999525,1433652239,17351993910,-5615,,
15947377935,1422.01258,17352049715,1433702412,17352044083,-5632,,
15947428984,1422.06363,17352100766,1433753457,17352095129,-5637,,
15947479539,1422.11419,17352151323,1433804010,17352145681,-5642,,
15947530556,1422.16520,17352202342,1433855024,17352196695,-5647,,
15947581117,1422.21576,17352252915,1433905592,17352247264,-5651,,
15947631677,1422.26633,17352303469,1433956150,17352297821,-5648,,
15947682714,1422.31736,17352354507,1434007174,17352348845,-5662,,
15947733793,1422.36844,17352405589,1434058251,17352399922,-5667,,
15947784322,1422.41897,17352456121,1434108776,17352450448,-5673,,
15947835350,1422.47000,17352507150,1434159801,17352501472,-5678,,
15947885949,1422.52060,17352557752,1434210398,17352552070,-5682,,
15947936597,1422.57125,17352608403,1434261043,17352602714,-5689,,
15947987125,1422.62177,17352658944,1434311580,17352653251,-5693,,
15948037750,1422.67240,17352709559,1434362201,17352703872,-5687,,
15948088145,1422.72279,17352759958,1434412593,17352754264,-5694,,
15948138738,1422.77339,17352810552,1434463173,17352804844,-5708,,
15948189790,1422.82444,17352861607,1434514222,17352855893,-5714,,
15948240145,1422.87479,17352911965,1434564575,17352906246,-5719,,
15948290745,1422.92539,17352962567,1434615172,17352956844,-5723,,
15948341797,1422.97645,17353013622,1434666221,17353007892,-5730,,
15948392138,1423.02679,17353063964,1434716560,17353058241,-5723,,
15948442955,1423.07760,17353114784,1434767374,17353109045,-5739,,
15948493505,1423.12815,17353165346,1434817931,17353159602,-5744,,
15948543676,1423.17832,17353215510,1434868089,17353209761,-5749,,
15948594274,1423.22892,17353266110,1434918685,17353260357,-5753,,
15948644851,1423.27950,17353316690,1434969259,17353310931,-5759,,
15948695399,1423.33005,17353367240,1435019805,17353361476,-5764,,
15948746448,1423.38110,17353418291,1435070852,17353412523,-5768,,
15948797498,1423.43215,17353469344,1435121898,17353463570,-5774,,
15948848546,1423.48319,17353520393,1435172943,17353514614,-5779,,
15948899595,1423.53424,17353571445,1435223989,17353565661,-5784,,
15948950117,1423.58477,17353621970,1435274509,17353616180,-5790,,
15949000671,1423.63532,17353672526,1435325060,17353666732,-5794,,
15949051206,1423.68585,17353723063,1435375592,17353717264,-5799,,
15949101753,1423.73640,17353773612,1435426137,17353767808,-5804,,
15949151801,1423.78645,17353823663,1435476183,17353817854,-5809,,
15949202358,1423.83701,17353874233,1435526746,17353868417,-5816,,
15949253418,1423.88807,17353925285,1435577793,17353919465,-5820,,
15949304042,1423.93869,17353975910,1435628415,17353970086,-5824,,
15949354813,1423.98946,17354026685,1435679183,17354020865,-5820,,
15949405235,1424.03988,17354077109,1435729603,17354071274,-5835,,
15949455846,1424.09049,17354127722,1435780211,17354121883,-5839,,
15949506896,1424.14154,17354178775,1435831258,17354172930,-5845,,
15949557432,1424.19208,17354229313,1435881791,17354223463,-5850,,
15949608302,1424.24295,17354280185,1435932658,17354274330,-5855,,
15949658423,1424.29307,17354330309,1435982777,17354324449,-5860,,
15949708863,1424.34351,17354380751,1436033214,17354374885,-5866,,
15949759343,1424.39399,17354431233,1436083691,17354425362,-5871,,
15949809913,1424.44456,17354481806,1436134260,17354475931,-5875,,
15949860513,1424.49516,17354532418,1436184866,17354526538,-5880,,
15949911578,1424.54623,17354583476,1436235918,17354577589,-5887,,
15949962212,1424.59686,17354634112,1436286550,17354628221,-5891,,
15950013260,1424.64791,17354685162,1436337596,17354679267,-5895,,
15950063780,1424.69843,17354735685,1436388112,17354729784,-5901,,
15950113884,1424.74853,17354785791,1436438214,17354779885,-5906,,
15950164259,1424.79891,17354836168,1436488586,17354830267,-5901,,
15950214880,1424.84953,17354886791,1436539204,17354880875,-5916,,
15950265398,1424.90005,17354937312,1436589719,17354931391,-5921,,
15950316004,1424.95065,17354987920,1436640323,17354981995,-5925,,
15950367066,1425.00171,17355038985,1436691383,17355033054,-5931,,
15950418110,1425.05276,17355090031,1436742424,17355084095,-5936,,
15950468567,1425.10322,17355140489,1436792877,17355134548,-5941,,
15950519301,1425.15395,17355191227,1436843609,17355185281,-5946,,
15950569398,1425.20405,17355241326,1436893704,17355235375,-5951,,
15950619978,1425.25463,17355291907,1436944280,17355285951,-5956,,
15950671027,1425.30568,17355342959,1436995327,17355336998,-5961,,
15950722075,1425.35672,17355394009,1437046372,17355388043,-5966,,
15950773116,1425.40776,17355445054,1437097410,17355439082,-5972,,
15950823643,1425.45829,17355495582,1437147934,17355489605,-5977,,
15950874192,1425.50884,17355546134,1437198481,17355540153,-5981,,
15950924848,1425.55950,17355596792,1437249134,17355590806,-5986,,
15950975433,1425.61008,17355647380,1437299716,17355641388,-5992,,
15951025973,1425.66062,17355697921,1437350254,17355691925,-5996,,
15951076621,1425.71127,17355748572,1437400899,17355742570,-6002,,
15951127252,1425.76190,17355799206,1437451527,17355793199,-6007,,
15951177808,1425.81246,17355849764,1437502081,17355843753,-6011,,
15951228404,1425.86305,17355900374,1437552686,17355894358,-6016,,
15951279039,1425.91369,17355951000,1437603307,17355944978,-6022,,
15951329746,1425.96439,17356001709,1437654010,17355995681,-6028,,
15951380787,1426.01544,17356052752,1437705049,17356046720,-6032,,
15951431360,1426.06601,17356103327,1437755619,17356097290,-6037,,
15951482004,1426.11665,17356153975,1437806261,17356147932,-6043,,
15951532720,1426.16737,17356204693,1437856974,17356198646,-6047,,
15951583316,1426.21796,17356255291,1437907567,17356249239,-6052,,
15951633883,1426.26853,17356305861,1437958132,17356299804,-6057,,
15951684903,1426.31955,17356356883,1438009148,17356350819,-6064,,
15951735945,1426.37059,17356407927,1438060188,17356401860,-6067,,
15951786091,1426.42074,17356458076,1438110331,17356452003,-6073,,
15951836175,1426.47082,17356508162,1438160413,17356502084,-6078,,
15951887222,1426.52187,17356559211,1438211457,17356553129,-6082,,
15951937834,1426.57248,17356609826,1438262067,17356603738,-6088,,
15951988148,1426.62280,17356660141,1438312377,17356654049,-6092,,
15952039192,1426.67384,17356711188,1438363419,17356705090,-6098,,
15952090238,1426.72489,17356762237,1438414463,17356756134,-6103,,
15952140768,1426.77542,17356812769,1438464990,17356806661,-6108,,
15952191308,1426.82596,17356863312,1438515526,17356857198,-6114,,
15952241881,1426.87653,17356913887,1438566097,17356907768,-6119,,
15952292929,1426.92758,17356964937,1438617143,17356958814,-6123,,
15952343986,1426.97863,17357015997,1438668196,17357009868,-6129,,
15952395001,1427.02965,17357067014,1438719209,17357060880,-6134,,
15952445576,1427.08022,17357117591,1438769782,17357111453,-6138,,
15952496678,1427.13133,17357168696,1438820881,17357162552,-6144,,
15952547225,1427.18187,17357219245,1438871424,17357213095,-6150,,
15952597728,1427.23238,17357269750,1438921925,17357263597,-6153,,
15952648758,1427.28341,17357320783,1438972952,17357314624,-6159,,
15952699359,1427.33401,17357371386,1439023551,17357365222,-6164,,
15952749912,1427.38456,17357421954,1439074112,17357415784,-6170,,
15952800466,1427.43511,17357472497,1439124652,17357466324,-6173,,
15952851061,1427.48571,17357523095,1439175244,17357516916,-6179,,
15952902101,1427.53675,17357574138,1439226281,17357567953,-6185,,
15952952663,1427.58731,17357624701,1439276841,17357618512,-6189,,
15953003199,1427.63785,17357675240,1439327374,17357669046,-6194,,
15953053759,1427.68841,17357725803,1439377932,17357719603,-6200,,
15953104330,1427.73898,17357776375,1439428499,17357770170,-6205,,
15953154746,1427.78939,17357826794,1439478913,17357820585,-6209,,
15953204948,1427.83960,17357876999,1439529113,17357870784,-6215,,
15953255580,1427.89023,17357927633,1439579741,17357921413,-6220,,
15953306632,1427.94128,17357978687,1439630791,17357972463,-6224,,
15953357649,1427.99230,17358029707,1439681805,17358023477,-6230,,
15953408290,1428.04294,17358080349,1439732443,17358074114,-6235,,
15953458887,1428.09353,17358130949,1439783038,17358124709,-6240,,
15953509435,1428.14408,17358181500,1439833583,17358175254,-6246,,
15953559983,1428.19463,17358232050,1439884129,17358225800,-6250,,
15953611023,1428.24567,17358283093,1439935166,17358276837,-6256,,
15953662097,1428.29675,17358334169,1439986237,17358327908,-6261,,
15953712622,1428.34727,17358384696,1440036760,17358378431,-6265,,
15953767300,1428.40195,17358439377,1440091454,17358433593,-5784,,
15953820253,1428.45490,17358492332,1440144385,17358486056,-6276,,
15953871288,1428.50594,17358543370,1440195416,17358537088,-6282,,
15953921813,1428.55646,17358593897,1440245939,17358587611,-6286,,
15953972990,1428.60764,17358645076,1440297114,17358638785,-6291,,
15954023939,1428.65859,17358696027,1440348058,17358689730,-6297,,
15954074452,1428.70910,17358746543,1440398570,17358740242,-6301,,
15954124503,1428.75915,17358796596,1440448618,17358790290,-6306,,
15954175181,1428.80983,17358847277,1440499293,17358840965,-6312,,
15954226107,1428.86075,17358898204,1440550216,17358891887,-6317,,
15954276661,1428.91131,17358948762,1440600769,17358942440,-6322,,
15954326719,1428.96137,17358998821,1440650823,17358992495,-6326,,
15954377761,1429.01241,17359049866,1440701863,17359043534,-6332,,
15954428314,1429.06296,17359100421,1440752413,17359094084,-6337,,
15954479400,1429.11405,17359151509,1440803496,17359145167,-6342,,
15954530400,1429.16505,17359202511,1440854493,17359196164,-6347,,
15954580478,1429.21513,17359252593,1440904569,17359246241,-6352,,
15954631503,1429.26615,17359303620,1440955591,17359297262,-6358,,
15954682542,1429.31719,17359354661,1441006627,17359348299,-6362,,
15954732590,1429.36724,17359404712,1441056672,17359398344,-6368,,
15954786757,1429.42141,17359458880,1441110836,17359452507,-6373,,
15954837212,1429.47186,17359509339,1441161289,17359502960,-6379,,
15954887818,1429.52247,17359559947,1441211892,17359553564,-6383,,
15954938292,1429.57294,17359610423,1441262363,17359604034,-6389,,
15954988389,1429.62304,17359660523,1441312458,17359654130,-6393,,
15955038901,1429.67355,17359711036,1441362967,17359704638,-6398,,
15955089960,1429.72461,17359762098,1441414024,17359755695,-6403,,
15955140929,1429.77558,17359813070,1441464990,17359806661,-6409,,
15955192001,1429.82665,17359864144,1441516060,17359857731,-6413,,
15955242520,1429.87717,17359914665,1441566575,17359908247,-6418,,
15955293072,1429.92772,17359965219,1441617124,17359958795,-6424,,
15955343589,1429.97824,17360015739,1441667639,17360009310,-6429,,
15955394606,1430.02925,17360066759,1441718653,17360060325,-6434,,
15955446440,1430.08109,17360118595,1441770484,17360112156,-6439,,
15955497193,1430.13184,17360169349,1441821234,17360162906,-6443,,
15955547743,1430.18239,17360219902,1441871782,17360213453,-6449,,
15955598294,1430.23294,17360270456,1441922331,17360264002,-6454,,
15955649333,1430.28398,17360321497,1441973367,17360315038,-6459,,
15955699377,1430.33403,17360371543,1442023408,17360365080,-6463,,
15955749940,1430.38459,17360422109,1442073969,17360415640,-6469,,
15955800496,1430.43514,17360472667,1442124521,17360466193,-6474,,
15955851526,1430.48617,17360523700,1442175548,17360517220,-6480,,
15955902594,1430.53724,17360574770,1442226615,17360568286,-6484,,
15955953142,1430.58779,17360625320,1442277159,17360618831,-6489,,
15956004175,1430.63882,17360676356,1442328189,17360669861,-6495,,
15956054730,1430.68938,17360726912,1442378742,17360720413,-6499,,
15956105302,1430.73995,17360777488,1442429312,17360770983,-6505,,
15956156327,1430.79097,17360828515,1442480333,17360822005,-6510,,
15956208866,1430.84351,17360881055,1442532869,17360874540,-6515,,
15956259411,1430.89406,17360931604,1442583412,17360925084,-6520,,
15956309986,1430.94463,17360982181,1442633984,17360975656,-6525,,
15956360973,1430.99562,17361033170,1442684968,17361026640,-6530,,
15956411035,1431.04568,17361083235,1442735028,17361076700,-6535,,
15956462100,1431.09675,17361134302,1442786090,17361127762,-6540,,
15956512480,1431.14713,17361184684,1442836467,17361178139,-6545,,
15956563547,1431.19819,17361235754,1442887531,17361229203,-6551,,
15956614126,1431.24877,17361286335,1442938109,17361279780,-6555,,
15956665036,1431.29968,17361337248,1442989016,17361330687,-6561,,
15956715158,1431.34981,17361387372,1443039134,17361380806,-6566,,
15956765850,1431.40050,17361438066,1443089825,17361431496,-6570,,
15956816468,1431.45112,17361488687,1443140439,17361482110,-6577,,
15956867408,1431.50206,17361539629,1443191377,17361533048,-6581,,
15956918448,1431.55310,17361590671,1443242414,17361584086,-6585,,
15956968994,1431.60364,17361641219,1443292957,17361634629,-6590,,
15957019639,1431.65429,17361691867,1443343599,17361685270,-6597,,
15957070180,1431.70483,17361742410,1443394138,17361735809,-6601,,
15957120712,1431.75536,17361792945,1443444667,17361786339,-6606,,
15957171272,1431.80592,17361843506,1443495224,17361836895,-6611,,
15957222361,1431.85701,17361894597,1443546310,17361887981,-6616,,
15957272537,1431.90719,17361944776,1443596483,17361938154,-6622,,
15957323242,1431.95789,17361995483,1443647186,17361988857,-6626,,
15957374170,1432.00882,17362046415,1443698112,17362039783,-6632,,
15957424815,1432.05946,17362097061,1443748753,17362090424,-6637,,
15957475362,1432.11001,17362147611,1443799299,17362140970,-6641,,
15957525520,1432.16017,17362197771,1443849453,17362191125,-6646,,
15957576116,1432.21076,17362248369,1443900046,17362241717,-6652,,
15957626695,1432.26134,17362298951,1443950623,17362292295,-6656,,
15957677696,1432.31234,17362349955,1444001621,17362343293,-6662,,
15957728588,1432.36324,17362400849,1444052511,17362394182,-6667,,
15957779470,1432.41412,17362451743,1444103400,17362445071,-6672,,
15957830200,1432.46485,17362502466,1444154117,17362495789,-6677,,
15957880753,1432.51540,17362553021,1444204667,17362546338,-6683,,
15957931809,1432.56646,17362604078,1444255720,17362597392,-6686,,
15957982845,1432.61749,17362655118,1444306754,17362648426,-6692,,
15958033383,1432.66803,17362705658,1444357289,17362698961,-6697,,
15958084443,1432.71909,17362756721,1444408347,17362750019,-6702,,
15958134968,1432.76962,17362807248,1444458869,17362800540,-6708,,
15958186025,1432.82067,17362858307,1444509923,17362851594,-6713,,
15958236875,1432.87152,17362909159,1444560770,17362902441,-6718,,
15958286962,1432.92161,17362959249,1444610854,17362952526,-6723,,
15958337987,1432.97264,17363010276,1444661876,17363003548,-6728,,
15958388169,1433.02282,17363060472,1444712068,17363053739,-6733,,
15958439198,1433.07385,17363111492,1444763083,17363104754,-6738,,
15958489775,1433.12442,17363162071,1444813657,17363155329,-6742,,
15958540696,1433.17534,17363212996,1444864576,17363206248,-6748,,
15958591223,1433.22587,17363263524,1444915100,17363256771,-6753,,
15958641762,1433.27641,17363314065,1444965635,17363307307,-6758,,
15958691815,1433.32646,17363364121,1445015686,17363357357,-6764,,
15958741865,1433.37651,17363414172,1445065733,17363407404,-6768,,
15958799503,1433.43415,17363471814,1445123368,17363465039,-6775,,
15958855552,1433.49020,17363527865,1445179415,17363521086,-6779,,
15958906514,1433.54116,17363578830,1445230373,17363572045,-6785,,
15958957230,1433.59188,17363629548,1445281086,17363622757,-6791,,
15959007690,1433.64234,17363680010,1445331544,17363673215,-6795,,
15959058743,1433.69339,17363731065,1445382594,17363724265,-6800,,
15959121540,1433.75619,17363793865,1445445388,17363787059,-6806,,
15959193059,1433.82771,17363865387,1445516903,17363858574,-6813,,
15959244465,1433.87911,17363916798,1445568307,17363909979,-6819,,
15959295100,1433.92975,17363967434,1445618938,17363960609,-6825,,
15959345811,1433.98046,17364018147,1445669648,17364011319,-6828,,
15959396215,1434.03086,17364068554,1445720049,17364061720,-6834,,
15959446951,1434.08160,17364119292,1445770781,17364112452,-6840,,
15959497165,1434.13181,17364169507,1445820992,17364162664,-6843,,
15959548040,1434.18269,17364220385,1445871865,17364213537,-6848,,
15959598371,1434.23302,17364270718,1445922193,17364263865,-6853,,
15959649145,1434.28379,17364321494,1445972964,17364314635,-6859,,
15959699572,1434.33422,17364371924,1446023389,17364365060,-6864,,
15959750321,1434.38497,17364422675,1446074135,17364415806,-6869,,
15959800719,1434.43537,17364473075,1446124530,17364466201,-6874,,
15959851528,1434.48618,17364523887,1446175336,17364517008,-6879,,
15959903872,1434.53852,17364576233,1446227678,17364569349,-6884,,
15959954406,1434.58905,17364626771,1446278210,17364619881,-6890,,
15960004736,1434.63938,17364677102,1446328536,17364670207,-6895,,
15960055048,1434.68970,17364727416,1446378846,17364720517,-6899,,
15960105353,1434.74000,17364777724,1446429148,17364770819,-6905,,
15960156011,1434.79066,17364828384,1446479803,17364821474,-6910,,
15960206453,1434.84110,17364878829,1446530243,17364871914,-6915,,
15960257537,1434.89218,17364929916,1446581325,17364922996,-6920,,
15960307832,1434.94248,17364980212,1446631616,17364973288,-6924,,
15960358235,1434.99288,17365030617,1446682016,17365023687,-6930,,
15960408796,1435.04344,17365081181,1446732575,17365074246,-6935,,
15960459763,1435.09441,17365132150,1446783539,17365125210,-6940,,
15960513018,1435.14767,17365185408,1446836791,17365178462,-6946,,
15960563902,1435.19855,17365236294,1446887672,17365229343,-6951,,
15960614068,1435.24872,17365286463,1446937837,17365279508,-6955,,
15960664640,1435.29929,17365337038,1446988405,17365330077,-6961,,
15960715185,1435.34983,17365387585,1447038947,17365380619,-6966,,
15960765331,1435.39998,17365437732,1447089091,17365430762,-6970,,
15960816113,1435.45076,17365488518,1447139871,17365481543,-6975,,
15960866660,1435.50131,17365539066,1447190414,17365532085,-6981,,
15960917254,1435.55190,17365589674,1447241017,17365582689,-6985,,
15960967835,1435.60248,17365640247,1447291584,17365633256,-6991,,
15961018408,1435.65306,17365690822,1447342155,17365683826,-6996,,
15961068997,1435.70365,17365741412,1447392740,17365734411,-7001,,
15961119510,1435.75416,17365791929,1447443251,17365784923,-7006,,
15961170559,1435.80521,17365842980,1447494297,17365835968,-7012,,
15961221108,1435.85576,17365893530,1447544843,17365886514,-7016,,
15961271549,1435.90620,17365943975,1447595282,17365936953,-7022,,
15961322104,1435.95675,17365994531,1447645834,17365987505,-7026,,
15961372577,1436.00723,17366045007,1447696305,17366037976,-7031,,
15961423627,1436.05828,17366096059,1447747351,17366089022,-7037,,
15961474233,1436.10888,17366146668,1447797955,17366139627,-7041,,
15961525261,1436.15991,17366197698,1447848980,17366190651,-7047,,
15961575899,1436.21055,17366248339,1447899616,17366241287,-7052,,
15961626662,1436.26131,17366299104,1447950376,17366292048,-7056,,
15961677219,1436.31187,17366349663,1448000930,17366342601,-7062,,
15961727811,1436.36246,17366400257,1448051519,17366393191,-7066,,
15961778816,1436.41346,17366451265,1448102521,17366444193,-7072,,
15961829385,1436.46403,17366501837,1448153088,17366494760,-7077,,
15961879936,1436.51458,17366552400,1448203647,17366545319,-7081,,
15961930985,1436.56563,17366603441,1448254682,17366596354,-7087,,
15961982033,1436.61668,17366654492,1448305737,17366647409,-7083,,
15962033107,1436.66775,17366705567,1448356799,17366698470,-7097,,
15962084103,1436.71875,17366756567,1448407792,17366749464,-7103,,
15962134166,1436.76881,17366806632,1448457853,17366799524,-7108,,
15962184205,1436.81885,17366856672,1448507889,17366849560,-7112,,
15962234299,1436.86895,17366906770,1448557981,17366899652,-7118,,
15962285085,1436.91973,17366957558,1448608763,17366950435,-7123,,
15962335398,1436.97005,17367007873,1448659075,17367000746,-7127,,
15962386493,1437.02114,17367058971,1448710166,17367051838,-7133,,
15962437544,1437.07219,17367110024,1448761215,17367102886,-7138,,
15962488160,1437.12281,17367160641,1448811827,17367153499,-7142,,
15962539196,1437.17384,17367211681,1448862861,17367204533,-7148,,
15962590274,1437.22492,17367262760,1448913936,17367255607,-7153,,
15962641160,1437.27581,17367313649,1448964819,17367306491,-7158,,
15962691794,1437.32644,17367364285,1449015450,17367357124,-7161,,
15962742664,1437.37731,17367415158,1449066318,17367407990,-7168,,
15962793265,1437.42791,17367465762,1449116917,17367458588,-7174,,
15962843794,1437.47844,17367516293,1449167442,17367509114,-7179,,
15962893900,1437.52855,17367566400,1449217545,17367559217,-7183,,
15962944532,1437.57918,17367617035,1449268175,17367609847,-7188,,
15962995597,1437.63025,17367668103,1449319237,17367660909,-7194,,
15963046397,1437.68105,17367718904,1449370035,17367711706,-7198,,
15963097424,1437.73207,17367769935,1449421059,17367762731,-7204,,
15963147984,1437.78263,17367820496,1449471616,17367813287,-7209,,
15963198531,1437.83318,17367871046,1449522160,17367863831,-7215,,
15963249115,1437.88376,17367921633,1449572743,17367914414,-7219,,
15963299249,1437.93390,17367971769,1449622873,17367964544,-7225,,
15963349746,1437.98439,17368022268,1449673367,17368015039,-7229,,
15963400619,1438.03527,17368073143,1449724238,17368065909,-7234,,
15963451307,1438.08596,17368123833,1449774923,17368116594,-7239,,
15963501698,1438.13635,17368174226,1449825311,17368166982,-7244,,
15963551985,1438.18663,17368224517,1449875596,17368217268,-7249,,
15963603037,1438.23769,17368275581,1449926655,17368268327,-7254,,
15963654080,1438.28873,17368326616,1449977685,17368319356,-7260,,
15963704727,1438.33938,17368377266,1450028329,17368370000,-7266,,
15963755320,1438.38997,17368427872,1450078932,17368420603,-7269,,
15963806391,1438.44104,17368478935,1450129989,17368471660,-7275,,
15963857466,1438.49211,17368530012,1450181060,17368522732,-7280,,
15963908086,1438.54273,17368580634,1450231677,17368573349,-7285,,
15963959131,1438.59378,17368631682,1450282720,17368624392,-7290,,
15964010162,1438.64481,17368682715,1450333749,17368675420,-7295,,
15964061210,1438.69586,17368733766,1450384793,17368726465,-7301,,
15964112258,1438.74691,17368784816,1450435839,17368777511,-7305,,
15964162374,1438.79702,17368834934,1450485952,17368827624,-7310,,
15964213169,1438.84782,17368885732,1450536745,17368878416,-7316,,
15964264213,1438.89886,17368936778,1450587785,17368929457,-7321,,
15964314328,1438.94898,17368986895,1450637898,17368979570,-7325,,
15964364801,1438.99945,17369037371,1450688369,17369030040,-7331,,
15964415863,1439.05051,17369088434,1450739427,17369081098,-7336,,
15964466941,1439.10159,17369139514,1450790503,17369132174,-7340,,
15964517860,1439.15251,17369190437,1450841419,17369183091,-7346,,
15964568408,1439.20306,17369240987,1450891965,17369233636,-7351,,
15964618962,1439.25361,17369291543,1450942515,17369284187,-7356,,
15964669524,1439.30417,17369342108,1450993076,17369334747,-7361,,
15964720571,1439.35522,17369393157,1451044120,17369385791,-7366,,
15964771604,1439.40625,17369444193,1451095150,17369436821,-7372,,
15964821976,1439.45662,17369494567,1451145520,17369487191,-7376,,
15964872055,1439.50670,17369544648,1451195595,17369537267,-7381,,
15964922623,1439.55727,17369595219,1451246160,17369587832,-7387,,
15964973640,1439.60829,17369646237,1451297174,17369638845,-7392,,
15965024690,1439.65934,17369697290,1451348222,17369689894,-7396,,
15965075731,1439.71038,17369748334,1451399261,17369740932,-7402,,
15965126286,1439.76093,17369798891,1451449812,17369791484,-7407,,
15965176831,1439.81148,17369849438,1451500355,17369842026,-7412,,
15965227891,1439.86254,17369900500,1451551412,17369893083,-7417,,
15965278434,1439.91308,17369951046,1451601953,17369943624,-7422,,
15965328983,1439.96363,17370001596,1451652498,17369994169,-7427,,
15965380022,1440.01467,17370052639,1451703536,17370045207,-7432,,
15965430588,1440.06524,17370103207,1451754099,17370095770,-7437,,
15965481613,1440.11626,17370154235,1451805120,17370146792,-7443,,
15965532191,1440.16684,17370204815,1451855697,17370197368,-7447,,
15965583224,1440.21787,17370255850,1451906727,17370248398,-7452,,
15965633800,1440.26845,17370306430,1451957301,17370298973,-7457,,
15965684872,1440.31952,17370357503,1452008369,17370350040,-7463,,
15965735898,1440.37055,17370408531,1452059393,17370401065,-7466,,
15965786929,1440.42158,17370459565,1452110420,17370452092,-7473,,
15965837978,1440.47263,17370510616,1452161466,17370503138,-7478,,
15965888522,1440.52317,17370561162,1452212008,17370553680,-7482,,
15965939563,1440.57421,17370612206,1452263046,17370604717,-7489,,
15965990654,1440.62530,17370663298,1452314134,17370655805,-7493,,
15966041205,1440.67585,17370713853,1452364682,17370706354,-7499,,
15966092249,1440.72690,17370764899,1452415724,17370757396,-7503,,
15966143268,1440.77792,17370815920,1452466740,17370808412,-7508,,
15966193847,1440.82849,17370866501,1452517316,17370858987,-7514,,
15966244892,1440.87954,17370917548,1452568358,17370910029,-7519,,
15966295808,1440.93046,17370968467,1452619272,17370960944,-7523,,
15966346668,1440.98132,17371019329,1452670129,17371011800,-7529,,
15966397244,1441.03189,17371069908,1452720702,17371062373,-7535,,
15966448165,1441.08281,17371120831,1452771621,17371113293,-7538,,
15966498774,1441.13342,17371171443,1452822227,17371163898,-7545,,
15966549265,1441.18391,17371221935,1452872715,17371214386,-7549,,
15966599829,1441.23448,17371272503,1452923276,17371264947,-7556,,
15966650919,1441.28557,17371323595,1452974364,17371316036,-7559,,
15966701974,1441.33662,17371374651,1453025416,17371367087,-7564,,
15966753010,1441.38766,17371425691,1453076450,17371418121,-7570,,
15966803962,1441.43861,17371476644,1453127398,17371469070,-7574,,
15966854514,1441.48916,17371527198,1453177948,17371519619,-7579,,
15966905043,1441.53969,17371577731,1453228474,17371570146,-7585,,
15966955102,1441.58975,17371627792,1453278530,17371620202,-7590,,
15967005551,1441.64020,17371678242,1453328977,17371670649,-7593,,
15967055619,1441.69027,17371728316,1453379047,17371720718,-7598,,
15967106162,1441.74081,17371778858,1453429582,17371771254,-7604,,
15967157210,1441.79186,17371829909,1453480628,17371822300,-7609,,
15967207744,1441.84239,17371880446,1453531159,17371872830,-7616,,
15967257798,1441.89245,17371930501,1453581209,17371922881,-7620,,
15967307854,1441.94250,17371980560,1453631264,17371972936,-7624,,
15967358903,1441.99355,17372031611,1453682310,17372023981,-7630,,
15967409451,1442.04410,17372082161,1453732855,17372074526,-7635,,
15967459988,1442.09464,17372132702,1453783390,17372125061,-7641,,
15967510548,1442.14520,17372183264,1453833947,17372175619,-7645,,
15967561598,1442.19625,17372234315,1453884994,17372226665,-7650,,
15967612135,1442.24678,17372284855,1453935528,17372277199,-7656,,
15967662180,1442.29683,17372334902,1453985571,17372327243,-7659,,
15967712242,1442.34689,17372384966,1454035630,17372377302,-7664,,
15967763289,1442.39794,17372436017,1454086675,17372428346,-7671,,
15967813832,1442.44848,17372486563,1454137216,17372478887,-7676,,
15967864393,1442.49904,17372537125,1454187773,17372529445,-7680,,
15967915435,1442.55008,17372588169,1454238812,17372580483,-7686,,
15967965990,1442.60064,17372638727,1454289364,17372631036,-7691,,
15968016533,1442.65118,17372689272,1454339905,17372681577,-7695,,
15968067579,1442.70223,17372740321,1454390949,17372732620,-7701,,
15968117627,1442.75228,17372790371,1454440993,17372782665,-7706,,
15968167690,1442.80234,17372840435,1454491054,17372832725,-7710,,
15968218235,1442.85288,17372890984,1454541597,17372883268,-7716,,
15968269296,1442.90394,17372942047,1454592655,17372934326,-7721,,
15968320318,1442.95497,17372993071,1454643673,17372985344,-7727,,
15968370370,1443.00502,17373043125,1454693723,17373035394,-7731,,
15968421459,1443.05611,17373094216,1454744809,17373086481,-7735,,
15968472103,1443.10675,17373144863,1454795450,17373137122,-7741,,
15968522951,1443.15760,17373195713,1454846296,17373187967,-7746,,
15968573688,1443.20834,17373246453,1454897031,17373238702,-7751,,
15968623763,1443.25841,17373296530,1454947106,17373288778,-7752,,
15968674294,1443.30894,17373347063,1454997630,17373339301,-7762,,
15968724342,1443.35899,17373397114,1455047676,17373389348,-7766,,
15968774403,1443.40905,17373447178,1455097735,17373439406,-7772,,
15968825428,1443.46008,17373498205,1455148757,17373490428,-7777,,
15968875500,1443.51015,17373548279,1455198827,17373540498,-7781,,
15968926537,1443.56119,17373599318,1455249860,17373591532,-7786,,
15968976597,1443.61125,17373649380,1455299917,17373641588,-7792,,
15969027147,1443.66179,17373699932,1455350465,17373692136,-7796,,
15969077700,1443.71235,17373750488,1455401015,17373742686,-7802,,
15969128265,1443.76291,17373801055,1455451577,17373793248,-7807,,
15969178802,1443.81345,17373851595,1455502111,17373843783,-7812,,
15969228864,1443.86351,17373901660,1455552172,17373893843,-7817,,
15969279413,1443.91406,17373952211,1455602717,17373944388,-7823,,
15969330435,1443.96508,17374003236,1455653736,17373995408,-7828,,
15969380509,1444.01516,17374053312,1455703808,17374045480,-7832,,
15969431057,1444.06570,17374103862,1455754353,17374096024,-7838,,
15969481622,1444.11627,17374154429,1455804915,17374146586,-7843,,
15969532672,1444.16732,17374205481,1455855963,17374197635,-7846,,
15969583768,1444.21842,17374256580,1455907057,17374248728,-7852,,
15969634749,1444.26940,17374307564,1455958035,17374299706,-7858,,
15969685299,1444.31995,17374358116,1456008581,17374350252,-7864,,
15969735860,1444.37051,17374408679,1456059140,17374400812,-7867,,
15969786417,1444.42106,17374459239,1456109695,17374451366,-7873,,
15969837456,1444.47210,17374510280,1456160730,17374502402,-7878,,
15969888534,1444.52318,17374561360,1456211807,17374553478,-7882,,
15969939530,1444.57418,17374612359,1456262800,17374604471,-7888,,
15969990561,1444.62521,17374663403,1456313839,17374655510,-7893,,
15970041584,1444.67623,17374714418,1456364847,17374706519,-7899,,
15970092136,1444.72678,17374764972,1456415397,17374757069,-7903,,
15970142694,1444.77734,17374815532,1456465952,17374807624,-7908,,
15970193779,1444.82843,17374866620,1456517034,17374858706,-7914,,
15970244800,1444.87945,17374917643,1456568052,17374909723,-7920,,
15970295329,1444.92998,17374968174,1456618580,17374960251,-7923,,
15970345943,1444.98059,17375018791,1456669190,17375010861,-7930,,
15970396907,1445.03156,17375069757,1456720151,17375061822,-7935,,
15970447453,1445.08210,17375120304,1456770695,17375112366,-7938,,
15970497732,1445.13238,17375170587,1456820972,17375162643,-7944,,
15970547817,1445.18247,17375220674,1456871054,17375212725,-7949,,
15970598044,1445.23269,17375270902,1456921278,17375262949,-7953,,
15970649014,1445.28366,17375321876,1456972245,17375313916,-7960,,
15970699548,1445.33420,17375372412,1457022777,17375364448,-7964,,
15970749597,1445.38424,17375422464,1457072822,17375414493,-7971,,
15970800119,1445.43477,17375472987,1457123342,17375465013,-7974,,
15970851159,1445.48581,17375524030,1457174379,17375516051,-7979,,
15970902187,1445.53684,17375575061,1457225405,17375567076,-7985,,
15970952771,1445.58742,17375625647,1457275986,17375617658,-7989,,
15971003348,1445.63800,17375676226,1457326560,17375668232,-7994,,
15971054417,1445.68907,17375727298,1457377627,17375719298,-8000,,
15971105413,1445.74006,17375778295,1457428619,17375770291,-8004,,
15971156413,1445.79106,17375829298,1457479617,17375821289,-8009,,
15971206961,1445.84161,17375879849,1457530162,17375871834,-8015,,
15971257517,1445.89216,17375930406,1457580715,17375922386,-8020,,
15971517612,1446.15226,17376190513,1457840795,17376182466,-8047,17376188474,
15971542901,1446.17755,17376215804,1457866084,17376207786,-8018,,
15971593928,1446.22858,17376266833,1457917108,17376258871,-7962,,
15971644095,1446.27874,17376317003,1457967273,17376309097,-7906,,
15971694689,1446.32934,17376367599,1458017876,17376359760,-7839,,
15971745093,1446.37974,17376418017,1458068277,17376410222,-7795,,
15971795759,1446.43041,17376468674,1458118929,17376460934,-7740,,
15971846315,1446.48096,17376519233,1458169483,17376511549,-7684,,
15971896486,1446.53113,17376569405,1458219650,17376561777,-7628,,
15971947154,1446.58180,17376620076,1458270316,17376612503,-7573,,
15971997822,1446.63247,17376670746,1458320981,17376663229,-7517,,
15972048426,1446.68307,17376721353,1458371582,17376713891,-7462,,
15972099011,1446.73366,17376771939,1458422164,17376764534,-7405,,
15972150053,1446.78470,17376822985,1458473204,17376815636,-7349,,
15972200619,1446.83527,17376873553,1458523767,17376866260,-7293,,
15972251224,1446.88587,17376924160,1458574369,17376916923,-7237,,
15972302252,1446.93690,17376975191,1458625394,17376968008,-7183,,
15972353277,1446.98792,17377026218,1458676417,17377019093,-7125,,
15972404347,1447.03900,17377077290,1458727484,17377070222,-7068,,
15972454898,1447.08955,17377127844,1458778033,17377120830,-7014,,
15972505920,1447.14057,17377178868,1458829051,17377171910,-6958,,
15972556474,1447.19112,17377229437,1458879616,17377222536,-6901,,
15972607546,1447.24219,17377280498,1458930672,17377273653,-6845,,
15972658564,1447.29321,17377331518,1458981687,17377324729,-6789,,
15972709211,1447.34386,17377382169,1459032333,17377375436,-6733,,
15972759804,1447.39445,17377432774,1459082933,17377426097,-6677,,
15972810837,1447.44548,17377483799,1459133953,17377477178,-6621,,
15972860889,1447.49554,17377533854,1459184001,17377527286,-6568,,
15972911420,1447.54607,17377584386,1459234530,17377577876,-6510,,
15972961994,1447.59664,17377634963,1459285101,17377628509,-6454,,
15973013024,1447.64767,17377685996,1459336128,17377679596,-6400,,
15973063616,1447.69826,17377736590,1459386718,17377730248,-6342,,
15973114665,1447.74931,17377787640,1459437764,17377781354,-6286,,
15973165688,1447.80034,17377838667,1459488785,17377832437,-6230,,
15973216717,1447.85136,17377889697,1459539809,17377883523,-6174,,
15973266778,1447.90143,17377939762,1459589870,17377933643,-6119,,
15973317308,1447.95196,17377990293,1459640396,17377984230,-6063,,
15973367906,1448.00255,17378040893,1459690991,17378034886,-6007,,
15973418953,1448.05360,17378091944,1459742036,17378085993,-5951,,
15973470003,1448.10465,17378142995,1459793083,17378137100,-5895,,
15973521012,1448.15566,17378194007,1459844089,17378188169,-5838,,
15973572077,1448.20673,17378245075,1459895152,17378239292,-5783,,
15973623116,1448.25776,17378296115,1459946188,17378290389,-5726,,
15973673615,1448.30826,17378346617,1459996685,17378340948,-5669,,
15973724090,1448.35874,17378397095,1460047156,17378391480,-5615,,
15973775126,1448.40977,17378448133,1460098191,17378442576,-5557,,
15973826187,1448.46084,17378499197,1460149249,17378493694,-5503,,
15973877234,1448.51188,17378550246,1460200293,17378544800,-5446,,
15973928283,1448.56293,17378601297,1460251339,17378595907,-5390,,
15973979332,1448.61398,17378652348,1460302385,17378647014,-5334,,
15974030381,1448.66503,17378703399,1460353431,17378698122,-5277,,
15974080929,1448.71558,17378753950,1460403977,17378748728,-5222,,
15974131977,1448.76662,17378805000,1460455021,17378799834,-5166,,
15974182461,1448.81711,17378855486,1460505503,17378850377,-5109,,
15974232588,1448.86724,17378905616,1460555627,17378900562,-5054,,
15974283609,1448.91826,17378956640,1460606645,17378951641,-4999,,
15974334156,1448.96880,17379007188,1460657190,17379002246,-4942,,
15974384711,1449.01936,17379057746,1460707742,17379052859,-4887,,
15974435294,1449.06994,17379108332,1460758322,17379103499,-4833,,
15974486350,1449.12100,17379159389,1460809376,17379154615,-4774,,
15974537397,1449.17205,17379210439,1460860420,17379205721,-4718,,
15974588442,1449.22309,17379261487,1460911462,17379256824,-4663,,
15974638990,1449.27364,17379312037,1460962007,17379307430,-4607,,
15974689613,1449.32426,17379362663,1461012628,17379358112,-4551,,
15974740663,1449.37531,17379413714,1461063675,17379409219,-4495,,
15974791210,1449.42586,17379464263,1461114219,17379459824,-4439,,
15974841676,1449.47632,17379514733,1461164683,17379510350,-4383,,
15974892046,1449.52669,17379565104,1461215050,17379560776,-4328,,
15974942399,1449.57705,17379615460,1461265401,17379611188,-4272,,
15974993448,1449.62810,17379666511,1461316446,17379662294,-4217,,
15975044268,1449.67892,17379717334,1461367264,17379713173,-4161,,
15975095012,1449.72966,17379768080,1461418005,17379763975,-4105,,
15975145907,1449.78056,17379818978,1461468898,17379814929,-4049,,
15975196412,1449.83106,17379869484,1461519400,17379865492,-3992,,
15975246462,1449.88111,17379919537,1461569447,17379915599,-3938,,
15975297018,1449.93167,17379970095,1461620000,17379966214,-3881,,
15975347626,1449.98227,17380020706,1461670605,17380016880,-3826,,
15975398137,1450.03279,17380071219,1461721114,17380067448,-3771,,
15975448243,1450.08289,17380121328,1461771217,17380117613,-3715,,
15975499274,1450.13392,17380172361,1461822246,17380168702,-3659,,
15975549733,1450.18438,17380222822,1461872702,17380219219,-3603,,
15975600803,1450.23545,17380273895,1461923769,17380270348,-3547,,
15975651381,1450.28603,17380324474,1461974344,17380320984,-3490,,
15975701464,1450.33611,17380374560,1462024425,17380371124,-3436,,
15975752547,1450.38720,17380425646,1462075505,17380422266,-3380,,
15975803568,1450.43822,17380476670,1462126523,17380473345,-3325,,
15975854643,1450.48929,17380527746,1462177595,17380524478,-3268,,
15975905666,1450.54031,17380578772,1462228616,17380575560,-3212,,
15975956217,1450.59086,17380629338,1462279177,17380626182,-3156,,
15976007266,1450.64191,17380680377,1462330210,17380677277,-3100,,
15976058315,1450.69296,17380731428,1462381256,17380728385,-3043,,
15976108921,1450.74357,17380782037,1462431860,17380779050,-2987,,
15976159481,1450.79413,17380832598,1462482417,17380829666,-2932,,
15976210056,1450.84470,17380883175,1462532989,17380880299,-2876,,
15976260281,1450.89493,17380933404,1462583212,17380930584,-2820,,
15976311330,1450.94598,17380984455,1462634259,17380981691,-2764,,
15976362002,1450.99665,17381035129,1462684927,17381032421,-2708,,
15976412639,1451.04729,17381085769,1462735562,17381083116,-2653,,
15976462903,1451.09755,17381136034,1462785823,17381133437,-2597,,
15976513077,1451.14773,17381186212,1462835994,17381183669,-2543,,
15976563215,1451.19786,17381236351,1462886129,17381233809,-2542,,
15976613753,1451.24840,17381286891,1462936665,17381284346,-2545,,
15976663876,1451.29852,17381337017,1462986785,17381334465,-2552,,
15976714453,1451.34910,17381387597,1463037360,17381385040,-2557,,
15976764546,1451.39919,17381437692,1463087450,17381435131,-2561,,
15976815130,1451.44978,17381488279,1463138032,17381485712,-2567,,
15976865751,1451.50040,17381538902,1463188649,17381536330,-2572,,
15976916800,1451.55145,17381589952,1463239695,17381587375,-2577,,
15976967827,1451.60247,17381640983,1463290720,17381638401,-2582,,
15977018387,1451.65304,17381691545,1463341277,17381688957,-2588,,
15977068947,1451.70359,17381742107,1463391835,17381739515,-2592,,
15977119993,1451.75464,17381793156,1463442879,17381790559,-2597,,
15977170545,1451.80519,17381843720,1463493438,17381841118,-2602,,
15977221567,1451.85622,17381894733,1463544446,17381892126,-2607,,
15977271629,1451.90628,17381944799,1463594506,17381942187,-2612,,
15977322685,1451.95733,17381995857,1463645559,17381993240,-2617,,
15977373223,1452.00787,17382046397,1463696094,17382043774,-2623,,
15977424277,1452.05893,17382097454,1463747146,17382094826,-2628,,
15977474798,1452.10945,17382147976,1463797664,17382145344,-2632,,
15977525386,1452.16003,17382198567,1463848249,17382195930,-2637,,
15977575911,1452.21056,17382249094,1463898771,17382246452,-2642,,
15977626959,1452.26161,17382300145,1463949816,17382297497,-2648,,
15977677016,1452.31166,17382350204,1463999871,17382347551,-2653,,
15977728050,1452.36270,17382401240,1464050902,17382398582,-2658,,
15977778611,1452.41326,17382451804,1464101461,17382449141,-2663,,
15977829166,1452.46381,17382502362,1464152014,17382499694,-2668,,
15977879716,1452.51436,17382552914,1464202560,17382550241,-2673,,
15977930520,1452.56517,17382603719,1464253361,17382601041,-2678,,
15977980910,1452.61556,17382654113,1464303749,17382651430,-2683,,
15978031452,1452.66610,17382704656,1464354288,17382701968,-2688,,
15978082361,1452.71701,17382755568,1464405194,17382752875,-2693,,
15978133165,1452.76781,17382806374,1464455995,17382803675,-2699,,
15978183766,1452.81841,17382856978,1464506594,17382854275,-2703,,
15978234153,1452.86880,17382907368,1464556978,17382904659,-2709,,
15978295700,1452.93035,17382968916,1464618522,17382966202,-2714,,
15978346269,1452.98092,17383019488,1464669088,17383016769,-2719,,
15978397299,1453.03195,17383070521,1464720116,17383067796,-2725,,
15978447346,1453.08199,17383120570,1464770161,17383117841,-2729,,
15978497414,1453.13206,17383170641,1464820226,17383167906,-2735,,
15978548969,1453.18362,17383222197,1464871777,17383219458,-2739,,
15978599490,1453.23414,17383272722,1464922296,17383269977,-2745,,
15978649540,1453.28419,17383322774,1464972343,17383320024,-2750,,
15978700098,1453.33475,17383373333,1465022898,17383370578,-2755,,
15978750668,1453.38532,17383423907,1465073465,17383421145,-2762,,
15978801196,1453.43584,17383474436,1465123991,17383471671,-2765,,
15978851773,1453.48642,17383525016,1465174566,17383522246,-2770,,
15978902307,1453.53696,17383575553,1465225096,17383572776,-2777,,
15978952866,1453.58751,17383626124,1465275663,17383623344,-2780,,
15979003444,1453.63809,17383676694,1465326229,17383673910,-2784,,
15979054090,1453.68874,17383727343,1465376872,17383724552,-2791,,
15979105083,1453.73973,17383778338,1465427862,17383775542,-2796,,
15979155628,1453.79028,17383828885,1465478405,17383826085,-2800,,
15979206176,1453.84082,17383879436,1465528950,17383876630,-2806,,
15979256715,1453.89136,17383929978,1465579487,17383927167,-2811,,
15979306774,1453.94142,17383980038,1465629542,17383977223,-2815,,
15979358097,1453.99275,17384031364,1465680862,17384028543,-2821,,
15979408709,1454.04336,17384081978,1465731471,17384079152,-2826,,
15979458918,1454.09357,17384132189,1465781678,17384129358,-2831,,
15979509479,1454.14413,17384182753,1465832236,17384179916,-2837,,
15979560519,1454.19517,17384233795,1465883274,17384230954,-2841,,
15979610951,1454.24560,17384284230,1465933703,17384281383,-2847,,
15979661599,1454.29625,17384334880,1465984349,17384332029,-2851,,
15979712179,1454.34683,17384385462,1466034925,17384382606,-2856,,
15979762729,1454.39738,17384436015,1466085473,17384433153,-2862,,
15979813306,1454.44795,17384486594,1466136048,17384483728,-2866,,
15979864333,1454.49898,17384537634,1466187083,17384534763,-2871,,
15979915376,1454.55002,17384588669,1466238112,17384585792,-2877,,
15979966404,1454.60105,17384639699,1466289136,17384636817,-2882,,
15980017454,1454.65210,17384690750,1466340184,17384687864,-2886,,
15980068188,1454.70284,17384741488,1466390915,17384738596,-2892,,
15980118687,1454.75334,17384791988,1466441410,17384789091,-2897,,
15980169304,1454.80395,17384842609,1466492025,17384839706,-2903,,
15980219707,1454.85435,17384893014,1466542426,17384890107,-2907,,
15980270763,1454.90541,17384944082,1466593490,17384941170,-2912,,
15980321504,1454.95615,17384994816,1466644218,17384991898,-2918,,
15980371754,1455.00640,17385045068,1466694466,17385042146,-2922,,
15980421928,1455.05658,17385095244,1466744637,17385092317,-2927,,
15980472498,1455.10715,17385145816,1466795203,17385142884,-2932,,
15980523532,1455.15818,17385196853,1466846235,17385193916,-2937,,
15980574122,1455.20877,17385247445,1466896823,17385244503,-2942,,
15980624664,1455.25931,17385297989,1466947361,17385295041,-2948,,
15980675720,1455.31037,17385349048,1466998415,17385346095,-2953,,
15980726334,1455.36098,17385399664,1467049026,17385396707,-2957,,
15980777379,1455.41203,17385450711,1467100068,17385447748,-2963,,
15980827932,1455.46258,17385501266,1467150618,17385498298,-2968,,
15980878481,1455.51313,17385551818,1467201165,17385548845,-2973,,
15980929512,1455.56416,17385602852,1467252193,17385599874,-2978,,
15980980088,1455.61474,17385653430,1467302767,17385650447,-2983,,
15981031093,1455.66574,17385704438,1467353768,17385701449,-2989,,
15981082174,1455.71682,17385755521,1467404848,17385752528,-2993,,
15981132723,1455.76737,17385806072,1467455393,17385803074,-2998,,
15981183247,1455.81789,17385856599,1467505914,17385853595,-3004,,
15981234290,1455.86894,17385907643,1467556955,17385904635,-3008,,
15981284834,1455.91948,17385958190,1467607497,17385955177,-3013,,
15981335868,1455.97052,17386009227,1467658527,17386006208,-3019,,
15981386467,1456.02112,17386059828,1467709124,17386056804,-3024,,
15981437515,1456.07216,17386110878,1467760170,17386107850,-3028,,
15981488082,1456.12273,17386161447,1467810733,17386158413,-3034,,
15981538567,1456.17322,17386211935,1467861215,17386208895,-3040,,
15981589154,1456.22380,17386262525,1467911800,17386259481,-3044,,
15981640234,1456.27488,17386313606,1467962877,17386310557,-3049,,
15981691255,1456.32590,17386364630,1468013895,17386361576,-3054,,
15981742307,1456.37695,17386415685,1468064944,17386412625,-3060,,
15981792430,1456.42708,17386465809,1468115065,17386462745,-3064,,
15981843448,1456.47810,17386516829,1468166080,17386513761,-3068,,
15981894063,1456.52871,17386567447,1468216692,17386564372,-3075,,
15981944644,1456.57929,17386618030,1468267270,17386614950,-3080,,
15981995237,1456.62989,17386668626,1468317861,17386665542,-3084,,
15982045840,1456.68049,17386719232,1468368461,17386716142,-3090,,
15982096509,1456.73116,17386769902,1468419127,17386766819,-3083,,
15982147469,1456.78212,17386820866,1468470086,17386817766,-3100,,
15982198075,1456.83272,17386871478,1468520692,17386868373,-3105,,
15982248650,1456.88330,17386922051,1468571261,17386918941,-3110,,
15982299722,1456.93437,17386973126,1468622331,17386970011,-3115,,
15982350770,1456.98542,17387024176,1468673376,17387021056,-3120,,
15982401812,1457.03646,17387075219,1468724414,17387072094,-3125,,
15982452868,1457.08752,17387126279,1468775467,17387123148,-3131,,
15982503371,1457.13802,17387176784,1468825969,17387173649,-3135,,
15982553923,1457.18857,17387227338,1468876517,17387224198,-3140,,
15982604521,1457.23917,17387277951,1468927125,17387274805,-3146,,
15982655567,1457.29021,17387328987,1468978155,17387325836,-3151,,
15982706642,1457.34129,17387380065,1469029229,17387376909,-3156,,
15982757681,1457.39233,17387431106,1469080265,17387427946,-3160,,
15982808689,1457.44334,17387482116,1469131269,17387478950,-3166,,
15982859288,1457.49394,17387532718,1469181866,17387529547,-3171,,
15982910303,1457.54495,17387583735,1469232879,17387580559,-3176,,
15982961385,1457.59603,17387634819,1469283957,17387631638,-3181,,
15983012434,1457.64708,17387685870,1469335003,17387682683,-3187,,
15983063075,1457.69772,17387736514,1469385643,17387733323,-3191,,
15983113665,1457.74831,17387787106,1469436229,17387783910,-3196,,
15983164652,1457.79930,17387838096,1469487213,17387834894,-3202,,
15983215224,1457.84987,17387888670,1469537783,17387885464,-3206,,
15983265292,1457.89994,17387938740,1469587848,17387935528,-3212,,
15983315833,1457.95048,17387989284,1469638386,17387986067,-3217,,
15983365906,1458.00055,17388039359,1469688456,17388036137,-3222,,
15983416929,1458.05158,17388090385,1469739477,17388087158,-3227,,
15983467116,1458.10176,17388140574,1469789661,17388137342,-3232,,
15983518065,1458.15271,17388191524,1469840606,17388188287,-3237,,
15983569144,1458.20379,17388242607,1469891684,17388239365,-3242,,
15983620083,1458.25473,17388293548,1469942620,17388290301,-3247,,
15983670696,1458.30534,17388344162,1469993230,17388340910,-3252,,
15983720833,1458.35548,17388394303,1470043364,17388391044,-3259,,
15983771421,1458.40607,17388444893,1470093950,17388441631,-3262,,
15983822433,1458.45708,17388495907,1470144970,17388492651,-3256,,
15983873530,1458.50818,17388547007,1470196054,17388543734,-3273,,
15983924568,1458.55922,17388598046,1470247089,17388594770,-3276,,
15983975153,1458.60980,17388648633,1470297671,17388645351,-3282,,
15984025699,1458.66035,17388699183,1470348215,17388695895,-3288,,
15984076748,1458.71140,17388750234,1470399261,17388746941,-3293,,
15984127802,1458.76245,17388801291,1470450312,17388797993,-3298,,
15984178853,1458.81350,17388852343,1470501360,17388849040,-3303,,
15984229901,1458.86455,17388903394,1470552405,17388900086,-3308,,
15984280117,1458.91476,17388953613,1470602619,17388950300,-3313,,
15984331145,1458.96579,17389004643,1470653644,17389001325,-3318,,
15984381842,1459.01649,17389055341,1470704338,17389052018,-3323,,
15984432407,1459.06705,17389105909,1470754900,17389102580,-3329,,
15984482571,1459.11722,17389156076,1470805062,17389152742,-3334,,
15984533552,1459.16820,17389207058,1470856040,17389203720,-3338,,
15984584594,1459.21924,17389258103,1470907079,17389254759,-3344,,
15984635605,1459.27025,17389309117,1470958088,17389305768,-3349,,
15984686224,1459.32087,17389359739,1471008704,17389356385,-3354,,
15984736929,1459.37158,17389410446,1471059406,17389407087,-3359,,
15984787314,1459.42196,17389460833,1471109788,17389457469,-3364,,
15984838322,1459.47297,17389511843,1471160794,17389508475,-3368,,
15984888911,1459.52356,17389562435,1471211380,17389559061,-3374,,
15984939934,1459.57458,17389613460,1471262400,17389610081,-3379,,
15984991007,1459.62566,17389664536,1471313472,17389661152,-3384,,
15985042028,1459.67668,17389715559,1471364489,17389712170,-3389,,
15985093092,1459.72774,17389766624,1471415550,17389763231,-3393,,
15985143752,1459.77840,17389817288,1471466207,17389813888,-3400,,
15985194316,1459.82896,17389867854,1471516769,17389864462,-3392,,
15985244458,1459.87911,17389917998,1471566908,17389914588,-3410,,
15985294998,1459.92965,17389968541,1471617446,17389965126,-3415,,
15985345547,1459.98020,17390019091,1471667992,17390015673,-3418,,
15985396585,1460.03123,17390070132,1471719026,17390066707,-3425,,
15985447326,1460.08197,17390120876,1471769765,17390117446,-3430,,
15985497937,1460.13259,17390171488,1471820373,17390168053,-3435,,
15985548737,1460.18339,17390222292,1471871172,17390218852,-3440,,
15985599797,1460.23445,17390273353,1471922228,17390269908,-3445,,
15985650845,1460.28549,17390324404,1471973273,17390320954,-3450,,
15985701893,1460.33654,17390375454,1472024318,17390371998,-3456,,
15985752483,1460.38713,17390426046,1472074906,17390422587,-3459,,
15985803531,1460.43818,17390477098,1472125951,17390473631,-3467,,
15985854049,1460.48870,17390527618,1472176466,17390524147,-3471,,
15985905130,1460.53978,17390578700,1472227545,17390575225,-3475,,
15985955680,1460.59033,17390629254,1472278093,17390625773,-3481,,
15986006695,1460.64134,17390680271,1472329105,17390676785,-3486,,
15986057744,1460.69239,17390731322,1472380150,17390727831,-3491,,
15986108833,1460.74348,17390782413,1472431237,17390778917,-3496,,
15986159832,1460.79448,17390833415,1472482234,17390829914,-3501,,
15986210380,1460.84503,17390883964,1472532778,17390880458,-3506,,
15986260939,1460.89559,17390934527,1472583336,17390931016,-3511,,
15986311473,1460.94612,17390985063,1472633867,17390981547,-3516,,
15986362034,1460.99668,17391035625,1472684424,17391032104,-3521,,
15986412580,1461.04723,17391086174,1472734967,17391082647,-3527,,
15986463115,1461.09776,17391136711,1472785500,17391133180,-3531,,
15986513490,1461.14814,17391187090,1472835872,17391183553,-3537,,
15986563976,1461.19862,17391237578,1472886355,17391234036,-3542,,
15986614536,1461.24918,17391288140,1472936913,17391284594,-3546,,
15986665153,1461.29980,17391338760,1472987527,17391335208,-3552,,
15986715672,1461.35032,17391389281,1473038043,17391385724,-3557,,
15986766285,1461.40093,17391439895,1473088654,17391436335,-3560,,
15986816835,1461.45148,17391490448,1473139201,17391486882,-3566,,
15986867416,1461.50206,17391541032,1473189780,17391537460,-3572,,
15986918431,1461.55308,17391592049,1473240791,17391588472,-3577,,
15986968980,1461.60363,17391642601,1473291338,17391639019,-3582,,
15987020029,1461.65468,17391693651,1473342384,17391690064,-3587,,
15987071061,1461.70571,17391744686,1473393413,17391741094,-3592,,
15987121127,1461.75578,17391794755,1473443477,17391791158,-3597,,
15987172171,1461.80682,17391845801,1473494519,17391842199,-3602,,
15987223200,1461.85785,17391896833,1473545544,17391893224,-3609,,
15987273267,1461.90792,17391946902,1473595608,17391943289,-3613,,
15987323811,1461.95846,17391997447,1473646150,17391993830,-3617,,
15987374884,1462.00953,17392048525,1473697221,17392044902,-3623,,
15987425416,1462.06006,17392099058,1473747749,17392095429,-3629,,
15987475564,1462.11021,17392149208,1473797895,17392145576,-3632,,
15987526617,1462.16126,17392200263,1473848945,17392196625,-3638,,
15987577152,1462.21180,17392250801,1473899477,17392247158,-3643,,
15987627705,1462.26235,17392301356,1473950027,17392297708,-3648,,
15987677878,1462.31253,17392351531,1474000198,17392347878,-3653,,
15987728031,1462.36268,17392401697,1474050359,17392398039,-3658,,
15987779070,1462.41372,17392452728,1474101384,17392449065,-3663,,
15987829742,1462.46439,17392503403,1474152055,17392499735,-3668,,
15987880745,1462.51539,17392554408,1474203054,17392550735,-3673,,
15987931342,1462.56599,17392605007,1474253648,17392601329,-3678,,
15987981506,1462.61615,17392655174,1474303811,17392651491,-3683,,
15988032542,1462.66719,17392706212,1474354843,17392702524,-3688,,
15988083416,1462.71806,17392757088,1474405714,17392753394,-3694,,
15988133676,1462.76832,17392807351,1474455972,17392803652,-3699,,
15988184528,1462.81918,17392858204,1474506821,17392854501,-3703,,
15988235013,1462.86966,17392908693,1474557303,17392904983,-3710,,
15988285557,1462.92020,17392959239,1474607845,17392955525,-3714,,
15988335702,1462.97035,17393009386,1474657988,17393005668,-3718,,
15988386704,1463.02135,17393060390,1474708986,17393056667,-3723,,
15988436769,1463.07142,17393110458,1474759049,17393106729,-3729,,
15988487810,1463.12246,17393161501,1474810086,17393157767,-3734,,
15988538390,1463.17304,17393212084,1474860665,17393208345,-3739,,
15988588957,1463.22360,17393262652,1474911228,17393258908,-3744,,
15988639315,1463.27396,17393313013,1474961584,17393309264,-3749,,
15988690348,1463.32500,17393364048,1475012614,17393360294,-3754,,
15988740855,1463.37550,17393414558,1475063119,17393410799,-3759,,
15988791418,1463.42607,17393465123,1475113679,17393461359,-3764,,
15988842059,1463.47671,17393515767,1475164317,17393511998,-3769,,
15988892560,1463.52721,17393566269,1475214815,17393562495,-3774,,
15988943126,1463.57777,17393616838,1475265378,17393613058,-3780,,
15988993648,1463.62830,17393667363,1475315897,17393663578,-3785,,
15989043695,1463.67834,17393717412,1475365942,17393713623,-3789,,
15989094259,1463.72891,17393767979,1475416504,17393764184,-3795,,
15989144289,1463.77894,17393818011,1475466530,17393814210,-3801,,
15989194336,1463.82898,17393868059,1475516575,17393864255,-3804,,
15989244394,1463.87904,17393918120,1475566630,17393914310,-3810,,
15989294960,1463.92961,17393968689,1475617193,17393964874,-3815,,
15989345496,1463.98014,17394019227,1475667727,17394015408,-3819,,
15989396058,1464.03071,17394069792,1475718287,17394065967,-3825,,
15989447089,1464.08174,17394120825,1475769314,17394116995,-3830,,
15989497643,1464.13229,17394171381,1475819865,17394167546,-3835,,
15989548693,1464.18334,17394222434,1475870913,17394218594,-3840,,
15989599788,1464.23444,17394273531,1475922005,17394269686,-3845,,
15989650799,1464.28545,17394324543,1475973013,17394320693,-3850,,
15989701120,1464.33577,17394374868,1476023332,17394371013,-3855,,
15989751664,1464.38631,17394425414,1476073873,17394421554,-3860,,
15989802220,1464.43687,17394475971,1476124426,17394472106,-3865,,
15989852689,1464.48734,17394526443,1476174892,17394522572,-3871,,
15989903506,1464.53815,17394577263,1476225708,17394573388,-3875,,
15989954046,1464.58869,17394627806,1476276245,17394623925,-3881,,
15990004685,1464.63933,17394678447,1476326880,17394674560,-3887,,
15990055190,1464.68984,17394728953,1476377383,17394725064,-3889,,
15990105698,1464.74035,17394779465,1476427888,17394775569,-3896,,
15990156225,1464.79087,17394829994,1476478413,17394826093,-3901,,
15990207106,1464.84175,17394880877,1476529291,17394876971,-3906,,
15990258058,1464.89271,17394931832,1476580240,17394927921,-3911,,
15990309125,1464.94377,17394982901,1476631305,17394978985,-3916,,
15990359451,1464.99410,17395033229,1476681627,17395029307,-3922,,
15990410019,1465.04467,17395083799,1476732193,17395079873,-3926,,
15990460420,1465.09507,17395134203,1476782592,17395130272,-3931,,
15990511193,1465.14584,17395184977,1476833361,17395181041,-3936,,
15990561431,1465.19608,17395235219,1476883598,17395231278,-3941,,
15990611953,1465.24660,17395285743,1476934116,17395281797,-3946,,
15990663788,1465.29844,17395337580,1476985948,17395333629,-3951,,
15990714400,1465.34905,17395388195,1477036558,17395384238,-3957,,
15990765305,1465.39995,17395439102,1477087461,17395435141,-3961,,
15990815511,1465.45016,17395489310,1477137663,17395485343,-3967,,
15990866627,1465.50128,17395540429,1477188776,17395536457,-3972,,
15990917948,1465.55260,17395591752,1477240094,17395587775,-3977,,
15990968498,1465.60315,17395642304,1477290642,17395638322,-3982,,
15991019057,1465.65370,17395692865,1477341198,17395688878,-3987,,
15991070069,1465.70472,17395743880,1477392207,17395739887,-3993,,
15991120835,1465.75548,17395794651,1477442973,17395790654,-3997,,
15991171172,1465.80582,17395844988,1477493305,17395840986,-4002,,
15991221474,1465.85612,17395895292,1477543604,17395891285,-4007,,
15991271954,1465.90660,17395945775,1477594081,17395941761,-4014,,
15991322024,1465.95667,17395995847,1477644150,17395991830,-4017,,
15991372873,1466.00752,17396046698,1477694995,17396042676,-4022,,
15991423395,1466.05804,17396097223,1477745515,17396093195,-4028,,
15991473531,1466.10818,17396147360,1477795648,17396143328,-4032,,
15991523821,1466.15847,17396197654,1477845935,17396193616,-4038,,
15991574289,1466.20894,17396248126,1477896403,17396244083,-4043,,
15991624651,1466.25930,17396298488,1477946760,17396294441,-4047,,
15991675090,1466.30974,17396348930,1477997197,17396344877,-4053,,
15991725557,1466.36020,17396399399,1478047661,17396395341,-4058,,
15991775965,1466.41061,17396449808,1478098066,17396445746,-4062,,
15991826523,1466.46117,17396500370,1478148622,17396496302,-4068,,
15991877005,1466.51165,17396550853,1478199099,17396546780,-4073,,
15991927205,1466.56185,17396601056,1478249297,17396596978,-4078,,
15991977701,1466.61235,17396651555,1478299792,17396647472,-4083,,
15992028312,1466.66296,17396702168,1478350400,17396698080,-4088,,
15992078494,1466.71314,17396752352,1478400579,17396748259,-4093,,
15992129091,1466.76374,17396802952,1478451173,17396798854,-4098,,
15992179800,1466.81445,17396853663,1478501879,17396849559,-4104,,
15992229980,1466.86463,17396903844,1478552056,17396899736,-4108,,
15992280530,1466.91518,17396954398,1478602604,17396950285,-4113,,
15992330824,1466.96547,17397004694,1478652896,17397000576,-4118,,
15992381511,1467.01616,17397055383,1478703579,17397051260,-4123,,
15992431773,1467.06642,17397105648,1478753838,17397101519,-4129,,
15992482629,1467.11728,17397156506,1478804693,17397152373,-4133,,
15992532786,1467.16743,17397206665,1478854847,17397202527,-4138,,
15992583175,1467.21782,17397257056,1478905232,17397252912,-4144,,
15992634105,1467.26875,17397307989,1478956161,17397303841,-4148,,
15992684493,1467.31914,17397358378,1479006545,17397354226,-4152,,
15992734870,1467.36952,17397408759,1479056920,17397404600,-4159,,
15992785369,1467.42002,17397459259,1479107415,17397455096,-4163,,
15992835718,1467.47037,17397509612,1479157762,17397505443,-4169,,
15992886091,1467.52074,17397559986,1479208132,17397555813,-4173,,
15992936199,1467.57085,17397610097,1479258238,17397605918,-4179,,
15992986470,1467.62112,17397660371,1479308506,17397656187,-4184,,
15993036998,1467.67165,17397710901,1479359032,17397706712,-4189,,
15993087519,1467.72217,17397761423,1479409549,17397757230,-4193,,
15993138499,1467.77315,17397812407,1479460527,17397808208,-4199,,
15993189067,1467.82371,17397862977,1479511092,17397858773,-4204,,
15993239670,1467.87432,17397913582,1479561692,17397909373,-4209,,
15993290238,1467.92489,17397964153,1479612258,17397959939,-4214,,
15993340825,1467.97547,17398014741,1479662842,17398010522,-4219,,
15993391822,1468.02647,17398065740,1479713836,17398061516,-4224,,
15993441912,1468.07656,17398115834,1479763923,17398111604,-4230,,
15993492482,1468.12713,17398166405,1479814491,17398162171,-4234,,
15993543341,1468.17799,17398217266,1479865347,17398213027,-4239,,
15993593471,1468.22812,17398267400,1479915475,17398263155,-4245,,
15993644009,1468.27866,17398317940,1479966011,17398313691,-4249,,
15993694845,1468.32949,17398368778,1480016843,17398364524,-4254,,
15993745411,1468.38006,17398419346,1480067406,17398415086,-4260,,
15993795689,1468.43034,17398469627,1480117681,17398465362,-4265,,
15993846233,1468.48088,17398520174,1480168236,17398515917,-4257,,
15993897002,1468.53165,17398570944,1480218989,17398566669,-4275,,
15993947533,1468.58218,17398621478,1480269517,17398617197,-4281,,
15993998296,1468.63294,17398672243,1480320278,17398667958,-4285,,
15994048745,1468.68339,17398722694,1480370724,17398718404,-4290,,
15994099035,1468.73368,17398772987,1480421012,17398768692,-4295,,
15994149151,1468.78380,17398823106,1480471126,17398818806,-4300,,
15994199720,1468.83437,17398873677,1480521692,17398869372,-4305,,
15994250265,1468.88491,17398924224,1480572234,17398919914,-4310,,
15994300501,1468.93515,17398974462,1480622466,17398970146,-4316,,
15994351011,1468.98566,17399024974,1480672974,17399020654,-4320,,
15994401652,1469.03630,17399075618,1480723612,17399071293,-4325,,
15994454014,1469.08866,17399127982,1480775971,17399123651,-4331,,
15994504727,1469.13937,17399178697,1480826682,17399174362,-4335,,
15994555237,1469.18989,17399229209,1480877189,17399224869,-4340,,
15994605809,1469.24046,17399279784,1480927758,17399275439,-4345,,
15994656207,1469.29085,17399330184,1480978153,17399325833,-4351,,
15994707253,1469.34190,17399381234,1481029198,17399376878,-4356,,
15994758479,1469.39313,17399432462,1481080420,17399428101,-4361,,
15994809337,1469.44399,17399483322,1481131275,17399478956,-4366,,
15994859387,1469.49403,17399533375,1481181324,17399529004,-4371,,
15994909432,1469.54408,17399583421,1481231365,17399579045,-4376,,
15994959644,1469.59429,17399633636,1481281575,17399629255,-4381,,
15995009694,1469.64434,17399683688,1481331622,17399679302,-4386,,
15995060532,1469.69518,17399734528,1481382457,17399730137,-4391,,
15995111065,1469.74571,17399785064,1481432987,17399780668,-4396,,
15995161794,1469.79644,17399835796,1481483714,17399831394,-4402,,
15995212288,1469.84694,17399886292,1481534205,17399881886,-4406,,
15995262830,1469.89748,17399936835,1481584744,17399932424,-4411,,
15995312918,1469.94757,17399986926,1481634829,17399982510,-4416,,
15995363954,1469.99860,17400037964,1481685863,17400033544,-4420,,
15995415169,1470.04982,17400089182,1481737075,17400084756,-4426,,
15995466042,1470.10069,17400140058,1481787946,17400135626,-4432,,
15995516653,1470.15130,17400190671,1481838554,17400186234,-4437,,
15995567674,1470.20232,17400241695,1481889572,17400237253,-4442,,
15995617786,1470.25243,17400291809,1481939681,17400287361,-4448,,
15995668367,1470.30301,17400342392,1481990259,17400337940,-4452,,
15995718880,1470.35353,17400392908,1482040771,17400388451,-4457,,
15995768956,1470.40360,17400442986,1482090843,17400438524,-4462,,
15995819042,1470.45369,17400493073,1482140926,17400488606,-4467,,
15995869594,1470.50424,17400543629,1482191477,17400539158,-4471,,
15995920644,1470.55529,17400594681,1482242523,17400590204,-4477,,
15995971193,1470.60584,17400645231,1482293069,17400640750,-4481,,
15996022244,1470.65689,17400696286,1482344117,17400691798,-4488,,
15996073272,1470.70792,17400747316,1482395144,17400742834,-4482,,
15996124440,1470.75909,17400798486,1482446308,17400793988,-4498,,
15996174869,1470.80952,17400848918,1482496734,17400844415,-4503,,
15996225405,1470.86005,17400899455,1482547267,17400894947,-4508,,
15996275450,1470.91010,17400949503,1482597310,17400944991,-4512,,
15996326030,1470.96068,17401000085,1482647887,17400995568,-4517,,
15996376977,1471.01163,17401051035,1482698831,17401046512,-4523,,
15996427544,1471.06219,17401101605,1482749397,17401097077,-4528,,
15996477956,1471.11260,17401152019,1482799805,17401147486,-4533,,
15996528028,1471.16268,17401202093,1482849875,17401197555,-4538,,
15996578569,1471.21322,17401252637,1482900413,17401248094,-4543,,
15996629605,1471.26425,17401303674,1482951446,17401299126,-4548,,
15996680658,1471.31531,17401354730,1483002496,17401350177,-4553,,
15996731239,1471.36589,17401405314,1483053075,17401400755,-4559,,
15996781789,1471.41644,17401455865,1483103622,17401451302,-4563,,
15996832870,1471.46752,17401506949,1483154700,17401502381,-4568,,
15996883904,1471.51855,17401557985,1483205731,17401553412,-4573,,
15996934432,1471.56908,17401608515,1483256257,17401603937,-4578,,
15996984573,1471.61922,17401658658,1483306395,17401654075,-4583,,
15997035116,1471.66976,17401709204,1483356935,17401704615,-4589,,
15997085670,1471.72032,17401759761,1483407486,17401755167,-4594,,
15997136707,1471.77136,17401810801,1483458521,17401806202,-4599,,
15997187730,1471.82238,17401861826,1483509541,17401857222,-4604,,
15997238314,1471.87296,17401912413,1483560124,17401907804,-4609,,
15997288841,1471.92349,17401962941,1483610647,17401958327,-4614,,
15997339372,1471.97402,17402013475,1483661176,17402008856,-4619,,
15997390442,1472.02509,17402064547,1483712242,17402059923,-4624,,
15997440972,1472.07562,17402115080,1483762769,17402110450,-4630,,
15997491232,1472.12588,17402165342,1483813027,17402160708,-4634,,
15997541822,1472.17647,17402215933,1483863613,17402211294,-4639,,
15997592496,1472.22714,17402266610,1483914285,17402261965,-4645,,
15997643080,1472.27773,17402317196,1483964867,17402312547,-4649,,
15997693628,1472.32828,17402367747,1484015412,17402363093,-4654,,
15997744193,1472.37884,17402418315,1484065974,17402413655,-4660,,
15997795234,1472.42988,17402469357,1484117012,17402464692,-4665,,
15997846286,1472.48093,17402520413,1484168062,17402515743,-4670,,
15997897326,1472.53197,17402571455,1484219099,17402566780,-4675,,
15997948446,1472.58309,17402622577,1484270216,17402617897,-4680,,
15997999436,1472.63408,17402673569,1484321204,17402668885,-4684,,
15998050478,1472.68513,17402724613,1484372242,17402719923,-4690,,
15998101032,1472.73568,17402775170,1484422794,17402770474,-4696,,
15998152083,1472.78673,17402826223,1484473842,17402821523,-4700,,
15998202638,1472.83729,17402876781,1484524395,17402872076,-4705,,
15998253005,1472.88765,17402927150,1484574759,17402922440,-4710,,
15998304034,1472.93868,17402978181,1484625785,17402973465,-4716,,
15998354579,1472.98923,17403028728,1484676328,17403024008,-4720,,
15998405645,1473.04029,17403079798,1484727392,17403075072,-4726,,
15998456665,1473.09131,17403130820,1484778409,17403126089,-4731,,
15998506979,1473.14163,17403181136,1484828720,17403176401,-4735,,
15998557501,1473.19215,17403231661,1484879239,17403226920,-4741,,
15998608556,1473.24320,17403282718,1484930292,17403277972,-4746,,
15998659110,1473.29376,17403333274,1484980842,17403328523,-4751,,
15998709748,1473.34440,17403383914,1485031478,17403379158,-4756,,
15998760797,1473.39545,17403434965,1485082524,17403430204,-4761,,
15998811833,1473.44648,17403486004,1485133558,17403481238,-4766,,
15998862850,1473.49750,17403537024,1485184572,17403532253,-4771,,
15998913367,1473.54802,17403587543,1485235086,17403582767,-4776,,
15998964456,1473.59910,17403638634,1485286172,17403633853,-4781,,
15999015002,1473.64965,17403689182,1485336715,17403684396,-4786,,
15999066016,1473.70066,17403740199,1485387727,17403735408,-4791,,
15999116512,1473.75116,17403790698,1485438220,17403785901,-4797,,
15999167226,1473.80187,17403841413,1485488931,17403836611,-4802,,
15999217865,1473.85251,17403892055,1485539568,17403887248,-4807,,
15999268410,1473.90306,17403942602,1485590120,17403937801,-4801,,
15999319461,1473.95411,17403993655,1485641157,17403988838,-4817,,
15999369982,1474.00463,17404044179,1485691677,17404039357,-4822,,
15999421033,1474.05568,17404095233,1485742725,17404090406,-4827,,
15999471266,1474.10591,17404145468,1485792956,17404140636,-4832,,
15999522354,1474.15700,17404196558,1485844041,17404191721,-4837,,
15999573186,1474.20783,17404247392,1485894869,17404242550,-4842,,
15999623744,1474.25839,17404297952,1485945425,17404293106,-4846,,
15999673905,1474.30855,17404348115,1485995583,17404343263,-4852,,
15999724481,1474.35913,17404398695,1486046156,17404393837,-4858,,
15999775512,1474.41016,17404449728,1486097186,17404444866,-4862,,
15999826191,1474.46084,17404500410,1486147862,17404495542,-4868,,
15999877157,1474.51181,17404551377,1486198824,17404546504,-4873,,
15999927894,1474.56254,17404602116,1486249558,17404597238,-4878,,
15999978912,1474.61356,17404653138,1486300574,17404648255,-4883,,
16000028975,1474.66362,17404703203,1486350634,17404698315,-4888,,
16000079544,1474.71419,17404753774,1486401200,17404748881,-4893,,
16000129626,1474.76427,17404803858,1486451280,17404798961,-4897,,
16000180147,1474.81480,17404854381,1486501798,17404849478,-4903,,
16000230696,1474.86534,17404904932,1486552344,17404900024,-4908,,
16000281256,1474.91590,17404955496,1486602901,17404950582,-4914,,
16000331829,1474.96648,17405006071,1486653472,17405001153,-4918,,
16000382382,1475.01703,17405056625,1486704022,17405051702,-4923,,
16000433007,1475.06766,17405107254,1486754645,17405102325,-4929,,
16000484046,1475.11869,17405158295,1486805682,17405153362,-4933,,
16000535084,1475.16973,17405209336,1486856716,17405204397,-4939,,
16000585725,1475.22037,17405259978,1486907354,17405255034,-4944,,
16000636003,1475.27065,17405310259,1486957631,17405305311,-4948,,
16000686666,1475.32131,17405360924,1487008290,17405355971,-4953,,
16000737636,1475.37228,17405411896,1487059257,17405406938,-4958,,
16000788213,1475.42286,17405462475,1487109831,17405457511,-4964,,
16000838531,1475.47318,17405512797,1487160148,17405507828,-4969,,
16000889089,1475.52374,17405563357,1487210703,17405558383,-4974,,
16000940197,1475.57485,17405614467,1487261807,17405609487,-4980,,
16000990773,1475.62542,17405665046,1487312382,17405660062,-4984,,
16001040959,1475.67561,17405715233,1487362564,17405710244,-4989,,
16001091799,1475.72645,17405766076,1487413401,17405761082,-4994,,
16001142078,1475.77673,17405816358,1487463677,17405811357,-5001,,
16001192202,1475.82685,17405866484,1487513800,17405861480,-5004,,
16001243251,1475.87790,17405917535,1487564846,17405912526,-5009,,
16001293809,1475.92846,17405968096,1487615400,17405963081,-5015,,
16001344857,1475.97951,17406019146,1487666447,17406014127,-5019,,
16001395396,1476.03004,17406069688,1487716982,17406064663,-5025,,
16001445957,1476.08061,17406120250,1487767540,17406115220,-5030,,
16001496505,1476.13115,17406170801,1487818085,17406165766,-5035,,
16001546639,1476.18129,17406220937,1487868217,17406215897,-5040,,
16001597168,1476.23182,17406271481,1487918756,17406266436,-5045,,
16001647790,1476.28244,17406322092,1487969362,17406317042,-5050,,
16001698490,1476.33314,17406372796,1488020061,17406367741,-5055,,
16001748899,1476.38355,17406423207,1488070476,17406418157,-5050,,
16001799664,1476.43431,17406473973,1488121227,17406468908,-5065,,
16001850682,1476.48533,17406524994,1488172244,17406519924,-5070,,
16001901266,1476.53591,17406575581,1488222825,17406570506,-5075,,
16001951835,1476.58648,17406626152,1488273391,17406621072,-5080,,
16002002594,1476.63724,17406676914,1488324148,17406671828,-5086,,
16002053138,1476.68779,17406727460,1488374689,17406722370,-5090,,
16002103461,1476.73811,17406777785,1488425009,17406772690,-5095,,
16002153599,1476.78825,17406827926,1488475144,17406822825,-5101,,
16002203728,1476.83838,17406878057,1488525272,17406872952,-5105,,
16002254832,1476.88948,17406929164,1488576373,17406924053,-5111,,
16002305383,1476.94003,17406979716,1488626920,17406974612,-5104,,
16002356417,1476.99106,17407030753,1488677952,17407025632,-5121,,
16002407469,1477.04212,17407081820,1488729013,17407076694,-5126,,
16002458489,1477.09314,17407132829,1488780018,17407127698,-5131,,
16002508541,1477.14319,17407182883,1488830067,17407177748,-5135,,
16002558625,1477.19327,17407232972,1488880151,17407227831,-5141,,
16002609268,1477.24392,17407283616,1488930790,17407278470,-5146,,
16002659799,1477.29445,17407334149,1488981317,17407328998,-5151,,
16002710364,1477.34501,17407384717,1489031881,17407379561,-5156,,
16002760515,1477.39516,17407434870,1489082029,17407429709,-5161,,
16002811006,1477.44565,17407485363,1489132516,17407480197,-5166,,
16002861557,1477.49620,17407535917,1489183064,17407530745,-5172,,
16002911868,1477.54652,17407586230,1489233374,17407581054,-5176,,
16002962434,1477.59708,17407636798,1489283937,17407631617,-5181,,
16003012998,1477.64765,17407687364,1489334497,17407682178,-5186,,
16003063275,1477.69792,17407737643,1489384772,17407732452,-5191,,
16003113879,1477.74853,17407788250,1489435373,17407783054,-5196,,
16003164483,1477.79913,17407838857,1489485975,17407833655,-5202,,
16003215340,1477.84999,17407889715,1489536829,17407884510,-5205,,
16003266366,1477.90101,17407940745,1489587852,17407935533,-5212,,
16003316454,1477.95110,17407990835,1489637937,17407985618,-5217,,
16003367256,1478.00190,17408041639,1489688736,17408036416,-5223,,
16003417315,1478.05196,17408091700,1489738793,17408086473,-5227,,
16003468353,1478.10300,17408142741,1489789828,17408137509,-5232,,
16003518524,1478.15317,17408192914,1489839997,17408187678,-5236,,
16003569075,1478.20372,17408243468,1489890545,17408238226,-5242,,
16003619223,1478.25387,17408293618,1489940691,17408288371,-5247,,
16003669764,1478.30441,17408344161,1489991228,17408338909,-5252,,
16003720030,1478.35468,17408394430,1490041492,17408389173,-5257,,
16003771136,1478.40578,17408445538,1490092596,17408440276,-5262,,
16003821459,1478.45611,17408495863,1490142916,17408490596,-5267,,
16003872530,1478.50718,17408546937,1490193983,17408541664,-5273,,
16003923537,1478.55819,17408597946,1490244989,17408592669,-5277,,
16003974093,1478.60874,17408648504,1490295541,17408643222,-5282,,
16004025149,1478.65980,17408699563,1490346595,17408694275,-5288,,
16004076164,1478.71081,17408750579,1490397606,17408745286,-5293,,
16004126739,1478.76139,17408801157,1490448179,17408795860,-5297,,
16004177260,1478.81191,17408851681,1490498698,17408846379,-5302,,
16004228334,1478.86298,17408902756,1490549768,17408897448,-5308,,
16004278918,1478.91357,17408953344,1490600351,17408948031,-5313,,
16004329944,1478.96459,17409004372,1490651374,17408999054,-5318,,
16004380976,1479.01562,17409055406,1490702402,17409050082,-5324,,
16004431564,1479.06621,17409105996,1490752987,17409100667,-5329,,
16004482612,1479.11726,17409157047,1490804034,17409151714,-5333,,
16004532716,1479.16736,17409207153,1490854135,17409201827,-5326,,
16004583550,1479.21820,17409257989,1490904965,17409252646,-5343,,
16004633702,1479.26835,17409308143,1490955115,17409302795,-5348,,
16004683850,1479.31850,17409358294,1491005260,17409352941,-5353,,
16004734711,1479.36936,17409409158,1491056118,17409403799,-5359,,
16004785742,1479.42039,17409460191,1491107146,17409454827,-5364,,
16004836400,1479.47105,17409510852,1491157802,17409505483,-5369,,
16004886587,1479.52123,17409561041,1491207987,17409555667,-5374,,
16004937177,1479.57182,17409611633,1491258573,17409606254,-5379,,
16004987795,1479.62244,17409662254,1491309190,17409656870,-5384,,
16005038375,1479.67302,17409712836,1491359767,17409707447,-5389,,
16005089389,1479.72404,17409763851,1491410777,17409758457,-5394,,
16005139919,1479.77457,17409814385,1491461305,17409808986,-5399,,
16005190503,1479.82515,17409864971,1491511887,17409859567,-5404,,
16005241069,1479.87572,17409915540,1491562451,17409910131,-5409,,
16005292083,1479.92673,17409966556,1491613461,17409961141,-5415,,
16005342701,1479.97735,17410017176,1491664076,17410011757,-5419,,
16005393740,1480.02839,17410068217,1491715112,17410062793,-5424,,
16005444291,1480.07894,17410118770,1491765660,17410113340,-5430,,
16005494887,1480.12954,17410169369,1491816254,17410163934,-5435,,
16005545915,1480.18056,17410220400,1491867280,17410214960,-5440,,
16005596473,1480.23112,17410270960,1491917834,17410265515,-5445,,
16005646562,1480.28121,17410321051,1491967921,17410315601,-5450,,
16005697596,1480.33224,17410372088,1492018952,17410366633,-5455,,
16005748639,1480.38329,17410423133,1492069992,17410417673,-5460,,
16005799185,1480.43383,17410473681,1492120535,17410468216,-5465,,
16005850234,1480.48488,17410524733,1492171582,17410519263,-5470,,
16005900830,1480.53548,17410575331,1492222175,17410569856,-5475,,
16005951557,1480.58621,17410626059,1492272899,17410620579,-5480,,
16006002101,1480.63675,17410676607,1492323440,17410671121,-5486,,
16006053672,1480.68832,17410728179,1492375009,17410722690,-5489,,
16006104220,1480.73887,17410778731,1492425554,17410773235,-5496,,
16006155271,1480.78992,17410829783,1492476602,17410824282,-5501,,
16006206316,1480.84096,17410880830,1492527644,17410875324,-5506,,
16006256880,1480.89153,17410931398,1492578207,17410925887,-5511,,
16006307910,1480.94256,17410982430,1492629233,17410976914,-5516,,
16006358472,1480.99312,17411032994,1492679793,17411027473,-5521,,
16006409603,1481.04425,17411084128,1492730921,17411078602,-5526,,
16006460599,1481.09525,17411135133,1492781922,17411129602,-5531,,
16006511128,1481.14578,17411185657,1492832441,17411180121,-5536,,
16006562164,1481.19681,17411236695,1492883473,17411231154,-5541,,
16006612717,1481.24736,17411287251,1492934025,17411281705,-5546,,
16006663247,1481.29789,17411337783,1492984552,17411332232,-5551,,
16006714302,1481.34895,17411388841,1493035603,17411383284,-5557,,
16006764851,1481.39950,17411439392,1493086150,17411433830,-5562,,
16006815938,1481.45059,17411490482,1493137234,17411484915,-5567,,
16006866489,1481.50114,17411541035,1493187783,17411535463,-5572,,
16006917062,1481.55171,17411591609,1493238352,17411586032,-5577,,
16006967675,1481.60232,17411642226,1493288963,17411636644,-5582,,
16007018753,1481.65340,17411693305,1493340038,17411687718,-5587,,
16007069798,1481.70445,17411744352,1493391080,17411738760,-5592,,
16007120846,1481.75549,17411795404,1493442126,17411789807,-5597,,
16007171396,1481.80604,17411845956,1493492673,17411840354,-5602,,
16007222167,1481.85682,17411896729,1493543441,17411891121,-5608,,
16007272286,1481.90693,17411946851,1493593557,17411941238,-5613,,
16007322832,1481.95748,17411997399,1493644101,17411991782,-5617,,
16007373351,1482.00800,17412047920,1493694617,17412042297,-5623,,
16007423891,1482.05854,17412098463,1493745154,17412092835,-5628,,
16007474429,1482.10908,17412149003,1493795690,17412143371,-5632,,
16007524990,1482.15964,17412199567,1493846248,17412193929,-5638,,
16007576013,1482.21066,17412250591,1493897268,17412244948,-5643,,
16007626441,1482.26109,17412301022,1493947695,17412295375,-5647,,
16007677020,1482.31167,17412351604,1493998271,17412345951,-5653,,
16007727641,1482.36229,17412402227,1494048889,17412396569,-5658,,
16007778455,1482.41310,17412453043,1494099699,17412447380,-5663,,
16007829534,1482.46418,17412504125,1494150777,17412498458,-5667,,
16007880585,1482.51523,17412555178,1494201824,17412549504,-5674,,
16007931616,1482.56626,17412606210,1494252851,17412600532,-5678,,
16007982174,1482.61682,17412656771,1494303407,17412651087,-5684,,
16008032392,1482.66704,17412706992,1494353623,17412701304,-5688,,
16008082935,1482.71758,17412757538,1494404163,17412751843,-5695,,
16008133826,1482.76847,17412808431,1494455051,17412802732,-5699,,
16008184405,1482.81905,17412859012,1494505628,17412853309,-5703,,
16008234977,1482.86963,17412909587,1494556198,17412903879,-5708,,
16008285761,1482.92041,17412960372,1494606978,17412954659,-5713,,
16008336822,1482.97147,17413011436,1494658038,17413005718,-5718,,
16008387351,1483.02200,17413061967,1494708563,17413056243,-5724,,
16008437911,1483.07256,17413112530,1494759120,17413106801,-5729,,
16008488460,1483.12311,17413163080,1494809666,17413157346,-5734,,
16008539050,1483.17370,17413213674,1494860256,17413207936,-5738,,
16008590108,1483.22476,17413264734,1494911310,17413258990,-5744,,
16008640755,1483.27540,17413315383,1494961953,17413309634,-5749,,
16008691389,1483.32604,17413366020,1495012586,17413360266,-5754,,
16008742448,1483.37710,17413417081,1495063641,17413411322,-5759,,
16008793280,1483.42793,17413467916,1495114470,17413462151,-5765,,
16008843382,1483.47803,17413518019,1495164569,17413512250,-5769,,
16008893690,1483.52834,17413568330,1495214876,17413562556,-5774,,
16008944222,1483.57887,17413618864,1495265404,17413613084,-5780,,
16008994766,1483.62941,17413669411,1495315946,17413663626,-5785,,
16009045338,1483.67999,17413719985,1495366515,17413714195,-5790,,
16009095905,1483.73055,17413770554,1495417079,17413764759,-5795,,
16009146493,1483.78114,17413821145,1495467675,17413815355,-5790,,
16009197517,1483.83217,17413872171,1495518685,17413866366,-5805,,
16009248066,1483.88271,17413922723,1495569232,17413916923,-5800,,
16009298630,1483.93328,17413973289,1495619794,17413967474,-5815,,
16009349660,1483.98431,17414024321,1495670830,17414018511,-5810,,
16009400183,1484.03483,17414074846,1495721341,17414069021,-5825,,
16009450776,1484.08542,17414125442,1495771932,17414119612,-5830,,
16009501781,1484.13643,17414176449,1495822934,17414170614,-5835,,
16009552329,1484.18698,17414227000,1495873478,17414221158,-5842,,
16009603888,1484.23854,17414278560,1495925035,17414272715,-5845,,
16009654453,1484.28910,17414329128,1495975597,17414323277,-5851,,
16009705524,1484.34017,17414380202,1496026665,17414374346,-5856,,
16009756014,1484.39066,17414430693,1496077153,17414424833,-5860,,
16009806572,1484.44122,17414481254,1496127708,17414475398,-5856,,
16009857125,1484.49177,17414531810,1496178258,17414525939,-5871,,
16009907669,1484.54232,17414582355,1496228799,17414576479,-5876,,
16009957864,1484.59251,17414632554,1496278992,17414626673,-5881,,
16010008481,1484.64313,17414683172,1496329606,17414677286,-5886,,
16010059326,1484.69397,17414734019,1496380448,17414728129,-5890,,
16010110331,1484.74498,17414785028,1496431451,17414779132,-5896,,
16010161353,1484.79600,17414836052,1496482470,17414830150,-5902,,
16010211935,1484.84658,17414886637,1496533049,17414880730,-5907,,
16010262950,1484.89760,17414937654,1496584062,17414931742,-5912,,
16010313533,1484.94818,17414988239,1496634642,17414982323,-5916,,
16010364569,1484.99922,17415039278,1496685676,17415033356,-5922,,
16010415120,1485.04977,17415089830,1496736223,17415083903,-5927,,
16010466202,1485.10085,17415140914,1496787303,17415134983,-5931,,
16010516754,1485.15140,17415191479,1496837862,17415185543,-5936,,
16010566925,1485.20157,17415241643,1496888020,17415235701,-5942,,
16010617976,1485.25262,17415292696,1496939068,17415286749,-5947,,
16010668058,1485.30271,17415342792,1496989160,17415336840,-5952,,
16010718724,1485.35337,17415393449,1497039812,17415387503,-5946,,
16010769335,1485.40398,17415444062,1497090420,17415438100,-5962,,
16010820373,1485.45502,17415495103,1497141455,17415489136,-5967,,
16010870964,1485.50561,17415545696,1497192044,17415539724,-5972,,
16010922012,1485.55666,17415596747,1497243088,17415590769,-5978,,
16010972640,1485.60729,17415647377,1497293714,17415641395,-5982,,
16011023203,1485.65785,17415697941,1497344274,17415691954,-5987,,
16011073811,1485.70846,17415748553,1497394880,17415742560,-5993,,
16011124839,1485.75949,17415799593,1497445915,17415793595,-5998,,
16011175909,1485.81056,17415850655,1497496972,17415844663,-5992,,
16011226480,1485.86113,17415901239,1497547551,17415895232,-6007,,
16011277155,1485.91180,17415951905,1497598222,17415945902,-6003,,
16011328271,1485.96292,17416003024,1497649326,17415997006,-6018,,
16011379299,1486.01395,17416054054,1497700351,17416048032,-6022,,
16011430333,1486.06498,17416105091,1497751382,17416099063,-6028,,
16011480942,1486.11559,17416155702,1497801988,17416149668,-6034,,
16011531545,1486.16619,17416206307,1497852599,17416200279,-6028,,
16011582003,1486.21665,17416256768,1497903044,17416250725,-6043,,
16011632587,1486.26724,17416307354,1497953625,17416301305,-6049,,
16011683188,1486.31784,17416357958,1498004223,17416351914,-6044,,
16011733798,1486.36845,17416408570,1498054831,17416402512,-6058,,
16011784602,1486.41925,17416459376,1498105632,17416453312,-6064,,
16011835229,1486.46988,17416510005,1498156256,17416503937,-6068,,
16011885553,1486.52020,17416560332,1498206578,17416554259,-6073,,
16011936585,1486.57123,17416611367,1498257607,17416605288,-6079,,
16011987669,1486.62232,17416662453,1498308689,17416656369,-6084,,
16012038217,1486.67287,17416713002,1498359233,17416706913,-6089,,
16012089264,1486.72391,17416764053,1498410278,17416757959,-6094,,
16012140312,1486.77496,17416815103,1498461323,17416809004,-6099,,
16012191337,1486.82598,17416866131,1498512346,17416860026,-6105,,
16012242426,1486.87707,17416917221,1498563432,17416911113,-6108,,
16012293459,1486.92811,17416968257,1498614463,17416962144,-6113,,
16012344520,1486.97917,17417019321,1498665521,17417013201,-6120,,
16012395518,1487.03017,17417070321,1498716515,17417064196,-6125,,
16012446582,1487.08123,17417121386,1498767577,17417115257,-6129,,
16012497137,1487.13179,17417171956,1498818141,17417165821,-6135,,
16012548181,1487.18283,17417222991,1498869171,17417216851,-6140,,
16012598731,1487.23338,17417273543,1498919719,17417267399,-6144,,
16012649299,1487.28395,17417324113,1498970283,17417317964,-6149,,
16012700354,1487.33500,17417375171,1499021335,17417369016,-6155,,
16012750909,1487.38556,17417425728,1499071887,17417419567,-6161,,
16012801461,1487.43611,17417476283,1499122437,17417470118,-6165,,
16012852065,1487.48671,17417526889,1499173039,17417520719,-6170,,
16012903114,1487.53776,17417577941,1499224085,17417571765,-6176,,
16012953695,1487.58834,17417628524,1499274663,17417622344,-6180,,
16013004252,1487.63890,17417679083,1499325218,17417672898,-6185,,
16013054818,1487.68947,17417729652,1499375780,17417723461,-6191,,
16013105567,1487.74022,17417780402,1499426526,17417774206,-6196,,
16013156136,1487.79078,17417830974,1499477093,17417824773,-6201,,
16013206275,1487.84092,17417881116,1499527229,17417874910,-6206,,
16013257147,1487.89180,17417931990,1499578098,17417925779,-6211,,
16013307701,1487.94235,17417982546,1499628651,17417976332,-6214,,
16013358715,1487.99336,17418033562,1499679661,17418027341,-6221,,
16013409256,1488.04390,17418084105,1499730199,17418077879,-6226,,
16013459820,1488.09447,17418134674,1499780762,17418128442,-6232,,
16013510396,1488.14504,17418185251,1499831335,17418179016,-6235,,
16013561409,1488.19606,17418236266,1499882345,17418230025,-6241,,
16013612472,1488.24712,17418287331,1499933404,17418281084,-6247,,
16013662604,1488.29725,17418337465,1499983534,17418331214,-6251,,
16013713639,1488.34829,17418388503,1500034567,17418382247,-6256,,
16013764188,1488.39884,17418439054,1500085112,17418432792,-6262,,
16013814383,1488.44903,17418489252,1500135316,17418482996,-6256,,
16013865451,1488.50010,17418540321,1500186370,17418534051,-6270,,
16013916035,1488.55068,17418590909,1500236952,17418584632,-6277,,
16013967082,1488.60173,17418641957,1500287995,17418635675,-6282,,
16014018132,1488.65278,17418693009,1500339043,17418686723,-6286,,
16014069167,1488.70382,17418744047,1500390075,17418737755,-6292,,
16014120198,1488.75485,17418795081,1500441104,17418788784,-6297,,
16014171279,1488.80593,17418846165,1500492182,17418839862,-6303,,
16014222291,1488.85694,17418897179,1500543192,17418890872,-6307,,
16014273352,1488.90800,17418948241,1500594249,17418941930,-6311,,
16014324389,1488.95904,17418999282,1500645283,17418992963,-6319,,
16014374518,1489.00917,17419049412,1500695409,17419043090,-6322,,
16014424602,1489.05925,17419099499,1500745492,17419093173,-6326,,
16014475651,1489.11030,17419150551,1500796538,17419144219,-6332,,
16014526723,1489.16137,17419201625,1500847606,17419195287,-6338,,
16014577732,1489.21238,17419252637,1500898613,17419246293,-6344,,
16014628320,1489.26297,17419303226,1500949198,17419296878,-6348,,
16014679370,1489.31402,17419354278,1501000245,17419347926,-6352,,
16014730418,1489.36507,17419405330,1501051291,17419398971,-6359,,
16014781467,1489.41611,17419456381,1501102337,17419450018,-6363,,
16014831942,1489.46659,17419506858,1501152809,17419500490,-6368,,
16014883008,1489.51766,17419557927,1501203873,17419551553,-6374,,
16014933860,1489.56851,17419608792,1501254734,17419602414,-6378,,
16014984495,1489.61914,17419659418,1501305355,17419653035,-6383,,
16015035074,1489.66972,17419710000,1501355931,17419703611,-6389,,
16015085202,1489.71985,17419760129,1501406055,17419753736,-6393,,
16015135842,1489.77049,17419810772,1501456693,17419804374,-6398,,
16015186432,1489.82108,17419861365,1501507280,17419854961,-6404,,
16015236537,1489.87118,17419911472,1501557382,17419905062,-6410,,
16015287221,1489.92187,17419962158,1501608063,17419955744,-6414,,
16015338295,1489.97294,17420013234,1501659135,17420006815,-6419,,
16015389370,1490.02402,17420064312,1501710207,17420057888,-6424,,
16015439873,1490.07452,17420114818,1501760708,17420108389,-6429,,
16015489921,1490.12457,17420164868,1501810754,17420158434,-6434,,
16015540501,1490.17515,17420215460,1501861341,17420209021,-6439,,
16015591545,1490.22619,17420266497,1501912372,17420260052,-6445,,
16015642189,1490.27684,17420317143,1501963013,17420310693,-6450,,
16015692792,1490.32744,17420367748,1502013624,17420361305,-6443,,
16015743854,1490.37850,17420418812,1502064671,17420412352,-6460,,
16015793988,1490.42864,17420468948,1502114803,17420462484,-6464,,
16015844107,1490.47876,17420519070,1502164921,17420512601,-6469,,
16015895152,1490.52980,17420570117,1502215962,17420563642,-6475,,
16015946101,1490.58075,17420621068,1502266907,17420614588,-6480,,
16015996647,1490.63129,17420671617,1502317452,17420665133,-6484,,
16016047751,1490.68240,17420722723,1502368553,17420716233,-6490,,
16016098279,1490.73293,17420773254,1502419089,17420766770,-6484,,
16016148929,1490.78358,17420823907,1502469727,17420817407,-6500,,
16016199555,1490.83420,17420874535,1502520349,17420868030,-6505,,
16016250277,1490.88493,17420925258,1502571068,17420918749,-6509,,
16016301301,1490.93595,17420976285,1502622099,17420969780,-6505,,
16016351982,1490.98663,17421026969,1502672768,17421020449,-6520,,
16016403066,1491.03771,17421078055,1502723850,17421071541,-6514,,
16016453652,1491.08830,17421128644,1502774432,17421122113,-6531,,
16016504238,1491.13889,17421179231,1502825016,17421172697,-6534,,
16016554887,1491.18953,17421229883,1502875662,17421223343,-6540,,
16016605425,1491.24007,17421280424,1502926198,17421273878,-6546,,
16016655948,1491.29060,17421330972,1502976742,17421324422,-6550,,
16016706845,1491.34149,17421381848,1503027612,17421375293,-6555,,
16016757452,1491.39210,17421432458,1503078216,17421425897,-6561,,
16016808018,1491.44267,17421483026,1503128779,17421476460,-6566,,
16016858197,1491.49284,17421533208,1503178957,17421526637,-6571,,
16016909200,1491.54385,17421584213,1503229956,17421577636,-6577,,
16016960156,1491.59480,17421635171,1503280920,17421628601,-6570,,
16017010705,1491.64535,17421685723,1503331455,17421679136,-6587,,
16017061679,1491.69633,17421736698,1503382427,17421730107,-6591,,
16017112327,1491.74698,17421787349,1503433072,17421780753,-6596,,
16017163251,1491.79790,17421838276,1503483993,17421831674,-6602,,
16017213965,1491.84861,17421888991,1503534705,17421882385,-6606,,
16017264491,1491.89914,17421939519,1503585228,17421932908,-6611,,
16017315040,1491.94969,17421990071,1503635774,17421983455,-6616,,
16017365602,1492.00025,17422040636,1503686334,17422034014,-6622,,
16017416164,1492.05081,17422091200,1503736893,17422084573,-6627,,
16017467197,1492.10184,17422142236,1503787924,17422135604,-6632,,
16017517806,1492.15245,17422192847,1503838530,17422186210,-6637,,
16017568327,1492.20297,17422243371,1503889048,17422236729,-6642,,
16017618913,1492.25356,17422293959,1503939632,17422287312,-6647,,
16017669945,1492.30459,17422344993,1503990661,17422338341,-6652,,
16017720546,1492.35519,17422395597,1504041259,17422388939,-6658,,
16017771163,1492.40581,17422446216,1504091873,17422439554,-6662,,
16017821648,1492.45630,17422496703,1504142356,17422490036,-6667,,
16017872718,1492.50737,17422547775,1504193422,17422541103,-6672,,
16017923174,1492.55782,17422598245,1504243888,17422591568,-6677,,
16017973761,1492.60841,17422648822,1504294460,17422642140,-6682,,
16018024561,1492.65921,17422699625,1504345257,17422692937,-6688,,
16018075333,1492.70998,17422750399,1504396027,17422743707,-6692,,
16018125928,1492.76058,17422800998,1504446619,17422794300,-6698,,
16018177021,1492.81167,17422852093,1504497709,17422845390,-6703,,
16018227630,1492.86228,17422902704,1504548315,17422895995,-6709,,
16018278219,1492.91287,17422953295,1504598902,17422946583,-6712,,
16018329192,1492.96384,17423004271,1504649873,17422997553,-6718,,
16018379738,1493.01439,17423054819,1504700416,17423048097,-6722,,
16018430296,1493.06494,17423105380,1504750971,17423098652,-6728,,
16018480872,1493.11552,17423155958,1504801545,17423149225,-6733,,
16018530978,1493.16563,17423206066,1504851648,17423199328,-6738,,
16018581876,1493.21652,17423256967,1504902543,17423250223,-6744,,
16018632501,1493.26715,17423307594,1504953166,17423300846,-6748,,
16018683535,1493.31818,17423358630,1505004196,17423351877,-6753,,
16018733613,1493.36826,17423408711,1505054271,17423401952,-6759,,
16018784244,1493.41889,17423459355,1505104911,17423452592,-6763,,
16018835313,1493.46996,17423510415,1505155967,17423503647,-6768,,
16018886423,1493.52107,17423561528,1505207073,17423554754,-6774,,
16018937491,1493.57214,17423612597,1505258138,17423605818,-6779,,
16018988563,1493.62321,17423663673,1505309209,17423656889,-6784,,
16019039591,1493.67424,17423714702,1505360233,17423707913,-6789,,
16019090662,1493.72531,17423765775,1505411301,17423758982,-6793,,
16019141716,1493.77636,17423816833,1505462352,17423810033,-6800,,
16019192752,1493.82740,17423867871,1505513387,17423861067,-6804,,
16019243767,1493.87841,17423918900,1505564411,17423912091,-6809,,
16019294256,1493.92890,17423969380,1505614884,17423962565,-6815,,
16019344343,1493.97899,17424019479,1505664980,17424012660,-6819,,
16019395426,1494.03007,17424070555,1505716050,17424063730,-6825,,
16019446411,1494.08106,17424121541,1505767031,17424114711,-6830,,
16019496983,1494.13163,17424172116,1505817600,17424165281,-6835,,
16019548149,1494.18280,17424223285,1505868765,17424216445,-6840,,
16019598569,1494.23322,17424273707,1505919182,17424266862,-6845,,
16019649123,1494.28377,17424324263,1505969732,17424317413,-6850,,
16019699671,1494.33432,17424374814,1506020279,17424367959,-6855,,
16019750722,1494.38537,17424425866,1506071326,17424419006,-6860,,
16019801771,1494.43642,17424476917,1506122372,17424470052,-6865,,
16019852349,1494.48700,17424527499,1506172947,17424520628,-6871,,
16019902841,1494.53749,17424577993,1506223438,17424571118,-6875,,
16019953355,1494.58800,17424628509,1506273949,17424621629,-6880,,
16020004068,1494.63872,17424679224,1506324658,17424672338,-6886,,
16020054655,1494.68930,17424729825,1506375254,17424722935,-6890,,
16020105737,1494.74039,17424780899,1506426322,17424774002,-6897,,
16020156332,1494.79098,17424831496,1506476915,17424824595,-6901,,
16020206961,1494.84161,17424882127,1506527540,17424875232,-6895,,
16020257795,1494.89244,17424932964,1506578372,17424926053,-6911,,
16020308359,1494.94301,17424983530,1506628933,17424976613,-6917,,
16020359390,1494.99404,17425034562,1506679961,17425027641,-6921,,
16020410436,1495.04508,17425085612,1506731005,17425078686,-6926,,
16020461059,1495.09571,17425136237,1506781626,17425129306,-6931,,
16020511589,1495.14624,17425186769,1506832152,17425179833,-6936,,
16020562638,1495.19729,17425237820,1506883198,17425230878,-6942,,
16020613700,1495.24835,17425288884,1506934258,17425281938,-6946,,
16020664730,1495.29938,17425339929,1506985297,17425332977,-6952,,
16020715411,1495.35006,17425390601,1507035964,17425383644,-6957,,
16020766034,1495.40068,17425441226,1507086584,17425434264,-6962,,
16020816572,1495.45122,17425491767,1507137120,17425484810,-6957,,
16020867217,1495.50186,17425542413,1507187761,17425535441,-6972,,
16020917704,1495.55235,17425592903,1507238245,17425585925,-6978,,
16020967942,1495.60259,17425643144,1507288481,17425636162,-6982,,
16021018987,1495.65363,17425694191,1507339524,17425687204,-6987,,
16021069140,1495.70379,17425744346,1507389674,17425737354,-6992,,
16021119266,1495.75391,17425794475,1507439797,17425787478,-6997,,
16021169898,1495.80455,17425845108,1507490426,17425838106,-7002,,
16021220388,1495.85504,17425895601,1507540913,17425888594,-7007,,
16021271457,1495.90611,17425946672,1507591980,17425939660,-7012,,
16021321613,1495.95626,17425996831,1507642133,17425989814,-7017,,
16021372662,1496.00731,17426047882,1507693179,17426040860,-7022,,
16021423706,1496.05835,17426098928,1507744219,17426091900,-7028,,
16021474715,1496.10936,17426149940,1507795227,17426142908,-7032,,
16021525263,1496.15991,17426200491,1507845772,17426193453,-7038,,
16021575813,1496.21046,17426251043,1507896319,17426244000,-7043,,
16021626862,1496.26151,17426302094,1507947366,17426295046,-7048,,
16021677398,1496.31205,17426352632,1507997899,17426345579,-7053,,
16021727474,1496.36212,17426402710,1508047972,17426395652,-7058,,
16021778511,1496.41316,17426453750,1508099007,17426446687,-7063,,
16021829126,1496.46377,17426504368,1508149619,17426497300,-7068,,
16021880158,1496.51481,17426555402,1508200649,17426548330,-7072,,
16021931245,1496.56589,17426606491,1508251733,17426599414,-7077,,
16021981591,1496.61624,17426656839,1508302076,17426649756,-7083,,
16022032162,1496.66681,17426707412,1508352644,17426700325,-7087,,
16022083164,1496.71781,17426758418,1508403644,17426751324,-7094,,
16022133224,1496.76787,17426808479,1508453700,17426801380,-7099,,
16022183319,1496.81797,17426858577,1508503794,17426851474,-7103,,
16022234368,1496.86902,17426909629,1508554840,17426902520,-7109,,
16022285384,1496.92003,17426960646,1508605852,17426953532,-7114,,
16022335919,1496.97057,17427011184,1508656386,17427004066,-7118,,
16022386483,1497.02113,17427061751,1508706946,17427054627,-7124,,
16022437030,1497.07168,17427112300,1508757491,17427105172,-7128,,
16022488070,1497.12272,17427163342,1508808528,17427156208,-7134,,
16022539134,1497.17378,17427214409,1508859589,17427207270,-7139,,
16022589674,1497.22432,17427264951,1508910127,17427257807,-7144,,
16022640718,1497.27537,17427315997,1508961168,17427308848,-7149,,
16022691235,1497.32588,17427366517,1509011683,17427359364,-7153,,
16022741553,1497.37620,17427416837,1509061997,17427409678,-7159,,
16022792110,1497.42676,17427467396,1509112551,17427460232,-7164,,
16022842768,1497.47742,17427518057,1509163207,17427510887,-7170,,
16022893322,1497.52797,17427568612,1509213762,17427561445,-7167,,
16022944403,1497.57905,17427619697,1509264836,17427612517,-7180,,
16022994488,1497.62914,17427669783,1509314918,17427662598,-7185,,
16023044596,1497.67924,17427719893,1509365024,17427712704,-7189,,
16023095614,1497.73026,17427770915,1509416039,17427763720,-7195,,
16023146205,1497.78085,17427821508,1509466628,17427814308,-7200,,
16023196740,1497.83139,17427872046,1509517162,17427864842,-7204,,
16023247808,1497.88246,17427923116,1509568226,17427915906,-7210,,
16023298362,1497.93301,17427973671,1509618776,17427966456,-7215,,
16023348980,1497.98363,17428024292,1509669403,17428017083,-7209,,
16023399924,1498.03457,17428075238,1509720332,17428068013,-7225,,
16023450907,1498.08556,17428126224,1509771314,17428118994,-7230,,
16023501425,1498.13607,17428176744,1509821828,17428169509,-7235,,
16023551982,1498.18663,17428227304,1509872384,17428220064,-7240,,
16023602505,1498.23715,17428277829,1509922903,17428270584,-7245,,
16023653096,1498.28774,17428328423,1509973492,17428321172,-7251,,
16023703655,1498.33830,17428378984,1510024047,17428371728,-7256,,
16023754329,1498.38898,17428429659,1510074719,17428422399,-7260,,
16023804882,1498.43953,17428480216,1510125269,17428472949,-7267,,
16023855298,1498.48995,17428530633,1510175693,17428523373,-7260,,
16023906356,1498.54100,17428581694,1510226738,17428574418,-7276,,
16023956447,1498.59109,17428631798,1510276837,17428624517,-7281,,
16024007506,1498.64215,17428682849,1510327883,17428675563,-7286,,
16024058104,1498.69275,17428733448,1510378477,17428726157,-7291,,
16024108786,1498.74343,17428784134,1510429158,17428776838,-7296,,
16024159391,1498.79404,17428834741,1510479760,17428827440,-7301,,
16024210420,1498.84507,17428885771,1510530785,17428878465,-7306,,
16024261460,1498.89611,17428936814,1510581823,17428929503,-7311,,
16024312042,1498.94669,17428987398,1510632402,17428980082,-7316,,
16024362673,1498.99732,17429038033,1510683030,17429030711,-7322,,
16024413754,1499.04840,17429089115,1510734108,17429081788,-7327,,
16024464778,1499.09943,17429140142,1510785131,17429132811,-7331,,
16024515783,1499.15043,17429191149,1510836132,17429183812,-7337,,
16024566810,1499.20146,17429242179,1510887156,17429234837,-7342,,
16024616858,1499.25151,17429292229,1510937202,17429284882,-7347,,
16024666955,1499.30160,17429342329,1510987297,17429334977,-7352,,
16024717906,1499.35255,17429393282,1511038245,17429385925,-7357,,
16024768741,1499.40339,17429444119,1511089076,17429436757,-7362,,
16024818960,1499.45361,17429494340,1511139293,17429486974,-7366,,
16024869871,1499.50452,17429545253,1511190201,17429537881,-7372,,
16024920595,1499.55524,17429595979,1511240921,17429588602,-7377,,
16024970791,1499.60544,17429646179,1511291116,17429638797,-7382,,
16025021337,1499.65599,17429696726,1511341659,17429689339,-7387,,
16025071921,1499.70657,17429747313,1511392240,17429739921,-7392,,
16025122132,1499.75678,17429797527,1511442449,17429790130,-7397,,
16025173024,1499.80767,17429848421,1511493339,17429841019,-7402,,
16025224064,1499.85871,17429899464,1511544375,17429892056,-7408,,
16025275134,1499.90978,17429950536,1511595443,17429943123,-7413,,
16025325775,1499.96042,17430001179,1511646081,17429993761,-7418,,
16025376495,1500.01114,17430051902,1511696799,17430044479,-7423,,
16025427104,1500.06175,17430102513,1511747405,17430095085,-7428,,
16025477653,1500.11230,17430153064,1511797951,17430145631,-7433,,
16025528672,1500.16332,17430204086,1511848967,17430196647,-7439,,
16025579187,1500.21384,17430254602,1511899479,17430247159,-7443,,
16025629749,1500.26440,17430305167,1511950038,17430297719,-7448,,
16025679787,1500.31444,17430355207,1512000074,17430347754,-7453,,
16025730167,1500.36481,17430405590,1512050451,17430398132,-7458,,
16025780829,1500.41548,17430456253,1512101110,17430448790,-7463,,
16025831873,1500.46652,17430507301,1512152153,17430499833,-7468,,
16025882956,1500.51760,17430558385,1512203232,17430550912,-7473,,
16025933584,1500.56823,17430609017,1512253858,17430601538,-7479,,
16025984600,1500.61925,17430660034,1512304870,17430652551,-7483,,
16026034756,1500.66940,17430710193,1512355024,17430702705,-7488,,
16026084954,1500.71960,17430760394,1512405220,17430752900,-7494,,
16026135971,1500.77062,17430811413,1512456234,17430803914,-7499,,
16026186997,1500.82164,17430862440,1512507257,17430854937,-7503,,
16026238096,1500.87274,17430913542,1512558353,17430906033,-7509,,
16026289140,1500.92379,17430964589,1512609394,17430957075,-7514,,
16026340096,1500.97474,17431015547,1512660347,17431008028,-7519,,
16026391152,1501.02580,17431066605,1512711401,17431059081,-7524,,
16026442184,1501.07683,17431117640,1512762430,17431110111,-7529,,
16026492754,1501.12740,17431168213,1512812998,17431160678,-7535,,
16026542871,1501.17752,17431218331,1512863110,17431210791,-7540,,
16026593766,1501.22841,17431269229,1512914004,17431261685,-7544,,
16026644409,1501.27906,17431319875,1512964644,17431312325,-7550,,
16026694882,1501.32953,17431370350,1513015115,17431362795,-7555,,
16026745235,1501.37988,17431420705,1513065465,17431413146,-7559,,
16026795861,1501.43051,17431471333,1513116099,17431463779,-7554,,
16026846442,1501.48109,17431521917,1513166667,17431514357,-7560,,
16026897060,1501.53171,17431572536,1513217282,17431564962,-7574,,
16026948108,1501.58276,17431623588,1513268327,17431616008,-7580,,
16026999108,1501.63376,17431674590,1513319325,17431667005,-7585,,
16027049770,1501.68442,17431725254,1513369984,17431717664,-7590,,
16027100296,1501.73494,17431775782,1513420518,17431768199,-7583,,
16027151364,1501.78601,17431826853,1513471573,17431819253,-7600,,
16027201964,1501.83661,17431877456,1513522170,17431869850,-7606,,
16027252544,1501.88719,17431928038,1513572747,17431920428,-7610,,
16027303254,1501.93790,17431978750,1513623454,17431971135,-7615,,
16027353782,1501.98843,17432029280,1513673979,17432021659,-7621,,
16027403943,1502.03859,17432079444,1513724137,17432071818,-7626,,
16027454965,1502.08961,17432130468,1513775157,17432122838,-7630,,
16027505770,1502.14042,17432181275,1513825959,17432173639,-7636,,
16027556823,1502.19147,17432232331,1513877010,17432224690,-7641,,
16027607366,1502.24201,17432282876,1513927550,17432275231,-7645,,
16027657882,1502.29253,17432333395,1513978063,17432325744,-7651,,
16027708487,1502.34314,17432384013,1514028676,17432376357,-7656,,
16027759101,1502.39375,17432434629,1514079288,17432426969,-7660,,
16027809733,1502.44438,17432485253,1514129906,17432477587,-7666,,
16027860775,1502.49542,17432536297,1514180945,17432528626,-7671,,
16027911845,1502.54649,17432587370,1514232013,17432579693,-7677,,
16027962899,1502.59755,17432638426,1514283065,17432630745,-7681,,
16028013042,1502.64769,17432688571,1514333204,17432680885,-7686,,
16028064102,1502.69875,17432739634,1514384261,17432731942,-7692,,
16028114610,1502.74926,17432790143,1514434766,17432782446,-7697,,
16028165134,1502.79978,17432840682,1514485301,17432832981,-7701,,
16028215845,1502.85049,17432891383,1514535996,17432883676,-7707,,
16028266857,1502.90151,17432942398,1514587005,17432934686,-7712,,
16028317413,1502.95206,17432992956,1514637560,17432985240,-7716,,
16028367573,1503.00222,17433043118,1514687716,17433035397,-7721,,
16028417700,1503.05235,17433093248,1514737840,17433085521,-7727,,
16028468585,1503.10323,17433144135,1514788722,17433136402,-7733,,
16028519616,1503.15426,17433195169,1514839751,17433187432,-7737,,
16028570192,1503.20484,17433245747,1514890324,17433238005,-7742,,
16028620745,1503.25539,17433296303,1514940874,17433288555,-7748,,
16028671793,1503.30644,17433347353,1514991921,17433339601,-7752,,
16028722849,1503.35750,17433398411,1515042973,17433390654,-7757,,
16028773678,1503.40833,17433449243,1515093800,17433441480,-7763,,
16028824255,1503.45890,17433499834,1515144386,17433492067,-7767,,
16028874497,1503.50914,17433550066,1515194613,17433542293,-7773,,
16028925061,1503.55971,17433600633,1515245175,17433592855,-7778,,
16028976102,1503.61075,17433651675,1515296212,17433643892,-7783,,
16029026280,1503.66093,17433701855,1515346388,17433694068,-7787,,
16029076812,1503.71146,17433752391,1515396917,17433744598,-7793,,
16029127362,1503.76201,17433802942,1515447464,17433795144,-7798,,
16029177921,1503.81257,17433853504,1515498021,17433845702,-7802,,
16029228995,1503.86364,17433904580,1515549092,17433896773,-7807,,
16029280029,1503.91468,17433955616,1515600123,17433947803,-7813,,
16029330165,1503.96481,17434005756,1515650256,17433997937,-7819,,
16029380703,1504.01535,17434056296,1515700793,17434048473,-7823,,
16029430871,1504.06552,17434106465,1515750957,17434098637,-7828,,
16029481268,1504.11592,17434156866,1515801351,17434149032,-7834,,
16029531816,1504.16646,17434207416,1515851897,17434199578,-7838,,
16029581896,1504.21654,17434257498,1515901975,17434249655,-7843,,
16029632943,1504.26759,17434308547,1515953017,17434300698,-7849,,
16029683492,1504.31814,17434359099,1516003564,17434351245,-7854,,
16029734063,1504.36871,17434409672,1516054133,17434401814,-7858,,
16029784636,1504.41928,17434460248,1516104704,17434452384,-7864,,
16029834796,1504.46944,17434510420,1516154870,17434502551,-7869,,
16029885636,1504.52028,17434561252,1516205698,17434553379,-7873,,
16029936648,1504.57130,17434612277,1516256717,17434604398,-7879,,
16029986968,1504.62162,17434662589,1516307024,17434654704,-7885,,
16030037031,1504.67168,17434712654,1516357085,17434704766,-7888,,
16030087173,1504.72182,17434762799,1516407225,17434754905,-7894,,
16030138258,1504.77291,17434813886,1516458306,17434805987,-7899,,
16030188879,1504.82353,17434864509,1516508924,17434856605,-7904,,
16030239309,1504.87396,17434914942,1516559352,17434907033,-7909,,
16030290300,1504.92495,17434965934,1516610339,17434958020,-7914,,
16030340652,1504.97530,17435016288,1516660689,17435008370,-7918,,
16030391649,1505.02630,17435067288,1516711684,17435059364,-7924,,
16030442247,1505.07689,17435117888,1516762279,17435109959,-7929,,
16030493261,1505.12791,17435168906,1516813290,17435160971,-7935,,
16030543811,1505.17846,17435219457,1516863837,17435211517,-7940,,
16030594643,1505.22929,17435270292,1516914667,17435262348,-7944,,
16030645226,1505.27987,17435320878,1516965247,17435312928,-7950,,
16030695793,1505.33044,17435371447,1517015811,17435363502,-7945,,
16030745973,1505.38062,17435421629,1517065989,17435413670,-7959,,
16030796634,1505.43128,17435472293,1517116647,17435464328,-7965,,
16030846811,1505.48146,17435522472,1517166822,17435514514,-7958,,
16030897365,1505.53201,17435573028,1517217373,17435565054,-7974,,
16030947987,1505.58263,17435623652,1517267992,17435615672,-7980,,
16030999035,1505.63368,17435674703,1517319038,17435666718,-7985,,
16031049160,1505.68381,17435724829,1517369159,17435716840,-7989,,
16031100231,1505.73488,17435775904,1517420228,17435767909,-7995,,
16031150449,1505.78510,17435826123,1517470443,17435818123,-8000,,
16031201394,1505.83604,17435877071,1517521385,17435869065,-8006,,
16031252489,1505.88714,17435928169,1517572478,17435920159,-8010,,
16031303516,1505.93816,17435979197,1517623502,17435971182,-8015,,
16031354273,1505.98892,17436029957,1517674256,17436021936,-8021,,
16031405312,1506.03996,17436080998,1517725292,17436072972,-8026,,
16031455849,1506.09050,17436131538,1517775828,17436123508,-8030,,
16031506473,1506.14112,17436182165,1517826448,17436174129,-8036,,
16031767524,1506.40217,17436443227,1518087484,17436435165,-8062,17436440736,
16031792809,1506.42746,17436468513,1518112769,17436460477,-8036,,
16031843319,1506.47797,17436519026,1518163276,17436511040,-7986,,
16031893912,1506.52856,17436569622,1518213866,17436561686,-7936,,
16031944586,1506.57923,17436620298,1518264538,17436612416,-7882,,
16031995122,1506.62977,17436670836,1518315071,17436663005,-7831,,
16032045697,1506.68034,17436721414,1518365644,17436713633,-7781,,
16032096287,1506.73094,17436772006,1518416230,17436764276,-7730,,
16032146881,1506.78153,17436822601,1518466821,17436814924,-7677,,
16032197899,1506.83255,17436873623,1518517837,17436865997,-7626,,
16032248382,1506.88303,17436924108,1518568318,17436916533,-7575,,
16032298810,1506.93346,17436974538,1518618742,17436967014,-7524,,
16032349715,1506.98436,17437025446,1518669646,17437017974,-7472,,
16032400385,1507.03503,17437076118,1518720312,17437068698,-7420,,
16032451380,1507.08603,17437127115,1518771304,17437119746,-7369,,
16032501975,1507.13662,17437177713,1518821898,17437170396,-7317,,
16032552605,1507.18725,17437228345,1518872525,17437221079,-7266,,
16032603609,1507.23826,17437279351,1518923525,17437272136,-7215,,
16032654162,1507.28881,17437329906,1518974076,17437322744,-7162,,
16032705221,1507.33987,17437380968,1519025133,17437373857,-7111,,
16032755800,1507.39045,17437431550,1519075708,17437424490,-7060,,
16032806848,1507.44150,17437482600,1519126753,17437475592,-7008,,
16032857899,1507.49255,17437533653,1519177802,17437526697,-6956,,
16032908948,1507.54360,17437584705,1519228848,17437577800,-6905,,
16032959497,1507.59415,17437635255,1519279394,17437628402,-6853,,
16033010548,1507.64520,17437686310,1519330442,17437679508,-6802,,
16033061482,1507.69613,17437737245,1519381374,17437730495,-6750,,
16033112092,1507.74674,17437787868,1519431991,17437781170,-6698,,
16033162758,1507.79741,17437838526,1519482644,17437831878,-6648,,
16033213389,1507.84804,17437889160,1519533274,17437882565,-6595,,
16033263685,1507.89833,17437939458,1519583566,17437932914,-6544,,
16033314295,1507.94894,17437990071,1519634174,17437983577,-6494,,
16033364544,1507.99919,17438040322,1519684421,17438033880,-6442,,
16033415054,1508.04970,17438090834,1519734927,17438084444,-6390,,
16033465115,1508.09976,17438140898,1519784986,17438134557,-6341,,
16033515774,1508.15042,17438191559,1519835641,17438185270,-6289,,
16033566288,1508.20094,17438242075,1519886154,17438235838,-6237,,
16033616839,1508.25149,17438292629,1519936701,17438286442,-6187,,
16033667387,1508.30203,17438343179,1519987247,17438337044,-6135,,
16033717936,1508.35258,17438393731,1520037794,17438387647,-6084,,
16033768589,1508.40324,17438444386,1520088443,17438438354,-6032,,
16033819135,1508.45378,17438494934,1520138987,17438488953,-5981,,
16033869206,1508.50385,17438545007,1520189055,17438539077,-5930,,
16033919765,1508.55441,17438595569,1520239612,17438589691,-5878,,
16033969868,1508.60452,17438645673,1520289711,17438639845,-5828,,
16034020381,1508.65503,17438696189,1520340221,17438690411,-5778,,
16034070532,1508.70518,17438746344,1520390371,17438740618,-5726,,
16034121014,1508.75566,17438796826,1520440849,17438791151,-5675,,
16034171694,1508.80634,17438847510,1520491526,17438841886,-5624,,
16034222702,1508.85735,17438898519,1520542532,17438892949,-5570,,
16034273307,1508.90795,17438949127,1520593134,17438943607,-5520,,
16034323909,1508.95856,17438999731,1520643733,17438994262,-5469,,
16034374575,1509.00922,17439050399,1520694396,17439044982,-5417,,
16034425180,1509.05983,17439101006,1520744999,17439095640,-5366,,
16034476012,1509.11066,17439151842,1520795828,17439146527,-5315,,
16034526116,1509.16076,17439201948,1520845929,17439196684,-5264,,
16034580279,1509.21493,17439256114,1520900089,17439250904,-5210,,
16034638362,1509.27301,17439314199,1520958169,17439309048,-5151,,
16034696549,1509.33120,17439372388,1521016353,17439367298,-5090,,
16034747157,1509.38180,17439422998,1521066959,17439417959,-5039,,
16034797441,1509.43209,17439473286,1521117240,17439468297,-4989,,
16034848478,1509.48313,17439524324,1521168274,17439519387,-4937,,
16034898659,1509.53331,17439574508,1521218453,17439569622,-4886,,
16034949206,1509.58385,17439625058,1521268997,17439620223,-4835,,
16034999782,1509.63443,17439675635,1521319569,17439670852,-4783,,
16035050837,1509.68548,17439726693,1521370622,17439721961,-4732,,
16035103365,1509.73801,17439779223,1521423148,17439774545,-4678,,
16035154394,1509.78904,17439830254,1521474174,17439825628,-4626,,
16035204447,1509.83910,17439880310,1521524224,17439875734,-4576,,
16035255496,1509.89014,17439931362,1521575270,17439926837,-4525,,
16035306068,1509.94072,17439981947,1521625852,17439977476,-4471,,
16035357116,1509.99176,17440032987,1521676885,17440028566,-4421,,
16035407805,1510.04245,17440083678,1521727572,17440079309,-4369,,
16035458214,1510.09286,17440134088,1521777978,17440129771,-4317,,
16035508756,1510.14340,17440184634,1521828517,17440180367,-4267,,
16035559805,1510.19445,17440235685,1521879564,17440231470,-4215,,
16035617108,1510.25176,17440292991,1521936863,17440288834,-4157,,
16035668628,1510.30328,17440344513,1521988380,17440340408,-4105,,
16035719644,1510.35429,17440395531,1522039394,17440391478,-4053,,
16035770642,1510.40529,17440446531,1522090389,17440442530,-4001,,
16035821695,1510.45634,17440497586,1522141439,17440493637,-3949,,
16035872762,1510.50741,17440548657,1522192504,17440544760,-3897,,
16035923815,1510.55846,17440599711,1522243554,17440595867,-3844,,
16035975273,1510.60992,17440651172,1522295009,17440647378,-3794,,
16036025497,1510.66015,17440701399,1522345230,17440697656,-3743,,
16036075742,1510.71039,17440751646,1522395472,17440747953,-3693,,
16036126770,1510.76142,17440802677,1522446498,17440799037,-3640,,
16036177359,1510.81201,17440853267,1522497084,17440849678,-3589,,
16036228399,1510.86305,17440904309,1522548121,17440900772,-3537,,
16036278921,1510.91357,17440954835,1522598642,17440951349,-3486,,
16036329467,1510.96411,17441005383,1522649185,17441001949,-3434,,
16036380020,1511.01467,17441055938,1522699735,17441052555,-3383,,
16036431065,1511.06571,17441106986,1522750776,17441103654,-3332,,
16036481116,1511.11576,17441157038,1522800825,17441153758,-3280,,
16036531663,1511.16631,17441207587,1522851369,17441204358,-3229,,
16036581752,1511.21640,17441257681,1522901457,17441254502,-3179,,
16036632324,1511.26697,17441308253,1522952025,17441305127,-3126,,
16036682918,1511.31757,17441358849,1523002616,17441355775,-3074,,
16036733043,1511.36769,17441408978,1523052739,17441405954,-3024,,
16036783633,1511.41828,17441459569,1523103337,17441456589,-2980,,
16036834678,1511.46933,17441510616,1523154368,17441507620,-2996,,
16036885346,1511.51999,17441561288,1523205034,17441558286,-3002,,
16036936384,1511.57103,17441612328,1523256069,17441609321,-3007,,
16036986970,1511.62162,17441662917,1523306652,17441659905,-3012,,
16037038028,1511.67268,17441713976,1523357707,17441710960,-3016,,
16037089077,1511.72373,17441765039,1523408765,17441762018,-3021,,
16037139435,1511.77408,17441815389,1523459109,17441812362,-3027,,
16037190466,1511.82511,17441866422,1523510137,17441863390,-3032,,
16037241464,1511.87611,17441917421,1523561132,17441914384,-3037,,
16037292317,1511.92697,17441968278,1523611983,17441965235,-3043,,
16037342881,1511.97753,17442018844,1523662545,17442015797,-3047,,
16037393518,1512.02817,17442069483,1523713178,17442066442,-3041,,
16037443972,1512.07862,17442119940,1523763630,17442116882,-3058,,
16037494992,1512.12964,17442170962,1523814647,17442167900,-3062,,
16037546031,1512.18068,17442222003,1523865682,17442218935,-3068,,
16037596607,1512.23125,17442272581,1523916256,17442269508,-3073,,
16037647155,1512.28180,17442323132,1523966802,17442320054,-3078,,
16037698194,1512.33284,17442374173,1524017838,17442371090,-3083,,
16037748747,1512.38340,17442424729,1524068389,17442421641,-3088,,
16037799330,1512.43398,17442475313,1524118968,17442472220,-3093,,
16037850346,1512.48499,17442526343,1524169993,17442523245,-3098,,
16037900999,1512.53565,17442576988,1524220633,17442573885,-3103,,
16037951558,1512.58621,17442627559,1524271198,17442624451,-3108,,
16038002236,1512.63688,17442678230,1524321864,17442675116,-3114,,
16038053226,1512.68787,17442729222,1524372851,17442726104,-3118,,
16038104788,1512.73944,17442780787,1524424410,17442777662,-3125,,
16038155376,1512.79002,17442831376,1524474995,17442828248,-3128,,
16038205875,1512.84052,17442881878,1524525492,17442878745,-3133,,
16038256892,1512.89154,17442932898,1524576506,17442929759,-3139,,
16038307555,1512.94220,17442983563,1524627166,17442980419,-3144,,
16038358145,1512.99279,17443034154,1524677753,17443031006,-3148,,
16038408315,1513.04296,17443084328,1524727921,17443081174,-3154,,
16038459386,1513.09403,17443135401,1524778989,17443132242,-3159,,
16038509986,1513.14463,17443186003,1524829586,17443182839,-3164,,
16038560557,1513.19520,17443236576,1524880165,17443233418,-3158,,
16038611589,1513.24624,17443287611,1524931184,17443284437,-3174,,
16038662177,1513.29682,17443338201,1524981770,17443335022,-3179,,
16038712748,1513.34740,17443388774,1525032337,17443385590,-3184,,
16038763337,1513.39799,17443439366,1525082924,17443436177,-3189,,
16038814298,1513.44895,17443490330,1525133882,17443487135,-3195,,
16038864845,1513.49949,17443540879,1525184427,17443537679,-3200,,
16038915338,1513.54999,17443591373,1525234917,17443588170,-3203,,
16038966208,1513.60086,17443642246,1525285784,17443639036,-3210,,
16039016317,1513.65097,17443692358,1525335890,17443689143,-3215,,
16039066909,1513.70156,17443742963,1525386491,17443739744,-3219,,
16039117948,1513.75260,17443793994,1525437517,17443790769,-3225,,
16039168473,1513.80312,17443844521,1525488038,17443841291,-3230,,
16039219050,1513.85370,17443895100,1525538612,17443891865,-3235,,
16039269544,1513.90419,17443945597,1525589104,17443942357,-3240,,
16039320103,1513.95475,17443996158,1525639660,17443992913,-3245,,
16039370703,1514.00535,17444046759,1525690267,17444043520,-3239,,
16039421317,1514.05597,17444097377,1525740868,17444094120,-3257,,
16039471536,1514.10618,17444147598,1525791085,17444144338,-3260,,
16039522483,1514.15713,17444198547,1525842029,17444195282,-3265,,
16039573025,1514.20767,17444249091,1525892568,17444245820,-3271,,
16039623573,1514.25822,17444299642,1525943115,17444296367,-3275,,
16039673634,1514.30828,17444349704,1525993172,17444346424,-3280,,
16039724178,1514.35883,17444400252,1526043713,17444396966,-3286,,
16039774717,1514.40936,17444450792,1526094250,17444447503,-3289,,
16039825785,1514.46043,17444501872,1526145324,17444498576,-3296,,
16039876817,1514.51147,17444552898,1526196344,17444549597,-3301,,
16039926942,1514.56159,17444603025,1526246467,17444599719,-3306,,
16039977985,1514.61263,17444654071,1526297507,17444650760,-3311,,
16040028565,1514.66321,17444704653,1526348084,17444701349,-3304,,
16040079214,1514.71386,17444755303,1526398730,17444751982,-3321,,
16040130226,1514.76487,17444806319,1526449740,17444802993,-3326,,
16040180807,1514.81545,17444856902,1526500318,17444853571,-3331,,
16040231812,1514.86646,17444907909,1526551321,17444904573,-3336,,
16040282410,1514.91706,17444958510,1526601915,17444955168,-3342,,
16040332946,1514.96759,17445009048,1526652450,17445005702,-3346,,
16040383974,1515.01862,17445060079,1526703475,17445056727,-3352,,
16040434543,1515.06919,17445110650,1526754041,17445107293,-3357,,
16040484880,1515.11953,17445161000,1526804387,17445157639,-3361,,
16040535463,1515.17011,17445211575,1526854967,17445208219,-3356,,
16040586408,1515.22106,17445262522,1526905897,17445259150,-3372,,
16040637008,1515.27166,17445313124,1526956495,17445309748,-3376,,
16040688053,1515.32270,17445364171,1527007537,17445360789,-3382,,
16040738611,1515.37326,17445414732,1527058102,17445411355,-3377,,
16040789680,1515.42433,17445465802,1527109158,17445462410,-3392,,
16040840731,1515.47538,17445516857,1527160207,17445513460,-3397,,
16040891306,1515.52595,17445567433,1527210779,17445564031,-3402,,
16040942333,1515.57698,17445618462,1527261803,17445615055,-3407,,
16040992894,1515.62754,17445669026,1527312361,17445665613,-3413,,
16041043460,1515.67811,17445719595,1527362926,17445716178,-3417,,
16041094301,1515.72895,17445770439,1527413764,17445767017,-3422,,
16041145349,1515.78000,17445821489,1527464808,17445818061,-3428,,
16041195944,1515.83059,17445872085,1527515401,17445868653,-3432,,
16041246460,1515.88111,17445922605,1527565915,17445919167,-3438,,
16041297061,1515.93171,17445973208,1527616512,17445969765,-3443,,
16041348047,1515.98269,17446024196,1527667495,17446020747,-3449,,
16041398592,1516.03324,17446074743,1527718038,17446071291,-3452,,
16041449658,1516.08431,17446125811,1527769101,17446122353,-3458,,
16041500205,1516.13485,17446176361,1527819645,17446172898,-3463,,
16041550755,1516.18540,17446226913,1527870193,17446223446,-3467,,
16041601274,1516.23592,17446277435,1527920709,17446273961,-3474,,
16041651848,1516.28650,17446328011,1527971280,17446324532,-3479,,
16041702915,1516.33756,17446379081,1528022344,17446375597,-3484,,
16041753931,1516.38858,17446430098,1528073358,17446426610,-3488,,
16041804498,1516.43915,17446480669,1528123922,17446477175,-3494,,
16041855562,1516.49021,17446531734,1528174983,17446528235,-3499,,
16041906587,1516.54123,17446582762,1528226007,17446579259,-3503,,
16041957149,1516.59180,17446633326,1528276565,17446629817,-3509,,
16042007969,1516.64262,17446684148,1528327382,17446680634,-3514,,
16042058719,1516.69337,17446734900,1528378129,17446731381,-3519,,
16042109816,1516.74446,17446786000,1528429224,17446782476,-3524,,
16042160739,1516.79539,17446836925,1528480144,17446833397,-3528,,
16042211791,1516.84644,17446887980,1528531192,17446884445,-3535,,
16042262856,1516.89750,17446939047,1528582255,17446935507,-3540,,
16042313362,1516.94801,17446989556,1528632759,17446986012,-3544,,
16042363923,1516.99857,17447040120,1528683317,17447036570,-3550,,
16042414489,1517.04914,17447090687,1528733880,17447087132,-3555,,
16042465025,1517.09967,17447141226,1528784414,17447137667,-3559,,
16042516057,1517.15071,17447192260,1528835443,17447188696,-3564,,
16042566134,1517.20078,17447242339,1528885517,17447238769,-3570,,
16042624595,1517.25924,17447300804,1528943976,17447297228,-3576,,
16042675294,1517.30994,17447351504,1528994671,17447347923,-3581,,
16042726571,1517.36122,17447402783,1529045946,17447399198,-3585,,
16042777369,1517.41202,17447453584,1529096741,17447449993,-3591,,
16042827856,1517.46250,17447504074,1529147225,17447500478,-3596,,
16042877993,1517.51264,17447554212,1529197360,17447550612,-3600,,
16042929493,1517.56414,17447605715,1529248856,17447602109,-3606,,
16042980130,1517.61478,17447656355,1529299491,17447652744,-3611,,
16043031169,1517.66582,17447707397,1529350527,17447703780,-3617,,
16043082188,1517.71684,17447758417,1529401544,17447754796,-3621,,
16043132688,1517.76734,17447808920,1529452041,17447805293,-3627,,
16043184045,1517.81869,17447860280,1529503395,17447856648,-3632,,
16043234775,1517.86942,17447911011,1529554122,17447907374,-3637,,
16043285838,1517.92049,17447962077,1529605184,17447958437,-3640,,
16043336854,1517.97150,17448013096,1529656197,17448009449,-3647,,
16043387902,1518.02255,17448064145,1529707240,17448060493,-3652,,
16043438484,1518.07313,17448114731,1529757821,17448111073,-3658,,
16043489079,1518.12373,17448165327,1529808413,17448161666,-3661,,
16043539652,1518.17430,17448215903,1529858983,17448212235,-3668,,
16043590320,1518.22497,17448266574,1529909648,17448262901,-3673,,
16043640943,1518.27559,17448317199,1529960270,17448313522,-3677,,
16043691960,1518.32661,17448368217,1530011283,17448364535,-3682,,
16043742501,1518.37715,17448418762,1530061821,17448415074,-3688,,
16043793558,1518.42821,17448469821,1530112876,17448466129,-3692,,
16043844144,1518.47879,17448520408,1530163458,17448516711,-3697,,
16043895160,1518.52981,17448571428,1530214473,17448567725,-3703,,
16043945750,1518.58040,17448622020,1530265059,17448618312,-3708,,
16043996299,1518.63095,17448672571,1530315607,17448668859,-3712,,
16044046908,1518.68156,17448723183,1530366212,17448719465,-3718,,
16044097431,1518.73208,17448773708,1530416733,17448769985,-3723,,
16044147626,1518.78227,17448823906,1530466926,17448820178,-3728,,
16044198662,1518.83331,17448874943,1530517958,17448871210,-3733,,
16044249682,1518.88433,17448925966,1530568975,17448922228,-3738,,
16044300674,1518.93532,17448976961,1530619964,17448973217,-3744,,
16044351270,1518.98592,17449027559,1530670558,17449023811,-3748,,
16044401412,1519.03606,17449077703,1530720697,17449073950,-3753,,
16044452028,1519.08668,17449128322,1530771311,17449124563,-3759,,
16044503074,1519.13772,17449179370,1530822355,17449175607,-3763,,
16044553913,1519.18856,17449230210,1530873190,17449226443,-3767,,
16044604446,1519.23909,17449280747,1530923720,17449276973,-3774,,
16044655000,1519.28965,17449331303,1530974271,17449327524,-3779,,
16044705511,1519.34016,17449381816,1531024781,17449378033,-3783,,
16044756066,1519.39071,17449432373,1531075332,17449428584,-3789,,
16044806657,1519.44131,17449482966,1531125920,17449479172,-3794,,
16044857243,1519.49189,17449533555,1531176504,17449529756,-3799,,
16044908246,1519.54289,17449584561,1531227505,17449580757,-3804,,
16044958888,1519.59354,17449635204,1531278143,17449631396,-3808,,
16045009402,1519.64405,17449685722,1531328655,17449681908,-3814,,
16045060448,1519.69510,17449736769,1531379698,17449732950,-3819,,
16045111041,1519.74569,17449787364,1531430288,17449783540,-3824,,
16045161586,1519.79623,17449837912,1531480830,17449834082,-3830,,
16045212130,1519.84678,17449888459,1531531373,17449884625,-3834,,
16045262674,1519.89732,17449939005,1531581914,17449935166,-3839,,
16045313259,1519.94791,17449989592,1531632495,17449985748,-3844,,
16045363425,1519.99807,17450039761,1531682659,17450035911,-3850,,
16045413981,1520.04863,17450090319,1531733212,17450086465,-3854,,
16045464263,1520.09891,17450140604,1531783491,17450136744,-3860,,
16045514840,1520.14949,17450191183,1531834067,17450187319,-3864,,
16045564921,1520.19957,17450241266,1531884144,17450237397,-3869,,
16045616221,1520.25087,17450292569,1531935441,17450288694,-3875,,
16045666914,1520.30156,17450343263,1531986131,17450339383,-3880,,
16045719436,1520.35408,17450395789,1532038651,17450391904,-3885,,
16045769967,1520.40461,17450446322,1532089179,17450442431,-3891,,
16045821020,1520.45567,17450497377,1532140230,17450493482,-3895,,
16045871550,1520.50620,17450547909,1532190756,17450544008,-3901,,
16045921627,1520.55627,17450597988,1532240831,17450594083,-3905,,
16045972144,1520.60679,17450648507,1532291344,17450644597,-3910,,
16046022708,1520.65736,17450699074,1532341906,17450695158,-3916,,
16046073750,1520.70840,17450750119,1532392946,17450746199,-3920,,
16046124361,1520.75901,17450800732,1532443555,17450796807,-3925,,
16046175024,1520.80967,17450851398,1532494215,17450847467,-3931,,
16046225574,1520.86022,17450901950,1532544761,17450898014,-3936,,
16046276142,1520.91079,17450952520,1532595328,17450948580,-3940,,
16046326739,1520.96139,17451003120,1532645922,17450999174,-3946,,
16046377787,1521.01244,17451054169,1532696966,17451050219,-3950,,
16046428331,1521.06298,17451104717,1532747509,17451100761,-3956,,
16046478765,1521.11341,17451155153,1532797940,17451151192,-3961,,
16046529347,1521.16400,17451205737,1532848519,17451201771,-3966,,
16046580379,1521.21503,17451256772,1532899547,17451252799,-3973,,
16046631370,1521.26602,17451307765,1532950537,17451303789,-3976,,
16046682424,1521.31707,17451358821,1533001587,17451354840,-3981,,
16046733508,1521.36816,17451409907,1533052668,17451405921,-3986,,
16046783613,1521.41826,17451460015,1533102771,17451456023,-3992,,
16046834182,1521.46883,17451510585,1533153337,17451506589,-3996,,
16046884804,1521.51945,17451561211,1533203957,17451557209,-4002,,
16046935783,1521.57043,17451612192,1533254932,17451608184,-4008,,
16046986832,1521.62148,17451663256,1533305991,17451659244,-4012,,
16047037374,1521.67202,17451713788,1533356518,17451709770,-4018,,
16047087712,1521.72236,17451764128,1533406854,17451760106,-4022,,
16047138248,1521.77290,17451814667,1533457387,17451810640,-4027,,
16047188330,1521.82298,17451864750,1533507466,17451860719,-4031,,
16047238876,1521.87352,17451915299,1533558009,17451911262,-4037,,
16047289182,1521.92383,17451965608,1533608313,17451961566,-4042,,
16047340090,1521.97474,17452016518,1533659218,17452012471,-4047,,
16047390636,1522.02528,17452067066,1533709762,17452063014,-4052,,
16047441255,1522.07590,17452117688,1533760378,17452113630,-4058,,
16047492303,1522.12695,17452168738,1533811423,17452164676,-4062,,
16047542944,1522.17759,17452219381,1533862061,17452215314,-4067,,
16047593538,1522.22819,17452269978,1533912653,17452265905,-4073,,
16047644384,1522.27903,17452320826,1533963496,17452316749,-4077,,
16047695422,1522.33007,17452371866,1534014532,17452367784,-4082,,
16047746000,1522.38065,17452422446,1534065106,17452418359,-4087,,
16047796567,1522.43122,17452473015,1534115670,17452468922,-4093,,
16047847587,1522.48223,17452524038,1534166688,17452519940,-4098,,
16047898147,1522.53280,17452574600,1534217245,17452570497,-4103,,
16047948527,1522.58317,17452624982,1534267622,17452620874,-4108,,
16047999177,1522.63382,17452675636,1534318271,17452671523,-4113,,
16048050220,1522.68487,17452726681,1534369311,17452722563,-4118,,
16048101275,1522.73592,17452777737,1534420362,17452773614,-4123,,
16048151826,1522.78647,17452828291,1534470910,17452824163,-4128,,
16048202665,1522.83731,17452879133,1534521747,17452874999,-4134,,
16048253553,1522.88820,17452930023,1534572633,17452925885,-4138,,
16048304074,1522.93872,17452980547,1534623151,17452976403,-4144,,
16048354642,1522.98929,17453031117,1534673717,17453026969,-4148,,
16048405750,1523.04040,17453082227,1534724821,17453078073,-4154,,
16048455822,1523.09047,17453132302,1534774890,17453128143,-4159,,
16048506406,1523.14105,17453182888,1534825472,17453178724,-4164,,
16048556652,1523.19130,17453233137,1534875715,17453228968,-4169,,
16048607519,1523.24217,17453284006,1534926579,17453279832,-4174,,
16048657973,1523.29262,17453334461,1534977030,17453330282,-4179,,
16048708612,1523.34326,17453385104,1535027667,17453380920,-4184,,
16048759202,1523.39385,17453435695,1535078254,17453431506,-4189,,
16048809784,1523.44443,17453486280,1535128833,17453482086,-4194,,
16048859877,1523.49453,17453536376,1535178924,17453532177,-4199,,
16048910468,1523.54512,17453586968,1535229512,17453582765,-4203,,
16048960598,1523.59525,17453637100,1535279639,17453632891,-4209,,
16049011139,1523.64579,17453687644,1535330177,17453683429,-4215,,
16049061779,1523.69643,17453738286,1535380815,17453734068,-4218,,
16049112368,1523.74702,17453788878,1535431401,17453784654,-4224,,
16049164463,1523.79911,17453840975,1535483493,17453836745,-4230,,
16049215254,1523.84990,17453891768,1535534282,17453887534,-4234,,
16049266283,1523.90093,17453942800,1535585308,17453938560,-4240,,
16049316812,1523.95146,17453993332,1535635834,17453989087,-4245,,
16049367443,1524.00209,17454043964,1535686462,17454039714,-4250,,
16049417978,1524.05263,17454094503,1535736996,17454090249,-4254,,
16049468490,1524.10314,17454145017,1535787505,17454140758,-4259,,
16049519045,1524.15369,17454195574,1535838056,17454191309,-4265,,
16049569863,1524.20451,17454246395,1535888872,17454242125,-4270,,
16049620391,1524.25504,17454296925,1535939398,17454292650,-4275,,
16049670961,1524.30561,17454347497,1535989964,17454343217,-4280,,
16049721491,1524.35614,17454398030,1536040491,17454393744,-4286,,
16049772033,1524.40668,17454448574,1536091031,17454444284,-4290,,
16049822643,1524.45729,17454499186,1536141639,17454494891,-4295,,
16049873639,1524.50829,17454550185,1536192632,17454545884,-4301,,
16049924684,1524.55933,17454601232,1536243674,17454596926,-4306,,
16049976250,1524.61090,17454652801,1536295238,17454648490,-4311,,
16050026794,1524.66144,17454703347,1536345778,17454699031,-4316,,
16050077381,1524.71203,17454753935,1536396362,17454749614,-4321,,
16050127930,1524.76258,17454804487,1536446909,17454800161,-4326,,
16050178952,1524.81360,17454855511,1536497928,17454851180,-4331,,
16050230007,1524.86466,17454906569,1536548980,17454902233,-4336,,
16050280528,1524.91518,17454957093,1536599500,17454952752,-4341,,
16050330604,1524.96525,17455007171,1536649572,17455002825,-4346,,
16050381638,1525.01629,17455058206,1536700603,17455053855,-4351,,
16050431699,1525.06635,17455108271,1536750661,17455103914,-4357,,
16050482782,1525.11743,17455159356,1536801743,17455154995,-4361,,
16050533828,1525.16848,17455210404,1536852786,17455206038,-4366,,
16050584343,1525.21899,17455260922,1536903298,17455256550,-4372,,
16050634879,1525.26953,17455311459,1536953831,17455307083,-4376,,
16050684941,1525.31959,17455361525,1537003891,17455357143,-4382,,
16050736041,1525.37069,17455412627,1537054987,17455408240,-4387,,
16050787017,1525.42167,17455463605,1537105961,17455459213,-4392,,
16050838066,1525.47271,17455514657,1537157007,17455510260,-4397,,
16050889114,1525.52376,17455565707,1537208052,17455561305,-4402,,
16050940164,1525.57481,17455616758,1537259099,17455612351,-4407,,
16050991212,1525.62586,17455667810,1537310145,17455663398,-4412,,
16051042260,1525.67691,17455718859,1537361190,17455714442,-4417,,
16051093270,1525.72792,17455769871,1537412197,17455765449,-4422,,
16051144333,1525.77898,17455820938,1537463258,17455816510,-4428,,
16051195397,1525.83004,17455872004,1537514320,17455867572,-4432,,
16051246458,1525.88111,17455923068,1537565377,17455918629,-4439,,
16051297008,1525.93166,17455973619,1537615924,17455969176,-4443,,
16051347568,1525.98222,17456024182,1537666481,17456019734,-4448,,
16051398120,1526.03277,17456074736,1537717031,17456070283,-4453,,
16051448673,1526.08332,17456125291,1537767581,17456120833,-4458,,
16051499302,1526.13395,17456175923,1537818207,17456171460,-4463,,
16051549449,1526.18410,17456226073,1537868352,17456221605,-4468,,
16051600338,1526.23499,17456276964,1537919238,17456272491,-4473,,
16051650454,1526.28510,17456327091,1537969361,17456322614,-4477,,
16051701016,1526.33566,17456377646,1538019911,17456373163,-4483,,
16051751563,1526.38621,17456428196,1538070455,17456423708,-4488,,
16051802115,1526.43676,17456478750,1538121004,17456474257,-4493,,
16051852656,1526.48730,17456529294,1538171542,17456524795,-4499,,
16051903711,1526.53836,17456580351,1538222596,17456575848,-4503,,
16051954691,1526.58934,17456631333,1538273572,17456626824,-4509,,
16052005220,1526.63987,17456681865,1538324098,17456677351,-4514,,
16052055836,1526.69048,17456732483,1538374713,17456727965,-4518,,
16052106825,1526.74147,17456783474,1538425698,17456778950,-4524,,
16052157410,1526.79206,17456834062,1538476280,17456829533,-4529,,
16052207991,1526.84264,17456884645,1538526859,17456880111,-4534,,
16052258621,1526.89327,17456935277,1538577486,17456930738,-4539,,
16052308749,1526.94340,17456985408,1538627611,17456980864,-4544,,
16052359115,1526.99376,17457035776,1538677974,17457031227,-4549,,
16052409254,1527.04390,17457085917,1538728121,17457081373,-4544,,
16052460110,1527.09476,17457136776,1538778964,17457132216,-4560,,
16052510554,1527.14520,17457187221,1538829405,17457182657,-4564,,
16052561102,1527.19575,17457237773,1538879952,17457233204,-4569,,
16052611792,1527.24644,17457288465,1538930638,17457283891,-4574,,
16052661859,1527.29651,17457338544,1538980713,17457333965,-4579,,
16052712917,1527.34757,17457389596,1539031758,17457385010,-4586,,
16052763975,1527.39862,17457440655,1539082814,17457436066,-4589,,
16052815024,1527.44967,17457491707,1539133860,17457487112,-4595,,
16052866070,1527.50072,17457542755,1539184903,17457538155,-4600,,
16052917121,1527.55177,17457593808,1539235951,17457589203,-4605,,
16052968149,1527.60280,17457644839,1539286976,17457640229,-4610,,
16053018300,1527.65295,17457694991,1539337124,17457690376,-4615,,
16053068849,1527.70350,17457745543,1539387670,17457740922,-4621,,
16053119476,1527.75412,17457796172,1539438295,17457791547,-4625,,
16053170077,1527.80472,17457846775,1539488893,17457842145,-4630,,
16053220666,1527.85531,17457897377,1539539489,17457892742,-4635,,
16053271734,1527.90638,17457948438,1539590544,17457943797,-4641,,
16053322737,1527.95738,17457999443,1539641546,17457994798,-4645,,
16053373284,1528.00793,17458049993,1539692089,17458045342,-4651,,
16053423882,1528.05853,17458100592,1539742684,17458095937,-4655,,
16053474909,1528.10956,17458151622,1539793721,17458146973,-4649,,
16053525456,1528.16010,17458202172,1539844253,17458197505,-4667,,
16053575656,1528.21030,17458252373,1539894450,17458247702,-4671,,
16053626244,1528.26089,17458302964,1539945036,17458298289,-4675,,
16053677303,1528.31195,17458354026,1539996092,17458349345,-4681,,
16053727879,1528.36253,17458404604,1540046666,17458399918,-4686,,
16053778917,1528.41357,17458455644,1540097701,17458450953,-4691,,
16053829465,1528.46411,17458506195,1540148247,17458501499,-4696,,
16053879802,1528.51445,17458556533,1540198580,17458551833,-4700,,
16053930682,1528.56533,17458607415,1540249457,17458602709,-4706,,
16053981731,1528.61638,17458658468,1540300504,17458653757,-4711,,
16054032365,1528.66701,17458709103,1540351135,17458704387,-4716,,
16054083420,1528.71807,17458760161,1540402187,17458755439,-4722,,
16054134468,1528.76912,17458811212,1540453233,17458806485,-4727,,
16054185497,1528.82014,17458862243,1540504259,17458857523,-4720,,
16054236528,1528.87118,17458913277,1540555288,17458908540,-4737,,
16054287412,1528.92206,17458964163,1540606168,17458959421,-4742,,
16054338011,1528.97266,17459014763,1540656764,17459010017,-4746,,
16054388991,1529.02364,17459065747,1540707742,17459060995,-4752,,
16054439575,1529.07422,17459116333,1540758323,17459111576,-4757,,
16054490477,1529.12513,17459167237,1540809223,17459162475,-4762,,
16054541491,1529.17614,17459218253,1540860234,17459213487,-4766,,
16054592028,1529.22668,17459268793,1540910768,17459264021,-4772,,
16054642077,1529.27672,17459318845,1540960814,17459314066,-4779,,
16054692125,1529.32677,17459368894,1541010859,17459364112,-4782,,
16054742161,1529.37681,17459418933,1541060893,17459414145,-4788,,
16054792716,1529.42736,17459469491,1541111445,17459464698,-4793,,
16054843290,1529.47794,17459520067,1541162016,17459515269,-4798,,
16054893859,1529.52851,17459570638,1541212584,17459565837,-4801,,
16054944854,1529.57950,17459621636,1541263575,17459616827,-4809,,
16054995416,1529.63006,17459672200,1541314134,17459667387,-4813,,
16055046470,1529.68112,17459723256,1541365186,17459718439,-4817,,
16055097022,1529.73167,17459773810,1541415735,17459768987,-4823,,
16055147547,1529.78220,17459824338,1541466257,17459819510,-4828,,
16055198621,1529.83327,17459875414,1541517338,17459870591,-4823,,
16055249645,1529.88429,17459926441,1541568350,17459921603,-4838,,
16055300238,1529.93489,17459977036,1541618941,17459972193,-4843,,
16055351229,1529.98588,17460028029,1541669929,17460023181,-4848,,
16055402312,1530.03696,17460079115,1541721010,17460074262,-4853,,
16055453325,1530.08797,17460130130,1541772019,17460125272,-4858,,
16055504292,1530.13894,17460181100,1541822983,17460176236,-4864,,
16055554900,1530.18955,17460231709,1541873588,17460226840,-4869,,
16055605485,1530.24013,17460282296,1541924171,17460277423,-4873,,
16055656284,1530.29093,17460333099,1541974967,17460328220,-4879,,
16055707094,1530.34174,17460383912,1542025776,17460379029,-4883,,
16055758108,1530.39276,17460434927,1542076786,17460430038,-4889,,
16055808168,1530.44282,17460484989,1542126843,17460480095,-4894,,
16055859263,1530.49391,17460536087,1542177936,17460531188,-4899,,
16055909800,1530.54445,17460586626,1542228470,17460581722,-4904,,
16055960534,1530.59518,17460637363,1542279201,17460632454,-4909,,
16056010940,1530.64559,17460687782,1542329615,17460682868,-4914,,
16056062013,1530.69666,17460738847,1542380674,17460733927,-4920,,
16056113080,1530.74773,17460789916,1542431750,17460785003,-4913,,
16056164150,1530.79880,17460840987,1542482806,17460836058,-4929,,
16056215410,1530.85006,17460892250,1542534063,17460887315,-4935,,
16056265762,1530.90041,17460942615,1542584423,17460937675,-4940,,
16056316804,1530.95145,17460993648,1542635452,17460988704,-4944,,
16056367872,1531.00252,17461044719,1542686517,17461039770,-4949,,
16056418935,1531.05358,17461095785,1542737577,17461090830,-4955,,
16056469985,1531.10463,17461146837,1542788624,17461141876,-4961,,
16056520804,1531.15545,17461197659,1542839441,17461192709,-4950,,
16056570998,1531.20565,17461247855,1542889632,17461242885,-4970,,
16056621150,1531.25580,17461298010,1542939781,17461293033,-4977,,
16056671474,1531.30612,17461348336,1542990104,17461343356,-4980,,
16056722465,1531.35711,17461399329,1543041091,17461394343,-4986,,
16056772630,1531.40728,17461449496,1543091263,17461444515,-4981,,
16056823673,1531.45832,17461500541,1543142293,17461495545,-4996,,
16056874224,1531.50887,17461551095,1543192843,17461546106,-4989,,
16056924387,1531.55903,17461601260,1543243002,17461596254,-5006,,
16056974982,1531.60963,17461651858,1543293594,17461646847,-5011,,
16057025118,1531.65977,17461701996,1543343728,17461696981,-5015,,
16057075705,1531.71035,17461752585,1543394312,17461747574,-5011,,
16057126333,1531.76098,17461803216,1543444938,17461798190,-5026,,
16057176710,1531.81136,17461853595,1543495312,17461848565,-5030,,
16057227300,1531.86195,17461904188,1543545899,17461899152,-5036,,
16057278340,1531.91299,17461955229,1543596936,17461950188,-5041,,
16057328882,1531.96353,17462005774,1543647475,17462000728,-5046,,
16057379479,1532.01413,17462056373,1543698070,17462051322,-5051,,
16057430054,1532.06470,17462106951,1543748643,17462101895,-5056,,
16057480635,1532.11528,17462157535,1543799231,17462152484,-5051,,
16057531659,1532.16631,17462208561,1543850243,17462203495,-5066,,
16057581846,1532.21649,17462258750,1543900426,17462253679,-5071,,
16057632915,1532.26756,17462309822,1543951492,17462304745,-5077,,
16057683425,1532.31807,17462360334,1544001999,17462355252,-5082,,
16057734042,1532.36869,17462410953,1544052614,17462405867,-5086,,
16057784601,1532.41925,17462461514,1544103170,17462456422,-5092,,
16057835646,1532.47029,17462512562,1544154212,17462507465,-5097,,
16057886195,1532.52084,17462563113,1544204759,17462558012,-5101,,
16057936778,1532.57143,17462613699,1544255339,17462608603,-5096,,
16057987504,1532.62215,17462664427,1544306062,17462659315,-5112,,
16058038076,1532.67272,17462715001,1544356642,17462709895,-5106,,
16058089113,1532.72376,17462766040,1544407666,17462760918,-5122,,
16058139693,1532.77434,17462816623,1544458243,17462811496,-5127,,
16058190742,1532.82539,17462867675,1544509289,17462862541,-5134,,
16058241330,1532.87598,17462918265,1544559876,17462913128,-5137,,
16058291984,1532.92663,17462968920,1544610526,17462963778,-5142,,
16058343027,1532.97768,17463019966,1544661566,17463014818,-5148,,
16058393671,1533.02832,17463070612,1544712207,17463065460,-5152,,
16058444369,1533.07902,17463121313,1544762903,17463116155,-5158,,
16058495432,1533.13008,17463172379,1544813964,17463167216,-5163,,
16058545573,1533.18022,17463222522,1544864102,17463217354,-5168,,
16058596538,1533.23119,17463273499,1544915074,17463268327,-5172,,
16058647099,1533.28175,17463324052,1544965622,17463318874,-5178,,
16058697211,1533.33186,17463374167,1545015732,17463368984,-5183,,
16058748260,1533.38291,17463425218,1545066778,17463420031,-5187,,
16058798875,1533.43352,17463475836,1545117401,17463470653,-5183,,
16058849505,1533.48415,17463526468,1545168017,17463521270,-5198,,
16058899652,1533.53430,17463576617,1545218161,17463571413,-5204,,
16058950461,1533.58511,17463627429,1545268968,17463622221,-5208,,
16059000788,1533.63544,17463677758,1545319292,17463672545,-5213,,
16059051264,1533.68591,17463728236,1545369765,17463723017,-5219,,
16059101837,1533.73648,17463778812,1545420336,17463773589,-5223,,
16059152433,1533.78708,17463829410,1545470929,17463824182,-5228,,
16059203041,1533.83769,17463880021,1545521534,17463874787,-5234,,
16059254083,1533.88873,17463931065,1545572574,17463925826,-5239,,
16059305132,1533.93978,17463982116,1545623620,17463976873,-5243,,
16059356159,1533.99081,17464033146,1545674644,17464027907,-5239,,
16059407229,1534.04188,17464084218,1545725712,17464078964,-5254,,
16059458278,1534.09293,17464135268,1545776758,17464130010,-5258,,
16059509327,1534.14397,17464186320,1545827804,17464181056,-5264,,
16059560375,1534.19502,17464237371,1545878849,17464232102,-5269,,
16059611423,1534.24607,17464288422,1545929894,17464283147,-5275,,
16059661944,1534.29659,17464338945,1545980413,17464333665,-5280,,
16059712522,1534.34717,17464389525,1546030988,17464384241,-5284,,
16059763538,1534.39819,17464440544,1546082001,17464435254,-5290,,
16059814573,1534.44922,17464491581,1546133033,17464486286,-5295,,
16059864621,1534.49927,17464541630,1546183079,17464536331,-5299,,
16059915169,1534.54982,17464592182,1546233624,17464586876,-5306,,
16059965745,1534.60039,17464642759,1546284207,17464637459,-5300,,
16060016811,1534.65146,17464693828,1546335262,17464688514,-5314,,
16060067860,1534.70251,17464744880,1546386307,17464739560,-5320,,
16060118909,1534.75356,17464795930,1546437353,17464790605,-5325,,
16060169958,1534.80461,17464846983,1546488400,17464841652,-5331,,
16060220487,1534.85514,17464897514,1546538926,17464892178,-5336,,
16060271038,1534.90569,17464948076,1546589484,17464942736,-5340,,
16060322046,1534.95669,17464999077,1546640479,17464993731,-5346,,
16060372650,1535.00730,17465049683,1546691081,17465044333,-5350,,
16060423701,1535.05835,17465100737,1546742129,17465095382,-5355,,
16060474715,1535.10936,17465151754,1546793140,17465146393,-5361,,
16060525147,1535.15980,17465202188,1546843580,17465196832,-5356,,
16060575558,1535.21021,17465252601,1546893978,17465247231,-5370,,
16060625686,1535.26033,17465302732,1546944104,17465297356,-5376,,
16060676158,1535.31081,17465353215,1546994582,17465347834,-5381,,
16060726268,1535.36092,17465403318,1547044691,17465397943,-5375,,
16060776896,1535.41154,17465453948,1547095305,17465448557,-5391,,
16060827068,1535.46172,17465504123,1547145475,17465498727,-5396,,
16060877755,1535.51240,17465554812,1547196160,17465549412,-5400,,
16060927895,1535.56254,17465604955,1547246296,17465599549,-5406,,
16060978488,1535.61314,17465655550,1547296886,17465650139,-5411,,
16061029541,1535.66419,17465706606,1547347936,17465701189,-5417,,
16061080273,1535.71492,17465757340,1547398666,17465751919,-5421,,
16061131171,1535.76582,17465808240,1547449561,17465802814,-5426,,
16061182218,1535.81687,17465859290,1547500606,17465853858,-5432,,
16061232840,1535.86749,17465909913,1547551225,17465904478,-5435,,
16061283376,1535.91802,17465960452,1547601758,17465955011,-5441,,
16061333520,1535.96817,17466010599,1547651899,17466005152,-5447,,
16061383622,1536.01827,17466060703,1547701999,17466055252,-5451,,
16061434695,1536.06934,17466111778,1547753070,17466106322,-5456,,
16061485260,1536.11991,17466162345,1547803631,17466156883,-5462,,
16061535869,1536.17052,17466212956,1547854237,17466207489,-5467,,
16061586445,1536.22109,17466263545,1547904821,17466258073,-5472,,
16061637024,1536.27167,17466314116,1547955387,17466308640,-5476,,
16061687676,1536.32232,17466364770,1548006036,17466359288,-5482,,
16061738253,1536.37290,17466415350,1548056621,17466409874,-5476,,
16061788825,1536.42347,17466465925,1548107180,17466460433,-5492,,
16061839867,1536.47452,17466516969,1548158220,17466511472,-5497,,
16061890415,1536.52506,17466567520,1548208764,17466562016,-5504,,
16061940989,1536.57564,17466618096,1548259336,17466612589,-5507,,
16061992074,1536.62672,17466669182,1548310418,17466663670,-5512,,
16062042689,1536.67734,17466719800,1548361030,17466714282,-5518,,
16062092845,1536.72749,17466769958,1548411184,17466764436,-5522,,
16062143388,1536.77804,17466820504,1548461724,17466814977,-5527,,
16062193977,1536.82863,17466871096,1548512310,17466865563,-5533,,
16062244958,1536.87961,17466922079,1548563288,17466916541,-5538,,
16062295995,1536.93064,17466973128,1548614334,17466967586,-5542,,
16062346631,1536.98128,17467023756,1548664955,17467018208,-5548,,
16062397623,1537.03227,17467074750,1548715945,17467069198,-5552,,
16062448671,1537.08332,17467125802,1548766991,17467120243,-5559,,
16062499022,1537.13367,17467176155,1548817340,17467170592,-5563,,
16062549659,1537.18431,17467226794,1548867973,17467221226,-5568,,
16062600242,1537.23489,17467277380,1548918554,17467271816,-5564,,
16062650838,1537.28549,17467327978,1548969147,17467322400,-5578,,
16062701625,1537.33627,17467378767,1549019932,17467373184,-5583,,
16062752046,1537.38669,17467429190,1549070348,17467423601,-5589,,
16062803095,1537.43774,17467480241,1549121396,17467474648,-5593,,
16062853253,1537.48790,17467530401,1549171551,17467524803,-5598,,
16062903813,1537.53846,17467580965,1549222108,17467575360,-5605,,
16062954417,1537.58906,17467631570,1549272709,17467625961,-5609,,
16063005491,1537.64014,17467682647,1549323781,17467677034,-5613,,
16063056075,1537.69072,17467733245,1549374373,17467727625,-5620,,
16063106653,1537.74130,17467783814,1549424937,17467778190,-5624,,
16063156827,1537.79147,17467833989,1549475109,17467828361,-5628,,
16063207450,1537.84210,17467884615,1549525729,17467878981,-5634,,
16063258266,1537.89291,17467935434,1549576543,17467929795,-5639,,
16063308917,1537.94357,17467986088,1549627191,17467980444,-5644,,
16063359502,1537.99415,17468036674,1549677773,17468031025,-5649,,
16063410552,1538.04520,17468087727,1549728821,17468082073,-5654,,
16063461602,1538.09625,17468138780,1549779867,17468133120,-5660,,
16063512608,1538.14726,17468189799,1549830883,17468184136,-5663,,
16063563701,1538.19835,17468240883,1549881962,17468235214,-5669,,
16063614703,1538.24935,17468291888,1549932961,17468286213,-5675,,
16063665764,1538.30041,17468342950,1549984018,17468337271,-5679,,
16063716843,1538.35149,17468394032,1550035095,17468388347,-5685,,
16063767904,1538.40255,17468445096,1550086154,17468439406,-5690,,
16063818897,1538.45355,17468496090,1550137143,17468490395,-5695,,
16063869454,1538.50410,17468546651,1550187699,17468540951,-5700,,
16063920041,1538.55469,17468597240,1550238282,17468591535,-5705,,
16063971095,1538.60574,17468648296,1550289333,17468642586,-5710,,
16064021745,1538.65639,17468698949,1550339981,17468693233,-5716,,
16064072364,1538.70701,17468749569,1550390597,17468743849,-5720,,
16064122670,1538.75732,17468799878,1550440900,17468794163,-5715,,
16064173080,1538.80773,17468850291,1550491307,17468844560,-5731,,
16064223467,1538.85811,17468900680,1550541693,17468894945,-5735,,
16064274517,1538.90917,17468951732,1550592740,17468945992,-5740,,
16064325567,1538.96022,17469002785,1550643787,17468997039,-5746,,
16064376142,1539.01079,17469053362,1550694358,17469047611,-5751,,
16064427202,1539.06185,17469104425,1550745417,17469098670,-5755,,
16064478255,1539.11290,17469155480,1550796467,17469149719,-5761,,
16064528876,1539.16352,17469206102,1550847084,17469200336,-5766,,
16064579464,1539.21411,17469256694,1550897671,17469250923,-5771,,
16064630512,1539.26516,17469307743,1550948715,17469301968,-5775,,
16064680886,1539.31553,17469358120,1550999086,17469352339,-5781,,
16064731484,1539.36613,17469408720,1551049691,17469402943,-5777,,
16064782552,1539.41720,17469459791,1551100747,17469453999,-5792,,
16064833618,1539.46827,17469510859,1551151811,17469505063,-5796,,
16064884036,1539.51868,17469561279,1551202225,17469555478,-5801,,
16064934679,1539.56933,17469611925,1551252866,17469606119,-5806,,
16064985390,1539.62004,17469662637,1551303574,17469656826,-5811,,
16065035953,1539.67060,17469713203,1551354134,17469707386,-5817,,
16065086270,1539.72092,17469763523,1551404449,17469757701,-5822,,
16065137273,1539.77192,17469814528,1551455449,17469808702,-5826,,
16065188333,1539.82298,17469865590,1551506506,17469859759,-5831,,
16065238434,1539.87308,17469915704,1551556615,17469909867,-5837,,
16065289458,1539.92411,17469966720,1551607626,17469960879,-5841,,
16065340034,1539.97468,17470017298,1551658199,17470011451,-5847,,
16065390811,1540.02546,17470068077,1551708973,17470062225,-5852,,
16065441403,1540.07605,17470118683,1551759573,17470112826,-5857,,
16065492466,1540.12711,17470169737,1551810623,17470163875,-5862,,
16065543523,1540.17817,17470220797,1551861677,17470214930,-5867,,
16065594090,1540.22874,17470271367,1551912242,17470265494,-5873,,
16065645118,1540.27977,17470322397,1551963267,17470316520,-5877,,
16065696090,1540.33074,17470373371,1552014236,17470367489,-5882,,
16065746717,1540.38136,17470424000,1552064860,17470418112,-5888,,
16065797297,1540.43195,17470474583,1552115438,17470468690,-5893,,
16065847862,1540.48251,17470525150,1552166000,17470519252,-5898,,
16065898897,1540.53355,17470576187,1552217032,17470570284,-5903,,
16065949453,1540.58410,17470626750,1552267589,17470620842,-5908,,
16066000032,1540.63468,17470677327,1552318162,17470671415,-5912,,
16066050179,1540.68483,17470727477,1552368306,17470721559,-5918,,
16066100640,1540.73529,17470777940,1552418765,17470772017,-5923,,
16066151679,1540.78633,17470828982,1552469800,17470823053,-5929,,
16066202678,1540.83733,17470879982,1552520797,17470874049,-5933,,
16066253275,1540.88792,17470930582,1552571392,17470924644,-5938,,
16066304300,1540.93895,17470981610,1552622413,17470975665,-5945,,
16066355334,1540.98998,17471032645,1552673445,17471026697,-5948,,
16066405390,1541.04004,17471082705,1552723499,17471076751,-5954,,
16066455592,1541.09024,17471132909,1552773697,17471126950,-5959,,
16066506606,1541.14125,17471183925,1552824708,17471177961,-5964,,
16066556671,1541.19132,17471233992,1552874771,17471228024,-5968,,
16066607057,1541.24170,17471284380,1552925154,17471278406,-5974,,
16066658087,1541.29273,17471335412,1552976181,17471329433,-5979,,
16066708474,1541.34312,17471385803,1553026566,17471379819,-5984,,
16066759519,1541.39417,17471436849,1553077608,17471430860,-5989,,
16066810543,1541.44519,17471487875,1553128629,17471481881,-5994,,
16066861089,1541.49574,17471538425,1553179172,17471532425,-6000,,
16066912141,1541.54679,17471589478,1553230222,17471583474,-6004,,
16066963190,1541.59784,17471640530,1553281269,17471634521,-6009,,
16067014249,1541.64890,17471691592,1553332324,17471685577,-6015,,
16067064835,1541.69948,17471742179,1553382908,17471736160,-6019,,
16067115847,1541.75050,17471793195,1553433917,17471787170,-6025,,
16067166631,1541.80128,17471843981,1553484699,17471837951,-6030,,
16067217340,1541.85199,17471894692,1553535404,17471888657,-6035,,
16067267841,1541.90249,17471945196,1553585904,17471939156,-6040,,
16067318243,1541.95289,17471995600,1553636303,17471989555,-6045,,
16067368358,1542.00301,17472045717,1553686414,17472039666,-6051,,
16067419426,1542.05407,17472096788,1553737481,17472090733,-6055,,
16067470295,1542.10494,17472147659,1553788347,17472141599,-6060,,
16067520859,1542.15551,17472198225,1553838907,17472192160,-6065,,
16067571949,1542.20660,17472249318,1553889995,17472243247,-6071,,
16067622958,1542.25761,17472300329,1553941001,17472294254,-6075,,
16067673378,1542.30803,17472350751,1553991418,17472344671,-6080,,
16067723867,1542.35851,17472401243,1554041904,17472395156,-6087,,
16067774443,1542.40909,17472451820,1554092478,17472445731,-6089,,
16067824982,1542.45963,17472502363,1554143015,17472496267,-6096,,
16067876018,1542.51067,17472553401,1554194047,17472547300,-6101,,
16067926060,1542.56071,17472603444,1554244086,17472597338,-6106,,
16067976173,1542.61082,17472653561,1554294197,17472647450,-6111,,
16068027068,1542.66172,17472704458,1554345090,17472698342,-6116,,
16068077693,1542.71234,17472755085,1554395711,17472748964,-6121,,
16068128315,1542.76296,17472805710,1554446331,17472799583,-6127,,
16068178936,1542.81358,17472856332,1554496949,17472850202,-6130,,
16068229465,1542.86411,17472906864,1554547476,17472900728,-6136,,
16068280019,1542.91467,17472957421,1554598028,17472951280,-6141,,
16068330586,1542.96523,17473008001,1554648603,17473001856,-6145,,
16068381624,1543.01627,17473059030,1554699627,17473052879,-6151,,
16068431731,1543.06638,17473109140,1554749731,17473102983,-6157,,
16068482288,1543.11694,17473159699,1554800286,17473153538,-6161,,
16068532462,1543.16711,17473209875,1554850456,17473203709,-6166,,
16068583119,1543.21777,17473260535,1554901111,17473254363,-6172,,
16068633199,1543.26785,17473310617,1554951189,17473304441,-6176,,
16068684185,1543.31883,17473361604,1555002171,17473355423,-6181,,
16068734408,1543.36906,17473411830,1555052391,17473405644,-6186,,
16068784998,1543.41965,17473462422,1555102979,17473456231,-6191,,
16068836026,1543.47067,17473513463,1555154014,17473507266,-6197,,
16068886697,1543.52135,17473564126,1555204672,17473557924,-6202,,
16068937749,1543.57240,17473615181,1555255721,17473608973,-6208,,
16068988794,1543.62344,17473666228,1555306764,17473660016,-6212,,
16069039843,1543.67449,17473717280,1555357810,17473711062,-6218,,
16069090871,1543.72552,17473768309,1555408835,17473762087,-6222,,
16069141942,1543.77659,17473819383,1555459903,17473813155,-6228,,
16069192989,1543.82764,17473870433,1555510948,17473864201,-6232,,
16069243999,1543.87865,17473921446,1555561955,17473915208,-6238,,
16069294543,1543.92919,17473971992,1555612497,17473965749,-6243,,
16069345139,1543.97979,17474022590,1555663091,17474016343,-6247,,
16069396137,1544.03078,17474073591,1555714085,17474067338,-6253,,
16069446736,1544.08138,17474124191,1555764681,17474117934,-6257,,
16069497781,1544.13243,17474175239,1555815723,17474168976,-6263,,
16069548316,1544.18296,17474225776,1555866255,17474219508,-6268,,
16069598364,1544.23301,17474275827,1555916302,17474269554,-6273,,
16069649413,1544.28406,17474326878,1555967347,17474320600,-6278,,
16069700470,1544.33512,17474377938,1556018402,17474371655,-6283,,
16069751009,1544.38566,17474428479,1556068939,17474422191,-6288,,
16069801058,1544.43571,17474478530,1556118984,17474472236,-6294,,
16069851119,1544.48577,17474528594,1556169043,17474522296,-6298,,
16069902169,1544.53682,17474579646,1556220090,17474573342,-6304,,
16069953203,1544.58785,17474630682,1556271122,17474624374,-6308,,
16070003265,1544.63791,17474680747,1556321180,17474674433,-6314,,
16070053799,1544.68845,17474731282,1556371711,17474724964,-6318,,
16070104392,1544.73904,17474781879,1556422302,17474775555,-6324,,
16070155440,1544.79009,17474832929,1556473347,17474826599,-6330,,
16070206489,1544.84114,17474883979,1556524393,17474877645,-6334,,
16070257538,1544.89219,17474935032,1556575440,17474928692,-6340,,
16070308584,1544.94323,17474986080,1556626483,17474979735,-6345,,
16070359193,1544.99384,17475036701,1556677100,17475030352,-6349,,
16070409954,1545.04460,17475087454,1556727848,17475081100,-6354,,
16070460576,1545.09522,17475138079,1556778468,17475131721,-6358,,
16070510887,1545.14554,17475188392,1556828775,17475182028,-6364,,
16070561671,1545.19632,17475239179,1556879556,17475232809,-6370,,
16070611982,1545.24663,17475289492,1556929865,17475283129,-6363,,
16070663078,1545.29773,17475340590,1556980958,17475334211,-6379,,
16070714083,1545.34873,17475391598,1557031960,17475385213,-6385,,
16070764819,1545.39947,17475442336,1557082695,17475435947,-6389,,
16070815845,1545.45049,17475493365,1557133717,17475486980,-6385,,
16070866913,1545.50156,17475544435,1557184783,17475538035,-6400,,
16070917675,1545.55232,17475595199,1557235542,17475588794,-6405,,
16070968286,1545.60293,17475645813,1557286151,17475639403,-6410,,
16071018777,1545.65342,17475696305,1557336638,17475689890,-6415,,
16071069509,1545.70416,17475747040,1557387367,17475740620,-6420,,
16071119598,1545.75425,17475797132,1557437454,17475790707,-6425,,
16071170237,1545.80489,17475847772,1557488090,17475841342,-6430,,
16071220435,1545.85508,17475897972,1557538285,17475891549,-6423,,
16071270953,1545.90560,17475948493,1557588801,17475942053,-6440,,
16071321996,1545.95664,17475999539,1557639842,17475993094,-6445,,
16071372557,1546.00721,17476050102,1557690409,17476043662,-6440,,
16071423093,1546.05774,17476100641,1557740932,17476094185,-6456,,
16071473242,1546.10789,17476150791,1557791079,17476144331,-6460,,
16071523394,1546.15804,17476200957,1557841239,17476194492,-6465,,
16071573972,1546.20862,17476251527,1557891803,17476245056,-6471,,
16071625020,1546.25967,17476302576,1557942849,17476296101,-6475,,
16071675631,1546.31028,17476353190,1557993457,17476346709,-6481,,
16071726573,1546.36122,17476404135,1558044396,17476397648,-6487,,
16071777205,1546.41185,17476454768,1558095025,17476448277,-6491,,
16071828279,1546.46293,17476505845,1558146097,17476499349,-6496,,
16071879277,1546.51392,17476556845,1558197092,17476550344,-6501,,
16071929340,1546.56399,17476606910,1558247152,17476600404,-6506,,
16071979924,1546.61457,17476657498,1558297735,17476650987,-6511,,
16072030514,1546.66516,17476708090,1558348321,17476701574,-6516,,
16072081520,1546.71617,17476759097,1558399324,17476752576,-6521,,
16072131582,1546.76623,17476809163,1558449383,17476802636,-6527,,
16072182130,1546.81678,17476859712,1558499929,17476853181,-6531,,
16072233230,1546.86788,17476910816,1558551026,17476904279,-6537,,
16072283786,1546.91843,17476961374,1558601579,17476954831,-6543,,
16072334335,1546.96898,17477011924,1558652126,17477005378,-6546,,
16072384883,1547.01953,17477062475,1558702671,17477055923,-6552,,
16072435948,1547.07060,17477113542,1558753733,17477106985,-6557,,
16072486513,1547.12116,17477164110,1558804297,17477157549,-6561,,
16072537460,1547.17211,17477215060,1558855240,17477208493,-6567,,
16072588521,1547.22317,17477266123,1558906298,17477259550,-6573,,
16072639298,1547.27395,17477316902,1558957072,17477310324,-6578,,
16072689799,1547.32445,17477367405,1559007571,17477360823,-6582,,
16072740798,1547.37545,17477418406,1559058566,17477411819,-6587,,
16072791054,1547.42570,17477468665,1559108820,17477462073,-6592,,
16072841486,1547.47613,17477519099,1559159250,17477512502,-6597,,
16072892052,1547.52670,17477569668,1559209813,17477563066,-6602,,
16072942626,1547.57727,17477620255,1559260396,17477613648,-6607,,
16072993235,1547.62788,17477670855,1559311000,17477664252,-6603,,
16073043831,1547.67848,17477721454,1559361585,17477714837,-6617,,
16073094389,1547.72904,17477772015,1559412139,17477765392,-6623,,
16073145328,1547.77998,17477822956,1559463076,17477816328,-6628,,
16073196361,1547.83101,17477873990,1559514106,17477867358,-6632,,
16073246890,1547.88154,17477924523,1559564632,17477917885,-6638,,
16073297346,1547.93199,17477974980,1559615085,17477968337,-6643,,
16073347898,1547.98255,17478025535,1559665634,17478018887,-6648,,
16073398069,1548.03272,17478075709,1559715803,17478069056,-6653,,
16073448257,1548.08290,17478125899,1559765988,17478119241,-6658,,
16073498876,1548.13352,17478176519,1559816604,17478169856,-6663,,
16073549683,1548.18433,17478227330,1559867409,17478220662,-6668,,
16073600731,1548.23538,17478278380,1559918454,17478271707,-6673,,
16073651291,1548.28594,17478328942,1559969021,17478322274,-6668,,
16073702296,1548.33694,17478379950,1560020013,17478373266,-6684,,
16073752469,1548.38712,17478430125,1560070184,17478423446,-6679,,
16073803560,1548.43821,17478481219,1560121273,17478474525,-6694,,
16073854036,1548.48868,17478531697,1560171745,17478524998,-6699,,
16073904586,1548.53923,17478582249,1560222293,17478575546,-6703,,
16073955133,1548.58978,17478632799,1560272838,17478626090,-6709,,
16074005678,1548.64033,17478683345,1560323379,17478676631,-6714,,
16074056733,1548.69138,17478734403,1560374432,17478727684,-6719,,
16074107784,1548.74243,17478785456,1560425480,17478778732,-6724,,
16074158315,1548.79296,17478835989,1560476008,17478829260,-6729,,
16074208886,1548.84353,17478886563,1560526576,17478879828,-6735,,
16074259934,1548.89458,17478937613,1560577622,17478930875,-6738,,
16074310463,1548.94511,17478988144,1560628148,17478981400,-6744,,
16074361010,1548.99566,17479038694,1560678693,17479031946,-6748,,
16074411581,1549.04623,17479089268,1560729262,17479082514,-6754,,
16074462158,1549.09681,17479139846,1560779835,17479133087,-6759,,
16074512721,1549.14737,17479190412,1560830395,17479183648,-6764,,
16074563298,1549.19795,17479240992,1560880970,17479234222,-6770,,
16074613854,1549.24850,17479291549,1560931523,17479284776,-6773,,
16074664507,1549.29915,17479342206,1560982173,17479335426,-6780,,
16074715044,1549.34969,17479392745,1561032707,17479385960,-6785,,
16074766105,1549.40075,17479443808,1561083767,17479437019,-6789,,
16074816380,1549.45103,17479494086,1561134049,17479487302,-6784,,
16074867449,1549.50210,17479545156,1561185104,17479538357,-6799,,
16074918505,1549.55315,17479596215,1561236157,17479589410,-6805,,
16074969553,1549.60420,17479647266,1561287204,17479640456,-6810,,
16075020170,1549.65482,17479697885,1561337817,17479691070,-6815,,
16075071250,1549.70590,17479748967,1561388895,17479742147,-6820,,
16075121513,1549.75616,17479799233,1561439156,17479792408,-6825,,
16075172038,1549.80669,17479849760,1561489678,17479842930,-6830,,
16075222631,1549.85728,17479900356,1561540267,17479893520,-6836,,
16075272746,1549.90739,17479950473,1561590380,17479943632,-6841,,
16075323349,1549.95800,17480001078,1561640981,17479994233,-6845,,
16075373896,1550.00854,17480051627,1561691524,17480044776,-6851,,
16075424539,1550.05919,17480102273,1561742164,17480095417,-6856,,
16075475551,1550.11020,17480153287,1561793174,17480146427,-6860,,
16075525683,1550.16033,17480203432,1561843313,17480196566,-6866,,
16075576727,1550.21138,17480254467,1561894344,17480247596,-6871,,
16075627765,1550.26241,17480305508,1561945379,17480298632,-6876,,
16075678310,1550.31296,17480356056,1561995922,17480349175,-6881,,
16075728398,1550.36305,17480406145,1562046007,17480399260,-6885,,
16075778918,1550.41357,17480456667,1562096524,17480449776,-6891,,
16075829502,1550.46415,17480507255,1562147106,17480500359,-6896,,
16075879965,1550.51461,17480557719,1562197566,17480550819,-6900,,
16075930513,1550.56516,17480608270,1562248111,17480601364,-6906,,
16075980561,1550.61521,17480658320,1562298157,17480651410,-6910,,
16076031657,1550.66630,17480709418,1562349250,17480702503,-6915,,
16076082204,1550.71685,17480759967,1562399794,17480753046,-6921,,
16076133252,1550.76790,17480811019,1562450839,17480804092,-6927,,
16076184304,1550.81895,17480862072,1562501889,17480855141,-6931,,
16076235353,1550.87000,17480913124,1562552935,17480906187,-6937,,
16076286381,1550.92103,17480964154,1562603960,17480957212,-6942,,
16076337372,1550.97202,17481015147,1562654959,17481008211,-6936,,
16076388397,1551.02304,17481066176,1562705971,17481059224,-6952,,
16076439349,1551.07400,17481117130,1562756920,17481110172,-6958,,
16076490376,1551.12502,17481168158,1562807944,17481161196,-6962,,
16076541002,1551.17565,17481218788,1562858569,17481211821,-6967,,
16076591424,1551.22607,17481269212,1562908988,17481262240,-6972,,
16076641974,1551.27662,17481319776,1562959545,17481312798,-6978,,
16076692567,1551.32722,17481370360,1563010124,17481363376,-6984,,
16076743155,1551.37780,17481420950,1563060711,17481413963,-6987,,
16076793707,1551.42836,17481471504,1563111259,17481464511,-6993,,
16076843814,1551.47846,17481521614,1563161363,17481514616,-6998,,
16076894817,1551.52947,17481572619,1563212364,17481565616,-7003,,
16076945896,1551.58054,17481623701,1563263441,17481616693,-7008,,
16076997347,1551.63199,17481675153,1563314888,17481668141,-7012,,
16077048021,1551.68267,17481725830,1563365559,17481718812,-7018,,
16077098841,1551.73349,17481776653,1563416377,17481769629,-7024,,
16077149447,1551.78409,17481827261,1563466981,17481820233,-7028,,
16077200468,1551.83512,17481878284,1563517999,17481871251,-7033,,
16077251513,1551.88616,17481929332,1563569041,17481922294,-7038,,
16077302539,1551.93719,17481980360,1563620064,17481973317,-7043,,
16077353643,1551.98829,17482031467,1563671165,17482024418,-7049,,
16077404453,1552.03910,17482082279,1563721972,17482075225,-7054,,
16077455128,1552.08978,17482132955,1563772645,17482125898,-7057,,
16077505675,1552.14032,17482183506,1563823190,17482176442,-7064,,
16077556234,1552.19088,17482234067,1563873745,17482226998,-7069,,
16077607249,1552.24190,17482285083,1563924758,17482278010,-7073,,
16077658331,1552.29298,17482336168,1563975837,17482329090,-7078,,
16077709359,1552.34401,17482387199,1564026862,17482380115,-7084,,
16077759749,1552.39440,17482437591,1564077250,17482430502,-7089,,
16077810823,1552.44547,17482488667,1564128321,17482481573,-7094,,
16077861872,1552.49652,17482539719,1564179367,17482532619,-7100,,
16077912876,1552.54752,17482590726,1564230369,17482583621,-7105,,
16077963424,1552.59807,17482641276,1564280913,17482634166,-7110,,
16078016184,1552.65083,17482694037,1564333671,17482686924,-7113,,
16078067019,1552.70167,17482744875,1564384503,17482737755,-7120,,
16078117490,1552.75214,17482795348,1564434971,17482788223,-7125,,
16078168044,1552.80269,17482845917,1564485536,17482838788,-7129,,
16078218649,1552.85330,17482896513,1564536137,17482889389,-7124,,
16078268761,1552.90341,17482946627,1564586234,17482939486,-7141,,
16078319792,1552.95444,17482997660,1564637262,17482990514,-7146,,
16078370315,1553.00496,17483048185,1564687783,17483041035,-7150,,
16078420483,1553.05513,17483098355,1564737948,17483091200,-7155,,
16078471556,1553.10620,17483149431,1564789018,17483142270,-7161,,
16078522108,1553.15676,17483199986,1564839569,17483192821,-7165,,
16078573156,1553.20780,17483251036,1564890613,17483243866,-7170,,
16078624167,1553.25881,17483302049,1564941621,17483294873,-7176,,
16078674773,1553.30942,17483352657,1564992224,17483345476,-7181,,
16078725250,1553.35990,17483403137,1565042699,17483395951,-7186,,
16078776279,1553.41093,17483454169,1565093725,17483446978,-7191,,
16078826354,1553.46100,17483504245,1565143797,17483497049,-7196,,
16078876955,1553.51160,17483554849,1565194397,17483547650,-7199,,
16078927860,1553.56251,17483605756,1565245298,17483598550,-7206,,
16078978916,1553.61356,17483656815,1565296351,17483649604,-7211,,
16079029972,1553.66462,17483707873,1565347404,17483700656,-7217,,
16079080547,1553.71519,17483758451,1565397978,17483751230,-7221,,
16079131540,1553.76619,17483809446,1565448968,17483802220,-7226,,
16079182130,1553.81678,17483860039,1565499555,17483852807,-7232,,
16079233211,1553.86786,17483911122,1565550633,17483903886,-7236,,
16079284233,1553.91888,17483962146,1565601652,17483954904,-7242,,
16079335308,1553.96996,17484013223,1565652724,17484005977,-7246,,
16079385824,1554.02047,17484063742,1565703238,17484056490,-7252,,
16079436362,1554.07101,17484114281,1565753773,17484107026,-7255,,
16079487407,1554.12206,17484165329,1565804815,17484158067,-7262,,
16079538442,1554.17309,17484216367,1565855847,17484209100,-7267,,
16079589031,1554.22368,17484266959,1565906440,17484259693,-7266,,
16079640075,1554.27472,17484318005,1565957476,17484310728,-7277,,
16079690619,1554.32527,17484368550,1566008016,17484361268,-7282,,
16079741187,1554.37584,17484419122,1566058581,17484411834,-7288,,
16079792259,1554.42691,17484470196,1566109651,17484462904,-7292,,
16079843307,1554.47796,17484521246,1566160697,17484513949,-7297,,
16079894314,1554.52896,17484572256,1566211701,17484564953,-7303,,
16079944369,1554.57902,17484622313,1566261753,17484615006,-7307,,
16079994907,1554.62955,17484672852,1566312288,17484665540,-7312,,
16080045475,1554.68012,17484723424,1566362853,17484716105,-7319,,
16080096508,1554.73116,17484774458,1566413883,17484767136,-7322,,
16080146590,1554.78124,17484824543,1566463963,17484817216,-7327,,
16080197188,1554.83184,17484875144,1566514559,17484867811,-7333,,
16080248095,1554.88274,17484926053,1566565462,17484918715,-7338,,
16080298199,1554.93285,17484976160,1566615564,17484968816,-7344,,
16080348342,1554.98299,17485026304,1566665704,17485018956,-7348,,
16080398934,1555.03358,17485076899,1566716293,17485069546,-7353,,
16080449539,1555.08419,17485127507,1566766895,17485120148,-7359,,
16080499712,1555.13436,17485177682,1566817066,17485170319,-7363,,
16080550314,1555.18496,17485228285,1566867665,17485220917,-7368,,
16080601196,1555.23584,17485279171,1566918554,17485271807,-7364,,
16080651737,1555.28639,17485329713,1566969083,17485322336,-7377,,
16080702342,1555.33699,17485380320,1567019685,17485372937,-7383,,
16080752877,1555.38753,17485430859,1567070228,17485423481,-7378,,
16080803942,1555.43859,17485481926,1567121281,17485474533,-7393,,
16080854551,1555.48920,17485532536,1567171886,17485525138,-7398,,
16080905297,1555.53994,17485583285,1567222629,17485575881,-7404,,
16080956344,1555.59099,17485634335,1567273674,17485626926,-7409,,
16081006847,1555.64150,17485684840,1567324174,17485677427,-7413,,
16081057590,1555.69224,17485735586,1567374915,17485728167,-7419,,
16081108026,1555.74267,17485786023,1567425347,17485778599,-7424,,
16081158598,1555.79325,17485836599,1567475918,17485829170,-7429,,
16081209637,1555.84428,17485887640,1567526954,17485880206,-7434,,
16081260183,1555.89483,17485938188,1567577497,17485930749,-7439,,
16081310758,1555.94541,17485988765,1567628068,17485981320,-7445,,
16081361323,1555.99597,17486039332,1567678631,17486031883,-7449,,
16081411904,1556.04655,17486089916,1567729210,17486082462,-7454,,
16081462506,1556.09715,17486140521,1567779818,17486133071,-7450,,
16081513072,1556.14772,17486191089,1567830372,17486183625,-7464,,
16081563338,1556.19799,17486241357,1567880636,17486233888,-7469,,
16081613900,1556.24855,17486291922,1567931194,17486284447,-7475,,
16081664462,1556.29911,17486342485,1567981753,17486335005,-7480,,
16081715003,1556.34965,17486393028,1568032292,17486385545,-7483,,
16081766043,1556.40069,17486444071,1568083329,17486436581,-7490,,
16081816545,1556.45119,17486494576,1568133828,17486487081,-7495,,
16081866973,1556.50162,17486545005,1568184254,17486537506,-7499,,
16081917524,1556.55217,17486595560,1568234802,17486588055,-7505,,
16081968069,1556.60272,17486646107,1568285344,17486638596,-7511,,
16082019122,1556.65377,17486697162,1568336395,17486689648,-7514,,
16082069671,1556.70432,17486747714,1568386942,17486740194,-7520,,
16082120360,1556.75501,17486798405,1568437627,17486790880,-7525,,
16082170919,1556.80557,17486848967,1568488183,17486841436,-7531,,
16082221982,1556.85663,17486900031,1568539244,17486892496,-7535,,
16082272045,1556.90669,17486950097,1568589304,17486942557,-7540,,
16082323101,1556.95775,17487001155,1568640357,17486993609,-7546,,
16082373744,1557.00839,17487051801,1568690998,17487044251,-7550,,
16082424006,1557.05865,17487102064,1568741257,17487094509,-7555,,
16082474565,1557.10921,17487152627,1568791814,17487145066,-7561,,
16082524862,1557.15951,17487202925,1568842107,17487195360,-7565,,
16082574914,1557.20956,17487252980,1568892158,17487245410,-7570,,
16082625501,1557.26015,17487303570,1568942742,17487295994,-7576,,
16082676503,1557.31115,17487354573,1568993740,17487346992,-7581,,
16082727553,1557.36220,17487405626,1569044788,17487398041,-7585,,
16082778207,1557.41286,17487456283,1569095439,17487448692,-7591,,
16082829145,1557.46379,17487507223,1569146374,17487499627,-7596,,
16082880194,1557.51484,17487558275,1569197420,17487550673,-7602,,
16082930311,1557.56496,17487608393,1569247535,17487600787,-7606,,
16082981317,1557.61596,17487659402,1569298539,17487651791,-7611,,
16083032112,1557.66676,17487710200,1569349331,17487702583,-7617,,
16083082712,1557.71736,17487760801,1569399928,17487753180,-7621,,
16083133770,1557.76842,17487811862,1569450983,17487804236,-7626,,
16083184324,1557.81897,17487862418,1569501534,17487854786,-7632,,
16083235382,1557.87003,17487913479,1569552589,17487905842,-7637,,
16083285933,1557.92058,17487964032,1569603139,17487956391,-7641,,
16083336749,1557.97140,17488014851,1569653951,17488007203,-7648,,
16083387289,1558.02194,17488065393,1569704488,17488057741,-7652,,
16083439834,1558.07448,17488117941,1569757032,17488110285,-7656,,
16083490888,1558.12554,17488168996,1569808082,17488161334,-7662,,
16083541426,1558.17607,17488219538,1569858618,17488211871,-7667,,
16083591496,1558.22614,17488269620,1569908694,17488261947,-7673,,
16083642019,1558.27667,17488320135,1569959206,17488312458,-7677,,
16083692567,1558.32722,17488370685,1570009750,17488363003,-7682,,
16083743126,1558.37777,17488421246,1570060306,17488413558,-7688,,
16083793678,1558.42833,17488471800,1570110856,17488464108,-7692,,
16083844728,1558.47938,17488522853,1570161903,17488515156,-7697,,
16083895784,1558.53043,17488573912,1570212957,17488566209,-7703,,
16083946818,1558.58147,17488624948,1570263987,17488617239,-7709,,
16083997417,1558.63207,17488675550,1570314584,17488667837,-7713,,
16084048423,1558.68307,17488726558,1570365588,17488718840,-7718,,
16084099469,1558.73412,17488777606,1570416630,17488769883,-7723,,
16084150549,1558.78520,17488828689,1570467708,17488820960,-7729,,
16084201067,1558.83571,17488879208,1570518223,17488871475,-7733,,
16084251615,1558.88626,17488929759,1570568768,17488922021,-7738,,
16084302651,1558.93730,17488980798,1570619802,17488973054,-7744,,
16084352709,1558.98736,17489030857,1570669857,17489023109,-7748,,
16084403275,1559.03792,17489081426,1570720421,17489073673,-7753,,
16084454309,1559.08896,17489132463,1570771451,17489124704,-7759,,
16084505357,1559.14000,17489183513,1570822498,17489175750,-7763,,
16084555904,1559.19055,17489234063,1570873041,17489226294,-7769,,
16084606450,1559.24110,17489284610,1570923584,17489276836,-7774,,
16084656995,1559.29164,17489335158,1570974126,17489327379,-7779,,
16084708050,1559.34270,17489386216,1571025180,17489378432,-7784,,
16084758585,1559.39323,17489436752,1571075711,17489428963,-7789,,
16084810396,1559.44504,17489488566,1571127519,17489480772,-7794,,
16084860745,1559.49539,17489538918,1571177865,17489531118,-7800,,
16084911356,1559.54600,17489589531,1571228475,17489581728,-7803,,
16084962361,1559.59701,17489640538,1571279477,17489632729,-7809,,
16085012419,1559.64707,17489690599,1571329531,17489682784,-7815,,
16085062959,1559.69761,17489741141,1571380070,17489733322,-7819,,
16085113513,1559.74816,17489791697,1571430620,17489783873,-7824,,
16085164050,1559.79870,17489842237,1571481154,17489834406,-7831,,
16085214166,1559.84881,17489892355,1571531268,17489884521,-7834,,
16085265246,1559.89989,17489943437,1571582345,17489935598,-7839,,
16085315379,1559.95003,17489993573,1571632475,17489985737,-7836,,
16085366391,1560.00104,17490044587,1571683484,17490036737,-7850,,
16085416997,1560.05165,17490095195,1571734088,17490087340,-7855,,
16085467986,1560.10263,17490146187,1571785074,17490138327,-7860,,
16085518501,1560.15315,17490196704,1571835586,17490188838,-7866,,
16085569097,1560.20375,17490247303,1571886180,17490239433,-7870,,
16085619191,1560.25384,17490297399,1571936272,17490289524,-7875,,
16085669771,1560.30442,17490347981,1571986848,17490340100,-7881,,
16085720299,1560.35495,17490398511,1572037374,17490390626,-7885,,
16085770885,1560.40553,17490449100,1572087958,17490441210,-7890,,
16085821918,1560.45657,17490500135,1572138987,17490492239,-7896,,
16085872463,1560.50711,17490550683,1572189529,17490542782,-7901,,
16085923057,1560.55770,17490601279,1572240122,17490593374,-7905,,
16085974064,1560.60871,17490652288,1572291125,17490644378,-7910,,
16086024612,1560.65926,17490702839,1572341670,17490694923,-7916,,
16086075159,1560.70981,17490753388,1572392216,17490745468,-7920,,
16086125707,1560.76035,17490803939,1572442760,17490796013,-7926,,
16086176252,1560.81090,17490854485,1572493302,17490846554,-7931,,
16086226854,1560.86150,17490905091,1572543902,17490897155,-7936,,
16086277869,1560.91252,17490956107,1572594914,17490948166,-7941,,
16086328891,1560.96354,17491007132,1572645933,17490999185,-7947,,
16086378946,1561.01359,17491057188,1572695985,17491049238,-7950,,
16086429989,1561.06464,17491108236,1572747027,17491100279,-7957,,
16086480546,1561.11519,17491158793,1572797580,17491150832,-7961,,
16086534939,1561.16959,17491213191,1572851972,17491205224,-7967,,
16086592982,1561.22763,17491271235,1572910011,17491263264,-7971,,
16086643691,1561.27834,17491321947,1572960716,17491313968,-7979,,
16086694158,1561.32881,17491372416,1573011181,17491364433,-7983,,
16086744301,1561.37895,17491422561,1573061321,17491414574,-7987,,
16086804032,1561.43868,17491482295,1573121049,17491474302,-7993,,
16086858923,1561.49357,17491537188,1573175937,17491529189,-7999,,
16086909240,1561.54389,17491587508,1573226252,17491579504,-8004,,
16086960226,1561.59487,17491638495,1573277234,17491630487,-8008,,
16087010778,1561.64543,17491689050,1573327783,17491681036,-8014,,
16087061344,1561.69599,17491739618,1573378347,17491731599,-8019,,
16087112395,1561.74704,17491790672,1573429395,17491782648,-8024,,
16087163433,1561.79808,17491841713,1573480430,17491833683,-8030,,
16087213983,1561.84863,17491892264,1573530978,17491884231,-8033,,
16087264530,1561.89918,17491942814,1573581522,17491934775,-8039,,
16087319932,1561.95458,17491998219,1573636922,17491990174,-8045,,
16087376979,1562.01163,17492055268,1573693965,17492047218,-8050,,
16087427406,1562.06205,17492105697,1573744389,17492097641,-8056,,
16087477738,1562.11239,17492156032,1573794718,17492147971,-8061,,
16087528091,1562.16274,17492206388,1573845069,17492198321,-8067,,
16087578621,1562.21327,17492256920,1573895596,17492248849,-8071,,
16087628898,1562.26355,17492307199,1573945870,17492299123,-8076,,
16087679207,1562.31386,17492357510,1573996177,17492349429,-8081,,
16087730037,1562.36469,17492408342,1574047004,17492400256,-8086,,
16087780265,1562.41491,17492458573,1574097230,17492450482,-8091,,
16087830542,1562.46519,17492508853,1574147505,17492500757,-8096,,
16087880807,1562.51545,17492559119,1574197765,17492551018,-8101,,
16087931461,1562.56611,17492609775,1574248417,17492601669,-8106,,
16087982054,1562.61670,17492660371,1574299007,17492652259,-8112,,
16088032392,1562.66704,17492710712,1574349343,17492702595,-8117,,
16088082780,1562.71743,17492761102,1574399728,17492752980,-8122,,
16088133175,1562.76782,17492811500,1574450120,17492803373,-8127,,
16088183688,1562.81834,17492862014,1574500631,17492853883,-8131,,
16088234397,1562.86904,17492912726,1574551337,17492904589,-8137,,
16088285042,1562.91969,17492963374,1574601980,17492955232,-8142,,
16088335516,1562.97016,17493013850,1574652451,17493005704,-8146,,
16088385813,1563.02046,17493064149,1574702745,17493055997,-8152,,
16088436169,1563.07082,17493114508,1574753098,17493106351,-8157,,
16088486632,1563.12128,17493164973,1574803560,17493156812,-8161,,
16088537626,1563.17227,17493215969,1574854550,17493207802,-8167,,
16088588310,1563.22296,17493266656,1574905231,17493258484,-8172,,
16088638747,1563.27339,17493317094,1574955665,17493308917,-8177,,
16088689150,1563.32380,17493367501,1575006066,17493359319,-8182,,
16088739810,1563.37446,17493418163,1575056723,17493409976,-8187,,
16088790336,1563.42498,17493468690,1575107246,17493460498,-8192,,
16088840915,1563.47556,17493519273,1575157823,17493511075,-8198,,
16088891093,1563.52574,17493569452,1575207998,17493561250,-8202,,
16088941437,1563.57608,17493619799,1575258340,17493611592,-8207,,
16088991568,1563.62622,17493669933,1575308468,17493661720,-8213,,
16089041880,1563.67653,17493720247,1575358777,17493712030,-8217,,
16089092359,1563.72701,17493770728,1575409253,17493762506,-8222,,
16089142745,1563.77739,17493821117,1575459637,17493812889,-8228,,
16089193520,1563.82817,17493871893,1575510409,17493863662,-8231,,
16089244045,1563.87869,17493922422,1575560931,17493914184,-8238,,
16089294756,1563.92940,17493973135,1575611639,17493964892,-8243,,
16089345527,1563.98017,17494023908,1575662409,17494015661,-8247,,
16089395950,1564.03060,17494074334,1575712828,17494066081,-8253,,
16089446425,1564.08107,17494124811,1575763301,17494116553,-8258,,
16089497057,1564.13171,17494175444,1575813929,17494167181,-8263,,
16089547511,1564.18216,17494225901,1575864381,17494217633,-8268,,
16089597766,1564.23241,17494276159,1575914633,17494267886,-8273,,
16089647961,1564.28261,17494326355,1575964825,17494318077,-8278,,
16089698292,1564.33294,17494376690,1576015154,17494368407,-8283,,
16089748917,1564.38357,17494427316,1576065776,17494419028,-8288,,
16089799326,1564.43397,17494477727,1576116182,17494469434,-8293,,
16089849967,1564.48462,17494528371,1576166821,17494520074,-8297,,
16089900756,1564.53540,17494579162,1576217607,17494570860,-8302,,
16089950909,1564.58556,17494629318,1576267758,17494621010,-8308,,
16090001191,1564.63584,17494679602,1576318036,17494671288,-8314,,
16090051379,1564.68603,17494729793,1576368223,17494721475,-8318,,
16090101715,1564.73636,17494780131,1576418555,17494771808,-8323,,
16090152117,1564.78677,17494830536,1576468954,17494822207,-8329,,
16090202753,1564.83740,17494881173,1576519588,17494872840,-8333,,
16090253172,1564.88782,17494931595,1576570004,17494923257,-8338,,
16090303638,1564.93829,17494982063,1576620467,17494973719,-8344,,
16090354137,1564.98879,17495032565,1576670964,17495024217,-8348,,
16090404477,1565.03913,17495082907,1576721302,17495074554,-8353,,
16090454595,1565.08924,17495133027,1576771416,17495124668,-8359,,
16090505034,1565.13968,17495183468,1576821853,17495175105,-8363,,
16090555874,1565.19052,17495234312,1576872690,17495225943,-8369,,
16090606226,1565.24087,17495284665,1576923038,17495276291,-8374,,
16090656612,1565.29126,17495335054,1576973422,17495326674,-8380,,
16090706991,1565.34164,17495385435,1577023799,17495377051,-8384,,
16090757281,1565.39193,17495435728,1577074086,17495427339,-8389,,
16090807455,1565.44210,17495485904,1577124257,17495477509,-8395,,
16090857565,1565.49221,17495536027,1577174375,17495527628,-8399,,
16090907846,1565.54249,17495586299,1577224643,17495577895,-8404,,
16090958154,1565.59280,17495636610,1577274948,17495628200,-8410,,
16091008765,1565.64341,17495687224,1577325557,17495678810,-8414,,
16091059351,1565.69400,17495737812,1577376141,17495729393,-8419,,
16091109824,1565.74447,17495788286,1577426610,17495779862,-8424,,
16091160655,1565.79530,17495839120,1577477438,17495830690,-8430,,
16091210920,1565.84557,17495889388,1577527702,17495880954,-8434,,
16091261335,1565.89598,17495939805,1577578114,17495931366,-8439,,
16091311632,1565.94628,17495990105,1577628408,17495981660,-8445,,
16091362278,1565.99693,17496040753,1577679051,17496032304,-8449,,
16091412966,1566.04761,17496091442,1577729736,17496082988,-8454,,
16091463253,1566.09790,17496141733,1577780020,17496133273,-8460,,
16091513558,1566.14821,17496192040,1577830324,17496183576,-8464,,
16091563988,1566.19864,17496242471,1577880750,17496234002,-8469,,
16091614173,1566.24882,17496292660,1577930932,17496284185,-8475,,
16091664522,1566.29917,17496343011,1577981290,17496334542,-8469,,
16091714966,1566.34961,17496393457,1578031720,17496384973,-8484,,
16091765448,1566.40010,17496443942,1578082199,17496435452,-8490,,
16092032245,1566.66689,17496710751,1578348982,17496702234,-8517,17496705187,
16092057303,1566.69195,17496735810,1578374039,17496727305,-8505,,
16092107792,1566.74244,17496786301,1578424524,17496777821,-8480,,
16092157943,1566.79259,17496836455,1578474673,17496828000,-8455,,
16092208533,1566.84318,17496887047,1578525261,17496878616,-8431,,
16092258697,1566.89334,17496937214,1578575432,17496928818,-8396,,
16092309553,1566.94420,17496988071,1578626275,17496979690,-8381,,
16092360415,1566.99506,17497038936,1578677134,17497030580,-8356,,
16092411462,1567.04611,17497089986,1578728180,17497081655,-8331,,
16092462258,1567.09691,17497140793,1578778982,17497132487,-8306,,
16092513008,1567.14766,17497191537,1578829719,17497183255,-8282,,
16092563594,1567.19824,17497242124,1578880302,17497233867,-8257,,
16092614634,1567.24928,17497293167,1578931341,17497284936,-8231,,
16092665639,1567.30029,17497344174,1578982342,17497335968,-8206,,
16092716200,1567.35085,17497394738,1579032901,17497386556,-8182,,
16092767250,1567.40190,17497445789,1579083947,17497437633,-8156,,
16092818286,1567.45293,17497496828,1579134981,17497488697,-8131,,
16092868490,1567.50314,17497547035,1579185182,17497538928,-8107,,
16092918558,1567.55321,17497597105,1579235247,17497589023,-8082,,
16092969665,1567.60431,17497648215,1579286352,17497640158,-8057,,
16093020154,1567.65480,17497698705,1579336838,17497690673,-8032,,
16093071227,1567.70588,17497749781,1579387909,17497741774,-8007,,
16093121765,1567.75641,17497800331,1579438454,17497792350,-7981,,
16093172311,1567.80696,17497850870,1579488987,17497842913,-7957,,
16093222875,1567.85752,17497901437,1579539548,17497893504,-7933,,
16093273838,1567.90849,17497952401,1579590508,17497944494,-7907,,
16093324441,1567.95909,17498003007,1579641110,17497995125,-7882,,
16093375430,1568.01008,17498053998,1579692095,17498046140,-7858,,
16093425967,1568.06062,17498104538,1579742637,17498096712,-7826,,
16093476023,1568.11067,17498154596,1579792684,17498146788,-7808,,
16093527074,1568.16172,17498205649,1579843731,17498197866,-7783,,
16093577666,1568.21231,17498256244,1579894321,17498248486,-7758,,
16093628684,1568.26333,17498307264,1579945335,17498299530,-7734,,
16093679720,1568.31437,17498358303,1579996369,17498350595,-7708,,
16093730257,1568.36490,17498408842,1580046903,17498401159,-7683,,
16093780834,1568.41548,17498459421,1580097478,17498451763,-7658,,
16093831301,1568.46595,17498509890,1580147942,17498502256,-7634,,
16093881725,1568.51637,17498560316,1580198363,17498552708,-7608,,
16093932598,1568.56725,17498611193,1580249233,17498603607,-7586,,
16093983285,1568.61793,17498661882,1580299918,17498654322,-7560,,
16094034293,1568.66894,17498712892,1580350929,17498705363,-7529,,
16094084891,1568.71954,17498763503,1580401528,17498755993,-7510,,
16094135808,1568.77046,17498814412,1580452432,17498806927,-7485,,
16094186380,1568.82103,17498864986,1580503003,17498857527,-7459,,
16094236802,1568.87145,17498915410,1580553421,17498907975,-7435,,
16094287840,1568.92249,17498966451,1580604457,17498959041,-7410,,
16094338433,1568.97308,17499017045,1580655045,17499009670,-7375,,
16094388956,1569.02360,17499067572,1580705567,17499060211,-7361,,
16094439550,1569.07420,17499118167,1580756158,17499110832,-7335,,
16094490183,1569.12483,17499168803,1580806789,17499161493,-7310,,
16094540726,1569.17537,17499219349,1580857330,17499212064,-7285,,
16094590868,1569.22552,17499269493,1580907469,17499262232,-7261,,
16094641631,1569.27628,17499320258,1580958228,17499313022,-7236,,
16094692190,1569.32684,17499370820,1581008786,17499363609,-7211,,
16094743239,1569.37789,17499421871,1581059832,17499414685,-7186,,
16094793804,1569.42845,17499472438,1581110393,17499465276,-7162,,
16094844339,1569.47899,17499522976,1581160926,17499515839,-7137,,
16094895326,1569.52997,17499573965,1581211911,17499566855,-7110,,
16094945381,1569.58003,17499624023,1581261962,17499616936,-7087,,
16094995879,1569.63053,17499674522,1581312457,17499667460,-7062,,
16095046899,1569.68155,17499725545,1581363475,17499718509,-7036,,
16095097460,1569.73211,17499776109,1581414034,17499769097,-7012,,
16095148345,1569.78299,17499826996,1581464916,17499820009,-6987,,
16095198896,1569.83354,17499877549,1581515463,17499870587,-6962,,
16095249475,1569.88412,17499928131,1581566041,17499921194,-6937,,
16095300063,1569.93471,17499978721,1581616625,17499971808,-6913,,
16095351126,1569.98577,17500029785,1581667685,17500022898,-6887,,
16095401725,1570.03637,17500080387,1581718282,17500073525,-6862,,
16095451920,1570.08657,17500130585,1581768475,17500123747,-6838,,
16095502956,1570.13760,17500181624,1581819507,17500174810,-6814,,
16095558227,1570.19287,17500236898,1581874777,17500230112,-6786,,
16095608553,1570.24320,17500287225,1581925099,17500280464,-6761,,
16095659120,1570.29377,17500337795,1581975664,17500331059,-6736,,
16095710201,1570.34485,17500388878,1582026742,17500382167,-6711,,
16095761239,1570.39589,17500439918,1582077776,17500433231,-6687,,
16095811789,1570.44644,17500490470,1582128323,17500483809,-6661,,
16095862417,1570.49707,17500541102,1582178950,17500534465,-6637,,
16095912984,1570.54763,17500591671,1582229513,17500585059,-6612,,
16095963138,1570.59779,17500641828,1582279666,17500635240,-6588,,
16096013679,1570.64833,17500692370,1582330204,17500685808,-6562,,
16096064235,1570.69888,17500742929,1582380757,17500736391,-6538,,
16096114797,1570.74944,17500793492,1582431315,17500786979,-6513,,
16096165372,1570.80002,17500844070,1582481889,17500837583,-6487,,
16096216448,1570.85110,17500895159,1582532972,17500888696,-6463,,
16096267473,1570.90212,17500946176,1582583984,17500939738,-6438,,
16096318444,1570.95309,17500997149,1582634951,17500990736,-6413,,
16096368719,1571.00337,17501047427,1582685224,17501041039,-6388,,
16096419358,1571.05401,17501098068,1582735861,17501091706,-6362,,
16096470379,1571.10503,17501149092,1582786879,17501142753,-6339,,
16096520472,1571.15512,17501199187,1582836970,17501192874,-6313,,
16096571502,1571.20615,17501250219,1582887997,17501243931,-6288,,
16096622567,1571.25722,17501301286,1582939058,17501295022,-6264,,
16096673657,1571.30831,17501352379,1582990145,17501346140,-6239,,
16096724305,1571.35895,17501403029,1583040792,17501396816,-6213,,
16096774873,1571.40952,17501453599,1583091356,17501447410,-6189,,
16096825465,1571.46011,17501504195,1583141947,17501498032,-6163,,
16096876029,1571.51068,17501554760,1583192508,17501548622,-6138,,
16096926850,1571.56150,17501605584,1583243325,17501599470,-6114,,
16096977587,1571.61224,17501656323,1583294071,17501650246,-6077,,
16097027683,1571.66233,17501706421,1583344154,17501700357,-6064,,
16097078242,1571.71289,17501756983,1583394709,17501750916,-6067,,
16097129285,1571.76393,17501808028,1583445749,17501801956,-6072,,
16097180316,1571.81496,17501859062,1583496778,17501852984,-6078,,
16097230381,1571.86503,17501909129,1583546840,17501903047,-6082,,
16097282918,1571.91757,17501961668,1583599374,17501955581,-6087,,
16097332997,1571.96764,17502011750,1583649451,17502005657,-6093,,
16097383591,1572.01824,17502062346,1583700042,17502056249,-6097,,
16097433937,1572.06858,17502112693,1583750385,17502106591,-6102,,
16097484956,1572.11960,17502163716,1583801401,17502157608,-6108,,
16097535105,1572.16975,17502213867,1583851548,17502207754,-6113,,
16097585160,1572.21981,17502263923,1583901600,17502257806,-6117,,
16097635747,1572.27040,17502314513,1583952184,17502308390,-6123,,
16097686305,1572.32095,17502365074,1584002739,17502358946,-6128,,
16097736381,1572.37103,17502415152,1584052813,17502409020,-6132,,
16097786955,1572.42160,17502465728,1584103384,17502459591,-6137,,
16097837493,1572.47214,17502516268,1584153919,17502510125,-6143,,
16097888127,1572.52277,17502566905,1584204551,17502560758,-6147,,
16097938679,1572.57333,17502617460,1584255101,17502611308,-6152,,
16097989707,1572.62435,17502668490,1584306126,17502662332,-6158,,
16098040276,1572.67492,17502719062,1584356691,17502712898,-6164,,
16098090340,1572.72499,17502769128,1584406753,17502762960,-6168,,
16098140428,1572.77508,17502819217,1584456838,17502813044,-6173,,
16098191057,1572.82570,17502869850,1584507464,17502863671,-6179,,
16098241611,1572.87626,17502920405,1584558016,17502914222,-6183,,
16098292651,1572.92730,17502971448,1584609053,17502965260,-6188,,
16098343245,1572.97789,17503022044,1584659644,17503015850,-6194,,
16098393792,1573.02844,17503072594,1584710189,17503066395,-6199,,
16098444544,1573.07919,17503123348,1584760938,17503117145,-6203,,
16098495591,1573.13024,17503174397,1584811982,17503168188,-6209,,
16098545933,1573.18058,17503224742,1584862322,17503218528,-6214,,
16098596475,1573.23112,17503275285,1584912861,17503269067,-6218,,
16098647307,1573.28195,17503326120,1584963690,17503319896,-6224,,
16098697414,1573.33206,17503376229,1585013794,17503370000,-6229,,
16098748008,1573.38266,17503426826,1585064386,17503420593,-6233,,
16098798520,1573.43317,17503477341,1585114895,17503471101,-6240,,
16098849085,1573.48373,17503527908,1585165457,17503521664,-6244,,
16098900147,1573.53480,17503578972,1585216516,17503572722,-6250,,
16098950659,1573.58531,17503629486,1585267026,17503623233,-6253,,
16099001212,1573.63586,17503680042,1585317577,17503673783,-6259,,
16099051370,1573.68602,17503730202,1585367731,17503723937,-6265,,
16099102403,1573.73705,17503781238,1585418762,17503774968,-6270,,
16099152945,1573.78759,17503831782,1585469301,17503825508,-6274,,
16099203274,1573.83792,17503882113,1585519627,17503875834,-6279,,
16099253998,1573.88865,17503932840,1585570349,17503926555,-6285,,
16099305037,1573.93969,17503983881,1585621385,17503977592,-6289,,
16099355588,1573.99024,17504034435,1585671934,17504028140,-6295,,
16099405641,1574.04029,17504084489,1585721983,17504078189,-6300,,
16099456680,1574.09133,17504135530,1585773020,17504129226,-6304,,
16099507395,1574.14204,17504186249,1585823733,17504179939,-6310,,
16099557942,1574.19259,17504236798,1585874276,17504230483,-6315,,
16099608046,1574.24269,17504286904,1585924379,17504280585,-6319,,
16099658114,1574.29276,17504336975,1585974443,17504330650,-6325,,
16099708702,1574.34335,17504387565,1586025029,17504381235,-6330,,
16099759751,1574.39440,17504438615,1586076074,17504432280,-6335,,
16099810786,1574.44543,17504489654,1586127107,17504483314,-6340,,
16099861295,1574.49594,17504540176,1586177625,17504533831,-6345,,
16099911928,1574.54658,17504590801,1586228243,17504584449,-6352,,
16099962756,1574.59740,17504641630,1586279069,17504635275,-6355,,
16100012930,1574.64758,17504691807,1586329241,17504685447,-6360,,
16100062981,1574.69763,17504741860,1586379288,17504735494,-6366,,
16100114061,1574.74871,17504792943,1586430366,17504786572,-6371,,
16100165145,1574.79979,17504844029,1586481447,17504837653,-6376,,
16100215769,1574.85042,17504894656,1586532068,17504888275,-6381,,
16100266332,1574.90098,17504945221,1586582629,17504938835,-6386,,
16100316380,1574.95103,17504995270,1586632674,17504988880,-6390,,
16100366461,1575.00111,17505045354,1586682752,17505038959,-6395,,
16100417456,1575.05210,17505096353,1586733745,17505089952,-6401,,
16100467727,1575.10237,17505146624,1586784013,17505140219,-6405,,
16100518283,1575.15293,17505197184,1586834566,17505190773,-6411,,
16100568836,1575.20348,17505247739,1586885116,17505241323,-6416,,
16100619454,1575.25410,17505298359,1586935732,17505291938,-6421,,
16100670182,1575.30483,17505349090,1586986458,17505342664,-6426,,
16100720793,1575.35544,17505399703,1587037066,17505393272,-6431,,
16100771810,1575.40646,17505450723,1587088080,17505444286,-6437,,
16100822889,1575.45754,17505501804,1587139156,17505495363,-6441,,
16100873454,1575.50810,17505552371,1587189718,17505545924,-6447,,
16100924488,1575.55914,17505603407,1587240749,17505596965,-6442,,
16100975528,1575.61018,17505654449,1587291785,17505647992,-6457,,
16101026083,1575.66073,17505705007,1587342339,17505698546,-6461,,
16101076670,1575.71132,17505755596,1587392923,17505749129,-6467,,
16101126938,1575.76159,17505805867,1587443188,17505799395,-6472,,
16101177899,1575.81255,17505856830,1587494147,17505850354,-6476,,
16101228970,1575.86362,17505907916,1587545228,17505901435,-6481,,
16101279703,1575.91435,17505958638,1587595945,17505952151,-6487,,
16101330330,1575.96498,17506009268,1587646569,17506002775,-6493,,
16101380955,1576.01560,17506059896,1587697193,17506053400,-6496,,
16101432006,1576.06665,17506110949,1587748241,17506104447,-6502,,
16101482628,1576.11728,17506161573,1587798859,17506155065,-6508,,
16101533172,1576.16782,17506212120,1587849402,17506205608,-6512,,
16101583741,1576.21839,17506262690,1587899967,17506256173,-6517,,
16101634340,1576.26899,17506313293,1587950564,17506306770,-6523,,
16101685319,1576.31997,17506364274,1588001539,17506357746,-6528,,
16101736347,1576.37099,17506415304,1588052565,17506408772,-6532,,
16101786677,1576.42133,17506465637,1588102892,17506459099,-6538,,
16101837186,1576.47183,17506516148,1588153399,17506509605,-6543,,
16101888219,1576.52287,17506567183,1588204429,17506560636,-6547,,
16101938275,1576.57292,17506617242,1588254483,17506610689,-6553,,
16101988858,1576.62351,17506667827,1588305062,17506661269,-6558,,
16102038920,1576.67357,17506717891,1588355121,17506711328,-6563,,
16102089535,1576.72418,17506768508,1588405734,17506761940,-6568,,
16102140104,1576.77475,17506819091,1588456312,17506812518,-6573,,
16102191178,1576.82583,17506870157,1588507372,17506863578,-6579,,
16102242227,1576.87687,17506921208,1588558419,17506914625,-6583,,
16102293275,1576.92792,17506972258,1588609464,17506965670,-6588,,
16102344294,1576.97894,17507023280,1588660479,17507016685,-6595,,
16102395369,1577.03002,17507074357,1588711552,17507067758,-6599,,
16102446383,1577.08103,17507125372,1588762563,17507118769,-6603,,
16102496971,1577.13162,17507175964,1588813148,17507169355,-6609,,
16102548045,1577.18269,17507227040,1588864220,17507220427,-6613,,
16102598590,1577.23324,17507277587,1588914762,17507270969,-6618,,
16102649225,1577.28387,17507328224,1588965394,17507321601,-6623,,
16102700238,1577.33489,17507379239,1589016404,17507372610,-6629,,
16102750813,1577.38546,17507429818,1589066977,17507423184,-6634,,
16102801718,1577.43637,17507480725,1589117879,17507474086,-6639,,
16102852377,1577.48702,17507531386,1589168536,17507524742,-6644,,
16102902930,1577.53758,17507581942,1589219086,17507575292,-6650,,
16102953543,1577.58819,17507632557,1589269696,17507625902,-6655,,
16103004089,1577.63874,17507683105,1589320239,17507676446,-6659,,
16103054653,1577.68930,17507733672,1589370800,17507727007,-6665,,
16103104824,1577.73947,17507783845,1589420968,17507777175,-6670,,
16103155897,1577.79055,17507834920,1589472040,17507828246,-6674,,
16103206526,1577.84117,17507885552,1589522666,17507878872,-6680,,
16103257530,1577.89218,17507936558,1589573667,17507929873,-6685,,
16103308607,1577.94325,17507987638,1589624742,17507980948,-6690,,
16103359600,1577.99425,17508038632,1589675731,17508031937,-6695,,
16103410614,1578.04526,17508089648,1589726742,17508082949,-6699,,
16103461674,1578.09632,17508140712,1589777799,17508134005,-6707,,
16103512298,1578.14695,17508191337,1589828421,17508184627,-6710,,
16103562822,1578.19747,17508241864,1589878942,17508235149,-6715,,
16103612914,1578.24756,17508291958,1589929031,17508285237,-6721,,
16103662973,1578.29762,17508342019,1589979088,17508335294,-6725,,
16103713496,1578.34814,17508392545,1590029608,17508385814,-6731,,
16103764594,1578.39924,17508443646,1590080703,17508436910,-6736,,
16103815651,1578.45030,17508494704,1590131757,17508487963,-6741,,
16103866699,1578.50135,17508545755,1590182803,17508539010,-6745,,
16103917601,1578.55225,17508596660,1590233702,17508589908,-6752,,
16103968650,1578.60330,17508647710,1590284748,17508640954,-6756,,
16104019665,1578.65431,17508698728,1590335760,17508691966,-6762,,
16104070204,1578.70485,17508749269,1590386297,17508742504,-6765,,
16104121204,1578.75585,17508800272,1590437294,17508793501,-6771,,
16104171780,1578.80643,17508850851,1590487867,17508844073,-6778,,
16104221918,1578.85657,17508900990,1590538003,17508894209,-6781,,
16104272440,1578.90709,17508951515,1590588523,17508944729,-6786,,
16104322912,1578.95756,17509001990,1590638991,17508995198,-6792,,
16104373149,1579.00780,17509052229,1590689226,17509045433,-6796,,
16104423761,1579.05841,17509102842,1590739835,17509096042,-6800,,
16104474828,1579.10948,17509153912,1590790899,17509147106,-6806,,
16104525853,1579.16050,17509204940,1590841921,17509198128,-6812,,
16104576411,1579.21106,17509255500,1590892478,17509248684,-6816,,
16104627009,1579.26166,17509306100,1590943072,17509299278,-6822,,
16104678061,1579.31271,17509357155,1590994122,17509350328,-6827,,
16104728682,1579.36333,17509407780,1591044742,17509400951,-6829,,
16104779571,1579.41422,17509458669,1591095626,17509451832,-6837,,
16104830163,1579.46481,17509509264,1591146215,17509502422,-6842,,
16104880467,1579.51511,17509559570,1591196516,17509552722,-6848,,
16104931498,1579.56615,17509610604,1591247546,17509603752,-6852,,
16104982564,1579.61721,17509661672,1591298609,17509654815,-6857,,
16105033157,1579.66781,17509712277,1591349208,17509705415,-6862,,
16105084190,1579.71884,17509763303,1591400230,17509756436,-6867,,
16105135149,1579.76980,17509814264,1591451185,17509807392,-6872,,
16105185686,1579.82033,17509864804,1591501719,17509857926,-6878,,
16105236794,1579.87144,17509915913,1591552823,17509909030,-6883,,
16105287331,1579.92198,17509966465,1591603370,17509959577,-6888,,
16105338325,1579.97297,17510017450,1591654350,17510010557,-6893,,
16105388866,1580.02351,17510067992,1591704888,17510061094,-6898,,
16105439455,1580.07410,17510118585,1591755475,17510111681,-6904,,
16105490460,1580.12511,17510169592,1591806477,17510162683,-6909,,
16105540555,1580.17520,17510219689,1591856569,17510212776,-6913,,
16105591563,1580.22621,17510270700,1591907574,17510263781,-6919,,
16105641680,1580.27633,17510320819,1591957690,17510313896,-6923,,
16105692978,1580.32763,17510372119,1592008984,17510365191,-6928,,
16105743367,1580.37802,17510422510,1592059370,17510415576,-6934,,
16105793955,1580.42860,17510473101,1592109957,17510466163,-6938,,
16105844501,1580.47915,17510523649,1592160500,17510516706,-6943,,
16105895050,1580.52970,17510574200,1592211045,17510567252,-6948,,
16105946134,1580.58078,17510625287,1592262126,17510618333,-6954,,
16105997177,1580.63182,17510676333,1592313167,17510669374,-6959,,
16106047718,1580.68237,17510726876,1592363705,17510719912,-6964,,
16106098765,1580.73341,17510777925,1592414750,17510770956,-6969,,
16106149342,1580.78399,17510828505,1592465325,17510821531,-6974,,
16106200061,1580.83471,17510879225,1592516040,17510872246,-6979,,
16106250897,1580.88555,17510930064,1592566874,17510923080,-6984,,
16106301435,1580.93608,17510980604,1592617408,17510973614,-6990,,
16106351528,1580.98618,17511030699,1592667499,17511023705,-6994,,
16106402531,1581.03718,17511081704,1592718499,17511074705,-6999,,
16106453093,1581.08774,17511132270,1592769058,17511125265,-7005,,
16106504071,1581.13872,17511183249,1592820034,17511176241,-7008,,
16106554738,1581.18939,17511233919,1592870699,17511226905,-7014,,
16106605615,1581.24026,17511284799,1592921573,17511277779,-7020,,
16106656156,1581.29080,17511335342,1592972111,17511328317,-7025,,
16106706708,1581.34136,17511385896,1593022660,17511378866,-7030,,
16106757252,1581.39190,17511436443,1593073201,17511429408,-7035,,
16106807843,1581.44249,17511487035,1593123789,17511479996,-7039,,
16106858853,1581.49350,17511538048,1593174797,17511531003,-7045,,
16106909470,1581.54412,17511588669,1593225413,17511581619,-7050,,
16106960052,1581.59470,17511639251,1593275990,17511632196,-7055,,
16107011093,1581.64574,17511690296,1593327029,17511683235,-7061,,
16107062147,1581.69680,17511741351,1593378080,17511734286,-7065,,
16107112753,1581.74740,17511791959,1593428683,17511784889,-7070,,
16107163297,1581.79795,17511842507,1593479225,17511835431,-7076,,
16107213869,1581.84852,17511893081,1593529795,17511886001,-7080,,
16107264921,1581.89957,17511944134,1593580843,17511937049,-7085,,
16107315824,1581.95047,17511995042,1593631745,17511987952,-7090,,
16107366373,1582.00102,17512045591,1593682289,17512038495,-7096,,
16107416945,1582.05159,17512096167,1593732860,17512089066,-7101,,
16107467947,1582.10260,17512147170,1593783858,17512140064,-7106,,
16107518544,1582.15319,17512197770,1593834452,17512190659,-7111,,
16107569544,1582.20419,17512248772,1593885450,17512241656,-7116,,
16107620100,1582.25475,17512299331,1593936003,17512292210,-7121,,
16107670656,1582.30530,17512349888,1593986556,17512342762,-7126,,
16107724648,1582.35930,17512403883,1594040546,17512396752,-7131,,
16107775042,1582.40969,17512454279,1594090937,17512447143,-7136,,
16107826259,1582.46091,17512505500,1594142151,17512498358,-7142,,
16107876870,1582.51152,17512556112,1594192759,17512548965,-7147,,
16107927345,1582.56199,17512606590,1594243231,17512599438,-7152,,
16107977827,1582.61247,17512657075,1594293712,17512649918,-7157,,
16108028444,1582.66309,17512707693,1594344325,17512700531,-7162,,
16108079018,1582.71367,17512758269,1594394896,17512751102,-7167,,
16108130062,1582.76471,17512809317,1594445938,17512802145,-7172,,
16108180638,1582.81529,17512859894,1594496511,17512852717,-7177,,
16108232181,1582.86683,17512911439,1594548051,17512904257,-7182,,
16108296274,1582.93092,17512975535,1594612141,17512968347,-7188,,
16108351176,1582.98582,17513030440,1594667040,17513023247,-7193,,
16108404870,1583.03952,17513084137,1594720731,17513076938,-7199,,
16108455868,1583.09052,17513135137,1594771726,17513127932,-7205,,
16108506417,1583.14107,17513185688,1594822272,17513178478,-7210,,
16108557458,1583.19211,17513236733,1594873311,17513229518,-7215,,
16108607497,1583.24214,17513286773,1594923347,17513279553,-7220,,
16108658048,1583.29270,17513337327,1594973895,17513330102,-7225,,
16108708611,1583.34326,17513387893,1595024456,17513380663,-7230,,
16108759161,1583.39381,17513438445,1595075003,17513431210,-7235,,
16108809724,1583.44437,17513489010,1595125563,17513481770,-7240,,
16108860759,1583.49541,17513540047,1595176595,17513532801,-7246,,
16108911806,1583.54645,17513591097,1595227641,17513583847,-7250,,
16108962897,1583.59755,17513642190,1595278728,17513634935,-7255,,
16109013543,1583.64819,17513692838,1595329371,17513685577,-7261,,
16109064594,1583.69924,17513743892,1595380420,17513736627,-7265,,
16109115164,1583.74981,17513794475,1595430998,17513787204,-7271,,
16109166111,1583.80076,17513845414,1595481931,17513838137,-7277,,
16109216356,1583.85100,17513895660,1595532173,17513888379,-7281,,
16109266898,1583.90155,17513946206,1595582713,17513938920,-7286,,
16109317458,1583.95211,17513996778,1595633281,17513989487,-7291,,
16109368358,1584.00301,17514047670,1595684167,17514040374,-7296,,
16109418872,1584.05352,17514098187,1595734679,17514090886,-7301,,
16109468939,1584.10359,17514148256,1595784743,17514140950,-7306,,
16109519958,1584.15461,17514199277,1595835759,17514191966,-7311,,
16109570020,1584.20467,17514249342,1595885819,17514242026,-7316,,
16109621082,1584.25573,17514300406,1595936878,17514293085,-7321,,
16109672114,1584.30676,17514351440,1595987907,17514344114,-7326,,
16109722199,1584.35685,17514401527,1596037989,17514394195,-7332,,
16109773191,1584.40784,17514452522,1596088979,17514445186,-7336,,
16109823857,1584.45851,17514503190,1596139642,17514495849,-7341,,
16109874487,1584.50914,17514553823,1596190269,17514546476,-7347,,
16109925359,1584.56001,17514604696,1596241139,17514597345,-7351,,
16109975526,1584.61017,17514654867,1596291313,17514647520,-7347,,
16110026141,1584.66079,17514705484,1596341915,17514698122,-7362,,
16110076553,1584.71120,17514755897,1596392324,17514748530,-7367,,
16110127101,1584.76175,17514806449,1596442871,17514799077,-7372,,
16110177702,1584.81235,17514857052,1596493468,17514849675,-7377,,
16110228265,1584.86291,17514907628,1596544039,17514900246,-7382,,
16110279290,1584.91394,17514958645,1596595051,17514951258,-7387,,
16110329879,1584.96453,17515009236,1596645637,17515001844,-7392,,
16110380328,1585.01498,17515059687,1596696084,17515052290,-7397,,
16110431207,1585.06586,17515110568,1596746959,17515103165,-7403,,
16110481748,1585.11640,17515161112,1596797498,17515153705,-7407,,
16110532473,1585.16712,17515211839,1596848220,17515204427,-7412,,
16110583507,1585.21816,17515262876,1596899251,17515255458,-7418,,
16110633600,1585.26825,17515312971,1596949343,17515305549,-7422,,
16110684223,1585.31887,17515363595,1596999962,17515356168,-7427,,
16110734352,1585.36900,17515413728,1597050089,17515406295,-7433,,
16110784805,1585.41945,17515464183,1597100539,17515456746,-7437,,
16110835419,1585.47007,17515514800,1597151151,17515507357,-7443,,
16110886464,1585.52111,17515565847,1597202193,17515558399,-7448,,
16110937513,1585.57216,17515616898,1597253239,17515609445,-7453,,
16110987831,1585.62248,17515667218,1597303554,17515659761,-7457,,
16111038001,1585.67265,17515717391,1597353721,17515709928,-7463,,
16111088725,1585.72337,17515768117,1597404443,17515760649,-7468,,
16111139330,1585.77398,17515818725,1597455046,17515811252,-7473,,
16111190003,1585.82465,17515869400,1597505716,17515861923,-7477,,
16111240580,1585.87523,17515919979,1597556289,17515912495,-7484,,
16111290678,1585.92533,17515970081,1597606385,17515962592,-7489,,
16111341229,1585.97588,17516020633,1597656933,17516013140,-7493,,
16111392250,1586.02690,17516071656,1597707951,17516064158,-7498,,
16111442854,1586.07750,17516122263,1597758553,17516114760,-7503,,
16111493596,1586.12824,17516173007,1597809293,17516165499,-7508,,
16111544144,1586.17879,17516223557,1597859838,17516216044,-7513,,
16111594708,1586.22936,17516274124,1597910399,17516266605,-7519,,
16111645388,1586.28004,17516324806,1597961076,17516317283,-7523,,
16111696424,1586.33107,17516375845,1598012109,17516368316,-7529,,
16111746563,1586.38121,17516425986,1598062245,17516418452,-7534,,
16111797152,1586.43180,17516476577,1598112832,17516469038,-7539,,
16111847767,1586.48241,17516527195,1598163445,17516519651,-7544,,
16111898820,1586.53347,17516578250,1598214494,17516570701,-7549,,
16111949865,1586.58451,17516629297,1598265536,17516621742,-7555,,
16112000431,1586.63508,17516679866,1598316100,17516672307,-7559,,
16112051006,1586.68565,17516730443,1598366673,17516722879,-7564,,
16112101148,1586.73580,17516780586,1598416811,17516773017,-7569,,
16112152197,1586.78685,17516831638,1598467857,17516824063,-7575,,
16112203245,1586.83789,17516882689,1598518904,17516875110,-7579,,
16112253841,1586.88849,17516933287,1598569496,17516925702,-7585,,
16112304625,1586.93927,17516984074,1598620277,17516976484,-7590,,
16112355151,1586.98980,17517034601,1598670801,17517027007,-7594,,
16112405448,1587.04010,17517084903,1598721097,17517077304,-7599,,
16112456508,1587.09116,17517135964,1598772153,17517128359,-7605,,
16112507072,1587.14172,17517186530,1598822713,17517178920,-7610,,
16112557965,1587.19261,17517237425,1598873604,17517229810,-7615,,
16112609004,1587.24365,17517288466,1598924640,17517280846,-7620,,
16112659553,1587.29420,17517339017,1598975186,17517331392,-7625,,
16112710110,1587.34476,17517389578,1599025742,17517381948,-7630,,
16112760659,1587.39531,17517440128,1599076287,17517432494,-7634,,
16112811186,1587.44583,17517490657,1599126811,17517483017,-7640,,
16112862260,1587.49691,17517541735,1599177882,17517534089,-7646,,
16112912841,1587.54749,17517592317,1599228461,17517584667,-7650,,
16112963891,1587.59854,17517643370,1599279508,17517635714,-7656,,
16113014906,1587.64955,17517694388,1599330520,17517686727,-7661,,
16113065455,1587.70010,17517744939,1599381067,17517737274,-7665,,
16113116490,1587.75114,17517795976,1599432099,17517788305,-7671,,
16113167026,1587.80167,17517846514,1599482632,17517838839,-7675,,
16113218100,1587.85275,17517897591,1599533704,17517889910,-7681,,
16113268592,1587.90324,17517948086,1599584193,17517940400,-7686,,
16113319167,1587.95382,17517998663,1599634765,17517990972,-7691,,
16113370186,1588.00483,17518049684,1599685781,17518041988,-7696,,
16113420430,1588.05508,17518099930,1599736023,17518092230,-7700,,
16113471229,1588.10588,17518150731,1599786819,17518143025,-7706,,
16113521680,1588.15633,17518201184,1599837267,17518193473,-7711,,
16113572293,1588.20694,17518251801,1599887878,17518244084,-7717,,
16113622900,1588.25755,17518302410,1599938483,17518294689,-7721,,
16113673741,1588.30839,17518353253,1599989321,17518345527,-7726,,
16113723891,1588.35854,17518403406,1600039468,17518395674,-7732,,
16113774390,1588.40904,17518453906,1600089964,17518446170,-7736,,
16113824671,1588.45932,17518504191,1600140243,17518496449,-7742,,
16113875244,1588.50989,17518554766,1600190813,17518547019,-7747,,
16113925803,1588.56045,17518605327,1600241369,17518597576,-7751,,
16113976368,1588.61102,17518655906,1600291942,17518648149,-7757,,
16114026806,1588.66145,17518706335,1600342367,17518698574,-7761,,
16114077884,1588.71253,17518757415,1600393441,17518749648,-7767,,
16114128891,1588.76354,17518808424,1600444446,17518800652,-7772,,
16114179479,1588.81413,17518859015,1600495031,17518851238,-7777,,
16114230501,1588.86515,17518910039,1600546051,17518902257,-7782,,
16114281590,1588.91624,17518961130,1600597136,17518953342,-7788,,
16114332631,1588.96728,17519012174,1600648175,17519004382,-7792,,
16114383650,1589.01830,17519063195,1600699192,17519055398,-7797,,
16114434709,1589.06936,17519114268,1600750258,17519106465,-7803,,
16114485745,1589.12039,17519165295,1600801281,17519157488,-7807,,
16114536357,1589.17100,17519215909,1600851890,17519208096,-7813,,
16114587177,1589.22183,17519266731,1600902707,17519258913,-7818,,
16114637258,1589.27191,17519316815,1600952786,17519308992,-7823,,
16114687831,1589.32248,17519367390,1601003356,17519359562,-7828,,
16114738268,1589.37292,17519417830,1601053791,17519409997,-7833,,
16114789239,1589.42389,17519468802,1601104758,17519460964,-7838,,
16114839832,1589.47448,17519519399,1601155349,17519511556,-7843,,
16114890428,1589.52508,17519569997,1601205942,17519562149,-7848,,
16114941468,1589.57612,17519621038,1601256979,17519613185,-7853,,
16114992105,1589.62675,17519671678,1601307613,17519663819,-7859,,
16115043034,1589.67768,17519722610,1601358540,17519714747,-7863,,
16115093269,1589.72792,17519772847,1601408773,17519764979,-7868,,
16115143582,1589.77823,17519823163,1601459082,17519815289,-7874,,
16115194212,1589.82886,17519873794,1601509710,17519865916,-7878,,
16115245214,1589.87986,17519924800,1601560722,17519916928,-7872,,
16115295596,1589.93024,17519975183,1601611088,17519967294,-7889,,
16115345730,1589.98038,17520025320,1601661221,17520017428,-7892,,
16115396750,1590.03140,17520076343,1601712237,17520068444,-7899,,
16115446915,1590.08156,17520126521,1601762411,17520118618,-7903,,
16115497577,1590.13223,17520177173,1601813058,17520169265,-7908,,
16115548261,1590.18291,17520227861,1601863741,17520219947,-7914,,
16115598750,1590.23340,17520278351,1601914226,17520270432,-7919,,
16115649157,1590.28381,17520328771,1601964641,17520320848,-7923,,
16115699485,1590.33413,17520379092,1602014956,17520371162,-7930,,
16115750079,1590.38473,17520429688,1602065547,17520421754,-7934,,
16115801129,1590.43578,17520480739,1602116594,17520472800,-7939,,
16115851267,1590.48591,17520530881,1602166729,17520522936,-7945,,
16115902318,1590.53697,17520581934,1602217779,17520573985,-7949,,
16115953350,1590.58800,17520632967,1602268807,17520625013,-7954,,
16116004032,1590.63868,17520683653,1602319487,17520675693,-7960,,
16116054097,1590.68874,17520733720,1602369550,17520725756,-7964,,
16116104666,1590.73931,17520784292,1602420115,17520776322,-7970,,
16116155221,1590.78987,17520834848,1602470667,17520826873,-7975,,
16116205765,1590.84041,17520885395,1602521209,17520877416,-7979,,
16116256417,1590.89107,17520936050,1602571858,17520928065,-7985,,
16116307470,1590.94212,17520987104,1602622908,17520979115,-7989,,
16116358069,1590.99272,17521037705,1602673504,17521029711,-7994,,
16116408691,1591.04334,17521088330,1602724124,17521080331,-7999,,
16116458798,1591.09345,17521138440,1602774228,17521130435,-8005,,
16116509788,1591.14444,17521189432,1602825215,17521181422,-8010,,
16116560359,1591.19501,17521240006,1602875784,17521231991,-8015,,
16116610458,1591.24511,17521290106,1602925880,17521282087,-8019,,
16116661137,1591.29579,17521340798,1602976567,17521332773,-8025,,
16116711732,1591.34638,17521391386,1603027148,17521383355,-8031,,
16116762333,1591.39698,17521441989,1603077748,17521433954,-8035,,
16116812910,1591.44756,17521492567,1603128321,17521484527,-8040,,
16116863968,1591.49862,17521543628,1603179376,17521535582,-8046,,
16116914998,1591.54965,17521594661,1603230404,17521586611,-8050,,
16116965282,1591.59993,17521644948,1603280686,17521636892,-8056,,
16117015843,1591.65049,17521695511,1603331244,17521687450,-8061,,
16117066412,1591.70106,17521746082,1603381810,17521738016,-8066,,
16117116996,1591.75164,17521796669,1603432391,17521788598,-8071,,
16117167600,1591.80225,17521847275,1603482992,17521839199,-8076,,
16117218206,1591.85285,17521897882,1603533595,17521889801,-8081,,
16117269247,1591.90389,17521948927,1603584634,17521940841,-8086,,
16117320324,1591.95497,17522000006,1603635708,17521991915,-8091,,
16117370903,1592.00555,17522050587,1603686284,17522042491,-8096,,
16117421743,1592.05639,17522101430,1603737121,17522093328,-8102,,
16117472239,1592.10689,17522151927,1603787615,17522143822,-8105,,
16117522844,1592.15749,17522202534,1603838217,17522194423,-8111,,
16117572984,1592.20763,17522252678,1603888355,17522244561,-8117,,
16117623516,1592.25816,17522303223,1603938896,17522295102,-8121,,
16117674074,1592.30872,17522353772,1603989440,17522345646,-8126,,
16117724705,1592.35935,17522404406,1604040068,17522396274,-8132,,
16117775011,1592.40966,17522454714,1604090372,17522446578,-8136,,
16117825581,1592.46023,17522505286,1604140938,17522497144,-8142,,
16117875689,1592.51034,17522555397,1604191043,17522547250,-8147,,
16117926307,1592.56095,17522606017,1604241658,17522597865,-8152,,
16117976892,1592.61154,17522656605,1604292242,17522648448,-8157,,
16118027957,1592.66260,17522707672,1604343304,17522699510,-8162,,
16118078549,1592.71320,17522758266,1604393893,17522750099,-8167,,
16118129530,1592.76418,17522809261,1604444882,17522801089,-8172,,
16118180054,1592.81470,17522859775,1604495392,17522851598,-8177,,
16118231163,1592.86581,17522910887,1604546499,17522902705,-8182,,
16118282086,1592.91673,17522961813,1604597419,17522953626,-8187,,
16118332661,1592.96731,17523012401,1604648002,17523004209,-8192,,
16118383590,1593.01824,17523063321,1604698918,17523055124,-8197,,
16118434101,1593.06875,17523113835,1604749425,17523105632,-8203,,
16118485057,1593.11971,17523164792,1604800379,17523156586,-8206,,
16118536152,1593.17080,17523215891,1604851471,17523207677,-8214,,
16118586848,1593.22150,17523266589,1604902164,17523258371,-8218,,
16118636908,1593.27156,17523316651,1604952222,17523308428,-8223,,
16118687573,1593.32222,17523367318,1605002884,17523359090,-8228,,
16118738123,1593.37277,17523417871,1605053432,17523409638,-8233,,
16118788669,1593.42332,17523468419,1605103975,17523460181,-8238,,
16118839129,1593.47378,17523518882,1605154433,17523510639,-8243,,
16118889703,1593.52435,17523569458,1605205004,17523561210,-8248,,
16118940273,1593.57492,17523620030,1605255570,17523611777,-8253,,
16118991306,1593.62595,17523671066,1605306602,17523662809,-8257,,
16119042300,1593.67695,17523722062,1605357593,17523713799,-8263,,
16119093330,1593.72798,17523773094,1605408619,17523764826,-8268,,
16119143928,1593.77858,17523823694,1605459214,17523815435,-8259,,
16119194977,1593.82963,17523874746,1605510261,17523866468,-8278,,
16119245504,1593.88015,17523925276,1605560786,17523916992,-8284,,
16119296073,1593.93072,17523975846,1605611351,17523967557,-8289,,
16119346621,1593.98127,17524026397,1605661897,17524018104,-8293,,
16119397669,1594.03232,17524077448,1605712942,17524069148,-8300,,
16119448688,1594.08334,17524128468,1605763958,17524120164,-8304,,
16119498738,1594.13339,17524178521,1605814006,17524170212,-8309,,
16119548835,1594.18348,17524228622,1605864101,17524220308,-8314,,
16119599828,1594.23448,17524279617,1605915092,17524271298,-8319,,
16119651833,1594.28648,17524331623,1605967092,17524323299,-8324,,
16119702443,1594.33709,17524382236,1606017700,17524373906,-8330,,
16119753502,1594.38815,17524433297,1606068756,17524424963,-8334,,
16119803851,1594.43850,17524483649,1606119102,17524475309,-8340,,
16119854681,1594.48933,17524534481,1606169929,17524526136,-8345,,
16119904941,1594.53959,17524584742,1606220187,17524576393,-8349,,
16119955548,1594.59020,17524635353,1606270792,17524626998,-8355,,
16120006103,1594.64075,17524685909,1606321343,17524677549,-8360,,
16120056231,1594.69088,17524736039,1606371469,17524727675,-8364,,
16120106616,1594.74126,17524786427,1606421851,17524778057,-8370,,
16120156735,1594.79138,17524836559,1606471978,17524828184,-8375,,
16120207247,1594.84190,17524887063,1606522476,17524878683,-8380,,
16120257349,1594.89200,17524937168,1606572577,17524928783,-8385,,
16120308399,1594.94305,17524988220,1606623623,17524979829,-8391,,
16120359243,1594.99389,17525039077,1606674476,17525030682,-8395,,
16120410329,1595.04498,17525090155,1606725549,17525081756,-8399,,
16120460842,1595.09549,17525140670,1606776059,17525132265,-8405,,
16120511894,1595.14654,17525191724,1606827107,17525183314,-8410,,
16120562932,1595.19758,17525242764,1606878142,17525234348,-8416,,
16120613480,1595.24813,17525293314,1606928688,17525284894,-8420,,
16120664564,1595.29921,17525344401,1606979769,17525335975,-8426,,
16120715578,1595.35023,17525395418,1607030780,17525386986,-8432,,
16120766173,1595.40082,17525446014,1607081373,17525437580,-8434,,
16120817175,1595.45182,17525497020,1607132372,17525488579,-8441,,
16120867265,1595.50191,17525547112,1607182459,17525538666,-8446,,
16120917914,1595.55256,17525597763,1607233106,17525589312,-8451,,
16120968484,1595.60313,17525648336,1607283673,17525639879,-8457,,
16121019543,1595.65419,17525699408,1607334741,17525690947,-8461,,
16121070081,1595.70473,17525749937,1607385264,17525741471,-8466,,
16121120881,1595.75553,17525800739,1607436062,17525792268,-8471,,
16121171959,1595.80661,17525851819,1607487137,17525843343,-8476,,
16121222980,1595.85763,17525902843,1607538155,17525894361,-8482,,
16121273967,1595.90862,17525953833,1607589139,17525945346,-8487,,
16121325045,1595.95969,17526004913,1607640215,17525996422,-8491,,
16121376134,1596.01078,17526056005,1607691301,17526047507,-8498,,
16121427127,1596.06177,17526107000,1607742291,17526098498,-8502,,
16121477515,1596.11216,17526157390,1607792676,17526148883,-8507,,
16121528615,1596.16326,17526208492,1607843774,17526199981,-8511,,
16121579659,1596.21431,17526259539,1607894816,17526251022,-8517,,
16121630218,1596.26487,17526310099,1607945371,17526301577,-8522,,
16121681213,1596.31586,17526361098,1607996364,17526352571,-8527,,
16121731398,1596.36605,17526411284,1608046546,17526402752,-8532,,
16121782434,1596.41708,17526462335,1608097591,17526453797,-8538,,
16121833110,1596.46776,17526513002,1608148253,17526504459,-8543,,
16121883632,1596.51828,17526563525,1608198772,17526554978,-8547,,
16121934252,1596.56890,17526614149,1608249390,17526605596,-8553,,
16121984780,1596.61943,17526664679,1608299914,17526656121,-8558,,
16122035475,1596.67012,17526715376,1608350608,17526706814,-8562,,
16122085780,1596.72043,17526765684,1608400910,17526757116,-8568,,
16122136370,1596.77102,17526816275,1608451496,17526807702,-8573,,
16122187385,1596.82203,17526867293,1608502510,17526858716,-8577,,
16122237929,1596.87258,17526917840,1608553051,17526909257,-8583,,
16122288457,1596.92311,17526968375,1608603581,17526959787,-8588,,
16122339016,1596.97366,17527018931,1608654131,17527010338,-8593,,
16122389911,1597.02456,17527069839,1608705035,17527061242,-8597,,
16122440117,1597.07477,17527120037,1608755228,17527111434,-8603,,
16122490661,1597.12531,17527170582,1608805768,17527161974,-8608,,
16122540698,1597.17535,17527220622,1608855803,17527212009,-8613,,
16122591274,1597.22592,17527271201,1608906377,17527262583,-8618,,
16122642335,1597.27698,17527322265,1608957434,17527313641,-8624,,
16122692853,1597.32750,17527372785,1609007950,17527364156,-8629,,
16122742916,1597.37756,17527422850,1609058010,17527414217,-8633,,
16122793031,1597.42768,17527472967,1609108122,17527464329,-8638,,
16122843277,1597.47792,17527523216,1609158365,17527514572,-8644,,
16122893866,1597.52851,17527573806,1609208952,17527565158,-8648,,
16122944628,1597.57928,17527624571,1609259711,17527615918,-8653,,
16122995686,1597.63033,17527675637,1609310771,17527666977,-8660,,
16123046304,1597.68095,17527726251,1609361382,17527717588,-8663,,
16123097088,1597.73174,17527777039,1609412164,17527768370,-8669,,
16123147834,1597.78248,17527827787,1609462907,17527819113,-8674,,
16123198210,1597.83286,17527878164,1609513279,17527869485,-8679,,
16123248770,1597.88342,17527928728,1609563838,17527920044,-8684,,
16123299047,1597.93369,17527979007,1609614111,17527970318,-8689,,
16123349918,1597.98457,17528029880,1609664979,17528021186,-8694,,
16123400527,1598.03517,17528080491,1609715586,17528071792,-8699,,
16123451194,1598.08584,17528131161,1609766250,17528122457,-8704,,
16123502152,1598.13680,17528182122,1609817205,17528173411,-8711,,
16123553098,1598.18775,17528233070,1609868148,17528224355,-8715,,
16123603831,1598.23848,17528283805,1609918879,17528275086,-8719,,
16123654643,1598.28929,17528334620,1609969688,17528325895,-8725,,
16123704868,1598.33952,17528384846,1610019910,17528376116,-8730,,
16123755849,1598.39050,17528435830,1610070890,17528427096,-8734,,
16123806098,1598.44075,17528486081,1610121135,17528477342,-8739,,
16123857271,1598.49192,17528537257,1610172305,17528528512,-8745,,
16123907443,1598.54209,17528587430,1610222474,17528578680,-8750,,
16123958478,1598.59313,17528638469,1610273507,17528629713,-8756,,
16124008566,1598.64321,17528688559,1610323592,17528679799,-8760,,
16124058873,1598.69352,17528738868,1610373896,17528730103,-8765,,
16124109509,1598.74416,17528789506,1610424530,17528780736,-8770,,
16124160361,1598.79501,17528840361,1610475380,17528831586,-8775,,
16124210923,1598.84557,17528890924,1610525938,17528882144,-8780,,
16124261450,1598.89610,17528941455,1610576464,17528932670,-8785,,
16124311969,1598.94662,17528991987,1610626991,17528983198,-8789,,
16124362547,1598.99719,17529042557,1610677555,17529033761,-8796,,
16124413486,1599.04813,17529093498,1610728491,17529084697,-8801,,
16124463811,1599.09846,17529143825,1610778814,17529135020,-8805,,
16124514309,1599.14896,17529194326,1610829308,17529185515,-8811,,
16124564874,1599.19952,17529244903,1610879880,17529236087,-8816,,
16124615320,1599.24997,17529295340,1610930313,17529286520,-8820,,
16124665697,1599.30035,17529345721,1610980688,17529336895,-8826,,
16124716252,1599.35090,17529396278,1611031241,17529387447,-8831,,
16124766432,1599.40108,17529446460,1611081418,17529437625,-8835,,
16124816678,1599.45133,17529496708,1611131661,17529487867,-8841,,
16124866806,1599.50145,17529546838,1611181786,17529537992,-8846,,
16124917754,1599.55240,17529597801,1611232743,17529588950,-8851,,
16124968296,1599.60294,17529648334,1611283272,17529639478,-8856,,
16125019250,1599.65390,17529699290,1611334223,17529690429,-8861,,
16125069786,1599.70443,17529749828,1611384756,17529740963,-8865,,
16125120027,1599.75467,17529800072,1611434995,17529791201,-8871,,
16125170460,1599.80511,17529850507,1611485424,17529841631,-8876,,
16125220864,1599.85551,17529900913,1611535825,17529892032,-8881,,
16125270968,1599.90562,17529951019,1611585927,17529942133,-8886,,
16125321481,1599.95613,17530001535,1611636438,17529992644,-8891,,
16125372097,1600.00674,17530052153,1611687050,17530043257,-8896,,
16125422202,1600.05685,17530102261,1611737153,17530093359,-8902,,
16125472774,1600.10742,17530152835,1611787722,17530143929,-8906,,
16125522916,1600.15756,17530202978,1611837861,17530194067,-8911,,
16125573728,1600.20838,17530253793,1611888670,17530244876,-8917,,
16125624538,1600.25919,17530304618,1611939490,17530295697,-8921,,
16125674936,1600.30958,17530355006,1611989873,17530346080,-8926,,
16125725562,1600.36021,17530405635,1612040496,17530396702,-8933,,
16125776202,1600.41085,17530456277,1612091134,17530447341,-8936,,
16125826778,1600.46143,17530506857,1612141708,17530497915,-8942,,
16125877239,1600.51189,17530557319,1612192165,17530548372,-8947,,
16125927744,1600.56239,17530607826,1612242668,17530598874,-8952,,
16125978409,1600.61306,17530658493,1612293330,17530649537,-8956,,
16126028670,1600.66332,17530708757,1612343588,17530699794,-8963,,
16126079162,1600.71381,17530759251,1612394078,17530750284,-8967,,
16126129330,1600.76398,17530809421,1612444243,17530800450,-8971,,
16126180236,1600.81488,17530860330,1612495147,17530851353,-8977,,
16126231271,1600.86592,17530911366,1612546178,17530902384,-8982,,
16126281389,1600.91604,17530961487,1612596293,17530952499,-8988,,
16126331529,1600.96618,17531011630,1612646443,17531002649,-8981,,
16126381997,1601.01664,17531062100,1612696896,17531053102,-8998,,
16126432335,1601.06698,17531112441,1612747232,17531103438,-9003,,
16126482968,1601.11762,17531163075,1612797862,17531154068,-9007,,
16126533562,1601.16821,17531213672,1612848453,17531204660,-9012,,
16126584671,1601.21932,17531264784,1612899560,17531255766,-9018,,
16126634804,1601.26945,17531314919,1612949690,17531305897,-9022,,
16126684972,1601.31962,17531365090,1612999856,17531356062,-9028,,
16126735119,1601.36977,17531415239,1613049999,17531406206,-9033,,
16126785684,1601.42033,17531465805,1613100562,17531456778,-9027,,
16126835899,1601.47055,17531516034,1613150785,17531506991,-9043,,
16126886657,1601.52130,17531566794,1613201539,17531557746,-9048,,
16126937752,1601.57240,17531617880,1613252621,17531608827,-9053,,
16126988276,1601.62292,17531668408,1613303143,17531659350,-9058,,
16127038444,1601.67309,17531718578,1613353308,17531709515,-9063,,
16127089086,1601.72373,17531769221,1613403947,17531760153,-9068,,
16127139238,1601.77389,17531819377,1613454097,17531810303,-9074,,
16127189355,1601.82400,17531869496,1613504211,17531860418,-9078,,
16127240003,1601.87465,17531920146,1613554868,17531911074,-9072,,
16127290597,1601.92524,17531970743,1613605448,17531961664,-9079,,
16127340890,1601.97554,17532021038,1613655739,17532011945,-9093,,
16127391520,1602.02617,17532071670,1613706365,17532062572,-9098,,
16127441671,1602.07632,17532121824,1613756513,17532112720,-9104,,
16127491797,1602.12645,17532171951,1613806637,17532162843,-9108,,
16127541893,1602.17654,17532222050,1613856730,17532212937,-9113,,
16127592037,1602.22669,17532272197,1613906871,17532263078,-9119,,
16127642194,1602.27684,17532322355,1613957026,17532313232,-9123,,
16127692330,1602.32698,17532372504,1614007169,17532363376,-9128,,
16127742501,1602.37715,17532422668,1614057357,17532413563,-9105,,
16127792973,1602.42762,17532473141,1614107797,17532464003,-9138,,
16127843175,1602.47782,17532523346,1614157996,17532514203,-9143,,
16127894291,1602.52894,17532574464,1614209109,17532565315,-9149,,
16127944674,1602.57932,17532624850,1614259489,17532615696,-9154,,
16127995347,1602.63000,17532675525,1614310161,17532666367,-9158,,
16128045436,1602.68008,17532725617,1614360246,17532716453,-9164,,
16128095603,1602.73025,17532775785,1614410420,17532766626,-9159,,
16128146227,1602.78087,17532826412,1614461032,17532817238,-9174,,
16128196899,1602.83155,17532877086,1614511701,17532867907,-9179,,
16128247427,1602.88207,17532927617,1614562226,17532918433,-9184,,
16128298017,1602.93267,17532978209,1614612825,17532969032,-9177,,
16128348574,1602.98322,17533028769,1614663368,17533019575,-9194,,
16128398637,1603.03328,17533078834,1614713428,17533069634,-9200,,
16128449253,1603.08390,17533129453,1614764042,17533120249,-9204,,
16128499874,1603.13452,17533180075,1614814659,17533170866,-9209,,
16128550830,1603.18548,17533231034,1614865613,17533221820,-9214,,
16128601394,1603.23604,17533281601,1614916174,17533272391,-9210,,
16128652033,1603.28668,17533332242,1614966811,17533323017,-9225,,
16128703068,1603.33772,17533383279,1615017844,17533374050,-9229,,
16128753914,1603.38856,17533434128,1615068687,17533424893,-9235,,
16128804531,1603.43918,17533484747,1615119301,17533475507,-9240,,
16128855126,1603.48977,17533535344,1615169893,17533526100,-9244,,
16128905320,1603.53997,17533585540,1615220084,17533576290,-9250,,
16128955858,1603.59051,17533636081,1615270620,17533626826,-9255,,
16129006827,1603.64147,17533687051,1615321586,17533677792,-9259,,
16129057386,1603.69203,17533737614,1615372142,17533728349,-9265,,
16129107965,1603.74261,17533788195,1615422718,17533778925,-9270,,
16129158150,1603.79280,17533838382,1615472901,17533829107,-9275,,
16129208885,1603.84353,17533889120,1615523633,17533879840,-9280,,
16129259839,1603.89449,17533940086,1615574595,17533930802,-9284,,
16129310479,1603.94513,17533990718,1615625221,17533981427,-9291,,
16129361081,1603.99573,17534041322,1615675821,17534032027,-9295,,
16129411677,1604.04633,17534091920,1615726414,17534082620,-9300,,
16129462727,1604.09738,17534142974,1615777461,17534133668,-9306,,
16129513688,1604.14834,17534193936,1615828420,17534184626,-9310,,
16129564302,1604.19895,17534244553,1615879031,17534235238,-9315,,
16129614417,1604.24906,17534294671,1615929143,17534285349,-9322,,
16129665035,1604.29968,17534345291,1615979758,17534335965,-9326,,
16129715657,1604.35030,17534395916,1616030380,17534386586,-9330,,
16129766191,1604.40084,17534446452,1616080909,17534437116,-9336,,
16129816761,1604.45141,17534497024,1616131476,17534487682,-9342,,
16129867305,1604.50195,17534547570,1616182019,17534538235,-9335,,
16129918379,1604.55303,17534598647,1616233090,17534589296,-9351,,
16129968972,1604.60362,17534649241,1616283679,17534639886,-9355,,
16130019139,1604.65379,17534699412,1616333844,17534690051,-9361,,
16130069763,1604.70441,17534750038,1616384475,17534740682,-9356,,
16130120405,1604.75505,17534800682,1616435104,17534791311,-9371,,
16130171320,1604.80597,17534851599,1616486017,17534842223,-9376,,
16130222064,1604.85671,17534902346,1616536758,17534892965,-9381,,
16130272758,1604.90741,17534953041,1616587449,17534943656,-9385,,
16130323703,1604.95835,17535003990,1616638391,17534994598,-9392,,
16130374303,1605.00895,17535054591,1616688989,17535045195,-9396,,
16130424933,1605.05958,17535105223,1616739616,17535095822,-9401,,
16130475907,1605.11055,17535156201,1616790587,17535146794,-9407,,
16130526446,1605.16109,17535206742,1616841124,17535197330,-9412,,
16130577000,1605.21165,17535257297,1616891675,17535247882,-9415,,
16130628073,1605.26272,17535308373,1616942745,17535298952,-9421,,
16130678692,1605.31334,17535358995,1616993362,17535349568,-9427,,
16130729315,1605.36396,17535409633,1617043995,17535400202,-9431,,
16130780392,1605.41504,17535460700,1617095057,17535451263,-9437,,
16130830887,1605.46554,17535511197,1617145549,17535501755,-9442,,
16130881983,1605.51663,17535562296,1617196641,17535552848,-9448,,
16130932531,1605.56718,17535612845,1617247187,17535603394,-9451,,
16130983579,1605.61823,17535663895,1617298232,17535654439,-9456,,
16131034127,1605.66878,17535714447,1617348777,17535704983,-9464,,
16131085190,1605.71984,17535765512,1617399837,17535756044,-9468,,
16131135703,1605.77035,17535816027,1617450349,17535806555,-9472,,
16131186276,1605.82092,17535866603,1617500919,17535857125,-9478,,
16131236905,1605.87155,17535917233,1617551544,17535907750,-9483,,
16131287964,1605.92261,17535968295,1617602601,17535958807,-9488,,
16131338888,1605.97354,17536019222,1617653533,17536009740,-9482,,
16131389020,1606.02367,17536069355,1617703651,17536059857,-9498,,
16131440059,1606.07471,17536120398,1617754688,17536110894,-9504,,
16131490674,1606.12532,17536171014,1617805300,17536161506,-9508,,
16131541343,1606.17599,17536221685,1617855966,17536212172,-9513,,
16131591917,1606.22656,17536272263,1617906537,17536262744,-9519,,
16131642506,1606.27715,17536322853,1617957124,17536313330,-9523,,
16131693134,1606.32778,17536373484,1618007750,17536363956,-9528,,
16131744192,1606.37884,17536424545,1618058805,17536415011,-9534,,
16131794760,1606.42941,17536475115,1618109370,17536465577,-9538,,
16131845333,1606.47998,17536525690,1618159941,17536516147,-9543,,
16131895947,1606.53059,17536576307,1618210551,17536566757,-9550,,
16131946570,1606.58122,17536626932,1618261172,17536617378,-9554,,
16131997155,1606.63180,17536677520,1618311754,17536667961,-9559,,
16132048041,1606.68269,17536728408,1618362638,17536718844,-9564,,
16132098192,1606.73284,17536778560,1618412785,17536768991,-9569,,
16132149249,1606.78390,17536829620,1618463840,17536820046,-9574,,
16132200297,1606.83495,17536880671,1618514886,17536871092,-9579,,
16132250813,1606.88546,17536931189,1618565398,17536921604,-9585,,
16132301359,1606.93601,17536981737,1618615941,17536972147,-9590,,
16132351500,1606.98615,17537031881,1618666080,17537022287,-9594,,
16132402105,1607.03675,17537082488,1618716683,17537072901,-9587,,
16132453154,1607.08780,17537133540,1618767740,17537123947,-9593,,
16132503743,1607.13839,17537184131,1618818327,17537174534,-9597,,
16132554343,1607.18899,17537234733,1618868913,17537225131,-9602,,
16132605010,1607.23966,17537285403,1618919576,17537275783,-9620,,
16132655615,1607.29026,17537336010,1618970178,17537326385,-9625,,
16132706723,1607.34137,17537387121,1619021284,17537377491,-9630,,
16132756972,1607.39162,17537437372,1619071531,17537427737,-9635,,
16132807563,1607.44221,17537487965,1619122118,17537478325,-9640,,
16132858622,1607.49327,17537539027,1619173175,17537529382,-9645,,
16132909038,1607.54369,17537589445,1619223588,17537579795,-9650,,
16132959603,1607.59425,17537640012,1619274151,17537630357,-9655,,
16133010143,1607.64479,17537690554,1619324687,17537680893,-9661,,
16133060735,1607.69538,17537741148,1619375277,17537731483,-9665,,
16133110865,1607.74551,17537791280,1619425404,17537781610,-9670,,
16133160967,1607.79561,17537841385,1619475503,17537831709,-9676,,
16133211551,1607.84620,17537891972,1619526086,17537882292,-9680,,
16133262633,1607.89728,17537943056,1619577164,17537933371,-9685,,
16133313250,1607.94790,17537993676,1619627779,17537983985,-9691,,
16133363797,1607.99844,17538044225,1619678323,17538034530,-9695,,
16133414430,1608.04908,17538094860,1619728953,17538085160,-9700,,
16133465460,1608.10011,17538145892,1619779980,17538136186,-9706,,
16133516519,1608.15117,17538196953,1619831036,17538187243,-9710,,
16133567163,1608.20181,17538247600,1619881678,17538237884,-9716,,
16133617311,1608.25196,17538297751,1619931823,17538288030,-9721,,
16133668360,1608.30301,17538348802,1619982869,17538339076,-9726,,
16133719009,1608.35366,17538399454,1620033516,17538389722,-9732,,
16133769445,1608.40409,17538449891,1620083949,17538440156,-9735,,
16133820479,1608.45513,17538500927,1620134980,17538491186,-9741,,
16133871129,1608.50578,17538551580,1620185627,17538541833,-9747,,
16133921733,1608.55638,17538602187,1620236230,17538592436,-9751,,
16133972342,1608.60699,17538652798,1620286835,17538643042,-9756,,
16134023333,1608.65798,17538703791,1620337823,17538694029,-9762,,
16134073966,1608.70861,17538754427,1620388454,17538744661,-9766,,
16134124580,1608.75923,17538805043,1620439065,17538795271,-9772,,
16134175073,1608.80972,17538855539,1620489555,17538845762,-9777,,
16134225709,1608.86036,17538906177,1620540188,17538896394,-9783,,
16134276226,1608.91087,17538956695,1620590702,17538946909,-9786,,
16134326721,1608.96137,17539007193,1620641195,17538997401,-9792,,
16134376912,1609.01156,17539057386,1620691383,17539047589,-9797,,
16134427353,1609.06200,17539107830,1620741822,17539098028,-9802,,
16134477946,1609.11259,17539158425,1620792412,17539148618,-9807,,
16134528507,1609.16315,17539208989,1620842970,17539199177,-9812,,
16134579109,1609.21376,17539259593,1620893570,17539249776,-9817,,
16134629247,1609.26390,17539309733,1620943705,17539299922,-9811,,
16134679830,1609.31448,17539360318,1620994285,17539350491,-9827,,
16134730396,1609.36504,17539410887,1621044848,17539401054,-9833,,
16134781476,1609.41612,17539461969,1621095926,17539452133,-9836,,
16134832036,1609.46668,17539512531,1621146483,17539502689,-9842,,
16134883072,1609.51772,17539563571,1621197517,17539553723,-9848,,
16134934097,1609.56875,17539614610,1621248552,17539604759,-9851,,
16134984697,1609.61935,17539665199,1621299136,17539655342,-9857,,
16135035745,1609.67039,17539716250,1621350181,17539706387,-9863,,
16135086794,1609.72144,17539767301,1621401227,17539757434,-9867,,
16135137843,1609.77249,17539818353,1621452274,17539808481,-9872,,
16135188892,1609.82354,17539869404,1621503320,17539859527,-9877,,
16135239435,1609.87408,17539919949,1621553860,17539910066,-9883,,
16135290449,1609.92510,17539970966,1621604871,17539961077,-9889,,
16135340597,1609.97525,17540021116,1621655017,17540011223,-9893,,
16135391097,1610.02574,17540071619,1621705514,17540061721,-9898,,
16135441575,1610.07622,17540122099,1621755989,17540112195,-9904,,
16135492178,1610.12683,17540172704,1621806590,17540162796,-9908,,
16135543253,1610.17790,17540223782,1621857663,17540213869,-9913,,
16135593895,1610.22854,17540274426,1621908301,17540264507,-9919,,
16135644482,1610.27913,17540325016,1621958886,17540315093,-9923,,
16135695080,1610.32973,17540375616,1622009481,17540365688,-9928,,
16135746133,1610.38078,17540426673,1622060533,17540416739,-9934,,
16135797214,1610.43186,17540477755,1622111609,17540467816,-9939,,
16135847853,1610.48250,17540528407,1622162257,17540518463,-9944,,
16135898036,1610.53268,17540578582,1622212426,17540568633,-9949,,
16135949043,1610.58369,17540629591,1622263431,17540619637,-9954,,
16135999615,1610.63426,17540680165,1622314000,17540670206,-9959,,
16136050639,1610.68529,17540731192,1622365021,17540721227,-9965,,
16136101619,1610.73627,17540782174,1622415998,17540772204,-9970,,
16136152246,1610.78689,17540832804,1622466622,17540822829,-9975,,
16136203285,1610.83793,17540883845,1622517660,17540873866,-9979,,
16136253832,1610.88848,17540934394,1622568203,17540924409,-9985,,
16136304384,1610.93903,17540984948,1622618752,17540974958,-9990,,
16136354979,1610.98963,17541035546,1622669345,17541025552,-9994,,
16136405622,1611.04027,17541086191,1622719985,17541076191,-10000,,
16136456305,1611.09095,17541136877,1622770666,17541126872,-10005,,
16136507355,1611.14200,17541187929,1622821712,17541177919,-10010,,
16136558262,1611.19291,17541238839,1622872617,17541228824,-10015,,
16136608845,1611.24349,17541289424,1622923197,17541279403,-10021,,
16136659468,1611.29412,17541340049,1622973818,17541330024,-10025,,
16136710010,1611.34466,17541390594,1623024357,17541380564,-10030,,
16136760623,1611.39527,17541441209,1623074967,17541431174,-10035,,
16136810721,1611.44537,17541491309,1623125062,17541481269,-10040,,
16136861795,1611.49644,17541542396,1623176144,17541532350,-10046,,
16136912433,1611.54708,17541593026,1623226769,17541582975,-10051,,
16136963497,1611.59814,17541644091,1623277830,17541634036,-10055,,
16137013621,1611.64827,17541694218,1623327951,17541684157,-10061,,
16137064705,1611.69935,17541745305,1623379033,17541735239,-10066,,
16137115260,1611.74991,17541795862,1623429585,17541785791,-10071,,
16137165857,1611.80050,17541846462,1623480180,17541836386,-10076,,
16137216051,1611.85070,17541896658,1623530370,17541886576,-10082,,
16137266617,1611.90126,17541947227,1623580944,17541937151,-10076,,
16137317233,1611.95188,17541997845,1623631547,17541987754,-10091,,
16137368312,1612.00296,17542048926,1623682623,17542038830,-10096,,
16137419369,1612.05402,17542099985,1623733678,17542089884,-10101,,
16137469958,1612.10461,17542150577,1623784265,17542140471,-10106,,
16137520957,1612.15560,17542201578,1623835261,17542191467,-10111,,
16137572020,1612.20667,17542252643,1623886319,17542242526,-10117,,
16137622651,1612.25730,17542303277,1623936950,17542293156,-10121,,
16137673247,1612.30789,17542353874,1623987542,17542343748,-10126,,
16137724295,1612.35894,17542404926,1624038587,17542394794,-10132,,
16137774846,1612.40949,17542455478,1624089136,17542445343,-10135,,
16137825568,1612.46022,17542506204,1624139855,17542496062,-10142,,
16137876201,1612.51085,17542556839,1624190485,17542546692,-10147,,
16137926779,1612.56143,17542607418,1624241071,17542597277,-10141,,
16137977384,1612.61203,17542658027,1624291663,17542647870,-10157,,
16138028010,1612.66266,17542708655,1624342286,17542698493,-10162,,
16138078661,1612.71331,17542759307,1624392934,17542749140,-10167,,
16138129239,1612.76389,17542809889,1624443510,17542799717,-10172,,
16138179780,1612.81443,17542860431,1624494048,17542850254,-10177,,
16138230527,1612.86517,17542911180,1624544792,17542900998,-10182,,
16138281514,1612.91616,17542962171,1624595776,17542951982,-10189,,
16138332110,1612.96676,17543012769,1624646370,17543002576,-10193,,
16138383158,1613.01781,17543063819,1624697415,17543053622,-10197,,
16138434194,1613.06884,17543114858,1624748448,17543104655,-10203,,
16138485222,1613.11987,17543165887,1624799474,17543155680,-10207,,
16138535395,1613.17004,17543216064,1624849644,17543205851,-10213,,
16138586432,1613.22108,17543267103,1624900679,17543256885,-10218,,
16138637037,1613.27168,17543317709,1624951280,17543307486,-10223,,
16138687291,1613.32194,17543367967,1625001532,17543357738,-10229,,
16138738374,1613.37302,17543419052,1625052612,17543408818,-10234,,
16138788982,1613.42363,17543469672,1625103227,17543459434,-10238,,
16138839499,1613.47415,17543520182,1625153733,17543509939,-10243,,
16138889655,1613.52430,17543570339,1625203885,17543560101,-10238,,
16138939828,1613.57448,17543620514,1625254055,17543610261,-10253,,
16138990388,1613.62504,17543671078,1625304624,17543660830,-10248,,
16139041041,1613.67569,17543721733,1625355263,17543711470,-10263,,
16139091586,1613.72623,17543772279,1625405805,17543762011,-10268,,
16139141693,1613.77634,17543822401,1625455920,17543812127,-10274,,
16139192214,1613.82686,17543872913,1625506428,17543862635,-10278,,
16139242276,1613.87692,17543922976,1625556487,17543912693,-10283,,
16139293309,1613.92796,17543974012,1625607517,17543963724,-10288,,
16139343391,1613.97804,17544024097,1625657597,17544013804,-10293,,
16139393975,1614.02862,17544074682,1625708178,17544064384,-10298,,
16139444577,1614.07922,17544125287,1625758777,17544114983,-10304,,
16139494700,1614.12935,17544175413,1625808898,17544165116,-10297,,
16139545288,1614.17994,17544226003,1625859483,17544215689,-10314,,
16139595886,1614.23053,17544276604,1625910078,17544266285,-10319,,
16139646467,1614.28111,17544327187,1625960656,17544316862,-10325,,
16139696672,1614.33132,17544377395,1626010859,17544367065,-10330,,
16139747741,1614.38239,17544428465,1626061925,17544418131,-10334,,
16139797857,1614.43250,17544478595,1626112049,17544468256,-10339,,
16139848424,1614.48307,17544529154,1626162603,17544518810,-10344,,
16139899471,1614.53412,17544580203,1626213648,17544569854,-10349,,
16139950520,1614.58517,17544631254,1626264693,17544620900,-10354,,
16140001570,1614.63622,17544682306,1626315740,17544671946,-10360,,
16140052618,1614.68727,17544733357,1626366786,17544722992,-10365,,
16140103667,1614.73832,17544784408,1626417832,17544774038,-10370,,
16140154697,1614.78934,17544835441,1626468870,17544825077,-10364,,
16140205755,1614.84040,17544886501,1626519919,17544876139,-10362,,
16140256812,1614.89146,17544937561,1626570969,17544927176,-10385,,
16140307831,1614.94248,17544988582,1626621985,17544978192,-10390,,
16140358376,1614.99302,17545039128,1626672527,17545028733,-10395,,
16140408461,1615.04311,17545089217,1626722610,17545078817,-10400,,
16140459507,1615.09416,17545140264,1626773653,17545129859,-10405,,
16140510543,1615.14519,17545191302,1626824686,17545180902,-10400,,
16140561140,1615.19579,17545241903,1626875281,17545231488,-10415,,
16140612231,1615.24688,17545292996,1626926370,17545282576,-10420,,
16140662843,1615.29749,17545343610,1626976979,17545333185,-10425,,
16140713334,1615.34798,17545394104,1627027466,17545383673,-10431,,
16140763870,1615.39852,17545444642,1627078000,17545434207,-10435,,
16140814908,1615.44956,17545495682,1627129035,17545485241,-10441,,
16140865489,1615.50014,17545546266,1627179613,17545535820,-10446,,
16140915585,1615.55023,17545596364,1627229707,17545585914,-10450,,
16140966153,1615.60080,17545646935,1627280273,17545636479,-10456,,
16141016369,1615.65102,17545697153,1627330485,17545686692,-10461,,
16141066728,1615.70138,17545747513,1627380841,17545737047,-10466,,
16141117290,1615.75194,17545798079,1627431402,17545787608,-10471,,
16141167409,1615.80206,17545848199,1627481517,17545837723,-10476,,
16141217534,1615.85218,17545898327,1627531639,17545887845,-10482,,
16141268319,1615.90297,17545949115,1627582423,17545938629,-10486,,
16141318401,1615.95305,17545999199,1627632502,17545988708,-10491,,
16141368937,1616.00358,17546049737,1627683035,17546039241,-10496,,
16141419463,1616.05411,17546100265,1627733558,17546089764,-10501,,
16141469820,1616.10447,17546150624,1627783912,17546140118,-10506,,
16141520357,1616.15501,17546201164,1627834446,17546190653,-10511,,
16141571364,1616.20601,17546252173,1627885450,17546241656,-10517,,
16141621493,1616.25614,17546302305,1627935578,17546291784,-10521,,
16141672044,1616.30669,17546352858,1627986125,17546342331,-10527,,
16141722578,1616.35723,17546403395,1628036656,17546392863,-10532,,
16141773641,1616.40829,17546454460,1628087718,17546443924,-10536,,
16141824725,1616.45937,17546505547,1628138798,17546495004,-10543,,
16141875518,1616.51017,17546556342,1628189588,17546545794,-10548,,
16141925759,1616.56041,17546606597,1628239840,17546596046,-10551,,
16141976804,1616.61145,17546657633,1628290869,17546647076,-10557,,
16142027391,1616.66204,17546708221,1628341464,17546697670,-10551,,
16142077540,1616.71219,17546758373,1628391599,17546747805,-10568,,
16142128146,1616.76279,17546808981,1628442203,17546798409,-10572,,
16142179234,1616.81388,17546860072,1628493289,17546849495,-10577,,
16142229774,1616.86442,17546910624,1628543836,17546900043,-10581,,
16142280440,1616.91509,17546961283,1628594489,17546950695,-10588,,
16142330991,1616.96564,17547011835,1628645037,17547001243,-10592,,
16142381043,1617.01569,17547061889,1628695086,17547051292,-10597,,
16142431148,1617.06580,17547111998,1628745188,17547101394,-10604,,
16142481742,1617.11639,17547162594,1628795780,17547151987,-10607,,
16142532791,1617.16744,17547213644,1628846826,17547203032,-10612,,
16142582973,1617.21762,17547263830,1628897005,17547253212,-10618,,
16142633397,1617.26805,17547314256,1628947428,17547303634,-10622,,
16142684249,1617.31890,17547365109,1628998276,17547354482,-10627,,
16142734849,1617.36950,17547415712,1629048873,17547405079,-10633,,
16142785356,1617.42000,17547466221,1629099378,17547455585,-10636,,
16142836202,1617.47085,17547517071,1629150222,17547506428,-10643,,
16142886281,1617.52093,17547567152,1629200297,17547556504,-10648,,
16142936813,1617.57146,17547617685,1629250826,17547607032,-10653,,
16142987784,1617.62243,17547668660,1629301796,17547658002,-10658,,
16143038412,1617.67306,17547719289,1629352420,17547708627,-10662,,
16143088586,1617.72323,17547769465,1629402591,17547758797,-10668,,
16143139397,1617.77404,17547820280,1629453400,17547809606,-10674,,
16143190034,1617.82468,17547870919,1629504034,17547860240,-10679,,
16143240624,1617.87527,17547921510,1629554621,17547910827,-10683,,
16143291222,1617.92587,17547972112,1629605216,17547961423,-10689,,
16143342225,1617.97687,17548023117,1629656217,17548012423,-10694,,
16143392821,1618.02747,17548073715,1629706810,17548063017,-10698,,
16143443878,1618.07853,17548124775,1629757864,17548114071,-10704,,
16143494469,1618.12912,17548175367,1629808463,17548164669,-10698,,
16143544670,1618.17932,17548225571,1629858651,17548214858,-10713,,
16143595268,1618.22992,17548276172,1629909246,17548265452,-10720,,
16143646072,1618.28072,17548326978,1629960047,17548316254,-10724,,
16143696669,1618.33132,17548377578,1630010642,17548366849,-10729,,
16143747306,1618.38195,17548428217,1630061276,17548417482,-10735,,
16143797428,1618.43208,17548478340,1630111395,17548467601,-10739,,
16143847821,1618.48247,17548528736,1630161786,17548517992,-10744,,
16143898458,1618.53311,17548579376,1630212420,17548568627,-10749,,
16143949519,1618.58417,17548630438,1630263478,17548619684,-10754,,
16144000548,1618.63520,17548681470,1630314505,17548670711,-10759,,
16144051495,1618.68614,17548732420,1630365449,17548721656,-10764,,
16144102107,1618.73675,17548783033,1630416058,17548772264,-10769,,
16144152264,1618.78691,17548833193,1630466212,17548822418,-10775,,
16144203337,1618.83798,17548884268,1630517282,17548873489,-10779,,
16144253944,1618.88859,17548934877,1630567887,17548924093,-10784,,
16144304803,1618.93945,17548985740,1630618743,17548974949,-10791,,
16144355347,1618.98999,17549036286,1630669286,17549025492,-10794,,
16144405457,1619.04011,17549086399,1630719393,17549075599,-10800,,
16144456502,1619.09115,17549137445,1630770434,17549126641,-10804,,
16144507116,1619.14176,17549188061,1630821045,17549177251,-10810,,
16144557742,1619.19239,17549238691,1630871669,17549227876,-10815,,
16144608817,1619.24347,17549289768,1630922741,17549278948,-10820,,
16144659547,1619.29419,17549340500,1630973468,17549329674,-10826,,
16144710118,1619.34477,17549391074,1631024048,17549380255,-10819,,
16144761200,1619.39585,17549442158,1631075117,17549431323,-10835,,
16144811761,1619.44641,17549492721,1631125675,17549481881,-10840,,
16144862809,1619.49746,17549543772,1631176719,17549532925,-10847,,
16144913857,1619.54850,17549594821,1631227765,17549583971,-10850,,
16144964444,1619.59909,17549645412,1631278349,17549634556,-10856,,
16145015475,1619.65012,17549696445,1631329388,17549685594,-10851,,
16145066543,1619.70119,17549747515,1631380443,17549736649,-10866,,
16145117148,1619.75180,17549798122,1631431045,17549787251,-10871,,
16145168216,1619.80286,17549849193,1631482110,17549838316,-10877,,
16145218378,1619.85303,17549899356,1631532269,17549888475,-10881,,
16145268971,1619.90362,17549949952,1631582859,17549939066,-10886,,
16145320009,1619.95466,17550000993,1631633895,17549990101,-10892,,
16145370597,1620.00525,17550051593,1631684491,17550040697,-10896,,
16145421220,1620.05587,17550102209,1631735101,17550091307,-10902,,
16145472294,1620.10694,17550153284,1631786172,17550142378,-10906,,
16145523341,1620.15799,17550204334,1631837217,17550193423,-10911,,
16145573778,1620.20843,17550254773,1631887650,17550243856,-10917,,
16145624804,1620.25945,17550305802,1631938674,17550294881,-10921,,
16145674986,1620.30963,17550355987,1631988853,17550345060,-10927,,
16145726057,1620.36071,17550407060,1632039921,17550396127,-10933,,
16145776181,1620.41083,17550457186,1632090044,17550446250,-10936,,
16145827997,1620.46265,17550509005,1632141857,17550498063,-10942,,
16145878482,1620.51313,17550559491,1632192338,17550548544,-10947,,
16145929447,1620.56409,17550610459,1632243301,17550599507,-10952,,
16145979589,1620.61424,17550660604,1632293440,17550649647,-10957,,
16146030600,1620.66525,17550711617,1632344448,17550700654,-10963,,
16146081216,1620.71586,17550762235,1632395061,17550751267,-10968,,
16146131821,1620.76647,17550812843,1632445663,17550801870,-10973,,
16146182369,1620.81702,17550863393,1632496209,17550852415,-10978,,
16146232977,1620.86763,17550914003,1632546815,17550903021,-10982,,
16146283980,1620.91863,17550965008,1632597814,17550954020,-10988,,
16146334588,1620.96924,17551015618,1632648420,17551004626,-10992,,
16146385093,1621.01974,17551066126,1632698922,17551055128,-10998,,
16146436010,1621.07066,17551117046,1632749836,17551106043,-11003,,
16146487072,1621.12172,17551168109,1632800895,17551157101,-11008,,
16146538120,1621.17277,17551219160,1632851941,17551208147,-11013,,
16146588730,1621.22338,17551269772,1632902548,17551258754,-11018,,
16146639362,1621.27401,17551320406,1632953177,17551309383,-11023,,
16146689990,1621.32464,17551371038,1633003803,17551360010,-11028,,
16146741075,1621.37572,17551422125,1633054886,17551411092,-11033,,
16146792121,1621.42677,17551473173,1633105929,17551462135,-11038,,
16146842660,1621.47731,17551523715,1633156465,17551512671,-11044,,
16146893670,1621.52832,17551574727,1633207472,17551563679,-11048,,
16146943896,1621.57854,17551624956,1633257695,17551613901,-11055,,
16146994390,1621.62904,17551675452,1633308186,17551664393,-11059,,
16147044994,1621.67964,17551726059,1633358790,17551714996,-11063,,
16147095690,1621.73034,17551776757,1633409482,17551765689,-11068,,
16147146251,1621.78090,17551827320,1633460040,17551816246,-11074,,
16147196841,1621.83149,17551877912,1633510638,17551866845,-11067,,
16147247485,1621.88213,17551928559,1633561269,17551917475,-11084,,
16147297872,1621.93252,17551978948,1633611652,17551967859,-11089,,
16147348456,1621.98310,17552029534,1633662233,17552018439,-11095,,
16147398972,1622.03362,17552080053,1633712748,17552068954,-11099,,
16147449536,1622.08418,17552130619,1633763308,17552119514,-11105,,
16147500585,1622.13523,17552181669,1633814354,17552170560,-11109,,
16147551143,1622.18579,17552232231,1633864910,17552221117,-11114,,
16147601766,1622.23641,17552282856,1633915530,17552271737,-11119,,
16147652341,1622.28699,17552333432,1633966102,17552322309,-11123,,
16147702452,1622.33710,17552383547,1634016211,17552372417,-11130,,
16147752568,1622.38722,17552433665,1634066324,17552422531,-11134,,
16147803208,1622.43786,17552484319,1634116973,17552473179,-11140,,
16147854276,1622.48892,17552535378,1634168027,17552524233,-11145,,
16147904764,1622.53941,17552585868,1634218512,17552574719,-11149,,
16147955301,1622.58995,17552636407,1634269046,17552625253,-11154,,
16148005392,1622.64004,17552686501,1634319134,17552675341,-11160,,
16148055479,1622.69013,17552736590,1634369220,17552725426,-11164,,
16148106091,1622.74074,17552787204,1634419828,17552776034,-11170,,
16148156632,1622.79128,17552837748,1634470377,17552826583,-11165,,
16148207257,1622.84190,17552888375,1634520988,17552877194,-11181,,
16148257858,1622.89251,17552938978,1634571587,17552927793,-11185,,
16148308833,1622.94348,17552989956,1634622559,17552978765,-11191,,
16148359395,1622.99404,17553040520,1634673119,17553029325,-11195,,
16148409946,1623.04459,17553091073,1634723667,17553079873,-11200,,
16148460515,1623.09516,17553141656,1634774244,17553130451,-11205,,
16148511231,1623.14588,17553192363,1634824946,17553181153,-11210,,
16148562283,1623.19693,17553243417,1634875995,17553232201,-11216,,
16148612375,1623.24702,17553293511,1634926085,17553282291,-11220,,
16148662931,1623.29758,17553344070,1634976638,17553332845,-11225,,
16148713554,1623.34820,17553394706,1635027268,17553383475,-11231,,
16148764180,1623.39883,17553445323,1635077882,17553434088,-11235,,
16148814331,1623.44898,17553495477,1635128030,17553484236,-11241,,
16148865348,1623.50000,17553546497,1635179045,17553535251,-11246,,
16148916383,1623.55103,17553597534,1635230077,17553586284,-11250,,
16148966793,1623.60144,17553647947,1635280485,17553636691,-11256,,
16149017791,1623.65244,17553698947,1635331479,17553687686,-11261,,
16149068413,1623.70306,17553749571,1635382108,17553738315,-11256,,
16149119041,1623.75369,17553800201,1635432724,17553788930,-11271,,
16149169645,1623.80429,17553850808,1635483325,17553839532,-11276,,
16149220233,1623.85488,17553901397,1635533910,17553890116,-11281,,
16149270366,1623.90501,17553951534,1635584042,17553940248,-11286,,
16149320498,1623.95515,17554001668,1635634171,17553990377,-11291,,
16149370604,1624.00525,17554051787,1635684285,17554040491,-11296,,
16149421658,1624.05631,17554102833,1635735325,17554091531,-11302,,
16149472099,1624.10675,17554153276,1635785774,17554141980,-11296,,
16149523166,1624.15781,17554204345,1635836827,17554193034,-11311,,
16149574191,1624.20884,17554255373,1635887849,17554244066,-11307,,
16149624339,1624.25899,17554305522,1635937995,17554294201,-11321,,
16149674492,1624.30914,17554355688,1635988155,17554344362,-11326,,
16149725093,1624.35974,17554406282,1636038754,17554394961,-11321,,
16149775619,1624.41027,17554456810,1636089268,17554445474,-11336,,
16149826178,1624.46083,17554507372,1636139824,17554496030,-11342,,
16149877214,1624.51186,17554558410,1636190857,17554547063,-11347,,
16149928260,1624.56291,17554609458,1636241900,17554598106,-11352,,
16149978329,1624.61298,17554659530,1636291967,17554648173,-11357,,
16150028865,1624.66351,17554710068,1636342500,17554698706,-11362,,
16150079419,1624.71407,17554760624,1636393050,17554749257,-11367,,
16150130046,1624.76469,17554811254,1636443676,17554799883,-11371,,
16150180594,1624.81524,17554861804,1636494221,17554850427,-11377,,
16150231154,1624.86580,17554912367,1636544778,17554900984,-11383,,
16150281556,1624.91620,17554962771,1636595177,17554951383,-11388,,
16150332601,1624.96725,17555013818,1636646219,17555002426,-11392,,
16150383137,1625.01779,17555064356,1636696752,17555052958,-11398,,
16150433213,1625.06786,17555114434,1636746825,17555103032,-11402,,
16150483806,1625.11845,17555165029,1636797416,17555153622,-11407,,
16150534438,1625.16909,17555215664,1636848045,17555204251,-11413,,
16150584936,1625.21958,17555266165,1636898541,17555254747,-11418,,
16150635271,1625.26992,17555316502,1636948873,17555305080,-11422,,
16150685802,1625.32045,17555367036,1636999402,17555355608,-11428,,
16150736362,1625.37101,17555417598,1637049959,17555406165,-11433,,
16150787380,1625.42203,17555468617,1637100973,17555457180,-11437,,
16150838362,1625.47301,17555519602,1637151953,17555508159,-11443,,
16150888921,1625.52357,17555570175,1637202520,17555558727,-11448,,
16150939476,1625.57412,17555620732,1637253073,17555609279,-11453,,
16150990514,1625.62516,17555671761,1637304097,17555660304,-11457,,
16151041050,1625.67570,17555722300,1637354630,17555710837,-11463,,
16151091677,1625.72633,17555772929,1637405254,17555761461,-11468,,
16151142043,1625.77669,17555823298,1637455617,17555811824,-11474,,
16151192630,1625.82728,17555873887,1637506202,17555862409,-11478,,
16151243433,1625.87808,17555924691,1637557002,17555913208,-11483,,
16151293981,1625.92863,17555975243,1637607548,17555963754,-11489,,
16151344585,1625.97923,17556025849,1637658149,17556014355,-11494,,
16151395111,1626.02976,17556076377,1637708672,17556064879,-11498,,
16151445657,1626.08030,17556126926,1637759215,17556115433,-11493,,
16151496726,1626.13137,17556177997,1637810281,17556166487,-11510,,
16151547701,1626.18235,17556228975,1637861255,17556217461,-11514,,
16151598741,1626.23339,17556280017,1637912291,17556268498,-11519,,
16151649359,1626.28401,17556330636,1637962906,17556319112,-11524,,
16151700369,1626.33502,17556381650,1638013915,17556370121,-11529,,
16151750418,1626.38507,17556431700,1638063960,17556420166,-11534,,
16151800465,1626.43511,17556481749,1638114004,17556470210,-11539,,
16151851022,1626.48567,17556532310,1638164559,17556520766,-11544,,
16151902064,1626.53671,17556583353,1638215598,17556571804,-11549,,
16151952686,1626.58733,17556633978,1638266218,17556622424,-11554,,
16152003499,1626.63815,17556684794,1638317027,17556673233,-11561,,
16152053854,1626.68850,17556735151,1638367380,17556723586,-11565,,
16152288495,1626.92314,17556969803,1638602008,17556958214,-11589,17556967511,
16152313638,1626.94829,17556994947,1638627150,17556983402,-11545,,
16152364189,1626.99884,17557045511,1638677709,17557034055,-11456,,
16152415222,1627.04987,17557096536,1638728728,17557085170,-11366,,
16152465269,1627.09992,17557146585,1638778773,17557135308,-11277,,
16152515360,1627.15001,17557196679,1638828861,17557185488,-11191,,
16152565933,1627.20058,17557247254,1638879431,17557236153,-11101,,
16152616520,1627.25117,17557297842,1638930016,17557286831,-11011,,
16152667128,1627.30178,17557348453,1638980621,17557337530,-10923,,
16152717725,1627.35237,17557399052,1639031215,17557388218,-10834,,
16152768349,1627.40300,17557449679,1639081837,17557438934,-10745,,
16152818912,1627.45356,17557500245,1639132397,17557489588,-10657,,
16152869500,1627.50415,17557550835,1639182982,17557540269,-10566,,
16152920557,1627.55520,17557601893,1639234036,17557591416,-10477,,
16152971205,1627.60585,17557652544,1639284682,17557642157,-10387,,
16153021754,1627.65640,17557703096,1639335228,17557692797,-10299,,
16153072125,1627.70677,17557753470,1639385597,17557743260,-10210,,
16153122752,1627.75740,17557804098,1639436220,17557793976,-10122,,
16153173263,1627.80791,17557854612,1639486729,17557844579,-10033,,
16153223424,1627.85807,17557904776,1639536888,17557894832,-9944,,
16153274316,1627.90896,17557955670,1639587777,17557945815,-9855,,
16153324470,1627.95912,17558005826,1639637929,17557996061,-9765,,
16153375181,1628.00983,17558056539,1639688636,17558046874,-9665,,
16153425833,1628.06048,17558107194,1639739286,17558097606,-9588,,
16153476842,1628.11149,17558158216,1639790304,17558148719,-9497,,
16153527482,1628.16213,17558208848,1639840929,17558199438,-9410,,
16153577674,1628.21232,17558259041,1639891118,17558249721,-9320,,
16153628317,1628.26296,17558309687,1639941758,17558300456,-9231,,
16153679366,1628.31401,17558360739,1639992806,17558351598,-9141,,
16153729545,1628.36419,17558410920,1640042981,17558401866,-9054,,
16153779840,1628.41449,17558461216,1640093273,17558452251,-8965,,
16153830677,1628.46532,17558512057,1640144109,17558503183,-8874,,
16153881302,1628.51595,17558562684,1640194730,17558553898,-8786,,
16153932351,1628.56700,17558613736,1640245776,17558605039,-8697,,
16153983398,1628.61805,17558664785,1640296820,17558656178,-8607,,
16154034446,1628.66909,17558715835,1640347866,17558707319,-8516,,
16154085497,1628.72015,17558766889,1640398914,17558758462,-8427,,
16154136545,1628.77119,17558817939,1640449959,17558809602,-8337,,
16154187559,1628.82221,17558868955,1640500971,17558860709,-8246,,
16154238108,1628.87276,17558919506,1640551517,17558911348,-8158,,
16154288669,1628.92332,17558970070,1640602075,17558962001,-8069,,
16154339721,1628.97437,17559021134,1640653134,17559013155,-7979,,
16154390752,1629.02540,17559072158,1640704154,17559064269,-7889,,
16154440819,1629.07547,17559122238,1640754229,17559114438,-7800,,
16154491954,1629.12660,17559173365,1640805350,17559165653,-7712,,
16154542913,1629.17756,17559224326,1640856306,17559216715,-7611,,
16154593987,1629.22863,17559275402,1640907377,17559267871,-7531,,
16154645036,1629.27968,17559326453,1640958423,17559319010,-7443,,
16154695589,1629.33024,17559377009,1641008973,17559369666,-7343,,
16154746295,1629.38094,17559427717,1641059677,17559420454,-7263,,
16154797369,1629.43202,17559478793,1641110748,17559471619,-7174,,
16154847906,1629.48255,17559529332,1641161282,17559522248,-7084,,
16154898922,1629.53357,17559580351,1641212295,17559573356,-6995,,
16154949510,1629.58416,17559630942,1641262881,17559624036,-6906,,
16155000570,1629.63522,17559682004,1641313938,17559675188,-6816,,
16155051618,1629.68627,17559733055,1641364983,17559726328,-6727,,
16155102669,1629.73732,17559784107,1641416032,17559777471,-6636,,
16155153718,1629.78837,17559835159,1641467079,17559828612,-6547,,
16155204764,1629.83941,17559886208,1641518122,17559879750,-6458,,
16155255815,1629.89046,17559937260,1641569169,17559930892,-6368,,
16155306868,1629.94152,17559988316,1641620220,17559982039,-6277,,
16155357917,1629.99257,17560039367,1641671266,17560033180,-6187,,
16155408910,1630.04356,17560090363,1641722257,17560084265,-6098,,
16155459111,1630.09376,17560140567,1641772465,17560134567,-6000,,
16155509683,1630.14433,17560191151,1641823035,17560185230,-5921,,
16155560800,1630.19545,17560242259,1641874137,17560236429,-5830,,
16155611409,1630.24606,17560292872,1641924744,17560287130,-5742,,
16155662061,1630.29671,17560343525,1641975394,17560337873,-5652,,
16155713139,1630.34779,17560394606,1642026469,17560389044,-5562,,
16155763762,1630.39841,17560445231,1642077089,17560439757,-5474,,
16155814335,1630.44898,17560495807,1642127659,17560490422,-5385,,
16155864488,1630.49914,17560545962,1642177821,17560540677,-5285,,
16155915084,1630.54973,17560596561,1642228403,17560591353,-5208,,
16155966090,1630.60074,17560647568,1642279406,17560642450,-5118,,
16156016651,1630.65130,17560698132,1642329965,17560693104,-5028,,
16156067282,1630.70193,17560748766,1642380593,17560743825,-4941,,
16156117739,1630.75239,17560799225,1642431048,17560794374,-4851,,
16156168365,1630.80301,17560849853,1642481671,17560845091,-4762,,
16156218923,1630.85357,17560900414,1642532226,17560895741,-4673,,
16156269071,1630.90372,17560950564,1642582372,17560945980,-4584,,
16156320141,1630.95479,17561001637,1642633438,17560997142,-4495,,
16156370750,1631.00540,17561052248,1642684045,17561047843,-4405,,
16156420980,1631.05563,17561102480,1642734272,17561098163,-4317,,
16156471514,1631.10616,17561153017,1642784803,17561148787,-4230,,
16156521602,1631.15625,17561203106,1642834889,17561198966,-4140,,
16156572575,1631.20722,17561254081,1642885859,17561250031,-4050,,
16156623581,1631.25823,17561305090,1642936862,17561301129,-3961,,
16156674158,1631.30881,17561355670,1642987436,17561351798,-3872,,
16156725147,1631.35980,17561406660,1643038423,17561402879,-3781,,
16156775313,1631.40996,17561456830,1643088587,17561453136,-3694,,
16156825863,1631.46051,17561507382,1643139134,17561503777,-3605,,
16156876415,1631.51106,17561557936,1643189684,17561554421,-3515,,
16156927483,1631.56213,17561609007,1643240748,17561605581,-3426,,
16156978041,1631.61269,17561659567,1643291303,17561656230,-3337,,
16157028179,1631.66283,17561709718,1643341450,17561706470,-3248,,
16157078815,1631.71346,17561760346,1643392072,17561757187,-3159,,
16157129581,1631.76423,17561811114,1643442835,17561808044,-3070,,
16157179734,1631.81438,17561861270,1643492986,17561858288,-2982,,
16157230337,1631.86498,17561911887,1643543598,17561908994,-2893,,
16157280953,1631.91560,17561962492,1643594198,17561959688,-2804,,
16157332003,1631.96665,17562013546,1643645246,17562010751,-2795,,
16157382415,1632.01706,17562063960,1643695656,17562061161,-2799,,
16157432985,1632.06763,17562114531,1643746223,17562111727,-2804,,
16157483734,1632.11838,17562165284,1643796970,17562162474,-2810,,
16157534781,1632.16943,17562216333,1643848013,17562213517,-2816,,
16157585349,1632.22000,17562266903,1643898580,17562264084,-2819,,
16157635980,1632.27063,17562317537,1643949208,17562314712,-2825,,
16157686477,1632.32112,17562368035,1643999701,17562365206,-2829,,
16157737040,1632.37169,17562418601,1644050263,17562415767,-2834,,
16157787640,1632.42229,17562469204,1644100859,17562466364,-2840,,
16157838554,1632.47320,17562520120,1644151771,17562517276,-2844,,
16157889161,1632.52381,17562570730,1644202375,17562567879,-2851,,
16157939664,1632.57431,17562621235,1644252875,17562618380,-2855,,
16157989770,1632.62442,17562671354,1644302990,17562668495,-2859,,
16158040486,1632.67513,17562722061,1644353691,17562719195,-2866,,
16158091075,1632.72572,17562772653,1644404279,17562769783,-2870,,
16158141314,1632.77596,17562822906,1644454526,17562820031,-2875,,
16158191917,1632.82657,17562873500,1644505115,17562870619,-2881,,
16158242287,1632.87694,17562923872,1644555482,17562920986,-2886,,
16158292840,1632.92749,17562974427,1644606032,17562971536,-2891,,
16158343346,1632.97799,17563024935,1644656535,17563022039,-2896,,
16158393470,1633.02812,17563075062,1644706657,17563072161,-2901,,
16158443875,1633.07852,17563125469,1644757059,17563122564,-2905,,
16158494388,1633.12904,17563175984,1644807569,17563173073,-2911,,
16158544482,1633.17913,17563226081,1644857660,17563223165,-2916,,
16158595326,1633.22997,17563276927,1644908503,17563274007,-2920,,
16158645926,1633.28057,17563327530,1644959099,17563324604,-2926,,
16158696490,1633.33114,17563378096,1645009661,17563375165,-2931,,
16158747079,1633.38173,17563428687,1645060247,17563425752,-2935,,
16158797655,1633.43230,17563479266,1645110820,17563476325,-2941,,
16158848221,1633.48287,17563529833,1645161383,17563526887,-2946,,
16158898573,1633.53322,17563580188,1645211733,17563577237,-2951,,
16158949199,1633.58385,17563630817,1645262357,17563627861,-2956,,
16158999721,1633.63437,17563681341,1645312876,17563678380,-2961,,
16159050275,1633.68492,17563731897,1645363427,17563728931,-2966,,
16159100897,1633.73555,17563782522,1645414047,17563779551,-2971,,
16159152026,1633.78667,17563833652,1645465172,17563830676,-2976,,
16159203100,1633.83775,17563884730,1645516244,17563881748,-2982,,
16159254151,1633.88880,17563935783,1645567292,17563932796,-2987,,
16159304674,1633.93932,17563986308,1645617813,17563983317,-2991,,
16159355322,1633.98997,17564036959,1645668458,17564033962,-2997,,
16159405845,1634.04049,17564087484,1645718977,17564084482,-3002,,
16159456889,1634.09154,17564138530,1645770019,17564135524,-3006,,
16159507944,1634.14259,17564189587,1645821071,17564186575,-3012,,
16159558989,1634.19364,17564240634,1645872113,17564237617,-3017,,
16159609526,1634.24417,17564291173,1645922647,17564288151,-3022,,
16159659638,1634.29429,17564341288,1645972757,17564338261,-3027,,
16159710179,1634.34483,17564391831,1646023295,17564388799,-3032,,
16159760754,1634.39540,17564442410,1646073867,17564439372,-3038,,
16159811386,1634.44603,17564493043,1646124497,17564490001,-3042,,
16159861929,1634.49658,17564543588,1646175037,17564540541,-3047,,
16159912977,1634.54762,17564594640,1646226083,17564591587,-3053,,
16159964034,1634.59868,17564645702,1646277147,17564642651,-3051,,
16160015073,1634.64972,17564696740,1646328174,17564693678,-3062,,
16160066122,1634.70077,17564747792,1646379220,17564744724,-3068,,
16160117157,1634.75181,17564798829,1646430251,17564795756,-3073,,
16160167721,1634.80237,17564849395,1646480813,17564846318,-3077,,
16160218254,1634.85290,17564899931,1646531343,17564896848,-3083,,
16160268815,1634.90346,17564950494,1646581902,17564947406,-3088,,
16160319864,1634.95451,17565001546,1646632948,17564998452,-3094,,
16160370946,1635.00559,17565052630,1646684027,17565049532,-3098,,
16160421986,1635.05663,17565103672,1646735064,17565100569,-3103,,
16160472511,1635.10716,17565154199,1646785586,17565151090,-3109,,
16160523054,1635.15770,17565204745,1646836127,17565201632,-3113,,
16160574106,1635.20875,17565255798,1646887176,17565252681,-3117,,
16160624545,1635.25919,17565306241,1646937613,17565303117,-3124,,
16160674952,1635.30960,17565356650,1646988017,17565353521,-3129,,
16160725666,1635.36031,17565407365,1647038728,17565404232,-3133,,
16160776763,1635.41141,17565458466,1647089823,17565455327,-3139,,
16160827333,1635.46198,17565509038,1647140390,17565505894,-3144,,
16160877950,1635.51260,17565559657,1647191004,17565556508,-3149,,
16160928560,1635.56321,17565610270,1647241611,17565607116,-3154,,
16160979110,1635.61376,17565660822,1647292159,17565657663,-3159,,
16161029795,1635.66444,17565711519,1647342850,17565708355,-3164,,
16161080868,1635.71552,17565762585,1647393911,17565759416,-3169,,
16161131878,1635.76653,17565813597,1647444918,17565810423,-3174,,
16161182631,1635.81728,17565864352,1647495668,17565861172,-3180,,
16161233183,1635.86783,17565914907,1647546218,17565911723,-3184,,
16161284240,1635.91889,17565965966,1647597272,17565962777,-3189,,
16161335271,1635.96992,17566017000,1647648301,17566013805,-3195,,
16161385872,1636.02052,17566067603,1647698899,17566064404,-3199,,
16161436606,1636.07125,17566118339,1647749630,17566115135,-3204,,
16161487193,1636.12184,17566168928,1647800214,17566165718,-3210,,
16161537746,1636.17239,17566219484,1647850765,17566216269,-3215,,
16161588599,1636.22325,17566270339,1647901615,17566267119,-3220,,
16161638719,1636.27337,17566320461,1647951732,17566317236,-3225,,
16161689699,1636.32435,17566371443,1648002709,17566368213,-3230,,
16161740252,1636.37490,17566422000,1648053259,17566418764,-3236,,
16161790324,1636.42497,17566472073,1648103329,17566468834,-3239,,
16161840854,1636.47550,17566522606,1648153856,17566519361,-3245,,
16161891403,1636.52605,17566573157,1648204401,17566569906,-3251,,
16161941992,1636.57664,17566623749,1648254989,17566620493,-3256,,
16161993041,1636.62769,17566674800,1648306036,17566671540,-3260,,
16162043633,1636.67828,17566725395,1648356624,17566722129,-3266,,
16162094183,1636.72883,17566775947,1648407171,17566772676,-3271,,
16162144842,1636.77949,17566826608,1648457828,17566823333,-3275,,
16162195828,1636.83048,17566877597,1648508811,17566874316,-3281,,
16162246305,1636.88095,17566928075,1648559285,17566924789,-3286,,
16162296356,1636.93100,17566978129,1648609334,17566974839,-3290,,
16162346891,1636.98154,17567028666,1648659866,17567025370,-3296,,
16162396965,1637.03161,17567078742,1648709937,17567075441,-3301,,
16162447487,1637.08214,17567129267,1648760457,17567125962,-3305,,
16162497536,1637.13218,17567179319,1648810503,17567176008,-3311,,
16162547596,1637.18224,17567229380,1648860560,17567226064,-3316,,
16162598094,1637.23274,17567279880,1648911056,17567276560,-3320,,
16162648136,1637.28278,17567329926,1648961095,17567326599,-3327,,
16162698507,1637.33316,17567380299,1649011464,17567376968,-3331,,
16162748872,1637.38352,17567430665,1649061825,17567427330,-3335,,
16162799153,1637.43380,17567480950,1649112105,17567477609,-3341,,
16162849682,1637.48433,17567531481,1649162630,17567528135,-3346,,
16162899741,1637.53439,17567581542,1649212687,17567578191,-3351,,
16162950752,1637.58540,17567632556,1649263696,17567629200,-3356,,
16163001794,1637.63644,17567683600,1649314735,17567680239,-3361,,
16163052348,1637.68700,17567734157,1649365285,17567730790,-3367,,
16163102899,1637.73755,17567784709,1649415834,17567781338,-3371,,
16163153448,1637.78810,17567835261,1649466380,17567831884,-3377,,
16163204014,1637.83866,17567885830,1649516944,17567882448,-3382,,
16163254545,1637.88919,17567936363,1649567472,17567932976,-3387,,
16163305157,1637.93980,17567986977,1649618081,17567983586,-3391,,
16163355643,1637.99029,17568037466,1649668565,17568034069,-3397,,
16163406694,1638.04134,17568088518,1649719612,17568085116,-3402,,
16163457238,1638.09189,17568139065,1649770154,17568135659,-3406,,
16163507288,1638.14194,17568189118,1649820201,17568185706,-3412,,
16163557850,1638.19250,17568239681,1649870760,17568236264,-3417,,
16163608395,1638.24304,17568290228,1649921302,17568286806,-3422,,
16163658933,1638.29358,17568340769,1649971838,17568337342,-3427,,
16163709472,1638.34412,17568391311,1650022375,17568387879,-3432,,
16163759535,1638.39418,17568441375,1650072434,17568437938,-3437,,
16163810585,1638.44523,17568492428,1650123482,17568488987,-3441,,
16163861636,1638.49628,17568543482,1650174531,17568540035,-3447,,
16163911835,1638.54648,17568593684,1650224727,17568590231,-3453,,
16163962335,1638.59698,17568644185,1650275224,17568640728,-3457,,
16164012894,1638.64754,17568694747,1650325781,17568691285,-3462,,
16164063456,1638.69810,17568745312,1650376340,17568741844,-3468,,
16164113991,1638.74864,17568795849,1650426871,17568792376,-3473,,
16164165040,1638.79969,17568846899,1650477918,17568843422,-3477,,
16164215596,1638.85024,17568897459,1650528471,17568893976,-3483,,
16164266639,1638.90129,17568948504,1650579512,17568945016,-3488,,
16164317198,1638.95185,17568999065,1650630068,17568995573,-3492,,
16164367769,1639.00242,17569049640,1650680638,17569046143,-3497,,
16164418819,1639.05347,17569100691,1650731684,17569097188,-3503,,
16164469808,1639.10446,17569151683,1650782669,17569148174,-3509,,
16164520414,1639.15506,17569202291,1650833273,17569198778,-3513,,
16164571454,1639.20610,17569253333,1650884310,17569249815,-3518,,
16164622043,1639.25669,17569303924,1650934896,17569300400,-3524,,
16164672247,1639.30689,17569354131,1650985098,17569350602,-3529,,
16164723013,1639.35766,17569404898,1651035861,17569401365,-3533,,
16164774064,1639.40871,17569455952,1651086908,17569452413,-3539,,
16164825335,1639.45998,17569507225,1651138176,17569503681,-3544,,
16164876156,1639.51080,17569558049,1651188997,17569554501,-3548,,
16164926718,1639.56137,17569608614,1651239556,17569605060,-3554,,
16164977792,1639.61244,17569659690,1651290626,17569656131,-3559,,
16165028840,1639.66349,17569710740,1651341672,17569707176,-3564,,
16165079801,1639.71445,17569761713,1651392640,17569758145,-3568,,
16165130459,1639.76511,17569812364,1651443285,17569808790,-3574,,
16165181072,1639.81572,17569862980,1651493896,17569859400,-3580,,
16165231167,1639.86582,17569913077,1651543988,17569909492,-3585,,
16165281493,1639.91614,17569963405,1651594312,17569959816,-3589,,
16165332492,1639.96714,17570014406,1651645307,17570010811,-3595,,
16165383033,1640.01768,17570064950,1651695846,17570061351,-3599,,
16165433102,1640.06775,17570115021,1651745912,17570111417,-3604,,
16165484131,1640.11878,17570166052,1651796938,17570162442,-3610,,
16165535178,1640.16983,17570217102,1651847982,17570213487,-3615,,
16165585228,1640.21988,17570267153,1651898030,17570263534,-3619,,
16165635774,1640.27042,17570317703,1651948573,17570314077,-3626,,
16165686392,1640.32104,17570368323,1651999188,17570364693,-3630,,
16165737405,1640.37205,17570419337,1652050199,17570415703,-3634,,
16165787971,1640.42262,17570469917,1652100773,17570466278,-3639,,
16165838519,1640.47317,17570520469,1652151319,17570516824,-3645,,
16165889566,1640.52421,17570571517,1652202363,17570567867,-3650,,
16165939870,1640.57452,17570621812,1652252653,17570618158,-3654,,
16165990784,1640.62543,17570672729,1652303564,17570669069,-3660,,
16166041460,1640.67611,17570723408,1652354238,17570719742,-3666,,
16166092058,1640.72671,17570774008,1652404833,17570770338,-3670,,
16166142333,1640.77698,17570824285,1652455106,17570820610,-3675,,
16166192928,1640.82758,17570874883,1652505698,17570871202,-3681,,
16166243039,1640.87769,17570924996,1652555807,17570921311,-3685,,
16166293619,1640.92827,17570975578,1652606384,17570971888,-3690,,
16166343765,1640.97841,17571025727,1652656526,17571022031,-3696,,
16166394289,1641.02894,17571076253,1652707047,17571072552,-3701,,
16166444337,1641.07899,17571126302,1652757093,17571122597,-3705,,
16166494402,1641.12905,17571176370,1652807155,17571172660,-3710,,
16166545002,1641.17965,17571226973,1652857752,17571223257,-3716,,
16166595670,1641.23032,17571277643,1652908418,17571273923,-3720,,
16166646727,1641.28138,17571328703,1652959473,17571324977,-3726,,
16166697320,1641.33197,17571379297,1653010062,17571375578,-3719,,
16166748168,1641.38282,17571430147,1653060908,17571426412,-3735,,
16166798756,1641.43340,17571480739,1653111493,17571476998,-3741,,
16166849318,1641.48397,17571531302,1653162052,17571527557,-3745,,
16166899939,1641.53459,17571581927,1653212670,17571578175,-3752,,
16166950449,1641.58510,17571632438,1653263178,17571628682,-3756,,
16167001480,1641.63613,17571683472,1653314206,17571679711,-3761,,
16167051555,1641.68620,17571733550,1653364279,17571729783,-3767,,
16167102122,1641.73677,17571784120,1653414844,17571780349,-3771,,
16167153140,1641.78779,17571835138,1653465858,17571831362,-3776,,
16167203193,1641.83784,17571885195,1653515908,17571881413,-3782,,
16167253771,1641.88842,17571935785,1653566493,17571931998,-3787,,
16167304780,1641.93943,17571986786,1653617490,17571982995,-3791,,
16167355405,1641.99005,17572037414,1653668112,17572033627,-3787,,
16167406004,1642.04065,17572088014,1653718708,17572084212,-3802,,
16167456583,1642.09123,17572138596,1653769285,17572134800,-3796,,
16167507226,1642.14187,17572189242,1653819926,17572185430,-3812,,
16167558299,1642.19295,17572240328,1653871007,17572236511,-3817,,
16167609402,1642.24405,17572291422,1653922096,17572287600,-3822,,
16167660032,1642.29468,17572342055,1653972724,17572338228,-3827,,
16167710652,1642.34530,17572392677,1654023340,17572388845,-3832,,
16167761219,1642.39587,17572443247,1654073905,17572439409,-3838,,
16167811684,1642.44633,17572493725,1654124378,17572489883,-3842,,
16167862743,1642.49739,17572544775,1654175424,17572540928,-3847,,
16167913866,1642.54851,17572595900,1654226543,17572592047,-3853,,
16167964656,1642.59930,17572646693,1654277341,17572642845,-3848,,
16168015264,1642.64991,17572697303,1654327937,17572693441,-3862,,
16168066312,1642.70096,17572748354,1654378982,17572744486,-3868,,
16168117360,1642.75201,17572799404,1654430026,17572795531,-3873,,
16168168420,1642.80307,17572850466,1654481085,17572846589,-3877,,
16168219408,1642.85406,17572901457,1654532069,17572897574,-3883,,
16168269985,1642.90463,17572952036,1654582643,17572948148,-3888,,
16168320533,1642.95518,17573002599,1654633200,17572998705,-3894,,
16168371618,1643.00627,17573053674,1654684272,17573049776,-3898,,
16168422668,1643.05732,17573104726,1654735318,17573100823,-3903,,
16168473690,1643.10834,17573155751,1654786338,17573151842,-3909,,
16168524218,1643.15887,17573206281,1654836862,17573202367,-3914,,
16168574800,1643.20945,17573256865,1654887443,17573252948,-3917,,
16168625384,1643.26003,17573307451,1654938023,17573303527,-3924,,
16168676108,1643.31076,17573358178,1654988744,17573354249,-3929,,
16168726867,1643.36152,17573408939,1655039512,17573405017,-3922,,
16168777910,1643.41256,17573459985,1655090542,17573456046,-3939,,
16168829008,1643.46366,17573511085,1655141636,17573507141,-3944,,
16168879485,1643.51413,17573561565,1655192110,17573557615,-3950,,
16168929679,1643.56433,17573611761,1655242302,17573607806,-3955,,
16168980698,1643.61535,17573662782,1655293319,17573658823,-3959,,
16169030896,1643.66554,17573712983,1655343513,17573709018,-3965,,
16169081440,1643.71609,17573763529,1655394055,17573759560,-3969,,
16169132056,1643.76670,17573814147,1655444668,17573810173,-3974,,
16169183035,1643.81768,17573865129,1655495645,17573861149,-3980,,
16169233580,1643.86823,17573915676,1655546188,17573911692,-3984,,
16169284128,1643.91878,17573966225,1655596732,17573962236,-3989,,
16169334705,1643.96935,17574016806,1655647306,17574012811,-3995,,
16169385313,1644.01996,17574067416,1655697911,17574063415,-4001,,
16169435861,1644.07051,17574117966,1655748458,17574113962,-4004,,
16169486470,1644.12112,17574168578,1655799063,17574164568,-4010,,
16169537059,1644.17171,17574219169,1655849650,17574215155,-4014,,
16169587214,1644.22186,17574269326,1655899802,17574265307,-4019,,
16169637321,1644.27197,17574319436,1655949906,17574315411,-4025,,
16169687912,1644.32256,17574370040,1656000505,17574366010,-4030,,
16169738939,1644.37359,17574421059,1656051520,17574417025,-4034,,
16169789470,1644.42412,17574471592,1656102047,17574467551,-4041,,
16169840210,1644.47486,17574522333,1656152784,17574518288,-4045,,
16169890897,1644.52554,17574573023,1656203468,17574568972,-4051,,
16169941338,1644.57599,17574623467,1656253908,17574619412,-4055,,
16169991436,1644.62608,17574673579,1656304015,17574669520,-4059,,
16170042530,1644.67718,17574724664,1656355093,17574720598,-4066,,
16170093571,1644.72822,17574775707,1656406133,17574771637,-4070,,
16170144502,1644.77915,17574826640,1656457061,17574822565,-4075,,
16170194587,1644.82923,17574876727,1656507142,17574872647,-4080,,
16170245120,1644.87977,17574927263,1656557673,17574923177,-4086,,
16170295308,1644.92996,17574977452,1656607858,17574973362,-4090,,
16170345915,1644.98056,17575028063,1656658463,17575023967,-4096,,
16170396895,1645.03154,17575079056,1656709451,17575074955,-4101,,
16170447966,1645.08261,17575130118,1656760508,17575126013,-4105,,
16170499021,1645.13367,17575181176,1656811560,17575177065,-4111,,
16170550010,1645.18466,17575232167,1656862546,17575228051,-4116,,
16170600582,1645.23523,17575282741,1656913115,17575278619,-4122,,
16170651624,1645.28627,17575333786,1656964155,17575329660,-4126,,
16170702208,1645.33686,17575384372,1657014736,17575380241,-4131,,
16170753270,1645.38792,17575435437,1657065796,17575431301,-4136,,
16170804319,1645.43897,17575486487,1657116842,17575482347,-4140,,
16170854845,1645.48949,17575537026,1657167376,17575532881,-4145,,
16170905875,1645.54052,17575588049,1657218393,17575583897,-4152,,
16170956471,1645.59112,17575638658,1657268997,17575634502,-4156,,
16171007043,1645.64169,17575689221,1657319556,17575685061,-4160,,
16171058007,1645.69266,17575740187,1657370516,17575736020,-4167,,
16171109039,1645.74369,17575791222,1657421546,17575787050,-4172,,
16171159617,1645.79426,17575841803,1657472121,17575837625,-4178,,
16171210189,1645.84484,17575892376,1657522690,17575888194,-4182,,
16171261316,1645.89596,17575943506,1657573815,17575939319,-4187,,
16171311930,1645.94658,17575994123,1657624425,17575989930,-4193,,
16171362617,1645.99726,17576044811,1657675110,17576040614,-4197,,
16171413167,1646.04781,17576095363,1657725657,17576091161,-4202,,
16171463823,1646.09847,17576146022,1657776310,17576141815,-4207,,
16171514848,1646.14950,17576197050,1657827342,17576192847,-4203,,
16171565873,1646.20052,17576248076,1657878355,17576243860,-4216,,
16171616495,1646.25114,17576298702,1657928975,17576294479,-4223,,
16171667545,1646.30219,17576349754,1657980021,17576345525,-4229,,
16171718337,1646.35298,17576400548,1658030822,17576396327,-4221,,
16171768980,1646.40363,17576451193,1658081451,17576446956,-4237,,
16171819832,1646.45448,17576502048,1658132301,17576497805,-4243,,
16171870405,1646.50505,17576552623,1658182870,17576548374,-4249,,
16171921435,1646.55608,17576603656,1658233899,17576599403,-4253,,
16171971934,1646.60658,17576654156,1658284404,17576649909,-4247,,
16172022983,1646.65763,17576705209,1658335441,17576700945,-4264,,
16172073574,1646.70822,17576755802,1658386030,17576751534,-4268,,
16172123967,1646.75861,17576806197,1658436420,17576801925,-4272,,
16172175008,1646.80966,17576857241,1658487457,17576852961,-4280,,
16172225157,1646.85981,17576907391,1658537603,17576903107,-4284,,
16172276235,1646.91088,17576958472,1658588680,17576954184,-4288,,
16172326808,1646.96146,17577009047,1658639249,17577004754,-4293,,
16172377364,1647.01201,17577059617,1658689814,17577055319,-4298,,
16172428337,1647.06299,17577110582,1658740773,17577106278,-4304,,
16172478479,1647.11313,17577160725,1658790912,17577156416,-4309,,
16172528629,1647.16328,17577210877,1658841059,17577206563,-4314,,
16172579658,1647.21431,17577261910,1658892086,17577257591,-4319,,
16172630126,1647.26477,17577312379,1658942551,17577308055,-4324,,
16172680729,1647.31538,17577362985,1658993151,17577358656,-4329,,
16172731778,1647.36643,17577414037,1659044197,17577409701,-4336,,
16172782791,1647.41744,17577465052,1659095209,17577460713,-4339,,
16172833412,1647.46806,17577515674,1659145826,17577511330,-4344,,
16172883948,1647.51860,17577566214,1659196360,17577561864,-4350,,
16172934121,1647.56877,17577616389,1659246530,17577612034,-4355,,
16172984717,1647.61937,17577666987,1659297124,17577662638,-4349,,
16173034911,1647.66956,17577717183,1659347314,17577712818,-4365,,
16173085819,1647.72047,17577768094,1659398219,17577763724,-4370,,
16173136826,1647.77147,17577819104,1659449225,17577814729,-4375,,
16173187476,1647.82212,17577869756,1659499871,17577865376,-4380,,
16173238103,1647.87275,17577920385,1659550496,17577916000,-4385,,
16173288725,1647.92337,17577971010,1659601116,17577966620,-4390,,
16173339388,1647.97404,17578021674,1659651775,17578017280,-4394,,
16173389919,1648.02457,17578072207,1659702303,17578067807,-4400,,
16173440501,1648.07515,17578122793,1659752883,17578118387,-4406,,
16173490635,1648.12528,17578172929,1659803014,17578168518,-4411,,
16173541228,1648.17588,17578223524,1659853604,17578219108,-4416,,
16173591990,1648.22664,17578274298,1659904373,17578269877,-4421,,
16173643089,1648.27774,17578325389,1659955460,17578320964,-4425,,
16173693953,1648.32860,17578376256,1660006321,17578371826,-4430,,
16173744541,1648.37919,17578426847,1660056906,17578422411,-4436,,
16173794630,1648.42928,17578476938,1660106993,17578472498,-4440,,
16173845239,1648.47989,17578527549,1660157600,17578523104,-4445,,
16173895780,1648.53043,17578578103,1660208148,17578573652,-4451,,
16173946513,1648.58116,17578628828,1660258868,17578624372,-4456,,
16173996667,1648.63132,17578678996,1660309030,17578674535,-4461,,
16174047699,1648.68235,17578730019,1660360049,17578725553,-4466,,
16174098118,1648.73277,17578780440,1660410464,17578775969,-4471,,
16174148267,1648.78292,17578830592,1660460611,17578826126,-4466,,
16174199359,1648.83401,17578881686,1660511700,17578877205,-4481,,
16174249917,1648.88457,17578932257,1660562266,17578927771,-4486,,
16174300305,1648.93495,17578982637,1660612640,17578978145,-4492,,
16174351359,1648.98601,17579033693,1660663692,17579029196,-4497,,
16174402209,1649.03686,17579084544,1660714539,17579080043,-4501,,
16174452819,1649.08747,17579135158,1660765147,17579130651,-4507,,
16174503867,1649.13852,17579186208,1660816193,17579181697,-4511,,
16174554866,1649.18951,17579237209,1660867189,17579232693,-4516,,
16174604915,1649.23956,17579287260,1660917234,17579282738,-4522,,
16174655012,1649.28966,17579337359,1660967328,17579332833,-4526,,
16174706057,1649.34071,17579388407,1661018371,17579383876,-4531,,
16174756623,1649.39127,17579438976,1661068934,17579434439,-4537,,
16174807656,1649.44230,17579490011,1661119965,17579485469,-4542,,
16174858655,1649.49330,17579541013,1661170962,17579536466,-4547,,
16174909251,1649.54390,17579591611,1661221555,17579587059,-4552,,
16174959856,1649.59450,17579642218,1661272156,17579637661,-4557,,
16175010053,1649.64470,17579692417,1661322350,17579687854,-4563,,
16175061075,1649.69572,17579743442,1661373370,17579738875,-4567,,
16175111612,1649.74626,17579793981,1661423905,17579789409,-4572,,
16175162216,1649.79686,17579844588,1661474506,17579840010,-4578,,
16175212737,1649.84739,17579895110,1661525024,17579890539,-4571,,
16175263466,1649.89811,17579945853,1661575762,17579941266,-4587,,
16175314366,1649.94901,17579996745,1661626647,17579992152,-4593,,
16175364502,1649.99915,17580046883,1661676791,17580042296,-4587,,
16175415086,1650.04973,17580097469,1661727362,17580092866,-4603,,
16175465679,1650.10033,17580148065,1661777952,17580143457,-4608,,
16175516724,1650.15137,17580199112,1661829004,17580194509,-4603,,
16175567314,1650.20196,17580249705,1661879582,17580245086,-4619,,
16175617459,1650.25211,17580299852,1661929734,17580295239,-4613,,
16175668550,1650.30320,17580350945,1661980812,17580346316,-4629,,
16175719294,1650.35394,17580401692,1662031554,17580397059,-4633,,
16175769853,1650.40450,17580452252,1662082110,17580447614,-4638,,
16175820829,1650.45548,17580503230,1662133083,17580498587,-4643,,
16175871467,1650.50611,17580553871,1662183718,17580549222,-4649,,
16175922082,1650.55673,17580604500,1662234343,17580599847,-4653,,
16175973159,1650.60781,17580655568,1662285405,17580650910,-4658,,
16176023243,1650.65789,17580705655,1662335486,17580700991,-4664,,
16176073761,1650.70841,17580756175,1662386003,17580751507,-4668,,
16176124351,1650.75900,17580806766,1662436589,17580802093,-4673,,
16176175399,1650.81005,17580857817,1662487634,17580853138,-4679,,
16176226448,1650.86110,17580908868,1662538680,17580904184,-4684,,
16176276977,1650.91162,17580959401,1662589208,17580954712,-4689,,
16176328001,1650.96265,17581010427,1662640228,17581005732,-4695,,
16176378571,1651.01322,17581060999,1662690795,17581056300,-4699,,
16176429123,1651.06377,17581111553,1662741345,17581106849,-4704,,
16176480197,1651.11485,17581162629,1662792416,17581157920,-4709,,
16176530794,1651.16544,17581213229,1662843010,17581208515,-4714,,
16176581326,1651.21597,17581263763,1662893539,17581259043,-4720,,
16176631401,1651.26605,17581313851,1662943623,17581309127,-4724,,
16176682056,1651.31670,17581364497,1662994264,17581359768,-4729,,
16176732431,1651.36708,17581414876,1663044647,17581410152,-4724,,
16176783027,1651.41767,17581465473,1663095230,17581460734,-4739,,
16176834075,1651.46872,17581516523,1663146275,17581511779,-4744,,
16176884555,1651.51920,17581567007,1663196752,17581562257,-4750,,
16176935205,1651.56985,17581617658,1663247400,17581612904,-4754,,
16176985823,1651.62047,17581668278,1663298015,17581663519,-4759,,
16177035930,1651.67058,17581718388,1663348119,17581713623,-4765,,
16177086981,1651.72163,17581769442,1663399167,17581764671,-4771,,
16177137478,1651.77213,17581819942,1663449673,17581815177,-4765,,
16177188015,1651.82266,17581870480,1663500207,17581865711,-4769,,
16177239122,1651.87377,17581921590,1663551301,17581916816,-4774,,
16177289723,1651.92437,17581972194,1663601899,17581967404,-4790,,
16177340740,1651.97539,17582023212,1663652913,17582018417,-4795,,
16177391434,1652.02608,17582073909,1663703605,17582069109,-4800,,
16177441909,1652.07656,17582124387,1663754076,17582119581,-4806,,
16177492662,1652.12731,17582175142,1663804827,17582170332,-4810,,
16177543287,1652.17793,17582225768,1663855449,17582220954,-4814,,
16177593848,1652.22850,17582276332,1663906007,17582271512,-4820,,
16177644442,1652.27909,17582326929,1663956600,17582322104,-4825,,
16177695476,1652.33012,17582377965,1664007630,17582373135,-4830,,
16177746046,1652.38069,17582428538,1664058197,17582423702,-4836,,
16177796311,1652.43096,17582478804,1664108459,17582473964,-4840,,
16177847298,1652.48195,17582529794,1664159444,17582524948,-4846,,
16177897900,1652.53255,17582580398,1664210043,17582575547,-4851,,
16177948522,1652.58317,17582631023,1664260662,17582626167,-4856,,
16177999164,1652.63381,17582681668,1664311303,17582676807,-4861,,
16178050195,1652.68484,17582732701,1664362331,17582727835,-4866,,
16178100687,1652.73534,17582783195,1664412820,17582778324,-4871,,
16178151264,1652.78591,17582833774,1664463393,17582828897,-4877,,
16178201415,1652.83606,17582883928,1664513552,17582879057,-4871,,
16178252038,1652.88669,17582934553,1664564162,17582929666,-4887,,
16178302431,1652.93708,17582984949,1664614552,17582980057,-4892,,
16178352756,1652.98740,17583035276,1664664875,17583030380,-4896,,
16178403382,1653.03803,17583085904,1664715498,17583081002,-4902,,
16178454459,1653.08911,17583136984,1664766572,17583132077,-4907,,
16178505509,1653.14016,17583188036,1664817620,17583183124,-4912,,
16178556110,1653.19076,17583238640,1664868218,17583233722,-4918,,
16178606715,1653.24136,17583289247,1664918821,17583284325,-4922,,
16178657262,1653.29191,17583339796,1664969364,17583334869,-4927,,
16178707373,1653.34202,17583389910,1665019474,17583384978,-4932,,
16178758183,1653.39283,17583440721,1665070280,17583435784,-4937,,
16178809142,1653.44379,17583491682,1665121236,17583486740,-4942,,
16178859695,1653.49434,17583542239,1665171788,17583537292,-4947,,
16178910325,1653.54497,17583592871,1665222414,17583587919,-4952,,
16178960659,1653.59531,17583643207,1665272745,17583638250,-4957,,
16179010757,1653.64540,17583693307,1665322850,17583688354,-4953,,
16179060886,1653.69553,17583743439,1665372968,17583738472,-4967,,
16179111089,1653.74574,17583793644,1665423167,17583788672,-4972,,
16179161247,1653.79589,17583843804,1665473322,17583838826,-4978,,
16179211819,1653.84647,17583894388,1665523902,17583889407,-4981,,
16179262438,1653.89709,17583945000,1665574508,17583940013,-4987,,
16179313044,1653.94769,17583995609,1665625111,17583990616,-4993,,
16179363216,1653.99786,17584045783,1665675281,17584040796,-4987,,
16179413858,1654.04851,17584096427,1665725921,17584091425,-5002,,
16179464692,1654.09934,17584147264,1665776761,17584142265,-4999,,
16179515805,1654.15045,17584198378,1665827861,17584193365,-5013,,
16179566185,1654.20083,17584248760,1665878239,17584243743,-5017,,
16179616353,1654.25100,17584298931,1665928404,17584293908,-5023,,
16179667357,1654.30201,17584349937,1665979405,17584344909,-5028,,
16179718355,1654.35300,17584400938,1666030401,17584395905,-5033,,
16179768456,1654.40310,17584451041,1666080499,17584446003,-5038,,
16179819075,1654.45372,17584501662,1666131115,17584496619,-5043,,
16179869662,1654.50431,17584552263,1666181711,17584547215,-5048,,
16179919819,1654.55447,17584602412,1666231865,17584597370,-5042,,
16179970858,1654.60551,17584653453,1666282891,17584648395,-5058,,
16180021489,1654.65614,17584704087,1666333518,17584699022,-5065,,
16180071975,1654.70662,17584754575,1666384003,17584749507,-5068,,
16180122564,1654.75721,17584805176,1666434598,17584800103,-5073,,
16180173127,1654.80777,17584855732,1666485149,17584850653,-5079,,
16180223739,1654.85839,17584906346,1666535759,17584901273,-5073,,
16180274346,1654.90899,17584956954,1666586362,17584951866,-5088,,
16180324549,1654.95920,17585007161,1666636562,17585002067,-5094,,
16180375128,1655.00978,17585057742,1666687139,17585052643,-5099,,
16180425920,1655.06057,17585108536,1666737928,17585103433,-5103,,
16180476532,1655.11118,17585159151,1666788537,17585154042,-5109,,
16180527581,1655.16223,17585210202,1666839583,17585205088,-5114,,
16180578183,1655.21283,17585260806,1666890183,17585255687,-5119,,
16180628244,1655.26289,17585310870,1666940241,17585305746,-5124,,
16180678870,1655.31352,17585361498,1666990865,17585356369,-5129,,
16180729376,1655.36402,17585412006,1667041368,17585406872,-5134,,
16180779943,1655.41459,17585462576,1667091933,17585457437,-5139,,
16180830573,1655.46522,17585513208,1667142560,17585508064,-5144,,
16180881079,1655.51573,17585563717,1667193062,17585558567,-5150,,
16180931641,1655.56629,17585614281,1667243622,17585609127,-5154,,
16180982725,1655.61737,17585665367,1667294703,17585660208,-5159,,
16181033751,1655.66840,17585716395,1667345738,17585711242,-5153,,
16181084796,1655.71944,17585767443,1667396779,17585762283,-5160,,
16181134927,1655.76958,17585817576,1667446897,17585812402,-5174,,
16181185566,1655.82021,17585868218,1667497533,17585863038,-5180,,
16181235735,1655.87038,17585918389,1667547699,17585913204,-5185,,
16181286322,1655.92097,17585968977,1667598284,17585963789,-5188,,
16181336906,1655.97155,17586019565,1667648866,17586014370,-5195,,
16181387794,1656.02244,17586070454,1667699750,17586065254,-5200,,
16181437909,1656.07256,17586120573,1667749863,17586115368,-5205,,
16181488948,1656.12360,17586171614,1667800899,17586166404,-5210,,
16181539024,1656.17367,17586221691,1667850972,17586216476,-5215,,
16181589177,1656.22383,17586271848,1667901123,17586266628,-5220,,
16181639279,1656.27393,17586321952,1667951223,17586316727,-5225,,
16181689799,1656.32445,17586372474,1668001740,17586367244,-5230,,
16181740357,1656.37501,17586423034,1668052294,17586417799,-5235,,
16181790921,1656.42557,17586473601,1668102857,17586468361,-5240,,
16181841073,1656.47572,17586523755,1668153006,17586518510,-5245,,
16181891652,1656.52630,17586574337,1668203582,17586569086,-5251,,
16181942214,1656.57686,17586624900,1668254141,17586619645,-5255,,
16181993198,1656.62785,17586675886,1668305122,17586670626,-5260,,
16182043389,1656.67804,17586726081,1668355310,17586720824,-5257,,
16182094006,1656.72865,17586776710,1668405936,17586771440,-5270,,
16182144572,1656.77922,17586827268,1668456489,17586821993,-5275,,
16182195161,1656.82981,17586877860,1668507075,17586872579,-5281,,
16182245326,1656.87997,17586928027,1668557237,17586922741,-5286,,
16182295984,1656.93063,17586978687,1668607893,17586973397,-5290,,
16182346604,1656.98125,17587029310,1668658509,17587024014,-5296,,
16182397167,1657.03182,17587079875,1668709081,17587074586,-5289,,
16182448202,1657.08285,17587130912,1668760114,17587125618,-5294,,
16182498799,1657.13345,17587181512,1668810696,17587176200,-5312,,
16182549847,1657.18449,17587232562,1668861742,17587227246,-5316,,
16182600461,1657.23511,17587283179,1668912352,17587277857,-5322,,
16182650961,1657.28561,17587333680,1668962850,17587328354,-5326,,
16182701028,1657.33568,17587383749,1669012914,17587378418,-5331,,
16182751110,1657.38576,17587433834,1669062993,17587428498,-5336,,
16182801308,1657.43596,17587484035,1669113189,17587478694,-5341,,
16182851869,1657.48652,17587534597,1669163747,17587529251,-5346,,
16182902925,1657.53757,17587585657,1669214800,17587580305,-5352,,
16182953512,1657.58816,17587636245,1669265396,17587630901,-5344,,
16183004119,1657.63877,17587686855,1669315989,17587681494,-5361,,
16183054616,1657.68926,17587737354,1669366483,17587731987,-5367,,
16183105635,1657.74028,17587788375,1669417499,17587783003,-5372,,
16183155755,1657.79040,17587838497,1669467617,17587833121,-5376,,
16183206324,1657.84097,17587889069,1669518183,17587883687,-5382,,
16183256928,1657.89158,17587939675,1669568784,17587934288,-5387,,
16183307472,1657.94212,17587990221,1669619326,17587984830,-5391,,
16183357592,1657.99224,17588040345,1669669443,17588034948,-5397,,
16183407706,1658.04235,17588090461,1669719554,17588085058,-5403,,
16183458327,1658.09298,17588141084,1669770173,17588135677,-5407,,
16183508891,1658.14354,17588191651,1669820734,17588186239,-5412,,
16183559484,1658.19413,17588242256,1669871335,17588236839,-5417,,
16183610554,1658.24520,17588293319,1669922392,17588287896,-5423,,
16183661447,1658.29609,17588344214,1669973282,17588338787,-5427,,
16183711636,1658.34628,17588394404,1670023468,17588388973,-5431,,
16183761768,1658.39642,17588444540,1670073598,17588439102,-5438,,
16183812362,1658.44701,17588495136,1670124189,17588489694,-5442,,
16183862481,1658.49713,17588545257,1670174306,17588539810,-5447,,
16183913538,1658.54819,17588596317,1670225360,17588590864,-5453,,
16183964565,1658.59921,17588647346,1670276393,17588641898,-5448,,
16184015144,1658.64979,17588697926,1670326960,17588692464,-5462,,
16184066193,1658.70084,17588748979,1670378006,17588743511,-5468,,
16184116789,1658.75144,17588799576,1670428599,17588794103,-5473,,
16184167379,1658.80203,17588850168,1670479187,17588844692,-5476,,
16184218387,1658.85304,17588901180,1670530193,17588895697,-5483,,
16184268937,1658.90359,17588951731,1670580739,17588946243,-5488,,
16184319486,1658.95413,17589002284,1670631285,17588996790,-5494,,
16184370072,1659.00472,17589052872,1670681869,17589047373,-5499,,
16184421120,1659.05577,17589103922,1670732914,17589098418,-5504,,
16184472169,1659.10682,17589154974,1670783960,17589149464,-5510,,
16184523222,1659.15787,17589206029,1670835011,17589200515,-5514,,
16184574222,1659.20887,17589257031,1670886008,17589251513,-5518,,
16184625281,1659.25993,17589308092,1670937064,17589302568,-5524,,
16184676343,1659.31099,17589359157,1670988123,17589353628,-5529,,
16184727413,1659.36206,17589410229,1671039191,17589404696,-5533,,
16184778431,1659.41308,17589461250,1671090206,17589455711,-5539,,
16184829480,1659.46413,17589512300,1671141252,17589506756,-5544,,
16184880353,1659.51500,17589563176,1671192122,17589557627,-5549,,
16184931175,1659.56582,17589614001,1671242942,17589608447,-5554,,
16184981788,1659.61644,17589664615,1671293552,17589659057,-5558,,
16185032408,1659.66706,17589715239,1671344169,17589709674,-5565,,
16185083022,1659.71767,17589765854,1671394781,17589760285,-5569,,
16185133868,1659.76852,17589816713,1671445635,17589811139,-5574,,
16185184418,1659.81907,17589867256,1671496172,17589861676,-5580,,
16185234511,1659.86916,17589917350,1671546261,17589911765,-5585,,
16185285559,1659.92021,17589968401,1671597307,17589962812,-5589,,
16185336592,1659.97124,17590019448,1671648348,17590013853,-5595,,
16185387659,1660.02231,17590070506,1671699402,17590064906,-5600,,
16185438171,1660.07282,17590121020,1671749911,17590115415,-5605,,
16185488720,1660.12337,17590171572,1671800457,17590165962,-5610,,
16185539257,1660.17391,17590222111,1671850991,17590216496,-5615,,
16185589850,1660.22450,17590272707,1671901581,17590267086,-5621,,
16185640901,1660.27555,17590323759,1671952630,17590318134,-5625,,
16185691633,1660.32628,17590374493,1672003359,17590368863,-5630,,
16185742225,1660.37687,17590425089,1672053948,17590419453,-5636,,
16185793274,1660.42792,17590476139,1672104995,17590470499,-5640,,
16185843879,1660.47853,17590526747,1672155598,17590521102,-5645,,
16185894490,1660.52914,17590577361,1672206205,17590571710,-5651,,
16185945539,1660.58019,17590628411,1672257251,17590622755,-5656,,
16185995714,1660.63036,17590678588,1672307424,17590672929,-5659,,
16186046272,1660.68092,17590729150,1672357979,17590723484,-5666,,
16186096853,1660.73150,17590779732,1672408557,17590774061,-5671,,
16186147808,1660.78246,17590830690,1672459510,17590825014,-5676,,
16186198854,1660.83350,17590881739,1672510554,17590876058,-5681,,
16186249020,1660.88367,17590931907,1672560717,17590926221,-5686,,
16186300094,1660.93474,17590982984,1672611788,17590977292,-5692,,
16186351147,1660.98580,17591034038,1672662838,17591028342,-5696,,
16186401296,1661.03594,17591084190,1672712984,17591078488,-5702,,
16186452344,1661.08699,17591135241,1672764029,17591129534,-5707,,
16186503042,1661.13769,17591185940,1672814725,17591180229,-5711,,
16186553355,1661.18800,17591236256,1672865035,17591230540,-5716,,
16186603917,1661.23857,17591286821,1672915594,17591281099,-5722,,
16186654931,1661.28958,17591337837,1672966605,17591332110,-5727,,
16186705015,1661.33966,17591387922,1673016687,17591382191,-5731,,
16186755325,1661.38997,17591438236,1673066994,17591432499,-5737,,
16186805721,1661.44037,17591488634,1673117387,17591482902,-5732,,
16186856335,1661.49098,17591539249,1673167999,17591533503,-5746,,
16186906929,1661.54158,17591589847,1673218590,17591584095,-5752,,
16186957473,1661.59212,17591640393,1673269131,17591634636,-5757,,
16187007991,1661.64264,17591690914,1673319647,17591685152,-5762,,
16187058573,1661.69322,17591741498,1673370227,17591735732,-5766,,
16187108735,1661.74338,17591791661,1673420385,17591785889,-5772,,
16187159324,1661.79397,17591842254,1673470973,17591836478,-5776,,
16187210401,1661.84505,17591893332,1673522046,17591887550,-5782,,
16187260995,1661.89564,17591943929,1673572637,17591938142,-5787,,
16187312028,1661.94668,17591994964,1673623667,17591989171,-5793,,
16187362646,1661.99729,17592045585,1673674283,17592039788,-5797,,
16187413216,1662.04786,17592096157,1673724851,17592090355,-5802,,
16187464232,1662.09888,17592147176,1673775863,17592141368,-5808,,
16187514856,1662.14950,17592197802,1673826485,17592191989,-5813,,
16187565441,1662.20009,17592248389,1673877068,17592242572,-5817,,
16187616011,1662.25066,17592298962,1673927635,17592293139,-5823,,
16187666580,1662.30123,17592349533,1673978201,17592343705,-5828,,
16187717625,1662.35227,17592400581,1674029244,17592394748,-5833,,
16187768681,1662.40333,17592451639,1674080296,17592445800,-5839,,
16187818786,1662.45343,17592501746,1674130398,17592495903,-5843,,
16187869273,1662.50392,17592552236,1674180883,17592546388,-5848,,
16187919386,1662.55403,17592602351,1674230994,17592596498,-5853,,
16187969968,1662.60462,17592652946,1674281583,17592647087,-5859,,
16188020358,1662.65501,17592703327,1674331959,17592697463,-5864,,
16188071392,1662.70604,17592754364,1674382991,17592748496,-5868,,
16188121937,1662.75659,17592804910,1674433533,17592799037,-5873,,
16188172067,1662.80671,17592855044,1674483661,17592849165,-5879,,
16188223125,1662.85777,17592906104,1674534717,17592900221,-5883,,
16188273717,1662.90837,17592956697,1674585316,17592950820,-5877,,
16188324789,1662.95944,17593007773,1674636374,17593001879,-5894,,
16188375237,1663.00988,17593058222,1674686819,17593052324,-5898,,
16188426310,1663.06096,17593109297,1674737890,17593103394,-5903,,
16188477308,1663.11196,17593160299,1674788885,17593154390,-5909,,
16188527891,1663.16254,17593210884,1674839465,17593204969,-5915,,
16188578537,1663.21319,17593261533,1674890109,17593255614,-5919,,
16188629109,1663.26376,17593312107,1674940678,17593306183,-5924,,
16188679659,1663.31431,17593362659,1674991225,17593356730,-5929,,
16188729708,1663.36436,17593412711,1675041271,17593406775,-5936,,
16188779838,1663.41449,17593462843,1675091409,17593456914,-5929,,
16188830469,1663.46512,17593513476,1675142027,17593507531,-5945,,
16188881475,1663.51612,17593564484,1675193030,17593558534,-5950,,
16188931650,1663.56630,17593614673,1675243215,17593608719,-5954,,
16188982277,1663.61693,17593665291,1675293828,17593659332,-5959,,
16189032866,1663.66751,17593715883,1675344413,17593709917,-5966,,
16189082975,1663.71762,17593765994,1675394520,17593760024,-5970,,
16189134042,1663.76869,17593817063,1675445585,17593811089,-5974,,
16189184674,1663.81932,17593867708,1675496224,17593861728,-5980,,
16189234846,1663.86949,17593917871,1675546382,17593911886,-5985,,
16189285416,1663.92006,17593968444,1675596950,17593962454,-5990,,
16189335968,1663.97062,17594018999,1675647499,17594013003,-5996,,
16189386600,1664.02125,17594069644,1675698140,17594063645,-5999,,
16189437243,1664.07189,17594120277,1675748769,17594114274,-6003,,
16189487435,1664.12208,17594170473,1675798958,17594164463,-6010,,
16189538048,1664.17270,17594221087,1675849568,17594215072,-6015,,
16189588901,1664.22355,17594271944,1675900420,17594265924,-6020,,
16189639066,1664.27371,17594322110,1675950581,17594316085,-6025,,
16189689755,1664.32440,17594372801,1676001267,17594366771,-6030,,
16189740364,1664.37501,17594423414,1676051873,17594417378,-6036,,
16189790847,1664.42549,17594473899,1676102354,17594467859,-6040,,
16189840943,1664.47559,17594523997,1676152447,17594517952,-6045,,
16189891902,1664.52655,17594574959,1676203403,17594568908,-6051,,
16189942507,1664.57715,17594625566,1676254006,17594619511,-6055,,
16189992618,1664.62727,17594675679,1676304114,17594669619,-6060,,
16190043239,1664.67789,17594726303,1676354733,17594720247,-6056,,
16190093812,1664.72846,17594776877,1676405303,17594770807,-6070,,
16190144243,1664.77889,17594827311,1676455731,17594821236,-6075,,
16190194621,1664.82927,17594877691,1676506106,17594871610,-6081,,
16190244961,1664.87961,17594928034,1676556443,17594921948,-6086,,
16190295996,1664.93064,17594979071,1676607476,17594972980,-6091,,
16190346162,1664.98081,17595029240,1676657640,17595023144,-6096,,
16190396977,1665.03163,17595080057,1676708452,17595073956,-6101,,
16190448032,1665.08268,17595131113,1676759504,17595125008,-6105,,
16190498656,1665.13330,17595181740,1676810125,17595175629,-6111,,
16190549126,1665.18377,17595232216,1676860602,17595226107,-6109,,
16190600138,1665.23479,17595283227,1676911601,17595277105,-6122,,
16190650918,1665.28557,17595334010,1676962379,17595327883,-6127,,
16190701783,1665.33643,17595384877,1677013241,17595378746,-6131,,
16190752340,1665.38699,17595435437,1677063796,17595429300,-6137,,
16190802942,1665.43759,17595486041,1677114396,17595479900,-6141,,
16190853985,1665.48863,17595537086,1677165435,17595530940,-6146,,
16190905027,1665.53967,17595588131,1677216475,17595581979,-6152,,
16190955595,1665.59024,17595638700,1677267039,17595632543,-6157,,
16191005779,1665.64043,17595688887,1677317222,17595682727,-6160,,
16191056819,1665.69147,17595739930,1677368259,17595733763,-6167,,
16191106918,1665.74157,17595790031,1677418354,17595783858,-6173,,
16191157504,1665.79215,17595840618,1677468938,17595834442,-6176,,
16191208059,1665.84271,17595891188,1677519501,17595885006,-6182,,
16191259106,1665.89375,17595942226,1677570534,17595936039,-6187,,
16191310164,1665.94481,17595993286,1677621589,17595987093,-6193,,
16191361233,1665.99588,17596044358,1677672668,17596038173,-6185,,
16191412305,1666.04695,17596095432,1677723726,17596089231,-6201,,
16191462835,1666.09748,17596145965,1677774252,17596139757,-6208,,
16191513459,1666.14811,17596196591,1677824874,17596190379,-6212,,
16191564508,1666.19916,17596247641,1677875920,17596241424,-6217,,
16191615556,1666.25020,17596298693,1677926966,17596292470,-6223,,
16191666604,1666.30125,17596349743,1677978011,17596343515,-6228,,
16191717645,1666.35229,17596400787,1678029050,17596394554,-6233,,
16191768184,1666.40283,17596451328,1678079585,17596445090,-6238,,
16191818755,1666.45340,17596501901,1678130153,17596495658,-6243,,
16191869782,1666.50443,17596552931,1678181179,17596546683,-6248,,
16191919963,1666.55461,17596603124,1678231366,17596596871,-6253,,
16191971031,1666.60568,17596654183,1678282421,17596647925,-6258,,
16192021658,1666.65631,17596704814,1678333045,17596698550,-6264,,
16192072690,1666.70734,17596755847,1678384075,17596749579,-6268,,
16192123760,1666.75841,17596806920,1678435142,17596800647,-6273,,
16192174341,1666.80899,17596857503,1678485720,17596851225,-6278,,
16192224941,1666.85959,17596908106,1678536319,17596901823,-6283,,
16192275566,1666.91021,17596958733,1678586940,17596952444,-6289,,
16192326140,1666.96079,17597009310,1678637511,17597003016,-6294,,
16192376678,1667.01133,17597059849,1678688046,17597053550,-6299,,
16192427281,1667.06193,17597110455,1678738647,17597104151,-6304,,
16192477888,1667.11254,17597161065,1678789251,17597154755,-6310,,
16192528282,1667.16293,17597211460,1678839642,17597205146,-6314,,
16192578642,1667.21329,17597261824,1678890001,17597255505,-6319,,
16192629261,1667.26391,17597312445,1678940616,17597306121,-6324,,
16192679826,1667.31447,17597363012,1678991179,17597356683,-6329,,
16192730320,1667.36497,17597413509,1679041669,17597407174,-6335,,
16192780906,1667.41555,17597464097,1679092254,17597457758,-6339,,
16192831013,1667.46566,17597514206,1679142358,17597507862,-6344,,
16192882031,1667.51668,17597565227,1679193372,17597558877,-6350,,
16192932605,1667.56725,17597615803,1679243945,17597609449,-6354,,
16192982698,1667.61735,17597665898,1679294034,17597659539,-6359,,
16193033298,1667.66795,17597716500,1679344631,17597710145,-6355,,
16193083951,1667.71860,17597767156,1679395283,17597760787,-6369,,
16193134041,1667.76869,17597817247,1679445368,17597810873,-6374,,
16193184646,1667.81929,17597867856,1679495972,17597861476,-6380,,
16193235716,1667.87036,17597918927,1679547038,17597912542,-6385,,
16193286286,1667.92093,17597969499,1679597616,17597963120,-6379,,
16193336878,1667.97153,17598020094,1679648195,17598013699,-6395,,
16193387445,1668.02209,17598070664,1679698759,17598064264,-6400,,
16193438020,1668.07267,17598121242,1679749343,17598114847,-6395,,
16193488617,1668.12326,17598171842,1679799927,17598165432,-6410,,
16193539221,1668.17387,17598222446,1679850527,17598216031,-6415,,
16193589806,1668.22445,17598273035,1679901110,17598266614,-6421,,
16193640382,1668.27503,17598323613,1679951683,17598317188,-6425,,
16193690971,1668.32562,17598374204,1680002269,17598367774,-6430,,
16193741548,1668.37620,17598424785,1680052844,17598418348,-6437,,
16193791688,1668.42634,17598474926,1680102982,17598468486,-6440,,
16193842329,1668.47698,17598525568,1680153619,17598519123,-6445,,
16193893355,1668.52800,17598576598,1680204653,17598570158,-6440,,
16193943927,1668.57858,17598627172,1680255212,17598620717,-6455,,
16193994522,1668.62917,17598677769,1680305805,17598671309,-6460,,
16194045081,1668.67973,17598728331,1680356360,17598721865,-6466,,
16194096119,1668.73077,17598779371,1680407395,17598772900,-6471,,
16194147176,1668.78182,17598830430,1680458450,17598823954,-6476,,
16194198155,1668.83280,17598881412,1680509426,17598874931,-6481,,
16194248785,1668.88343,17598932054,1680560064,17598925568,-6486,,
16194299389,1668.93404,17598982651,1680610655,17598976160,-6491,,
16194350023,1668.98467,17599033287,1680661286,17599026791,-6496,,
16194401019,1669.03567,17599084285,1680712279,17599077784,-6501,,
16194451629,1669.08628,17599134897,1680762886,17599128391,-6506,,
16194502242,1669.13689,17599185513,1680813497,17599179001,-6512,,
16194552335,1669.18698,17599235608,1680863587,17599229092,-6516,,
16194602928,1669.23758,17599286204,1680914178,17599279682,-6522,,
16194653336,1669.28798,17599336614,1680964583,17599330088,-6526,,
16194704300,1669.33895,17599387580,1681015544,17599381048,-6532,,
16194754803,1669.38945,17599438086,1681066044,17599431549,-6537,,
16194805400,1669.44005,17599488685,1681116638,17599482143,-6542,,
16194855553,1669.49020,17599538840,1681166790,17599532305,-6535,,
16194906639,1669.54129,17599589929,1681217872,17599583377,-6552,,
16194957251,1669.59190,17599640543,1681268481,17599633986,-6557,,
16195008281,1669.64293,17599691575,1681319509,17599685024,-6551,,
16195058420,1669.69307,17599741716,1681369645,17599735149,-6567,,
16195108857,1669.74350,17599792156,1681420079,17599785584,-6572,,
16195159865,1669.79451,17599843167,1681471085,17599836589,-6578,,
16195210517,1669.84516,17599893820,1681521734,17599887238,-6582,,
16195261571,1669.89622,17599944877,1681572785,17599938289,-6588,,
16195312637,1669.94728,17599995946,1681623848,17599989353,-6593,,
16195363669,1669.99832,17600046980,1681674879,17600040383,-6597,,
16195414214,1670.04886,17600097527,1681725420,17600090925,-6602,,
16195465242,1670.09989,17600148558,1681776445,17600141960,-6598,,
16195516310,1670.15096,17600199628,1681827511,17600193015,-6613,,
16195567361,1670.20201,17600250682,1681878559,17600244063,-6619,,
16195617962,1670.25261,17600301284,1681929157,17600294661,-6623,,
16195668606,1670.30325,17600351930,1681979798,17600345303,-6627,,
16195718949,1670.35360,17600402277,1682030140,17600395644,-6633,,
16195769981,1670.40463,17600453321,1682081179,17600446683,-6638,,
16195820593,1670.45524,17600503925,1682131778,17600497292,-6633,,
16195870682,1670.50533,17600554016,1682181863,17600547367,-6649,,
16195921307,1670.55596,17600604643,1682232486,17600597990,-6653,,
16195971901,1670.60655,17600655239,1682283077,17600648581,-6658,,
16196022511,1670.65716,17600705852,1682333684,17600699188,-6664,,
16196073124,1670.70777,17600756468,1682384295,17600749800,-6668,,
16196123251,1670.75790,17600806597,1682434419,17600799934,-6663,,
16196173905,1670.80855,17600857254,1682485071,17600850575,-6679,,
16196224501,1670.85915,17600907851,1682535664,17600901169,-6682,,
16196274650,1670.90930,17600958014,1682585822,17600951326,-6688,,
16196325654,1670.96030,17601009010,1682636811,17601002315,-6695,,
16196376425,1671.01107,17601059783,1682687579,17601053083,-6700,,
16196427047,1671.06170,17601110407,1682738199,17601103703,-6704,,
16196477550,1671.11220,17601160913,1682788699,17601154204,-6709,,
16196527677,1671.16233,17601211042,1682838823,17601204328,-6714,,
16196578660,1671.21331,17601262028,1682889805,17601255309,-6719,,
16196629238,1671.26389,17601312607,1682940379,17601305883,-6724,,
16196679856,1671.31450,17601363228,1682990994,17601356499,-6729,,
16196730427,1671.36507,17601413802,1683041562,17601407067,-6735,,
16196781019,1671.41567,17601464396,1683092152,17601457657,-6739,,
16196831536,1671.46618,17601514915,1683142666,17601508171,-6744,,
16196882624,1671.51727,17601566005,1683193751,17601559256,-6749,,
16196933251,1671.56790,17601616635,1683244376,17601609881,-6754,,
16196984299,1671.61895,17601667685,1683295421,17601660925,-6760,,
16197034436,1671.66908,17601717825,1683345555,17601711060,-6765,,
16197085008,1671.71966,17601768399,1683396124,17601761628,-6771,,
16197135617,1671.77027,17601819010,1683446732,17601812236,-6774,,
16197186222,1671.82087,17601869617,1683497333,17601862837,-6780,,
16197236393,1671.87104,17601919791,1683547501,17601913006,-6785,,
16197286967,1671.92161,17601970367,1683598074,17601963578,-6789,,
16197337910,1671.97256,17602021313,1683649013,17602014518,-6795,,
16197388537,1672.02319,17602071941,1683699637,17602065141,-6800,,
16197438731,1672.07338,17602122139,1683749830,17602115334,-6805,,
16197489597,1672.12424,17602173008,1683800694,17602166198,-6810,,
16197539899,1672.17455,17602223311,1683851002,17602216506,-6805,,
16197590052,1672.22470,17602273467,1683901142,17602266646,-6821,,
16197641156,1672.27580,17602324572,1683952243,17602317747,-6825,,
16197691782,1672.32643,17602375201,1684002866,17602368371,-6830,,
16197742863,1672.37751,17602426285,1684053944,17602419449,-6836,,
16197793726,1672.42837,17602477150,1684104805,17602470310,-6840,,
16197844412,1672.47906,17602527837,1684155488,17602520992,-6845,,
16197894989,1672.52964,17602578418,1684206062,17602571567,-6851,,
16197945527,1672.58018,17602628958,1684256597,17602622102,-6856,,
16197996332,1672.63098,17602679764,1684307400,17602672904,-6860,,
16198046907,1672.68155,17602730343,1684357973,17602723477,-6866,,
16198097482,1672.73213,17602780919,1684408544,17602774048,-6871,,
16198147665,1672.78231,17602831105,1684458725,17602824229,-6876,,
16198197855,1672.83250,17602881297,1684508912,17602874416,-6881,,
16198248884,1672.88353,17602932328,1684559938,17602925442,-6886,,
16198299412,1672.93406,17602982859,1684610464,17602975979,-6880,,
16198349960,1672.98461,17603033409,1684661009,17603026523,-6886,,
16198400530,1673.03518,17603083982,1684711576,17603077081,-6901,,
16198451549,1673.08620,17603135004,1684762592,17603128097,-6907,,
16198502107,1673.13675,17603185574,1684813159,17603178664,-6910,,
16198553151,1673.18780,17603236609,1684864189,17603229693,-6916,,
16198604191,1673.23884,17603287653,1684915226,17603280731,-6922,,
16198654250,1673.28890,17603337714,1684965283,17603330798,-6916,,
16198705286,1673.33993,17603388752,1685016316,17603381821,-6931,,
16198756332,1673.39098,17603439801,1685067360,17603432864,-6937,,
16198806381,1673.44103,17603489851,1685117405,17603482909,-6942,,
16198856444,1673.49109,17603539917,1685167476,17603532981,-6936,,
16198907004,1673.54165,17603590480,1685218023,17603583539,-6941,,
16198957265,1673.59191,17603640743,1685268282,17603633786,-6957,,
16199008110,1673.64276,17603691591,1685319124,17603684629,-6962,,
16199058726,1673.69337,17603742209,1685369738,17603735242,-6967,,
16199108838,1673.74349,17603792322,1685419846,17603785350,-6972,,
16199159464,1673.79411,17603842952,1685470470,17603835985,-6967,,
16199209847,1673.84450,17603893337,1685520850,17603886354,-6983,,
16199260036,1673.89468,17603943528,1685571036,17603936541,-6987,,
16199310219,1673.94487,17603993714,1685621216,17603986721,-6993,,
16199360673,1673.99532,17604044170,1685671668,17604037173,-6997,,
16199411285,1674.04593,17604094784,1685722278,17604087782,-7002,,
16199462219,1674.09687,17604145731,1685773218,17604138722,-7009,,
16199513286,1674.14793,17604196790,1685824273,17604189778,-7012,,
16199564402,1674.19905,17604247908,1685875386,17604240890,-7018,,
16199615450,1674.25010,17604298959,1685926432,17604291936,-7023,,
16199666045,1674.30069,17604349555,1685977023,17604342528,-7027,,
16199716927,1674.35157,17604400440,1686027903,17604393408,-7032,,
16199767521,1674.40217,17604451038,1686078496,17604444000,-7038,,
16199818512,1674.45316,17604502030,1686129482,17604494987,-7043,,
16199869320,1674.50397,17604552841,1686180288,17604545793,-7048,,
16199919803,1674.55445,17604603326,1686230769,17604596273,-7053,,
16199970731,1674.60538,17604654256,1686281694,17604647198,-7058,,
16200021328,1674.65598,17604704856,1686332287,17604697792,-7064,,
16200071489,1674.70614,17604755019,1686382446,17604747951,-7068,,
16200122064,1674.75671,17604805595,1686433018,17604798522,-7073,,
16200173158,1674.80781,17604856693,1686484109,17604849614,-7079,,
16200223622,1674.85827,17604907159,1686534571,17604900075,-7084,,
16200273871,1674.90852,17604957410,1686584817,17604950321,-7089,,
16200324945,1674.95959,17605008486,1686635888,17605001392,-7094,,
16200375090,1675.00974,17605058634,1686686030,17605051535,-7099,,
16200426154,1675.06080,17605109699,1686737092,17605102596,-7103,,
16200476804,1675.11145,17605160353,1686787740,17605153244,-7109,,
16200527855,1675.16250,17605211405,1686838787,17605204292,-7113,,
16200578901,1675.21355,17605262455,1686889831,17605255336,-7119,,
16200629919,1675.26457,17605313475,1686940846,17605306351,-7124,,
16200680501,1675.31515,17605364058,1686991425,17605356929,-7129,,
16200731547,1675.36620,17605415108,1687042468,17605407972,-7136,,
16200782550,1675.41720,17605466113,1687093470,17605458974,-7139,,
16200832600,1675.46725,17605516164,1687143516,17605509020,-7144,,
16200883195,1675.51784,17605566763,1687194109,17605559613,-7150,,
16200934197,1675.56885,17605617767,1687245108,17605610613,-7154,,
16200984798,1675.61945,17605668369,1687295706,17605661211,-7158,,
16201035830,1675.67048,17605719405,1687346736,17605712241,-7164,,
16201086892,1675.72154,17605770469,1687397794,17605763299,-7170,,
16201137490,1675.77214,17605821070,1687448390,17605813895,-7175,,
16201188043,1675.82269,17605871624,1687498940,17605864444,-7180,,
16201238705,1675.87335,17605922289,1687549599,17605915104,-7185,,
16201289803,1675.92445,17605973400,1687600706,17605966210,-7190,,
16201340870,1675.97552,17606024459,1687651759,17606017263,-7196,,
16201391092,1676.02574,17606074683,1687701978,17606067483,-7200,,
16201441654,1676.07630,17606125248,1687752538,17606118042,-7206,,
16201492248,1676.12690,17606175843,1687803129,17606168633,-7210,,
16201542877,1676.17753,17606226474,1687853755,17606219259,-7215,,
16201593010,1676.22766,17606276611,1687903886,17606269390,-7221,,
16201643377,1676.27803,17606326980,1687954251,17606319755,-7225,,
16201693948,1676.32860,17606377553,1688004819,17606370323,-7230,,
16201744565,1676.37921,17606428173,1688055432,17606420936,-7237,,
16201794748,1676.42940,17606478358,1688105613,17606471118,-7240,,
16201845358,1676.48001,17606528970,1688156221,17606521725,-7245,,
16201896423,1676.53107,17606580038,1688207282,17606572787,-7251,,
16201947009,1676.58166,17606630625,1688257865,17606623369,-7256,,
16201997384,1676.63203,17606681014,1688308249,17606673753,-7261,,
16202048023,1676.68267,17606731645,1688358874,17606724379,-7266,,
16202099072,1676.73372,17606782695,1688409920,17606775424,-7271,,
16202149662,1676.78431,17606833288,1688460508,17606826012,-7276,,
16202200733,1676.83538,17606884362,1688511576,17606877080,-7282,,
16202250901,1676.88555,17606934532,1688561741,17606927246,-7286,,
16202301935,1676.93658,17606985578,1688612782,17606978287,-7291,,
16202352463,1676.98711,17607036099,1688663299,17607028803,-7296,,
16202402619,1677.03727,17607086257,1688713462,17607078967,-7290,,
16202453260,1677.08791,17607136901,1688764089,17607129594,-7307,,
16202504313,1677.13896,17607187956,1688815140,17607180645,-7311,,
16202554948,1677.18960,17607238593,1688865782,17607231287,-7306,,
16202605957,1677.24060,17607289605,1688916778,17607282294,-7311,,
16202656101,1677.29075,17607339751,1688966920,17607332424,-7327,,
16202707120,1677.34177,17607390773,1689017937,17607383441,-7332,,
16202758169,1677.39282,17607441824,1689068982,17607434487,-7337,,
16202808716,1677.44336,17607492373,1689119526,17607485030,-7343,,
16202859277,1677.49392,17607542937,1689170095,17607535600,-7337,,
16202910310,1677.54496,17607593971,1689221115,17607586619,-7352,,
16202960886,1677.59553,17607644560,1689271699,17607637204,-7356,,
16203011838,1677.64649,17607695504,1689322637,17607688141,-7363,,
16203062018,1677.69667,17607745686,1689372815,17607738329,-7357,,
16203113097,1677.74774,17607796768,1689423892,17607789406,-7362,,
16203163751,1677.79840,17607847424,1689474541,17607840046,-7378,,
16203214344,1677.84899,17607898020,1689525133,17607890637,-7383,,
16203265248,1677.89990,17607948926,1689576034,17607941539,-7387,,
16203315771,1677.95042,17607999451,1689626554,17607992059,-7392,,
16203365917,1678.00057,17608049600,1689676707,17608042212,-7388,,
16203416510,1678.05116,17608100195,1689727288,17608092792,-7403,,
16203467108,1678.10176,17608150796,1689777883,17608143388,-7408,,
16203518047,1678.15269,17608201737,1689828820,17608194324,-7413,,
16203568590,1678.20324,17608252282,1689879360,17608244864,-7418,,
16203619116,1678.25376,17608302811,1689929883,17608295397,-7414,,
16203669669,1678.30432,17608353366,1689980434,17608345938,-7428,,
16203719827,1678.35448,17608403527,1690030589,17608396104,-7423,,
16203770397,1678.40504,17608454098,1690081156,17608446661,-7437,,
16203820610,1678.45526,17608504314,1690131366,17608496870,-7444,,
16203870751,1678.50540,17608554457,1690181504,17608547008,-7449,,
16203921370,1678.55602,17608605078,1690232121,17608597625,-7453,,
16203972319,1678.60697,17608656030,1690283068,17608648572,-7458,,
16204023316,1678.65796,17608707030,1690334061,17608699566,-7464,,
16204073908,1678.70856,17608757623,1690384651,17608750155,-7468,,
16204124116,1678.75876,17608807834,1690434857,17608800361,-7473,,
16204175162,1678.80981,17608858882,1690485899,17608851403,-7479,,
16204225683,1678.86033,17608909405,1690536416,17608901921,-7484,,
16204276337,1678.91098,17608960063,1690587069,17608952574,-7489,,
16204327395,1678.96204,17609011123,1690638124,17609003629,-7494,,
16204378004,1679.01265,17609061734,1690688730,17609054235,-7499,,
16204428626,1679.06327,17609112359,1690739351,17609104855,-7504,,
16204478802,1679.11345,17609162537,1690789524,17609155028,-7509,,
16204529418,1679.16407,17609213155,1690840136,17609205640,-7515,,
16204579999,1679.21465,17609263739,1690890715,17609256220,-7519,,
16204630614,1679.26526,17609314355,1690941327,17609306831,-7524,,
16204681357,1679.31600,17609365101,1690992068,17609357572,-7529,,
16204732395,1679.36704,17609416141,1691043102,17609408606,-7535,,
16204783420,1679.41807,17609467168,1691094125,17609459629,-7539,,
16204833491,1679.46814,17609517241,1691144193,17609509697,-7544,,
16204883605,1679.51825,17609567358,1691194304,17609559808,-7550,,
16204934081,1679.56873,17609617837,1691244778,17609610282,-7555,,
16204985006,1679.61965,17609668764,1691295701,17609661205,-7559,,
16205035619,1679.67027,17609719380,1691346310,17609711815,-7565,,
16205086189,1679.72084,17609769961,1691396887,17609762392,-7569,,
16205136835,1679.77148,17609820601,1691447521,17609813025,-7576,,
16205187913,1679.82256,17609871681,1691498596,17609864101,-7580,,
16205238505,1679.87315,17609922274,1691549185,17609914689,-7585,,
16205288882,1679.92353,17609972654,1691599560,17609965064,-7590,,
16205339448,1679.97410,17610023233,1691650134,17610015638,-7595,,
16205389985,1680.02463,17610073762,1691700657,17610066162,-7600,,
16205441067,1680.07571,17610124847,1691751736,17610117241,-7606,,
16205492120,1680.12677,17610175902,1691802788,17610168292,-7610,,
16205542645,1680.17729,17610226439,1691853320,17610218825,-7614,,
16205593712,1680.22836,17610277498,1691904373,17610269877,-7621,,
16205644358,1680.27901,17610328146,1691955017,17610320521,-7625,,
16205695388,1680.33004,17610379179,1692006044,17610371549,-7630,,
16205746437,1680.38108,17610430231,1692057090,17610422594,-7637,,
16205797524,1680.43217,17610481320,1692108174,17610473679,-7641,,
16205848578,1680.48323,17610532377,1692159227,17610524731,-7646,,
16205899491,1680.53414,17610583292,1692210136,17610575641,-7651,,
16205949569,1680.58422,17610633371,1692260211,17610625715,-7656,,
16206000273,1680.63492,17610684078,1692310913,17610676418,-7660,,
16206050661,1680.68531,17610734469,1692361299,17610726803,-7666,,
16206100830,1680.73548,17610784640,1692411474,17610776979,-7661,,
16206151452,1680.78610,17610835264,1692462083,17610827587,-7677,,
16206202051,1680.83670,17610885866,1692512681,17610878185,-7681,,
16206253133,1680.88778,17610936949,1692563759,17610929263,-7686,,
16206303986,1680.93863,17610987805,1692614609,17610980113,-7692,,
16206354538,1680.98919,17611038359,1692665158,17611030663,-7696,,
16206405548,1681.04020,17611089373,1692716167,17611081671,-7702,,
16206456094,1681.09074,17611139921,1692766709,17611132223,-7698,,
16206507116,1681.14176,17611190944,1692817728,17611183232,-7712,,
16206557678,1681.19233,17611241510,1692868289,17611233793,-7717,,
16206608321,1681.24297,17611292155,1692918929,17611284433,-7722,,
16206658423,1681.29307,17611342259,1692969039,17611334544,-7715,,
16206709010,1681.34366,17611392849,1693019612,17611385116,-7733,,
16206759569,1681.39422,17611443409,1693070168,17611435672,-7737,,
16206810615,1681.44526,17611494457,1693121211,17611486715,-7742,,
16206861166,1681.49581,17611545012,1693171760,17611537264,-7748,,
16206912249,1681.54690,17611596096,1693222840,17611588344,-7752,,
16206963277,1681.59793,17611647137,1693273875,17611639380,-7757,,
16207013903,1681.64855,17611697756,1693324488,17611689993,-7763,,
16207064481,1681.69913,17611748335,1693375064,17611740568,-7767,,
16207115008,1681.74966,17611798865,1693425598,17611791102,-7763,,
16207165637,1681.80029,17611849497,1693476214,17611841719,-7778,,
16207216346,1681.85099,17611900208,1693526920,17611892425,-7783,,
16207266909,1681.90156,17611950774,1693577482,17611942986,-7788,,
16207317572,1681.95222,17612001438,1693628141,17611993645,-7793,,
16207368640,1682.00329,17612052509,1693679207,17612044711,-7798,,
16207419224,1682.05387,17612103096,1693729788,17612095293,-7803,,
16207470242,1682.10489,17612154116,1693780804,17612146308,-7808,,
16207521293,1682.15594,17612205168,1693831851,17612197355,-7813,,
16207572376,1682.20702,17612256255,1693882932,17612248436,-7819,,
16207623408,1682.25806,17612307289,1693933961,17612299465,-7824,,
16207674473,1682.30912,17612358357,1693985023,17612350528,-7829,,
16207725523,1682.36017,17612409409,1694036071,17612401575,-7834,,
16207776572,1682.41122,17612460459,1694087116,17612452621,-7838,,
16207827492,1682.46214,17612511382,1694138034,17612503538,-7844,,
16207878120,1682.51277,17612562013,1694188660,17612554164,-7849,,
16207928680,1682.56333,17612612575,1694239216,17612604721,-7854,,
16207979116,1682.61376,17612663025,1694289662,17612655166,-7859,,
16208029682,1682.66433,17612713581,1694340213,17612705717,-7864,,
16208080255,1682.71490,17612764156,1694390783,17612756297,-7859,,
16208130889,1682.76554,17612814794,1694441416,17612806920,-7874,,
16208181480,1682.81613,17612865387,1694492003,17612857507,-7880,,
16208232082,1682.86673,17612915991,1694542602,17612908106,-7885,,
16208283159,1682.91781,17612967071,1694593676,17612959181,-7890,,
16208333245,1682.96789,17613017159,1694643760,17613009265,-7894,,
16208383417,1683.01806,17613067333,1694693929,17613059434,-7899,,
16208433740,1683.06839,17613117658,1694744249,17613109753,-7905,,
16208484292,1683.11894,17613168213,1694794799,17613160315,-7898,,
16208534829,1683.16948,17613218753,1694845333,17613210838,-7915,,
16208585877,1683.22052,17613269803,1694896378,17613261883,-7920,,
16208636958,1683.27161,17613320885,1694947456,17613312960,-7925,,
16208687960,1683.32261,17613371891,1694998456,17613363961,-7930,,
16208738555,1683.37320,17613422488,1695049048,17613414553,-7935,,
16208789586,1683.42423,17613473521,1695100076,17613465591,-7930,,
16208840120,1683.47477,17613524058,1695150609,17613516113,-7945,,
16208890704,1683.52535,17613574644,1695201190,17613566695,-7949,,
16208941712,1683.57636,17613625654,1695252194,17613617699,-7955,,
16208992768,1683.62742,17613676713,1695303247,17613668752,-7961,,
16209042883,1683.67753,17613726841,1695353372,17613718876,-7965,,
16209093515,1683.72816,17613777464,1695403989,17613769493,-7971,,
16209144064,1683.77871,17613828016,1695454535,17613820039,-7977,,
16209194652,1683.82930,17613878606,1695505121,17613870626,-7980,,
16209245284,1683.87993,17613929241,1695555750,17613921255,-7986,,
16209296322,1683.93097,17613980281,1695606785,17613972290,-7991,,
16209346525,1683.98117,17614030486,1695656985,17614022490,-7996,,
16209397562,1684.03221,17614081526,1695708020,17614073525,-8001,,
16209447769,1684.08242,17614131735,1695758224,17614123729,-8006,,
16209498337,1684.13298,17614182304,1695808789,17614174293,-8011,,
16209549364,1684.18401,17614233335,1695859814,17614225319,-8016,,
16209599522,1684.23417,17614283495,1695909979,17614275484,-8011,,
16209650593,1684.28524,17614334567,1695961037,17614326541,-8026,,
16209701650,1684.33630,17614385627,1696012091,17614377595,-8032,,
16209752239,1684.38689,17614436218,1696062678,17614428192,-8026,,
16209803326,1684.43797,17614487309,1696113763,17614479267,-8042,,
16209854396,1684.48904,17614538380,1696164829,17614530333,-8047,,
16209905441,1684.54009,17614589427,1696215872,17614581376,-8051,,
16209956471,1684.59112,17614640471,1696266910,17614632414,-8057,,
16210007539,1684.64219,17614691530,1696317964,17614683468,-8062,,
16210058112,1684.69276,17614742106,1696368535,17614734039,-8067,,
16210108302,1684.74295,17614792299,1696418722,17614784227,-8072,,
16210158894,1684.79354,17614842893,1696469311,17614834816,-8077,,
16210209027,1684.84368,17614893028,1696519441,17614884945,-8083,,
16210259451,1684.89410,17614943454,1696569863,17614935367,-8087,,
16210310021,1684.94467,17614994026,1696620430,17614985934,-8092,,
16210360565,1684.99521,17615044573,1696670971,17615036476,-8097,,
16210410655,1685.04530,17615094666,1696721060,17615086574,-8092,,
16210461281,1685.09593,17615145293,1696771682,17615137186,-8107,,
16210511849,1685.14650,17615195864,1696822247,17615187751,-8113,,
16210562455,1685.19710,17615246473,1696872850,17615238355,-8118,,
16210612831,1685.24748,17615296851,1696923224,17615288729,-8122,,
16210663235,1685.29788,17615347257,1696973626,17615339130,-8127,,
16210713433,1685.34808,17615397458,1697023820,17615389325,-8133,,
16210764058,1685.39871,17615448084,1697074443,17615439947,-8137,,
16210815112,1685.44976,17615499142,1697125504,17615491009,-8133,,
16210866152,1685.50080,17615550184,1697176531,17615542036,-8148,,
16210916737,1685.55138,17615600770,1697227113,17615592618,-8152,,
16210967266,1685.60191,17615651314,1697277651,17615643156,-8158,,
16211018323,1685.65297,17615702362,1697328694,17615694199,-8163,,
16211068487,1685.70313,17615752528,1697378855,17615744359,-8169,,
16211118891,1685.75354,17615802935,1697429258,17615794762,-8173,,
16211169902,1685.80455,17615853948,1697480265,17615845770,-8178,,
16211220513,1685.85516,17615904560,1697530873,17615896377,-8183,,
16211271049,1685.90570,17615955100,1697581407,17615946912,-8188,,
16211322028,1685.95668,17616006081,1697632383,17615997888,-8193,,
16211373078,1686.00773,17616057134,1697683430,17616048935,-8199,,
16211424127,1686.05877,17616108185,1697734476,17616099981,-8204,,
16211475175,1686.10982,17616159235,1697785522,17616151027,-8208,,
16211526224,1686.16087,17616210287,1697836568,17616202073,-8214,,
16211577274,1686.21192,17616261338,1697887615,17616253119,-8219,,
16211628276,1686.26292,17616312343,1697938614,17616304119,-8224,,
16211678870,1686.31352,17616362939,1697989206,17616354710,-8229,,
16211729897,1686.36454,17616413969,1698040230,17616405735,-8234,,
16211780933,1686.41558,17616465007,1698091263,17616456768,-8239,,
16211831519,1686.46617,17616515596,1698141847,17616507352,-8244,,
16211882304,1686.51695,17616566383,1698192629,17616558134,-8249,,
16211933321,1686.56797,17616617402,1698243643,17616609147,-8255,,
16211984290,1686.61894,17616668374,1698294609,17616660114,-8260,,
16212034865,1686.66951,17616718951,1698345183,17616710687,-8264,,
16212085502,1686.72015,17616769591,1698395817,17616761321,-8270,,
16212136103,1686.77075,17616820194,1698446414,17616811919,-8275,,
16212186258,1686.82091,17616870351,1698496567,17616862072,-8279,,
16212236881,1686.87153,17616920977,1698547188,17616912692,-8285,,
16212287488,1686.92214,17616971586,1698597791,17616963306,-8280,,
16212548069,1687.18272,17617232178,1698858357,17617223862,-8316,17617229765,
16212573353,1687.20800,17617257464,1698883642,17617249176,-8288,,
16212623958,1687.25861,17617308071,1698934243,17617299836,-8235,,
16212675028,1687.30968,17617359144,1698985310,17617350965,-8179,,
16212726069,1687.36072,17617410187,1699036349,17617402063,-8124,,
16212776218,1687.41087,17617460339,1699086505,17617452279,-8060,,
16212827286,1687.46193,17617511408,1699137560,17617503393,-8015,,
16212877906,1687.51255,17617562031,1699188178,17617554071,-7960,,
16212927971,1687.56262,17617612098,1699238240,17617604192,-7906,,
16212978583,1687.61323,17617662713,1699288850,17617654862,-7851,,
16213029141,1687.66379,17617713274,1699339404,17617705477,-7797,,
16213079730,1687.71438,17617763874,1699390001,17617756134,-7740,,
16213130355,1687.76500,17617814492,1699440614,17617806805,-7687,,
16213181403,1687.81605,17617865542,1699491658,17617857910,-7632,,
16213232451,1687.86710,17617916593,1699542705,17617909017,-7576,,
16213283500,1687.91815,17617967644,1699593750,17617960123,-7521,,
16213334527,1687.96917,17618018673,1699644784,17618011217,-7456,,
16213385607,1688.02025,17618069756,1699695851,17618062345,-7411,,
16213436654,1688.07130,17618120805,1699746897,17618113450,-7355,,
16213487186,1688.12183,17618171340,1699797426,17618164039,-7301,,
16213538203,1688.17285,17618222359,1699848439,17618215112,-7247,,
16213589252,1688.22390,17618273411,1699899486,17618266220,-7191,,
16213639850,1688.27450,17618324011,1699950081,17618316875,-7136,,
16213690430,1688.32508,17618374593,1700000659,17618367512,-7081,,
16213741489,1688.37614,17618425654,1700051714,17618418627,-7027,,
16213792562,1688.42721,17618476730,1700102785,17618469759,-6971,,
16213843096,1688.47774,17618527265,1700153316,17618520349,-6916,,
16213893707,1688.52835,17618577879,1700203924,17618571017,-6862,,
16213944111,1688.57876,17618628285,1700254326,17618621478,-6807,,
16213994315,1688.62896,17618678492,1700304528,17618671740,-6752,,
16214044971,1688.67962,17618729150,1700355180,17618722451,-6699,,
16214096056,1688.73070,17618780238,1700406262,17618773594,-6644,,
16214146671,1688.78132,17618830855,1700456875,17618824268,-6587,,
16214197683,1688.83233,17618881870,1700507885,17618875337,-6533,,
16214248318,1688.88297,17618932506,1700558516,17618926028,-6478,,
16214298465,1688.93311,17618982657,1700608661,17618976243,-6414,,
16214349536,1688.98418,17619033730,1700659729,17619027360,-6370,,
16214400453,1689.03510,17619084649,1700710643,17619078335,-6314,,
16214451467,1689.08612,17619135666,1700761654,17619129407,-6259,,
16214502590,1689.13724,17619186791,1700812776,17619180588,-6203,,
16214553520,1689.18817,17619237723,1700863703,17619231575,-6148,,
16214604112,1689.23876,17619288318,1700914302,17619282235,-6083,,
16214655213,1689.28986,17619339432,1700965401,17619333394,-6038,,
16214706034,1689.34068,17619390244,1701016208,17619384261,-5983,,
16214757094,1689.39174,17619441306,1701067265,17619435377,-5929,,
16214807671,1689.44232,17619491885,1701117851,17619486023,-5862,,
16214858190,1689.49284,17619542408,1701168356,17619536589,-5819,,
16214908699,1689.54335,17619592919,1701218863,17619587154,-5765,,
16214959238,1689.59389,17619643460,1701269399,17619637750,-5710,,
16215009382,1689.64403,17619693617,1701319551,17619687961,-5656,,
16215059993,1689.69464,17619744219,1701370148,17619738618,-5601,,
16215110194,1689.74484,17619794422,1701420346,17619788875,-5547,,
16215160758,1689.79541,17619844989,1701470907,17619839496,-5493,,
16215211802,1689.84645,17619896036,1701521949,17619890598,-5438,,
16215262351,1689.89700,17619946586,1701572495,17619941204,-5382,,
16215312921,1689.94757,17619997159,1701623062,17619991832,-5327,,
16215363933,1689.99858,17620048174,1701674073,17620042902,-5272,,
16215414500,1690.04915,17620098742,1701724636,17620093525,-5217,,
16215465534,1690.10018,17620149780,1701775668,17620144617,-5163,,
16215516086,1690.15073,17620200333,1701826216,17620195225,-5108,,
16215567144,1690.20179,17620251394,1701877272,17620246341,-5053,,
16215617694,1690.25234,17620301947,1701927819,17620296949,-4998,,
16215668245,1690.30289,17620352500,1701978367,17620347556,-4944,,
16215719291,1690.35394,17620403549,1702029412,17620398661,-4888,,
16215769837,1690.40449,17620454097,1702079955,17620449263,-4834,,
16215820887,1690.45554,17620505149,1702131001,17620500371,-4778,,
16215871494,1690.50614,17620555759,1702181605,17620551033,-4726,,
16215922016,1690.55666,17620606282,1702232125,17620601614,-4668,,
16215972569,1690.60722,17620656837,1702282675,17620652223,-4614,,
16216022664,1690.65731,17620706936,1702332768,17620702375,-4561,,
16216072765,1690.70741,17620757038,1702382866,17620752532,-4506,,
16216123158,1690.75781,17620807434,1702433257,17620802983,-4451,,
16216174194,1690.80884,17620858472,1702484289,17620854075,-4397,,
16216224463,1690.85911,17620908755,1702534568,17620904413,-4342,,
16216275504,1690.91015,17620959786,1702585594,17620955500,-4286,,
16216326124,1690.96077,17621010410,1702636211,17621006177,-4233,,
16216377208,1691.01186,17621061495,1702687292,17621057318,-4177,,
16216427780,1691.06243,17621112071,1702737862,17621107948,-4123,,
16216478139,1691.11279,17621162432,1702788219,17621158364,-4068,,
16216528224,1691.16287,17621212519,1702838300,17621208505,-4014,,
16216579264,1691.21391,17621263562,1702889338,17621259603,-3959,,
16216629835,1691.26448,17621314135,1702939907,17621310231,-3904,,
16216680893,1691.31554,17621365195,1702990961,17621361346,-3849,,
16216731942,1691.36659,17621416246,1703042007,17621412452,-3794,,
16216782489,1691.41714,17621466796,1703092552,17621463057,-3739,,
16216832973,1691.46762,17621517281,1703143033,17621513597,-3684,,
16216883548,1691.51820,17621567859,1703193605,17621564229,-3630,,
16216934096,1691.56874,17621618409,1703244151,17621614834,-3575,,
16216984159,1691.61881,17621668475,1703294211,17621664953,-3522,,
16217034992,1691.66964,17621719311,1703345041,17621715843,-3468,,
16217085835,1691.72048,17621770156,1703395881,17621766744,-3412,,
16217136184,1691.77083,17621820507,1703446228,17621817151,-3356,,
16217186831,1691.82148,17621871156,1703496872,17621867854,-3302,,
16217236981,1691.87163,17621921309,1703547020,17621918061,-3248,,
16217287081,1691.92173,17621971412,1703597118,17621968218,-3194,,
16217337599,1691.97225,17622021932,1703647633,17622018793,-3139,,
16217388185,1692.02283,17622072520,1703698215,17622069435,-3085,,
16217439229,1692.07388,17622123566,1703749257,17622120538,-3028,,
16217490206,1692.12485,17622174546,1703800231,17622171572,-2974,,
16217541254,1692.17590,17622225596,1703851277,17622222677,-2919,,
16217591371,1692.22602,17622275716,1703901391,17622272800,-2916,,
16217642389,1692.27704,17622326736,1703952406,17622323816,-2920,,
16217692966,1692.32761,17622377315,1704002980,17622374390,-2925,,
16217743138,1692.37779,17622427490,1704053149,17622424559,-2931,,
16217793773,1692.42842,17622478127,1704103782,17622475192,-2935,,
16217844347,1692.47899,17622528702,1704154353,17622525762,-2940,,
16217894609,1692.52926,17622578968,1704204613,17622576022,-2946,,
16217945154,1692.57980,17622629515,1704255154,17622626564,-2951,,
16217995540,1692.63019,17622679904,1704305540,17622676950,-2954,,
16218046578,1692.68123,17622730944,1704356574,17622727983,-2961,,
16218097112,1692.73176,17622781480,1704407104,17622778514,-2966,,
16218147309,1692.78196,17622831680,1704457300,17622828709,-2971,,
16218198361,1692.83301,17622882733,1704508348,17622879757,-2976,,
16218249293,1692.88394,17622933668,1704559277,17622930687,-2981,,
16218299616,1692.93426,17622983994,1704609599,17622981008,-2986,,
16218350128,1692.98478,17623034508,1704660108,17623031517,-2991,,
16218400626,1693.03527,17623085007,1704710602,17623082011,-2996,,
16218451164,1693.08581,17623135548,1704761137,17623132547,-3001,,
16218501316,1693.13596,17623185703,1704811288,17623182697,-3006,,
16218552335,1693.18698,17623236723,1704862303,17623233713,-3010,,
16218602953,1693.23760,17623287344,1704912918,17623284327,-3017,,
16218653595,1693.28824,17623337988,1704963558,17623334967,-3021,,
16218704098,1693.33875,17623388494,1705014070,17623385479,-3015,,
16218754682,1693.38933,17623439084,1705064643,17623436052,-3032,,
16218805417,1693.44007,17623489818,1705115372,17623486781,-3037,,
16218855572,1693.49022,17623539975,1705165524,17623536934,-3041,,
16218906600,1693.54125,17623591006,1705216549,17623587959,-3047,,
16218957652,1693.59230,17623642059,1705267598,17623639007,-3052,,
16219008286,1693.64293,17623692697,1705318231,17623689640,-3057,,
16219059320,1693.69397,17623743733,1705369261,17623740671,-3062,,
16219110175,1693.74482,17623794590,1705420113,17623791523,-3067,,
16219160707,1693.79535,17623845125,1705470643,17623842052,-3073,,
16219210825,1693.84547,17623895245,1705520758,17623892167,-3078,,
16219261421,1693.89607,17623945842,1705571351,17623942760,-3082,,
16219312031,1693.94668,17623996456,1705621959,17623993368,-3088,,
16219363081,1693.99773,17624047507,1705673006,17624044415,-3092,,
16219413719,1694.04837,17624098148,1705723642,17624095051,-3097,,
16219464734,1694.09938,17624149166,1705774654,17624146063,-3103,,
16219514891,1694.14954,17624199335,1705824818,17624196227,-3108,,
16219565930,1694.20058,17624250366,1705875844,17624247254,-3112,,
16219616479,1694.25113,17624300917,1705926390,17624297800,-3117,,
16219667025,1694.30167,17624351465,1705976933,17624348342,-3123,,
16219717584,1694.35223,17624402027,1706027490,17624398900,-3127,,
16219768146,1694.40279,17624452592,1706078049,17624449459,-3133,,
16219818678,1694.45333,17624503125,1706128578,17624499987,-3138,,
16219868771,1694.50342,17624553222,1706178669,17624550079,-3143,,
16219919330,1694.55398,17624603783,1706229225,17624600634,-3149,,
16219969859,1694.60451,17624654314,1706279752,17624651161,-3153,,
16220020919,1694.65557,17624705376,1706330808,17624702217,-3159,,
16220071899,1694.70655,17624756358,1706381786,17624753195,-3163,,
16220122902,1694.75755,17624807364,1706432796,17624804206,-3158,,
16220173602,1694.80825,17624858067,1706483484,17624854893,-3174,,
16220224202,1694.85885,17624908668,1706534081,17624905490,-3178,,
16220274812,1694.90946,17624959281,1706584688,17624956098,-3183,,
16220325371,1694.96002,17625009843,1706635244,17625006654,-3189,,
16220375465,1695.01011,17625059938,1706685335,17625056744,-3194,,
16220426505,1695.06115,17625110980,1706736373,17625107782,-3198,,
16220477083,1695.11173,17625161562,1706786948,17625158357,-3205,,
16220528102,1695.16275,17625212582,1706837964,17625209373,-3209,,
16220579143,1695.21379,17625263626,1706889003,17625260412,-3214,,
16220629717,1695.26436,17625314213,1706939584,17625310993,-3220,,
16220680739,1695.31539,17625365227,1706990605,17625362014,-3213,,
16220731803,1695.36645,17625416294,1707041654,17625413064,-3230,,
16220782874,1695.41752,17625467366,1707092723,17625464133,-3233,,
16220833421,1695.46807,17625517916,1707143267,17625514677,-3239,,
16220884471,1695.51912,17625568969,1707194314,17625565724,-3245,,
16220934987,1695.56964,17625619487,1707244829,17625616238,-3249,,
16220986023,1695.62067,17625670526,1707295861,17625667271,-3255,,
16221036591,1695.67124,17625721096,1707346426,17625717836,-3260,,
16221087642,1695.72229,17625772149,1707397484,17625768894,-3255,,
16221138220,1695.77287,17625822730,1707448050,17625819459,-3271,,
16221188855,1695.82350,17625873367,1707498682,17625870092,-3275,,
16221239025,1695.87367,17625923538,1707548849,17625920258,-3280,,
16221290083,1695.92473,17625974600,1707599905,17625971315,-3285,,
16221340674,1695.97532,17626025193,1707650504,17626021913,-3280,,
16221391206,1696.02585,17626075727,1707701023,17626072432,-3295,,
16221441326,1696.07597,17626125849,1707751139,17626122549,-3300,,
16221491918,1696.12657,17626176444,1707801729,17626173139,-3305,,
16221542482,1696.17713,17626227010,1707852290,17626223700,-3310,,
16221592530,1696.22718,17626277060,1707902335,17626273744,-3316,,
16221643092,1696.27774,17626327625,1707952895,17626324305,-3320,,
16221694146,1696.32879,17626378681,1708003947,17626375356,-3325,,
16221745195,1696.37984,17626429733,1708054992,17626426402,-3331,,
16221795771,1696.43042,17626480310,1708105565,17626476975,-3335,,
16221846792,1696.48144,17626531335,1708156584,17626527994,-3341,,
16221897821,1696.53247,17626582365,1708207610,17626579019,-3346,,
16221948377,1696.58302,17626632923,1708258163,17626629573,-3350,,
16221998915,1696.63356,17626683465,1708308700,17626680109,-3356,,
16222049479,1696.68413,17626734030,1708359270,17626730680,-3350,,
16222100138,1696.73479,17626784692,1708409916,17626781326,-3366,,
16222150270,1696.78492,17626834827,1708460045,17626831454,-3373,,
16222201280,1696.83593,17626885839,1708511065,17626882475,-3364,,
16222251785,1696.88643,17626936345,1708561555,17626932964,-3381,,
16222302369,1696.93702,17626986933,1708612136,17626983546,-3387,,
16222352745,1696.98739,17627037310,1708662510,17627033919,-3391,,
16222403321,1697.03797,17627087888,1708713083,17627084492,-3396,,
16222453981,1697.08863,17627138552,1708763740,17627135149,-3403,,
16222504997,1697.13964,17627189570,1708814755,17627186164,-3406,,
16222555607,1697.19025,17627240182,1708865361,17627236771,-3411,,
16222606631,1697.24128,17627291209,1708916382,17627287792,-3417,,
16222657271,1697.29192,17627341851,1708967019,17627338429,-3422,,
16222708319,1697.34297,17627392902,1709018066,17627389475,-3427,,
16222759350,1697.39400,17627443935,1709069093,17627440502,-3433,,
16222810403,1697.44505,17627494990,1709120144,17627491553,-3437,,
16222860968,1697.49562,17627545558,1709170705,17627542115,-3443,,
16222912023,1697.54667,17627596615,1709221758,17627593168,-3447,,
16222962571,1697.59722,17627647165,1709272303,17627643713,-3452,,
16223013163,1697.64781,17627697760,1709322893,17627694302,-3458,,
16223064197,1697.69884,17627748796,1709373924,17627745333,-3463,,
16223114788,1697.74944,17627799388,1709424511,17627795921,-3467,,
16223165339,1697.79999,17627849943,1709475060,17627846470,-3473,,
16223216387,1697.85103,17627900993,1709526105,17627897515,-3478,,
16223266957,1697.90161,17627951565,1709576673,17627948083,-3482,,
16223318031,1697.95268,17628002641,1709627744,17627999153,-3488,,
16223369100,1698.00375,17628053713,1709678810,17628050220,-3493,,
16223419711,1698.05436,17628104339,1709729432,17628100842,-3497,,
16223470346,1698.10499,17628154964,1709780051,17628151461,-3503,,
16223521394,1698.15604,17628206014,1709831096,17628202506,-3508,,
16223572446,1698.20709,17628257068,1709882145,17628253554,-3514,,
16223623493,1698.25814,17628308118,1709933191,17628304600,-3518,,
16223674544,1698.30919,17628359171,1709984238,17628355647,-3524,,
16223725591,1698.36024,17628410221,1710035282,17628406692,-3529,,
16223776639,1698.41129,17628461270,1710086327,17628457736,-3534,,
16223826743,1698.46139,17628511378,1710136429,17628507839,-3539,,
16223877793,1698.51244,17628562430,1710187476,17628558886,-3544,,
16223928811,1698.56346,17628613450,1710238491,17628609900,-3550,,
16223979394,1698.61404,17628664036,1710289073,17628660482,-3554,,
16224030434,1698.66508,17628715078,1710340109,17628711519,-3559,,
16224081442,1698.71609,17628766088,1710391114,17628762524,-3564,,
16224132520,1698.76717,17628817169,1710442190,17628813599,-3570,,
16224182895,1698.81754,17628867545,1710492562,17628863971,-3574,,
16224233543,1698.86819,17628918197,1710543207,17628914616,-3581,,
16224284128,1698.91878,17628968784,1710593789,17628965199,-3585,,
16224334720,1698.96937,17629019378,1710644379,17629015789,-3589,,
16224385012,1699.01966,17629069673,1710694669,17629066078,-3595,,
16224435564,1699.07021,17629120226,1710745217,17629116626,-3600,,
16224486154,1699.12080,17629170818,1710795805,17629167214,-3604,,
16224536754,1699.17140,17629221422,1710846403,17629217812,-3610,,
16224587267,1699.22192,17629271937,1710896913,17629268322,-3615,,
16224637826,1699.27247,17629322497,1710947468,17629318877,-3620,,
16224687900,1699.32255,17629372575,1710997540,17629368950,-3625,,
16224738513,1699.37316,17629423190,1711048151,17629419560,-3630,,
16224789281,1699.42393,17629473960,1711098916,17629470325,-3635,,
16224840086,1699.47473,17629524767,1711149718,17629521127,-3640,,
16224891134,1699.52578,17629575818,1711200763,17629572173,-3645,,
16224942134,1699.57678,17629626820,1711251760,17629623170,-3650,,
16224992732,1699.62738,17629677421,1711302355,17629673765,-3656,,
16225043471,1699.67812,17629728162,1711353092,17629724502,-3660,,
16225094027,1699.72868,17629778721,1711403645,17629775054,-3667,,
16225144693,1699.77934,17629829389,1711454309,17629825719,-3670,,
16225195288,1699.82994,17629879986,1711504902,17629876311,-3675,,
16225246311,1699.88096,17629931011,1711555921,17629927330,-3681,,
16225296509,1699.93116,17629981212,1711606116,17629977526,-3686,,
16225347118,1699.98177,17630031823,1711656723,17630028132,-3691,,
16225397697,1700.03235,17630082404,1711707299,17630078708,-3696,,
16225448204,1700.08285,17630132914,1711757803,17630129213,-3701,,
16225498354,1700.13300,17630183066,1711807950,17630179360,-3706,,
16225548966,1700.18361,17630233681,1711858561,17630229970,-3711,,
16225599990,1700.23464,17630284707,1711909581,17630280991,-3716,,
16225651043,1700.28569,17630335762,1711960631,17630332041,-3721,,
16225702121,1700.33677,17630386843,1712011707,17630383116,-3727,,
16225752707,1700.38736,17630437431,1712062290,17630433700,-3731,,
16225803271,1700.43792,17630487997,1712112851,17630484260,-3737,,
16225854316,1700.48896,17630539044,1712163893,17630535302,-3742,,
16225905120,1700.53977,17630589850,1712214695,17630586105,-3745,,
16225955473,1700.59012,17630640206,1712265045,17630636454,-3752,,
16226005817,1700.64046,17630690552,1712315386,17630686795,-3757,,
16226056223,1700.69087,17630740961,1712365790,17630737200,-3761,,
16226106957,1700.74160,17630791698,1712416521,17630787931,-3767,,
16226158006,1700.79265,17630842749,1712467567,17630838977,-3772,,
16226209055,1700.84370,17630893800,1712518613,17630890022,-3778,,
16226259606,1700.89425,17630944354,1712569163,17630940572,-3782,,
16226310610,1700.94526,17630995360,1712620163,17630991573,-3787,,
16226361203,1700.99585,17631045955,1712670754,17631042163,-3792,,
16226411348,1701.04600,17631096102,1712720896,17631092305,-3797,,
16226461935,1701.09658,17631146692,1712771480,17631142890,-3802,,
16226512535,1701.14718,17631197294,1712822077,17631193486,-3808,,
16226562739,1701.19739,17631247501,1712872279,17631243688,-3813,,
16226613301,1701.24795,17631298064,1712922838,17631294247,-3817,,
16226663889,1701.29854,17631348667,1712973434,17631344844,-3823,,
16226714928,1701.34958,17631399697,1713024459,17631395869,-3828,,
16226765533,1701.40018,17631450304,1713075062,17631446472,-3832,,
16226816549,1701.45120,17631501323,1713126075,17631497484,-3839,,
16226867158,1701.50181,17631551933,1713176681,17631548090,-3843,,
16226917746,1701.55239,17631602524,1713227267,17631598676,-3848,,
16226968772,1701.60342,17631653552,1713278290,17631649700,-3852,,
16227018885,1701.65353,17631703668,1713328400,17631699810,-3858,,
16227069428,1701.70408,17631754213,1713378940,17631750350,-3863,,
16227119980,1701.75463,17631804768,1713429491,17631800900,-3868,,
16227170296,1701.80494,17631855086,1713479803,17631851213,-3873,,
16227220903,1701.85555,17631905695,1713530407,17631901817,-3878,,
16227271383,1701.90603,17631956178,1713580885,17631952295,-3883,,
16227322037,1701.95669,17632006834,1713631537,17632002946,-3888,,
16227372609,1702.00726,17632057408,1713682105,17632053515,-3893,,
16227423229,1702.05788,17632108031,1713732723,17632104132,-3899,,
16227474139,1702.10879,17632158954,1713783641,17632155051,-3903,,
16227525133,1702.15978,17632209939,1713834621,17632206030,-3909,,
16227576184,1702.21083,17632260993,1713885669,17632257078,-3915,,
16227627198,1702.26185,17632312009,1713936680,17632308090,-3919,,
16227678249,1702.31290,17632363063,1713987729,17632359139,-3924,,
16227729297,1702.36395,17632414113,1714038774,17632410184,-3929,,
16227780345,1702.41499,17632465163,1714089819,17632461229,-3934,,
16227831394,1702.46604,17632516214,1714140866,17632512275,-3939,,
16227882440,1702.51709,17632567263,1714191909,17632563319,-3944,,
16227933004,1702.56765,17632617842,1714242482,17632613892,-3950,,
16227984034,1702.61868,17632668862,1714293498,17632664907,-3955,,
16228035124,1702.66977,17632719954,1714344586,17632715995,-3959,,
16228086173,1702.72082,17632771005,1714395631,17632767040,-3965,,
16228137242,1702.77189,17632822077,1714446697,17632818106,-3971,,
16228187809,1702.82246,17632872646,1714497272,17632868682,-3964,,
16228238928,1702.87358,17632923768,1714548378,17632919787,-3981,,
16228289506,1702.92415,17632974348,1714598953,17632970363,-3985,,
16228340577,1702.97522,17633025421,1714650021,17633021431,-3990,,
16228391623,1703.02627,17633076469,1714701065,17633072474,-3995,,
16228442672,1703.07732,17633127521,1714752111,17633123520,-4001,,
16228493456,1703.12810,17633178307,1714802892,17633174301,-4006,,
16228543966,1703.17861,17633228820,1714853400,17633224809,-4011,,
16228594150,1703.22880,17633279006,1714903581,17633274990,-4016,,
16228644755,1703.27940,17633329614,1714954183,17633325593,-4021,,
16228695401,1703.33005,17633380262,1715004827,17633376236,-4026,,
16228745907,1703.38055,17633430770,1715055330,17633426740,-4030,,
16228796949,1703.43160,17633481815,1715106370,17633477779,-4036,,
16228847012,1703.48166,17633531879,1715156429,17633527838,-4041,,
16228897592,1703.53224,17633582462,1715207007,17633578417,-4045,,
16228948595,1703.58324,17633633468,1715258007,17633629417,-4051,,
16228998656,1703.63330,17633683531,1715308065,17633679475,-4056,,
16229049715,1703.68436,17633734592,1715359121,17633730531,-4061,,
16229100785,1703.73543,17633785665,1715410190,17633781599,-4066,,
16229151413,1703.78606,17633836294,1715460814,17633832223,-4071,,
16229201982,1703.83663,17633886867,1715511381,17633882790,-4077,,
16229253073,1703.88772,17633937960,1715562468,17633933877,-4083,,
16229303355,1703.93800,17633988244,1715612749,17633984158,-4086,,
16229354415,1703.98906,17634039307,1715663805,17634035215,-4092,,
16229405066,1704.03971,17634089959,1715714453,17634085863,-4096,,
16229455690,1704.09034,17634140585,1715765075,17634136484,-4101,,
16229506391,1704.14104,17634191289,1715815784,17634187193,-4096,,
16229557462,1704.19211,17634242363,1715866841,17634238250,-4113,,
16229608344,1704.24299,17634293247,1715917720,17634289130,-4117,,
16229659439,1704.29409,17634344345,1715968814,17634340223,-4122,,
16229710450,1704.34510,17634395358,1716019821,17634391231,-4127,,
16229761465,1704.39611,17634446376,1716070833,17634442243,-4133,,
16229812072,1704.44672,17634496984,1716121438,17634492847,-4137,,
16229862230,1704.49688,17634547145,1716171593,17634543003,-4142,,
16229912816,1704.54746,17634597734,1716222176,17634593586,-4148,,
16229963452,1704.59810,17634648371,1716272809,17634644219,-4152,,
16230014021,1704.64867,17634698943,1716323377,17634694786,-4157,,
16230064137,1704.69879,17634749061,1716373489,17634744898,-4163,,
16230114852,1704.74950,17634799779,1716424201,17634795611,-4168,,
16230165458,1704.80011,17634850387,1716474805,17634846215,-4172,,
16230216068,1704.85072,17634901000,1716525413,17634896822,-4178,,
16230267012,1704.90166,17634951946,1716576353,17634947763,-4183,,
16230317564,1704.95221,17635002499,1716626903,17634998312,-4187,,
16230368669,1705.00332,17635053608,1716678005,17635049415,-4193,,
16230418808,1705.05346,17635103749,1716728141,17635099551,-4198,,
16230469854,1705.10450,17635154798,1716779185,17635150594,-4204,,
16230520473,1705.15512,17635205419,1716829802,17635201211,-4208,,
16230571031,1705.20568,17635255979,1716880367,17635251776,-4203,,
16230622066,1705.25671,17635307017,1716931388,17635302798,-4219,,
16230673124,1705.30777,17635358077,1716982444,17635353854,-4223,,
16230724197,1705.35884,17635409151,1717033514,17635404923,-4228,,
16230774637,1705.40928,17635459595,1717083952,17635455361,-4234,,
16230825544,1705.46019,17635510504,1717134856,17635506265,-4239,,
16230876155,1705.51080,17635561117,1717185464,17635556874,-4243,,
16230927153,1705.56180,17635612118,1717236459,17635607869,-4249,,
16230977450,1705.61210,17635662417,1717286753,17635658163,-4254,,
16231028497,1705.66314,17635713466,1717337799,17635709208,-4258,,
16231079061,1705.71371,17635764033,1717388360,17635759769,-4264,,
16231129934,1705.76458,17635814908,1717439229,17635810639,-4269,,
16231180537,1705.81518,17635865514,1717489829,17635861238,-4276,,
16231231095,1705.86574,17635916073,1717540385,17635911794,-4279,,
16231281655,1705.91630,17635966636,1717590942,17635962352,-4284,,
16231332271,1705.96692,17636017255,1717641556,17636012965,-4290,,
16231382846,1706.01749,17636067832,1717692128,17636063537,-4295,,
16231433027,1706.06768,17636118014,1717742306,17636113715,-4299,,
16231483615,1706.11826,17636168606,1717792891,17636164301,-4305,,
16231534164,1706.16881,17636219156,1717843437,17636214847,-4309,,
16231585214,1706.21986,17636270208,1717894485,17636265894,-4314,,
16231635336,1706.26998,17636320334,1717944605,17636316014,-4320,,
16231685952,1706.32060,17636370951,1717995217,17636366626,-4325,,
16231736588,1706.37124,17636421590,1718045851,17636417260,-4330,,
16231786697,1706.42134,17636471702,1718095967,17636467377,-4325,,
16231837539,1706.47219,17636522546,1718146796,17636518205,-4341,,
16231888141,1706.52279,17636573150,1718197397,17636568806,-4344,,
16231939146,1706.57379,17636624157,1718248398,17636619807,-4350,,
16231990130,1706.62478,17636675143,1718299379,17636670788,-4355,,
16232040702,1706.67535,17636725730,1718349959,17636721369,-4361,,
16232091269,1706.72592,17636776287,1718400513,17636771922,-4365,,
16232142317,1706.77697,17636827338,1718451559,17636822968,-4370,,
16232193366,1706.82801,17636878390,1718502604,17636874014,-4376,,
16232243972,1706.87862,17636928998,1718553207,17636924617,-4381,,
16232294390,1706.92904,17636979418,1718603623,17636975033,-4385,,
16232344961,1706.97961,17637029992,1718654191,17637025601,-4391,,
16232395728,1707.03038,17637080760,1718704955,17637076364,-4396,,
16232446367,1707.08101,17637131402,1718755592,17637127001,-4401,,
16232496522,1707.13117,17637181559,1718805744,17637177153,-4406,,
16232547558,1707.18221,17637232598,1718856777,17637228187,-4411,,
16232598111,1707.23276,17637283153,1718907328,17637278738,-4415,,
16232649159,1707.28381,17637334204,1718958373,17637329783,-4421,,
16232699326,1707.33397,17637384373,1719008537,17637379947,-4426,,
16232750157,1707.38480,17637435218,1719059376,17637430786,-4432,,
16232800746,1707.43539,17637485798,1719109952,17637481361,-4437,,
16232851755,1707.48640,17637536808,1719160958,17637532367,-4441,,
16232902342,1707.53699,17637587398,1719211542,17637582951,-4447,,
16232953347,1707.58800,17637638406,1719262545,17637633955,-4451,,
16233003894,1707.63854,17637688955,1719313090,17637684499,-4456,,
16233053954,1707.68860,17637739018,1719363146,17637734555,-4463,,
16233104040,1707.73869,17637789106,1719413230,17637784639,-4467,,
16233155039,1707.78969,17637840107,1719464227,17637835636,-4471,,
16233206085,1707.84073,17637891156,1719515270,17637886679,-4477,,
16233256660,1707.89131,17637941733,1719565841,17637937251,-4482,,
16233307289,1707.94194,17637992363,1719616468,17637987878,-4485,,
16233357909,1707.99256,17638042986,1719667085,17638038494,-4492,,
16233408544,1708.04319,17638093624,1719717718,17638089127,-4497,,
16233459214,1708.09386,17638144297,1719768384,17638139794,-4503,,
16233509739,1708.14439,17638194834,1719818917,17638190327,-4507,,
16233560773,1708.19542,17638245860,1719869938,17638241348,-4512,,
16233610905,1708.24555,17638295995,1719920067,17638291476,-4519,,
16233661540,1708.29619,17638346632,1719970700,17638342110,-4522,,
16233712532,1708.34718,17638397626,1720021689,17638393099,-4527,,
16233763166,1708.39781,17638448263,1720072321,17638443730,-4533,,
16233813816,1708.44846,17638498914,1720122967,17638494376,-4538,,
16233864893,1708.49954,17638549994,1720174043,17638545452,-4542,,
16233915950,1708.55060,17638601054,1720225096,17638596505,-4549,,
16233966529,1708.60118,17638651635,1720275673,17638647082,-4553,,
16234017173,1708.65182,17638702290,1720326324,17638697733,-4557,,
16234068206,1708.70285,17638753317,1720377344,17638748753,-4564,,
16234118767,1708.75341,17638803880,1720427903,17638799312,-4568,,
16234169834,1708.80448,17638854950,1720478966,17638850376,-4574,,
16234220384,1708.85503,17638905502,1720529514,17638900924,-4578,,
16234271421,1708.90607,17638956541,1720580548,17638951958,-4583,,
16234322489,1708.95714,17639007611,1720631613,17639003022,-4589,,
16234373564,1709.00821,17639058688,1720682686,17639054096,-4592,,
16234424158,1709.05881,17639109285,1720733277,17639104687,-4598,,
16234475210,1709.10986,17639160340,1720784326,17639155736,-4604,,
16234525708,1709.16036,17639210840,1720834822,17639206231,-4609,,
16234576723,1709.21137,17639261857,1720885835,17639257244,-4613,,
16234627266,1709.26191,17639312403,1720936374,17639307784,-4619,,
16234677804,1709.31245,17639362943,1720986909,17639358318,-4625,,
16234728362,1709.36301,17639413504,1721037465,17639408875,-4629,,
16234778916,1709.41356,17639464060,1721088017,17639459426,-4634,,
16234829483,1709.46413,17639514629,1721138580,17639510000,-4629,,
16234880522,1709.51517,17639565671,1721189616,17639561026,-4645,,
16234931092,1709.56574,17639616243,1721240184,17639611594,-4649,,
16234981655,1709.61630,17639666808,1721290744,17639662153,-4655,,
16235032699,1709.66735,17639717854,1721341785,17639713194,-4660,,
16235083255,1709.71790,17639768413,1721392340,17639763749,-4664,,
16235133841,1709.76849,17639819001,1721442922,17639814332,-4669,,
16235184923,1709.81957,17639870086,1721494001,17639865411,-4675,,
16235235430,1709.87008,17639920595,1721544506,17639915915,-4680,,
16235286028,1709.92068,17639971194,1721595101,17639966510,-4684,,
16235337077,1709.97173,17640022247,1721646147,17640017556,-4691,,
16235388126,1710.02277,17640073297,1721697193,17640068602,-4695,,
16235438721,1710.07337,17640123895,1721747786,17640119195,-4700,,
16235489216,1710.12386,17640174393,1721798278,17640169688,-4705,,
16235540275,1710.17492,17640225453,1721849334,17640220743,-4710,,
16235590861,1710.22551,17640276042,1721899917,17640271326,-4716,,
16235641473,1710.27612,17640326657,1721950528,17640321937,-4720,,
16235691818,1710.32647,17640377004,1722000869,17640372279,-4725,,
16235742411,1710.37706,17640427600,1722051459,17640422868,-4732,,
16235792993,1710.42764,17640478183,1722102039,17640473448,-4735,,
16235843908,1710.47856,17640529101,1722152951,17640524361,-4740,,
16235894936,1710.52958,17640580132,1722203987,17640575397,-4735,,
16235945814,1710.58046,17640631011,1722254851,17640626260,-4751,,
16235995992,1710.63064,17640681191,1722305027,17640676436,-4755,,
16236046512,1710.68116,17640731727,1722355557,17640726967,-4760,,
16236097137,1710.73178,17640782342,1722406167,17640777576,-4766,,
16236147654,1710.78230,17640832862,1722456682,17640828091,-4771,,
16236198540,1710.83319,17640883750,1722507576,17640878986,-4764,,
16236249173,1710.88382,17640934385,1722558195,17640929604,-4781,,
16236299824,1710.93447,17640985038,1722608842,17640980251,-4787,,
16236350365,1710.98501,17641035581,1722659381,17641030791,-4790,,
16236400960,1711.03561,17641086178,1722709973,17641081382,-4796,,
16236451981,1711.08663,17641137203,1722760991,17641132401,-4802,,
16236502505,1711.13715,17641187728,1722811513,17641182922,-4806,,
16236553568,1711.18822,17641238794,1722862574,17641233983,-4811,,
16236604156,1711.23880,17641289384,1722913158,17641284570,-4814,,
16236655166,1711.28981,17641340397,1722964166,17641335575,-4822,,
16236706212,1711.34086,17641391444,1723015209,17641386618,-4826,,
16236756785,1711.39143,17641442021,1723065779,17641437189,-4832,,
16236807833,1711.44248,17641493071,1723116824,17641488234,-4837,,
16236858882,1711.49353,17641544123,1723167871,17641539281,-4842,,
16236909931,1711.54458,17641595173,1723218916,17641590326,-4847,,
16236961000,1711.59565,17641646245,1723269984,17641641393,-4852,,
16237012029,1711.64668,17641697277,1723321010,17641692419,-4858,,
16237062542,1711.69719,17641747792,1723371521,17641742930,-4862,,
16237113084,1711.74773,17641798336,1723422060,17641793469,-4867,,
16237163171,1711.79782,17641848425,1723472143,17641843552,-4873,,
16237213820,1711.84847,17641899077,1723522791,17641894200,-4877,,
16237264368,1711.89902,17641949627,1723573335,17641944745,-4882,,
16237315394,1711.95004,17642000655,1723624358,17641995768,-4887,,
16237365524,1712.00017,17642050787,1723674484,17642045894,-4893,,
16237416573,1712.05122,17642101840,1723725533,17642096942,-4898,,
16237466830,1712.10148,17642152098,1723775786,17642147206,-4892,,
16237517877,1712.15252,17642203148,1723826830,17642198240,-4908,,
16237568435,1712.20308,17642253709,1723877386,17642248795,-4914,,
16237619080,1712.25373,17642304356,1723928028,17642299438,-4918,,
16237670159,1712.30481,17642355436,1723979104,17642350513,-4923,,
16237720796,1712.35544,17642406076,1724029738,17642401147,-4929,,
16237770907,1712.40556,17642456199,1724079857,17642451266,-4933,,
16237821521,1712.45617,17642506805,1724130458,17642501868,-4937,,
16237872143,1712.50679,17642557431,1724181077,17642552487,-4944,,
16237923193,1712.55784,17642608482,1724232124,17642603534,-4948,,
16237973710,1712.60836,17642659002,1724282639,17642654049,-4953,,
16238024351,1712.65900,17642709645,1724333277,17642704686,-4959,,
16238075399,1712.71005,17642760696,1724384323,17642755733,-4963,,
16238126448,1712.76110,17642811748,1724435370,17642806779,-4969,,
16238177468,1712.81212,17642862770,1724486386,17642857795,-4975,,
16238227596,1712.86224,17642912899,1724536511,17642907920,-4979,,
16238278219,1712.91287,17642963525,1724587132,17642958541,-4984,,
16238328346,1712.96299,17643013654,1724637256,17643008675,-4979,,
16238379428,1713.01408,17643064739,1724688335,17643059745,-4994,,
16238430476,1713.06512,17643115790,1724739382,17643110791,-4999,,
16238481090,1713.11574,17643166406,1724789992,17643161402,-5004,,
16238532092,1713.16674,17643217410,1724840991,17643212401,-5009,,
16238582762,1713.21741,17643268083,1724891659,17643263068,-5015,,
16238633810,1713.26846,17643319132,1724942704,17643314113,-5019,,
16238684837,1713.31948,17643370162,1724993728,17643365147,-5015,,
16238735908,1713.37056,17643421235,1725044796,17643416205,-5030,,
16238786437,1713.42108,17643471778,1725095333,17643466743,-5035,,
16238837498,1713.47215,17643522830,1725146381,17643517790,-5040,,
16238888559,1713.52321,17643573893,1725197439,17643568848,-5045,,
16238939583,1713.57423,17643624919,1725248460,17643619879,-5040,,
16238990656,1713.62530,17643675996,1725299532,17643670941,-5055,,
16239041676,1713.67632,17643727018,1725350548,17643721958,-5060,,
16239092716,1713.72736,17643778059,1725401585,17643772994,-5065,,
16239143259,1713.77791,17643828617,1725452137,17643823546,-5071,,
16239194339,1713.82899,17643879710,1725503226,17643874635,-5075,,
16239245400,1713.88005,17643930751,1725554261,17643925670,-5081,,
16239295782,1713.93043,17643981135,1725604640,17643976049,-5086,,
16239346437,1713.98108,17644031792,1725655293,17644026702,-5090,,
16239397469,1714.03212,17644082828,1725706323,17644077732,-5096,,
16239448519,1714.08317,17644133880,1725757369,17644128779,-5101,,
16239499117,1714.13377,17644184480,1725807964,17644179374,-5106,,
16239549685,1714.18433,17644235062,1725858542,17644229952,-5110,,
16239600293,1714.23494,17644285660,1725909135,17644280545,-5115,,
16239650886,1714.28553,17644336255,1725959725,17644331135,-5120,,
16239701934,1714.33658,17644387306,1726010770,17644382179,-5127,,
16239752932,1714.38758,17644438307,1726061766,17644433176,-5131,,
16239803496,1714.43814,17644488873,1726112327,17644483736,-5137,,
16239854562,1714.48921,17644539942,1726163390,17644534810,-5132,,
16239904702,1714.53935,17644590084,1726213529,17644584938,-5146,,
16239955750,1714.59040,17644641135,1726264574,17644635983,-5152,,
16240006357,1714.64100,17644691743,1726315177,17644686586,-5157,,
16240056499,1714.69115,17644741888,1726365317,17644736727,-5161,,
16240107545,1714.74219,17644792937,1726416360,17644787770,-5167,,
16240158534,1714.79318,17644843928,1726467346,17644838756,-5172,,
16240209115,1714.84376,17644894510,1726517924,17644889333,-5177,,
16240259687,1714.89433,17644945086,1726568495,17644939914,-5172,,
16240310742,1714.94539,17644996142,1726619545,17644990955,-5187,,
16240361436,1714.99608,17645046839,1726670237,17645041647,-5192,,
16240412045,1715.04669,17645097450,1726720843,17645092252,-5198,,
16240462202,1715.09685,17645147610,1726770999,17645142408,-5202,,
16240512803,1715.14745,17645198214,1726821596,17645193006,-5208,,
16240563876,1715.19852,17645249289,1726872666,17645244076,-5213,,
16240614951,1715.24960,17645300366,1726923739,17645295149,-5217,,
16240666000,1715.30065,17645351418,1726974785,17645346195,-5223,,
16240716917,1715.35156,17645402337,1727025699,17645397108,-5229,,
16240767495,1715.40214,17645452917,1727076274,17645447684,-5233,,
16240818109,1715.45276,17645503534,1727126887,17645498296,-5238,,
16240869153,1715.50380,17645554579,1727177927,17645549336,-5243,,
16240919306,1715.55395,17645604735,1727228078,17645599487,-5248,,
16240969390,1715.60404,17645654822,1727278159,17645649569,-5253,,
16241019885,1715.65453,17645705318,1727328651,17645700060,-5258,,
16241070430,1715.70508,17645755866,1727379194,17645750603,-5263,,
16241121032,1715.75568,17645806470,1727429793,17645801202,-5268,,
16241171167,1715.80581,17645856608,1727479926,17645851335,-5273,,
16241221666,1715.85631,17645907109,1727530422,17645901831,-5278,,
16241271808,1715.90646,17645957254,1727580560,17645951970,-5284,,
16241321940,1715.95659,17646007387,1727630700,17646002109,-5278,,
16241372477,1716.00713,17646057927,1727681224,17646052634,-5293,,
16241423064,1716.05771,17646108517,1727731808,17646103217,-5300,,
16241473156,1716.10780,17646158611,1727781909,17646153319,-5292,,
16241523627,1716.15828,17646209085,1727832366,17646203775,-5310,,
16241574202,1716.20885,17646259662,1727882939,17646254349,-5313,,
16241625242,1716.25989,17646310704,1727933976,17646305386,-5318,,
16241675798,1716.31045,17646361263,1727984529,17646355939,-5324,,
16241726349,1716.36100,17646411816,1728035077,17646406487,-5329,,
16241776968,1716.41162,17646462437,1728085693,17646457103,-5334,,
16241828019,1716.46267,17646513491,1728136742,17646508152,-5339,,
16241878267,1716.51292,17646563741,1728186988,17646558397,-5344,,
16241929114,1716.56376,17646614590,1728237831,17646609251,-5339,,
16241980201,1716.61485,17646665680,1728288916,17646660326,-5354,,
16242031260,1716.66591,17646716741,1728339973,17646711382,-5359,,
16242081851,1716.71650,17646767333,1728390560,17646761969,-5364,,
16242132937,1716.76759,17646818422,1728441643,17646813053,-5369,,
16242183984,1716.81863,17646869471,1728492688,17646864098,-5373,,
16242234605,1716.86925,17646920096,1728543306,17646914716,-5380,,
16242285702,1716.92035,17646971195,1728594401,17646965810,-5385,,
16242336336,1716.97098,17647021831,1728645033,17647016442,-5389,,
16242386844,1717.02149,17647072342,1728695537,17647066947,-5395,,
16242437480,1717.07213,17647122980,1728746171,17647117580,-5400,,
16242488099,1717.12275,17647173601,1728796786,17647168196,-5405,,
16242539180,1717.17383,17647224685,1728847865,17647219275,-5410,,
16242589309,1717.22396,17647274815,1728897991,17647269400,-5415,,
16242640356,1717.27500,17647325865,1728949035,17647320445,-5420,,
16242691401,1717.32605,17647376913,1729000079,17647371488,-5425,,
16242741917,1717.37657,17647427431,1729050591,17647422000,-5431,,
16242792942,1717.42759,17647478458,1729101613,17647473022,-5436,,
16242843523,1717.47817,17647529042,1729152191,17647523601,-5441,,
16242894063,1717.52871,17647579584,1729202729,17647574139,-5445,,
16242945158,1717.57981,17647630681,1729253821,17647625230,-5451,,
16242995759,1717.63041,17647681285,1729304419,17647675829,-5456,,
16243046255,1717.68090,17647731782,1729354913,17647726323,-5459,,
16243096802,1717.73145,17647782333,1729405457,17647776866,-5467,,
16243147859,1717.78251,17647833402,1729456522,17647827931,-5471,,
16243198931,1717.83358,17647884466,1729507580,17647878990,-5476,,
16243249458,1717.88411,17647934996,1729558105,17647929525,-5471,,
16243300557,1717.93520,17647986097,1729609201,17647980611,-5486,,
16243350687,1717.98534,17648036229,1729659329,17648030738,-5491,,
16243401303,1718.03595,17648086848,1729709942,17648081352,-5496,,
16243451891,1718.08654,17648137438,1729760527,17648131936,-5502,,
16243502491,1718.13714,17648188041,1729811125,17648182534,-5507,,
16243553114,1718.18776,17648238665,1729861744,17648233154,-5511,,
16243603598,1718.23825,17648289151,1729912226,17648283635,-5516,,
16243654076,1718.28872,17648339643,1729962712,17648334121,-5522,,
16243704705,1718.33935,17648390264,1730013327,17648384737,-5527,,
16243755321,1718.38997,17648440881,1730063941,17648435350,-5531,,
16243805912,1718.44056,17648491476,1730114530,17648485939,-5537,,
16243856919,1718.49157,17648542485,1730165533,17648536943,-5542,,
16243907556,1718.54220,17648593124,1730216168,17648587577,-5547,,
16243958136,1718.59278,17648643706,1730266745,17648638154,-5552,,
16244008720,1718.64337,17648694292,1730317326,17648688735,-5557,,
16244059757,1718.69440,17648745332,1730368361,17648739770,-5562,,
16244110689,1718.74534,17648796266,1730419290,17648790700,-5566,,
16244161267,1718.79591,17648846847,1730469865,17648841275,-5572,,
16244211860,1718.84651,17648897442,1730520455,17648891865,-5577,,
16244262420,1718.89707,17648948004,1730571012,17648942421,-5583,,
16244313039,1718.94769,17648998626,1730621629,17648993039,-5587,,
16244363587,1718.99824,17649049177,1730672174,17649043584,-5593,,
16244414666,1719.04931,17649100268,1730723261,17649094671,-5597,,
16244465214,1719.09986,17649150807,1730773806,17649145216,-5591,,
16244515720,1719.15037,17649201316,1730824299,17649195708,-5608,,
16244566495,1719.20114,17649252094,1730875071,17649246481,-5613,,
16244617566,1719.25221,17649303167,1730926140,17649297549,-5618,,
16244668614,1719.30326,17649354218,1730977185,17649348595,-5623,,
16244719662,1719.35431,17649405268,1731028230,17649399640,-5628,,
16244770710,1719.40536,17649456318,1731079275,17649450684,-5634,,
16244821236,1719.45588,17649506847,1731129800,17649501209,-5638,,
16244872307,1719.50696,17649557920,1731180867,17649552277,-5643,,
16244923359,1719.55801,17649608974,1731231916,17649603325,-5649,,
16244973947,1719.60859,17649659565,1731282501,17649653910,-5655,,
16245024559,1719.65921,17649710179,1731333112,17649704522,-5657,,
16245074714,1719.70936,17649760347,1731383274,17649754684,-5663,,
16245125751,1719.76040,17649811376,1731434297,17649805706,-5670,,
16245176302,1719.81095,17649861929,1731484846,17649856256,-5673,,
16245226912,1719.86156,17649912542,1731535453,17649906862,-5680,,
16245276991,1719.91164,17649962623,1731585530,17649956939,-5684,,
16245327806,1719.96245,17650013440,1731636342,17650007751,-5689,,
16245378020,1720.01267,17650063657,1731686553,17650057963,-5694,,
16245428626,1720.06327,17650114265,1731737157,17650108566,-5699,,
16245478761,1720.11341,17650164402,1731787288,17650158702,-5700,,
16245529399,1720.16405,17650215042,1731837924,17650209333,-5709,,
16245580186,1720.21483,17650265831,1731888708,17650260117,-5714,,
16245630800,1720.26545,17650316447,1731939319,17650310728,-5719,,
16245681772,1720.31642,17650367423,1731990290,17650361699,-5724,,
16245732173,1720.36682,17650417826,1732040687,17650412097,-5729,,
16245782334,1720.41698,17650467989,1732090845,17650462254,-5735,,
16245832906,1720.46755,17650518564,1732141414,17650512824,-5740,,
16245883539,1720.51819,17650569199,1732192045,17650563455,-5744,,
16245934087,1720.56874,17650619750,1732242590,17650613999,-5751,,
16245984621,1720.61927,17650670285,1732293121,17650664530,-5755,,
16246035230,1720.66988,17650720897,1732343729,17650715139,-5758,,
16246085770,1720.72042,17650771439,1732394265,17650765675,-5764,,
16246136398,1720.77105,17650822070,1732444890,17650816300,-5770,,
16246187462,1720.82211,17650873135,1732495952,17650867361,-5774,,
16246238487,1720.87314,17650924164,1732546974,17650918384,-5780,,
16246288714,1720.92336,17650974392,1732597198,17650968607,-5785,,
16246339702,1720.97435,17651025382,1732648183,17651019592,-5790,,
16246389833,1721.02448,17651075517,1732698312,17651069722,-5795,,
16246440851,1721.07550,17651126547,1732749337,17651120747,-5800,,
16246490959,1721.12561,17651176647,1732799433,17651170842,-5805,,
16246541080,1721.17573,17651226771,1732849551,17651220961,-5810,,
16246591626,1721.22627,17651277319,1732900095,17651271504,-5815,,
16246642186,1721.27683,17651327882,1732950651,17651322061,-5821,,
16246692263,1721.32691,17651377961,1733000727,17651372136,-5825,,
16246742868,1721.37752,17651428567,1733051328,17651422738,-5829,,
16246793458,1721.42811,17651479161,1733101916,17651473325,-5836,,
16246843713,1721.47836,17651529417,1733152167,17651523576,-5841,,
16246894237,1721.52888,17651579943,1733202688,17651574098,-5845,,
16246944815,1721.57946,17651630525,1733253264,17651624674,-5851,,
16246995349,1721.63000,17651681061,1733303795,17651675205,-5856,,
16247045534,1721.68018,17651731248,1733353978,17651725388,-5860,,
16247096520,1721.73117,17651782237,1733404961,17651776371,-5866,,
16247147093,1721.78174,17651832812,1733455531,17651826941,-5871,,
16247197216,1721.83186,17651882937,1733505652,17651877061,-5876,,
16247247837,1721.88249,17651933560,1733556270,17651927680,-5880,,
16247298459,1721.93311,17651984184,1733606889,17651978298,-5886,,
16247349393,1721.98404,17652035121,1733657820,17652029230,-5891,,
16247399481,1722.03413,17652085212,1733707906,17652079316,-5896,,
16247450080,1722.08473,17652135812,1733758502,17652129911,-5901,,
16247500734,1722.13538,17652186468,1733809153,17652180562,-5906,,
16247551316,1722.18596,17652237054,1733859733,17652231143,-5911,,
16247601867,1722.23652,17652287607,1733910281,17652281690,-5917,,
16247652450,1722.28710,17652338192,1733960861,17652332271,-5921,,
16247703513,1722.33816,17652389258,1734011921,17652383331,-5927,,
16247754111,1722.38876,17652439857,1734062517,17652433926,-5931,,
16247805188,1722.43984,17652490937,1734113591,17652485000,-5937,,
16247856222,1722.49087,17652541975,1734164624,17652536034,-5941,,
16247906961,1722.54161,17652592715,1734215359,17652586769,-5946,,
16247957011,1722.59166,17652642768,1734265406,17652636815,-5953,,
16248007561,1722.64221,17652693320,1734315953,17652687363,-5957,,
16248058106,1722.69275,17652743867,1734366495,17652737905,-5962,,
16248108443,1722.74309,17652794207,1734416831,17652788240,-5967,,
16248158986,1722.79363,17652844752,1734467371,17652838780,-5972,,
16248209555,1722.84420,17652895323,1734517936,17652889345,-5978,,
16248260601,1722.89525,17652946371,1734568980,17652940389,-5982,,
16248310724,1722.94537,17652996497,1734619101,17652990510,-5987,,
16248361331,1722.99598,17653047106,1734669704,17653041114,-5992,,
16248411924,1723.04657,17653097701,1734720294,17653091703,-5998,,
16248462457,1723.09711,17653148236,1734770825,17653142234,-6002,,
16248513062,1723.14771,17653198845,1734821428,17653192837,-6008,,
16248564063,1723.19871,17653249848,1734872425,17653243835,-6013,,
16248614757,1723.24941,17653300544,1734923117,17653294526,-6018,,
16248665349,1723.30000,17653351151,1734973719,17653345128,-6023,,
16248716386,1723.35103,17653402178,1735024741,17653396150,-6028,,
16248766938,1723.40159,17653452732,1735075290,17653446711,-6021,,
16248818022,1723.45267,17653503819,1735126371,17653497781,-6038,,
16248868531,1723.50318,17653554329,1735176877,17653548286,-6043,,
16248919121,1723.55377,17653604922,1735227464,17653598874,-6048,,
16248970127,1723.60478,17653655930,1735278468,17653649877,-6053,,
16249020705,1723.65535,17653706512,1735329044,17653700454,-6058,,
16249071777,1723.70643,17653757585,1735380112,17653751522,-6063,,
16249122766,1723.75741,17653808577,1735431098,17653802508,-6069,,
16249173814,1723.80846,17653859627,1735482145,17653853554,-6073,,
16249224409,1723.85906,17653910225,1735532737,17653904146,-6079,,
16249275459,1723.91011,17653961277,1735583783,17653955193,-6084,,
16249326090,1723.96074,17654011910,1735634412,17654005822,-6088,,
16249376714,1724.01136,17654062537,1735685033,17654056443,-6094,,
16249427785,1724.06243,17654113610,1735736102,17654107511,-6099,,
16249478386,1724.11303,17654164213,1735786699,17654158109,-6104,,
16249529450,1724.16410,17654215279,1735837761,17654209170,-6109,,
16249580046,1724.21469,17654265878,1735888354,17654259764,-6114,,
16249630905,1724.26555,17654316739,1735939211,17654310620,-6119,,
16249681496,1724.31614,17654367333,1735989800,17654361209,-6124,,
16249731621,1724.36627,17654417460,1736039921,17654411331,-6129,,
16249781813,1724.41646,17654467654,1736090110,17654461519,-6135,,
16249831899,1724.46655,17654517742,1736140194,17654511603,-6139,,
16249882477,1724.51713,17654568323,1736190769,17654562179,-6144,,
16249932828,1724.56748,17654618677,1736241118,17654612527,-6150,,
16249983407,1724.61805,17654669257,1736291693,17654663102,-6155,,
16250034045,1724.66869,17654719898,1736342330,17654713739,-6159,,
16250084628,1724.71928,17654770494,1736392920,17654764329,-6165,,
16250135217,1724.76986,17654821075,1736443495,17654814905,-6170,,
16250185800,1724.82045,17654871660,1736494076,17654865485,-6175,,
16250236394,1724.87104,17654922257,1736544667,17654916077,-6180,,
16250287445,1724.92209,17654973310,1736595715,17654967125,-6185,,
16250338332,1724.97298,17655024198,1736646599,17655018008,-6190,,
16250389315,1725.02396,17655075185,1736697580,17655068990,-6195,,
16250439951,1725.07460,17655125823,1736748213,17655119623,-6200,,
16250490589,1725.12524,17655176462,1736798848,17655170257,-6205,,
16250541654,1725.17630,17655227531,1736849912,17655221321,-6210,,
16250591800,1725.22645,17655277678,1736900054,17655271463,-6215,,
16250642895,1725.27754,17655328777,1736951146,17655322556,-6221,,
16250693913,1725.32856,17655379797,1737002161,17655373571,-6226,,
16250744983,1725.37963,17655430869,1737053229,17655424639,-6230,,
16250795546,1725.43019,17655481435,1737103790,17655475199,-6236,,
16250846579,1725.48123,17655532470,1737154819,17655526229,-6241,,
16250897205,1725.53185,17655583097,1737205443,17655576852,-6245,,
16250948066,1725.58271,17655633962,1737256302,17655627711,-6251,,
16250998601,1725.63325,17655684499,1737306833,17655678243,-6256,,
16251048747,1725.68340,17655734647,1737356976,17655728386,-6261,,
16251099342,1725.73399,17655785245,1737407570,17655778979,-6266,,
16251149904,1725.78455,17655835809,1737458129,17655829538,-6271,,
16251200939,1725.83559,17655886846,1737509160,17655880570,-6276,,
16251251022,1725.88567,17655936932,1737559241,17655930651,-6281,,
16251301601,1725.93625,17655987512,1737609816,17655981226,-6286,,
16251351691,1725.98634,17656037606,1737659905,17656031314,-6292,,
16251401966,1726.03661,17656087894,1737710189,17656081599,-6295,,
16251453048,1726.08770,17656138967,1737761256,17656132665,-6302,,
16251504126,1726.13877,17656190048,1737812331,17656183741,-6307,,
16251554690,1726.18934,17656240614,1737862892,17656234301,-6313,,
16251605609,1726.24026,17656291534,1737913809,17656285218,-6316,,
16251656149,1726.29080,17656342078,1737964347,17656335756,-6322,,
16251707224,1726.34187,17656393154,1738015418,17656386827,-6327,,
16251758255,1726.39290,17656444187,1738066446,17656437855,-6332,,
16251808845,1726.44349,17656494780,1738117034,17656488443,-6337,,
16251858961,1726.49361,17656544899,1738167148,17656538557,-6342,,
16251909596,1726.54424,17656595536,1738217779,17656589189,-6347,,
16251960631,1726.59528,17656646585,1738268824,17656640234,-6351,,
16252011088,1726.64574,17656697033,1738319266,17656690675,-6358,,
16252061723,1726.69637,17656747671,1738369899,17656741308,-6363,,
16252112315,1726.74696,17656798265,1738420489,17656791898,-6367,,
16252162864,1726.79751,17656848816,1738471034,17656842444,-6372,,
16252213447,1726.84810,17656899402,1738521615,17656893024,-6378,,
16252264536,1726.89918,17656950493,1738572700,17656944110,-6383,,
16252315351,1726.95000,17657001310,1738623514,17656994923,-6387,,
16252365957,1727.00060,17657051919,1738674116,17657045526,-6393,,
16252416502,1727.05115,17657102466,1738724658,17657096068,-6398,,
16252467094,1727.10174,17657153060,1738775249,17657146658,-6402,,
16252517234,1727.15188,17657203202,1738825385,17657196794,-6408,,
16252567851,1727.20250,17657253822,1738875999,17657247409,-6413,,
16252618860,1727.25351,17657304833,1738927005,17657298414,-6419,,
16252669388,1727.30404,17657355376,1738977543,17657348953,-6423,,
16252720444,1727.35509,17657406422,1739028585,17657399994,-6428,,
16252771487,1727.40613,17657457468,1739079624,17657451034,-6434,,
16252822535,1727.45718,17657508518,1739130682,17657502092,-6426,,
16252873137,1727.50779,17657559122,1739181270,17657552680,-6442,,
16252924164,1727.55881,17657610152,1739232293,17657603703,-6449,,
16252975215,1727.60986,17657661205,1739283341,17657654750,-6455,,
16253026293,1727.66094,17657712284,1739334417,17657705827,-6457,,
16253077314,1727.71196,17657763309,1739385436,17657756845,-6464,,
16253127928,1727.76258,17657813925,1739436047,17657807456,-6469,,
16253178937,1727.81359,17657864935,1739487052,17657858462,-6473,,
16253229014,1727.86366,17657915016,1739537128,17657908538,-6478,,
16253280075,1727.91472,17657966079,1739588186,17657959595,-6484,,
16253331124,1727.96577,17658017130,1739639231,17658010640,-6490,,
16253381699,1728.01635,17658067708,1739689804,17658061214,-6494,,
16253431839,1728.06649,17658117850,1739739941,17658111351,-6499,,
16253482200,1728.11685,17658168214,1739790299,17658161708,-6506,,
16253532801,1728.16745,17658218817,1739840898,17658212308,-6509,,
16253583911,1728.21856,17658269929,1739892006,17658263415,-6514,,
16253634286,1728.26893,17658320306,1739942377,17658313786,-6520,,
16253684859,1728.31951,17658370882,1739992948,17658364358,-6524,,
16253735005,1728.36965,17658421030,1740043092,17658414501,-6529,,
16253785887,1728.42053,17658471915,1740093971,17658465380,-6535,,
16253836102,1728.47075,17658522131,1740144194,17658515603,-6528,,
16253886728,1728.52138,17658572770,1740194816,17658566226,-6544,,
16253937342,1728.57199,17658623377,1740245418,17658616827,-6550,,
16253988415,1728.62306,17658674451,1740296487,17658667896,-6555,,
16254038998,1728.67365,17658725037,1740347079,17658718488,-6549,,
16254090045,1728.72469,17658776087,1740398112,17658769522,-6565,,
16254140719,1728.77537,17658826763,1740448783,17658820193,-6570,,
16254191523,1728.82617,17658877570,1740499584,17658870993,-6577,,
16254241847,1728.87649,17658927895,1740549906,17658921315,-6580,,
16254292357,1728.92701,17658978407,1740600413,17658971823,-6584,,
16254343350,1728.97800,17659029404,1740651403,17659022813,-6591,,
16254393554,1729.02820,17659079609,1740701604,17659073023,-6586,,
16254443727,1729.07838,17659129785,1740751776,17659123185,-6600,,
16254494797,1729.12945,17659180858,1740802852,17659174262,-6596,,
16254545603,1729.18025,17659231666,1740853646,17659225055,-6611,,
16254596183,1729.23083,17659282248,1740904223,17659275633,-6615,,
16254646847,1729.28149,17659332915,1740954884,17659326294,-6621,,
16254697282,1729.33193,17659383352,1741005316,17659376726,-6626,,
16254747853,1729.38250,17659433924,1741055884,17659427294,-6630,,
16254798899,1729.43355,17659484974,1741106929,17659478338,-6636,,
16254849501,1729.48415,17659535577,1741157527,17659528936,-6641,,
16254899626,1729.53427,17659585715,1741207660,17659579069,-6646,,
16254950215,1729.58486,17659636307,1741258247,17659629656,-6651,,
16255000328,1729.63498,17659686412,1741308346,17659679756,-6656,,
16255050873,1729.68552,17659736960,1741358888,17659730298,-6662,,
16255101923,1729.73657,17659788011,1741409936,17659781345,-6666,,
16255152926,1729.78757,17659839016,1741460936,17659832345,-6671,,
16255202995,1729.83764,17659889089,1741511002,17659882411,-6678,,
16255254010,1729.88866,17659940106,1741562014,17659933424,-6682,,
16255304607,1729.93926,17659990705,1741612610,17659984020,-6685,,
16255355687,1729.99033,17660041787,1741663686,17660035100,-6687,,
16255406690,1730.04134,17660092793,1741714687,17660086096,-6697,,
16255457241,1730.09189,17660143346,1741765236,17660136656,-6690,,
16255508315,1730.14296,17660194422,1741816305,17660187715,-6707,,
16255559336,1730.19398,17660245445,1741867324,17660238734,-6711,,
16255609981,1730.24463,17660296094,1741917966,17660289376,-6718,,
16255660507,1730.29516,17660346622,1741968491,17660339900,-6722,,
16255711069,1730.34572,17660397186,1742019050,17660390459,-6727,,
16255761642,1730.39629,17660447761,1742069618,17660441028,-6733,,
16255812228,1730.44688,17660498350,1742120204,17660491613,-6737,,
16255862801,1730.49745,17660548925,1742170773,17660542183,-6742,,
16255913426,1730.54807,17660599553,1742221396,17660592805,-6748,,
16255964430,1730.59908,17660650558,1742272396,17660643806,-6752,,
16256014976,1730.64962,17660701106,1742322940,17660694349,-6757,,
16256065881,1730.70053,17660752015,1742373843,17660745252,-6763,,
16256116430,1730.75108,17660802566,1742424389,17660795799,-6767,,
16256167456,1730.80210,17660853594,1742475413,17660846822,-6772,,
16256218002,1730.85265,17660904143,1742525955,17660897364,-6779,,
16256269052,1730.90370,17660955195,1742577003,17660948413,-6782,,
16256320136,1730.95478,17661006282,1742628083,17660999493,-6789,,
16256371184,1731.00583,17661057331,1742679129,17661050539,-6792,,
16256421806,1731.05645,17661107955,1742729748,17661101157,-6798,,
16256472852,1731.10750,17661159005,1742780803,17661152213,-6792,,
16256523484,1731.15813,17661209639,1742831433,17661202843,-6796,,
16256574548,1731.20920,17661260705,1742882482,17661253892,-6813,,
16256625142,1731.25979,17661311301,1742933073,17661304482,-6819,,
16256675286,1731.30993,17661361448,1742983214,17661354624,-6824,,
16256726342,1731.36099,17661412505,1743034268,17661405677,-6828,,
16256776924,1731.41157,17661463090,1743084847,17661456256,-6834,,
16256827443,1731.46209,17661513612,1743135364,17661506773,-6839,,
16256878543,1731.51319,17661564715,1743186461,17661557871,-6844,,
16256929074,1731.56372,17661615247,1743236989,17661608399,-6848,,
16256980082,1731.61473,17661666257,1743287994,17661659403,-6854,,
16257030641,1731.66529,17661716820,1743338551,17661709960,-6860,,
16257081718,1731.71637,17661767899,1743389626,17661761035,-6864,,
16257132769,1731.76742,17661818952,1743440673,17661812082,-6870,,
16257183817,1731.81847,17661870003,1743491718,17661863128,-6875,,
16257234328,1731.86898,17661920515,1743542227,17661913636,-6879,,
16257285411,1731.92006,17661971601,1743593307,17661964717,-6884,,
16257336459,1731.97111,17662022652,1743644353,17662015762,-6890,,
16257387096,1732.02174,17662073291,1743694986,17662066396,-6895,,
16257437383,1732.07203,17662123580,1743745272,17662116681,-6899,,
16257488407,1732.12306,17662174607,1743796293,17662167702,-6905,,
16257539411,1732.17406,17662225613,1743847293,17662218702,-6911,,
16257589962,1732.22461,17662276166,1743897841,17662269250,-6916,,
16257640134,1732.27478,17662326341,1743948011,17662319421,-6920,,
16257690715,1732.32536,17662376924,1743998590,17662369999,-6925,,
16257741344,1732.37599,17662427556,1744049216,17662420625,-6931,,
16257791426,1732.42607,17662477640,1744099296,17662470705,-6935,,
16257842456,1732.47710,17662528672,1744150323,17662521732,-6940,,
16257893539,1732.52819,17662579758,1744201403,17662572812,-6946,,
16257944561,1732.57921,17662630782,1744252423,17662623832,-6950,,
16257995602,1732.63025,17662681825,1744303461,17662674870,-6955,,
16258046686,1732.68133,17662732912,1744354541,17662725951,-6961,,
16258097733,1732.73238,17662783961,1744405585,17662776995,-6966,,
16258148722,1732.78337,17662834953,1744456573,17662827982,-6971,,
16258199366,1732.83401,17662885599,1744507214,17662878623,-6976,,
16258249918,1732.88457,17662936153,1744557773,17662929182,-6971,,
16258300514,1732.93516,17662986751,1744608355,17662979764,-6987,,
16258351064,1732.98571,17663037303,1744658903,17663030313,-6990,,
16258401708,1733.03636,17663087950,1744709545,17663080954,-6996,,
16258451813,1733.08646,17663138058,1744759646,17663131056,-7002,,
16258502414,1733.13706,17663188661,1744810245,17663181655,-7006,,
16258553004,1733.18765,17663239252,1744860832,17663232241,-7011,,
16258603573,1733.23822,17663289825,1744911399,17663282808,-7017,,
16258654621,1733.28927,17663340875,1744962444,17663333854,-7021,,
16258705057,1733.33971,17663391313,1745012877,17663384287,-7026,,
16258755763,1733.39041,17663442021,1745063580,17663434989,-7032,,
16258806610,1733.44126,17663492870,1745114424,17663485833,-7037,,
16258857060,1733.49171,17663543323,1745164872,17663536282,-7041,,
16258907565,1733.54221,17663593831,1745215374,17663586784,-7047,,
16258958125,1733.59277,17663644393,1745265931,17663637341,-7052,,
16259008711,1733.64336,17663694982,1745316516,17663687925,-7057,,
16259059240,1733.69389,17663745513,1745367052,17663738462,-7051,,
16259109778,1733.74443,17663796053,1745417577,17663788986,-7067,,
16259160823,1733.79547,17663847101,1745468618,17663840028,-7073,,
16259211866,1733.84651,17663898146,1745519660,17663891069,-7077,,
16259262437,1733.89709,17663948718,1745570227,17663941637,-7081,,
16259313479,1733.94813,17663999764,1745621267,17663992676,-7088,,
16259364495,1733.99914,17664050781,1745672280,17664043689,-7092,,
16259414633,1734.04928,17664100921,1745722415,17664093824,-7097,,
16259465624,1734.10027,17664151915,1745773402,17664144812,-7103,,
16259516168,1734.15082,17664202462,1745823944,17664195354,-7108,,
16259566749,1734.20140,17664253046,1745874523,17664245932,-7114,,
16259617786,1734.25243,17664304085,1745925557,17664296967,-7118,,
16259668427,1734.30308,17664354727,1745976194,17664347604,-7123,,
16259719148,1734.35380,17664405451,1746026914,17664398323,-7128,,
16259770012,1734.40466,17664456317,1746077775,17664449185,-7132,,
16259821047,1734.45570,17664507354,1746128807,17664500216,-7138,,
16259871632,1734.50628,17664557942,1746179389,17664550798,-7144,,
16259922637,1734.55729,17664608950,1746230393,17664601802,-7148,,
16259973178,1734.60783,17664659493,1746280931,17664652340,-7153,,
16260023775,1734.65842,17664710092,1746331524,17664702933,-7159,,
16260074778,1734.70943,17664761098,1746382525,17664753935,-7163,,
16260124937,1734.75959,17664811259,1746432681,17664804090,-7169,,
16260175066,1734.80971,17664861391,1746482808,17664854217,-7174,,
16260226117,1734.86076,17664912443,1746533855,17664905264,-7179,,
16260276709,1734.91136,17664963039,1746584445,17664955855,-7184,,
16260327303,1734.96195,17665013634,1746635036,17665006445,-7189,,
16260378261,1735.01291,17665064594,1746685991,17665057400,-7194,,
16260428385,1735.06303,17665114722,1746736113,17665107522,-7200,,
16260478528,1735.11318,17665164867,1746786253,17665157674,-7193,,
16260528729,1735.16338,17665215069,1746836451,17665207860,-7209,,
16260579252,1735.21390,17665265596,1746886972,17665258381,-7215,,
16260629892,1735.26454,17665316237,1746937619,17665309028,-7209,,
16260680510,1735.31516,17665366858,1746988224,17665359633,-7225,,
16260731092,1735.36574,17665417442,1747038803,17665410212,-7230,,
16260781806,1735.41645,17665468159,1747089525,17665460935,-7224,,
16260832886,1735.46753,17665519241,1747140592,17665512002,-7239,,
16260883018,1735.51767,17665569376,1747190721,17665562131,-7245,,
16260933740,1735.56839,17665620100,1747241442,17665612851,-7249,,
16260984294,1735.61894,17665670655,1747291992,17665663401,-7254,,
16261034423,1735.66907,17665720788,1747342119,17665713528,-7260,,
16261084915,1735.71956,17665771282,1747392607,17665764017,-7265,,
16261135625,1735.77027,17665821993,1747443315,17665814724,-7269,,
16261186628,1735.82128,17665873000,1747494315,17665865724,-7276,,
16261237177,1735.87182,17665923551,1747544861,17665916271,-7280,,
16261287772,1735.92242,17665974149,1747595455,17665966864,-7285,,
16261338820,1735.97347,17666025199,1747646499,17666017909,-7290,,
16261389875,1736.02452,17666076256,1747697551,17666068961,-7295,,
16261440458,1736.07511,17666126841,1747748131,17666119540,-7301,,
16261491530,1736.12618,17666177915,1747799201,17666170610,-7305,,
16261542132,1736.17678,17666228520,1747849801,17666221210,-7310,,
16261593106,1736.22775,17666279496,1747900771,17666272180,-7316,,
16261643695,1736.27834,17666330088,1747951358,17666322768,-7320,,
16261694714,1736.32936,17666381109,1748002375,17666373794,-7315,,
16261745264,1736.37991,17666431673,1748052933,17666424343,-7330,,
16261795926,1736.43057,17666482326,1748103580,17666474990,-7336,,
16261846317,1736.48096,17666532719,1748153969,17666525378,-7341,,
16261897384,1736.53203,17666583789,1748205033,17666576443,-7346,,
16261947952,1736.58260,17666634359,1748255598,17666627008,-7351,,
16261998545,1736.63319,17666684954,1748306189,17666677598,-7356,,
16262049570,1736.68422,17666735982,1748357211,17666728621,-7361,,
16262099772,1736.73442,17666786186,1748407411,17666778820,-7366,,
16262149866,1736.78451,17666836283,1748457502,17666828912,-7371,,
16262200935,1736.83558,17666887354,1748508568,17666879977,-7377,,
16262251985,1736.88663,17666938406,1748559615,17666931025,-7381,,
16262302999,1736.93765,17666989422,1748610626,17666982035,-7387,,
16262353576,1736.98822,17667040002,1748661201,17667032611,-7391,,
16262404626,1737.03927,17667091054,1748712248,17667083658,-7396,,
16262455644,1737.09029,17667142075,1748763264,17667134673,-7402,,
16262506485,1737.14113,17667192918,1748814101,17667185510,-7408,,
16262557530,1737.19218,17667243966,1748865144,17667236554,-7412,,
16262608167,1737.24282,17667294605,1748915778,17667287187,-7418,,
16262658786,1737.29343,17667345226,1748966395,17667337804,-7422,,
16262709423,1737.34407,17667395865,1749017029,17667388438,-7427,,
16262760497,1737.39514,17667446941,1749068100,17667439509,-7432,,
16262811476,1737.44612,17667497923,1749119076,17667490486,-7437,,
16262862083,1737.49673,17667548533,1749169680,17667541090,-7443,,
16262912711,1737.54736,17667599162,1749220306,17667591715,-7447,,
16262963266,1737.59791,17667649720,1749270859,17667642268,-7452,,
16263013589,1737.64824,17667700046,1749321189,17667692599,-7447,,
16263064668,1737.69932,17667751127,1749372255,17667743665,-7462,,
16263115721,1737.75037,17667802183,1749423305,17667794725,-7458,,
16263166735,1737.80138,17667853199,1749474316,17667845726,-7473,,
16263217783,1737.85243,17667904249,1749525361,17667896771,-7478,,
16263268297,1737.90295,17667954765,1749575873,17667947282,-7483,,
16263318381,1737.95303,17668004852,1749625954,17667997364,-7488,,
16263368910,1738.00356,17668055382,1749676491,17668047900,-7482,,
16263419947,1738.05460,17668106423,1749727526,17668098935,-7488,,
16263470339,1738.10499,17668156816,1749777904,17668149313,-7503,,
16263521163,1738.15581,17668207643,1749828725,17668200135,-7508,,
16263571353,1738.20600,17668257836,1749878913,17668250322,-7514,,
16263622055,1738.25670,17668308540,1749929613,17668301022,-7518,,
16263673117,1738.30777,17668359604,1749980671,17668352081,-7523,,
16263723568,1738.35822,17668410058,1750031119,17668402529,-7529,,
16263774201,1738.40885,17668460693,1750081750,17668453160,-7533,,
16263824738,1738.45939,17668511233,1750132285,17668503694,-7539,,
16263875800,1738.51045,17668562296,1750183343,17668554752,-7544,,
16263926846,1738.56149,17668613345,1750234387,17668605796,-7549,,
16263977356,1738.61200,17668663858,1750284894,17668656303,-7555,,
16264027952,1738.66260,17668714456,1750335487,17668706896,-7560,,
16264078952,1738.71360,17668765458,1750386485,17668757894,-7564,,
16264129554,1738.76420,17668816063,1750437084,17668808494,-7569,,
16264180603,1738.81525,17668867113,1750488130,17668859539,-7574,,
16264231640,1738.86629,17668918152,1750539164,17668910573,-7579,,
16264282703,1738.91735,17668969218,1750590224,17668961633,-7585,,
16264333219,1738.96787,17669019736,1750640749,17669012158,-7578,,
16264384307,1739.01896,17669070827,1750691823,17669063232,-7595,,
16264434885,1739.06953,17669121407,1750742398,17669113807,-7600,,
16264485048,1739.11970,17669171573,1750792559,17669163969,-7604,,
16264535225,1739.16987,17669221753,1750842733,17669214143,-7610,,
16264585820,1739.22047,17669272349,1750893325,17669264734,-7615,,
16264636452,1739.27110,17669322983,1750943954,17669315363,-7620,,
16264687077,1739.32173,17669373612,1750994577,17669365986,-7626,,
16264738153,1739.37280,17669424690,1751045651,17669417060,-7630,,
16264788690,1739.42334,17669475229,1751096185,17669467594,-7635,,
16264839285,1739.47393,17669525826,1751146777,17669518186,-7640,,
16264889818,1739.52447,17669576361,1751197307,17669568726,-7635,,
16264940853,1739.57550,17669627398,1751248339,17669619748,-7650,,
16264991512,1739.62616,17669678061,1751298996,17669670405,-7656,,
16265042408,1739.67706,17669728969,1751349900,17669721309,-7660,,
16265092686,1739.72733,17669779239,1751400164,17669771574,-7665,,
16265142880,1739.77753,17669829436,1751450356,17669821765,-7671,,
16265193477,1739.82812,17669880035,1751500950,17669872359,-7676,,
16265244086,1739.87873,17669930647,1751551556,17669922966,-7681,,
16265294601,1739.92925,17669981163,1751602068,17669973477,-7686,,
16265344715,1739.97936,17670031280,1751652180,17670023590,-7690,,
16265395289,1740.02994,17670081857,1751702751,17670074161,-7696,,
16265445778,1740.08043,17670132347,1751753237,17670124646,-7701,,
16265495993,1740.13064,17670182565,1751803450,17670174860,-7705,,
16265546605,1740.18125,17670233179,1751854059,17670225468,-7711,,
16265597425,1740.23207,17670284001,1751904876,17670276285,-7716,,
16265648475,1740.28312,17670335053,1751955923,17670327332,-7721,,
16265698649,1740.33330,17670385230,1752006095,17670377504,-7726,,
16265749222,1740.38387,17670435806,1752056666,17670428075,-7731,,
16265799823,1740.43447,17670486408,1752107263,17670478673,-7735,,
16265850457,1740.48510,17670537045,1752157895,17670529304,-7741,,
16265900591,1740.53524,17670587182,1752208026,17670579436,-7746,,
16265951134,1740.58578,17670637726,1752258566,17670629975,-7751,,
16266001209,1740.63586,17670687805,1752308639,17670680048,-7757,,
16266052191,1740.68684,17670738788,1752359618,17670731027,-7761,,
16266103135,1740.73778,17670789734,1752410559,17670781968,-7766,,
16266154185,1740.78883,17670840788,1752461606,17670833016,-7772,,
16266204766,1740.83941,17670891370,1752512185,17670883594,-7776,,
16266255406,1740.89005,17670942014,1752562823,17670934232,-7782,,
16266306407,1740.94106,17670993016,1752613820,17670985229,-7787,,
16266356663,1740.99131,17671043274,1752664073,17671035482,-7792,,
16266407234,1741.04188,17671093849,1752714642,17671086051,-7798,,
16266457683,1741.09233,17671144299,1752765088,17671136497,-7802,,
16266508550,1741.14320,17671195169,1752815952,17671187362,-7807,,
16266559460,1741.19411,17671246081,1752866860,17671238269,-7812,,
16266610052,1741.24470,17671296676,1752917449,17671288858,-7818,,
16266660683,1741.29533,17671347309,1752968077,17671339487,-7822,,
16266711297,1741.34595,17671397926,1753018688,17671390098,-7828,,
16266761429,1741.39608,17671448060,1753068818,17671440228,-7832,,
16266812069,1741.44672,17671498701,1753119455,17671490864,-7837,,
16266863116,1741.49776,17671549751,1753170509,17671541918,-7833,,
16266914155,1741.54880,17671600792,1753221536,17671592945,-7847,,
16266964718,1741.59937,17671651358,1753272096,17671643505,-7853,,
16267015756,1741.65040,17671702399,1753323132,17671694541,-7858,,
16267066802,1741.70145,17671753447,1753374175,17671745584,-7863,,
16267117844,1741.75249,17671804492,1753425214,17671796624,-7868,,
16267168394,1741.80304,17671855043,1753475761,17671847181,-7862,,
16267219477,1741.85413,17671906129,1753526842,17671898251,-7878,,
16267270487,1741.90513,17671957142,1753577849,17671949259,-7883,,
16267321041,1741.95569,17672007697,1753628400,17671999809,-7888,,
16267372119,1742.00677,17672058778,1753679475,17672050885,-7893,,
16267423138,1742.05779,17672109800,1753730491,17672101901,-7899,,
16267474198,1742.10885,17672160861,1753781559,17672152968,-7893,,
16267524809,1742.15946,17672211476,1753832169,17672203578,-7898,,
16267575413,1742.21006,17672262081,1753882758,17672254167,-7914,,
16267626442,1742.26109,17672313113,1753933786,17672305195,-7918,,
16267677002,1742.31165,17672363675,1753984342,17672355751,-7924,,
16267728058,1742.36271,17672414733,1754035395,17672406804,-7929,,
16267779123,1742.41377,17672465801,1754086458,17672457867,-7934,,
16267830149,1742.46480,17672516830,1754137482,17672508891,-7939,,
16267880731,1742.51538,17672567413,1754188060,17672559469,-7944,,
16267931798,1742.56645,17672618483,1754239124,17672610534,-7949,,
16267982784,1742.61743,17672669472,1754290107,17672661517,-7955,,
16268033379,1742.66803,17672720069,1754340701,17672712110,-7959,,
16268084401,1742.71905,17672771094,1754391720,17672763129,-7965,,
16268135455,1742.77010,17672822150,1754442771,17672814191,-7959,,
16268186523,1742.82117,17672873220,1754493837,17672865246,-7974,,
16268237546,1742.87219,17672924245,1754544856,17672916265,-7980,,
16268288098,1742.92275,17672974810,1754595415,17672966825,-7985,,
16268338713,1742.97336,17673025416,1754646017,17673017426,-7990,,
16268388886,1743.02353,17673075593,1754696188,17673067598,-7995,,
16268439862,1743.07451,17673126571,1754747161,17673118571,-8000,,
16268490911,1743.12556,17673177622,1754798207,17673169616,-8006,,
16268541462,1743.17611,17673228175,1754848756,17673220165,-8010,,
16268592093,1743.22674,17673278809,1754899384,17673270793,-8016,,
16268643146,1743.27779,17673329865,1754950435,17673321844,-8021,,
16268693912,1743.32856,17673380633,1755001197,17673372606,-8027,,
16268744911,1743.37956,17673431634,1755052194,17673423603,-8031,,
16268795949,1743.43060,17673482675,1755103230,17673474639,-8036,,
16268846593,1743.48124,17673533321,1755153871,17673525280,-8041,,
16268897211,1743.53186,17673583941,1755204487,17673575896,-8045,,
16268948259,1743.58291,17673634992,1755255532,17673626941,-8051,,
16268998845,1743.63349,17673685579,1755306114,17673677523,-8056,,
16269049474,1743.68412,17673736211,1755356741,17673728150,-8061,,
16269099661,1743.73431,17673786401,1755406925,17673778335,-8066,,
16269150203,1743.78485,17673836944,1755457464,17673828873,-8071,,
16269201087,1743.83574,17673887832,1755508346,17673879755,-8077,,
16269252161,1743.88681,17673938907,1755559417,17673930826,-8081,,
16269302673,1743.93732,17673989422,1755609926,17673981336,-8086,,
16269352796,1743.98744,17674039548,1755660046,17674031456,-8092,,
16269403280,1744.03793,17674090034,1755710537,17674081947,-8087,,
16269453520,1744.08817,17674140276,1755760766,17674132175,-8101,,
16269504600,1744.13925,17674191359,1755811842,17674183252,-8107,,
16269555203,1744.18985,17674241963,1755862442,17674233851,-8112,,
16269605780,1744.24043,17674292542,1755913017,17674284426,-8116,,
16269656349,1744.29100,17674343114,1755963583,17674334992,-8122,,
16269706996,1744.34164,17674393764,1756014237,17674385647,-8117,,
16269757146,1744.39179,17674443916,1756064376,17674435785,-8131,,
16269807644,1744.44229,17674494417,1756114870,17674486280,-8137,,
16269857742,1744.49239,17674544517,1756164965,17674536374,-8143,,
16269908280,1744.54293,17674595057,1756215500,17674586910,-8147,,
16269958412,1744.59306,17674645192,1756265630,17674637039,-8153,,
16270008517,1744.64316,17674695299,1756315733,17674687142,-8157,,
16270059058,1744.69371,17674745842,1756366271,17674737680,-8162,,
16270110077,1744.74473,17674796863,1756417286,17674788696,-8167,,
16270160223,1744.79487,17674847012,1756467430,17674838851,-8161,,
16270210408,1744.84506,17674897198,1756517612,17674889022,-8176,,
16270260958,1744.89561,17674947751,1756568160,17674939570,-8181,,
16270311459,1744.94611,17674998255,1756618658,17674990068,-8187,,
16270362532,1744.99718,17675049342,1756669739,17675041149,-8193,,
16270413574,1745.04822,17675100375,1756720767,17675092177,-8198,,
16270464618,1745.09927,17675151420,1756771809,17675143218,-8202,,
16270515233,1745.14988,17675202038,1756822421,17675193830,-8208,,
16270565619,1745.20027,17675252427,1756872804,17675244214,-8213,,
16270616223,1745.25087,17675303033,1756923406,17675294816,-8217,,
16270666836,1745.30148,17675353649,1756974016,17675345426,-8223,,
16270717435,1745.35208,17675404250,1757024613,17675396022,-8228,,
16270768529,1745.40318,17675455346,1757075703,17675447113,-8233,,
16270819619,1745.45427,17675506438,1757126791,17675498201,-8237,,
16270870620,1745.50527,17675557442,1757177790,17675549199,-8243,,
16270921208,1745.55586,17675608032,1757228375,17675599784,-8248,,
16270971286,1745.60593,17675658113,1757278451,17675649860,-8253,,
16271022328,1745.65698,17675709157,1757329490,17675700899,-8258,,
16271073357,1745.70800,17675760188,1757380515,17675751924,-8264,,
16271123935,1745.75858,17675810768,1757431090,17675802499,-8269,,
16271174983,1745.80963,17675861818,1757482136,17675853545,-8273,,
16271225116,1745.85976,17675911955,1757532266,17675903676,-8279,,
16271275720,1745.91037,17675962560,1757582867,17675954286,-8274,,
16271326256,1745.96090,17676013098,1757633401,17676004810,-8288,,
16271377056,1746.01170,17676063902,1757684199,17676055608,-8294,,
16271427869,1746.06252,17676114717,1757735020,17676106430,-8287,,
16271478966,1746.11361,17676165816,1757786102,17676157512,-8304,,
16271529494,1746.16414,17676216358,1757836640,17676208049,-8309,,
16271579701,1746.21435,17676266556,1757886832,17676258242,-8314,,
16271629863,1746.26451,17676316720,1757936992,17676308401,-8319,,
16271680486,1746.31513,17676367345,1757987612,17676359021,-8324,,
16271731554,1746.36620,17676418416,1758038678,17676410087,-8329,,
16271782549,1746.41720,17676469413,1758089669,17676461078,-8335,,
16271833161,1746.46781,17676520028,1758140279,17676511688,-8340,,
16271884210,1746.51886,17676571078,1758191325,17676562734,-8344,,
16271935266,1746.56991,17676622138,1758242379,17676613788,-8350,,
16271986310,1746.62096,17676673184,1758293419,17676664828,-8356,,
16272037360,1746.67201,17676724236,1758344467,17676715877,-8359,,
16272087903,1746.72255,17676774782,1758395007,17676766417,-8365,,
16272138951,1746.77360,17676825832,1758446052,17676817462,-8370,,
16272189500,1746.82415,17676876383,1758496598,17676868007,-8376,,
16272240549,1746.87520,17676927435,1758547645,17676919055,-8380,,
16272291097,1746.92575,17676977984,1758598190,17676969599,-8385,,
16272341627,1746.97627,17677028518,1758648717,17677020127,-8391,,
16272392647,1747.02730,17677079539,1758699734,17677071144,-8395,,
16272443246,1747.07789,17677130141,1758750332,17677121741,-8400,,
16272494272,1747.12892,17677181170,1758801355,17677172764,-8406,,
16272544892,1747.17954,17677231792,1758851972,17677223381,-8411,,
16272805227,1747.43988,17677492139,1759112292,17677483702,-8437,17677489651,
16272830704,1747.46535,17677517616,1759137767,17677509207,-8409,,
16272881275,1747.51592,17677568191,1759188337,17677559836,-8355,,
16272932363,1747.56701,17677619281,1759239423,17677610983,-8298,,
16272983351,1747.61800,17677670271,1759290408,17677662028,-8243,,
16273034415,1747.66906,17677721338,1759341468,17677713149,-8189,,
16273085495,1747.72014,17677772419,1759392545,17677764287,-8132,,
16273136507,1747.77115,17677823435,1759443556,17677815359,-8076,,
16273187060,1747.82171,17677873990,1759494105,17677865969,-8021,,
16273237639,1747.87229,17677924571,1759544681,17677916604,-7967,,
16273288689,1747.92334,17677975624,1759595729,17677967714,-7910,,
16273339232,1747.97388,17678026169,1759646269,17678018314,-7855,,
16273389805,1748.02445,17678076754,1759696849,17678068954,-7800,,
16273440918,1748.07557,17678127859,1759747949,17678120114,-7745,,
16273491009,1748.12566,17678177952,1759798038,17678170263,-7689,,
16273541183,1748.17583,17678228129,1759848209,17678220494,-7635,,
16273591733,1748.22638,17678278681,1759898756,17678271100,-7581,,
16273642751,1748.27740,17678329701,1759949772,17678322177,-7524,,
16273693242,1748.32789,17678380194,1760000259,17678372735,-7459,,
16273743806,1748.37845,17678430761,1760050821,17678423346,-7415,,
16273794419,1748.42907,17678481377,1760101433,17678474019,-7358,,
16273844999,1748.47965,17678531970,1760152021,17678524667,-7303,,
16273895600,1748.53025,17678582563,1760202607,17678575314,-7249,,
16273946211,1748.58086,17678633176,1760253215,17678625982,-7194,,
16273996514,1748.63116,17678683481,1760303517,17678676343,-7138,,
16274047113,1748.68176,17678734083,1760354112,17678727000,-7083,,
16274098189,1748.73284,17678785161,1760405185,17678778133,-7028,,
16274148768,1748.78342,17678835743,1760455763,17678828771,-6972,,
16274199839,1748.83449,17678886816,1760506830,17678879899,-6917,,
16274250795,1748.88544,17678937773,1760557783,17678930912,-6861,,
16274301418,1748.93607,17678988400,1760608403,17678981593,-6807,,
16274352044,1748.98669,17679039027,1760659027,17679032278,-6749,,
16274402150,1749.03680,17679089136,1760709130,17679082450,-6686,,
16274453223,1749.08787,17679140212,1760760201,17679133571,-6641,,
16274503382,1749.13803,17679190373,1760810357,17679183788,-6585,,
16274554039,1749.18869,17679241032,1760861011,17679234502,-6530,,
16274604605,1749.23925,17679291612,1760911586,17679285137,-6475,,
16274655472,1749.29012,17679342481,1760962450,17679336062,-6419,,
16274706522,1749.34117,17679393523,1761013486,17679387157,-6366,,
16274757122,1749.39177,17679444124,1761064082,17679437815,-6309,,
16274807364,1749.44201,17679494368,1761114322,17679488113,-6255,,
16274857755,1749.49240,17679544762,1761164711,17679538562,-6200,,
16274908711,1749.54336,17679595720,1761215664,17679589576,-6144,,
16274958860,1749.59351,17679645872,1761265811,17679639783,-6089,,
16275009425,1749.64407,17679696439,1761316373,17679690405,-6034,,
16275060362,1749.69501,17679747379,1761367308,17679741401,-5978,,
16275110953,1749.74560,17679797972,1761417895,17679792049,-5923,,
16275161541,1749.79619,17679848563,1761468490,17679842703,-5860,,
16275212499,1749.84715,17679899522,1761519435,17679893710,-5812,,
16275262686,1749.89733,17679949712,1761569620,17679943953,-5759,,
16275312792,1749.94744,17679999821,1761619723,17679994117,-5704,,
16275363831,1749.99848,17680050862,1761670760,17680045215,-5647,,
16275414918,1750.04957,17680101951,1761721845,17680096360,-5591,,
16275465940,1750.10059,17680152976,1761772863,17680147439,-5537,,
16275516523,1750.15117,17680203560,1761823443,17680198079,-5481,,
16275567202,1750.20185,17680254243,1761874120,17680248817,-5426,,
16275617708,1750.25236,17680304762,1761924635,17680299391,-5371,,
16275668298,1750.30295,17680355343,1761975210,17680350027,-5316,,
16275718926,1750.35357,17680405973,1762025836,17680400714,-5259,,
16275769582,1750.40423,17680456632,1762076490,17680451427,-5205,,
16275819702,1750.45435,17680506754,1762126606,17680501604,-5150,,
16275870192,1750.50484,17680557247,1762177093,17680552151,-5096,,
16275921239,1750.55589,17680608295,1762228138,17680603255,-5040,,
16275972287,1750.60694,17680659346,1762279183,17680654362,-4984,,
16276023335,1750.65798,17680710397,1762330228,17680705467,-4930,,
16276074354,1750.70900,17680761429,1762381257,17680756557,-4872,,
16276125432,1750.76008,17680812497,1762432320,17680807680,-4817,,
16276176480,1750.81113,17680863549,1762483366,17680858787,-4762,,
16276227530,1750.86218,17680914601,1762534412,17680909894,-4707,,
16276278598,1750.91325,17680965672,1762585478,17680961021,-4651,,
16276329607,1750.96426,17681016683,1762636485,17681012088,-4595,,
16276380140,1751.01479,17681067218,1762687014,17681062678,-4540,,
16276430339,1751.06499,17681117420,1762737212,17681112935,-4485,,
16276481325,1751.11597,17681168408,1762788195,17681163979,-4429,,
16276532374,1751.16702,17681219458,1762839240,17681215085,-4373,,
16276582940,1751.21759,17681270027,1762889803,17681265708,-4319,,
16276633424,1751.26807,17681320513,1762940285,17681316250,-4263,,
16276684020,1751.31867,17681371111,1762990878,17681366903,-4208,,
16276734591,1751.36924,17681421686,1763041446,17681417533,-4153,,
16276784711,1751.41936,17681471807,1763091574,17681467719,-4088,,
16276835573,1751.47022,17681522673,1763142423,17681518630,-4043,,
16276886158,1751.52081,17681573259,1763193005,17681569271,-3988,,
16276936686,1751.57133,17681623789,1763243541,17681619867,-3922,,
16276987236,1751.62188,17681674353,1763294089,17681670476,-3877,,
16277038271,1751.67292,17681725380,1763345111,17681721558,-3822,,
16277089350,1751.72400,17681776461,1763396187,17681772695,-3766,,
16277140401,1751.77505,17681827515,1763447235,17681823805,-3710,,
16277191017,1751.82567,17681878133,1763497848,17681874477,-3656,,
16277241175,1751.87582,17681928293,1763548003,17681924692,-3601,,
16277291308,1751.92596,17681978428,1763598133,17681974881,-3547,,
16277341482,1751.97613,17682028604,1763648305,17682025123,-3481,,
16277392017,1752.02667,17682079142,1763698837,17682075706,-3436,,
16277443099,1752.07775,17682130226,1763749916,17682126845,-3381,,
16277493977,1752.12863,17682181107,1763800803,17682177792,-3315,,
16277545046,1752.17969,17682232190,1763851869,17682228920,-3270,,
16277595240,1752.22989,17682282374,1763902049,17682279159,-3215,,
16277646094,1752.28074,17682333231,1763952900,17682330072,-3159,,
16277697135,1752.33178,17682384275,1764003939,17682381171,-3104,,
16277747668,1752.38232,17682434819,1764054479,17682431770,-3049,,
16277798294,1752.43294,17682485438,1764105093,17682482445,-2993,,
16277849360,1752.48401,17682536507,1764156156,17682533517,-2990,,
16277900406,1752.53505,17682587554,1764207199,17682584559,-2995,,
16277951462,1752.58611,17682638613,1764258252,17682635613,-3000,,
16278002011,1752.63666,17682689165,1764308798,17682686159,-3006,,
16278052564,1752.68721,17682739720,1764359349,17682736710,-3010,,
16278103585,1752.73823,17682790743,1764410368,17682787728,-3015,,
16278154658,1752.78931,17682841818,1764461437,17682838797,-3021,,
16278205706,1752.84035,17682892869,1764512484,17682889844,-3025,,
16278256223,1752.89087,17682943389,1764562997,17682940358,-3031,,
16278306305,1752.94095,17682993473,1764613077,17682990437,-3036,,
16278356831,1752.99148,17683044011,1764663609,17683040970,-3041,,
16278407409,1753.04206,17683094582,1764714175,17683091536,-3046,,
16278457953,1753.09260,17683145127,1764764716,17683142076,-3051,,
16278509002,1753.14365,17683196178,1764815761,17683193122,-3056,,
16278559860,1753.19451,17683247040,1764866618,17683243979,-3061,,
16278610301,1753.24495,17683297483,1764917056,17683294417,-3066,,
16278661367,1753.29601,17683348551,1764968119,17683345479,-3072,,
16278711977,1753.34662,17683399164,1765018726,17683396087,-3077,,
16278762995,1753.39764,17683450183,1765069742,17683447102,-3081,,
16278813185,1753.44783,17683500375,1765119929,17683497289,-3086,,
16278863283,1753.49793,17683550477,1765170024,17683547385,-3092,,
16278913860,1753.54851,17683601055,1765220610,17683597971,-3084,,
16278964439,1753.59909,17683651637,1765271185,17683648546,-3091,,
16279015008,1753.64966,17683702208,1765321741,17683699101,-3107,,
16279065550,1753.70020,17683752753,1765372282,17683749642,-3111,,
16279116169,1753.75082,17683803375,1765422897,17683800258,-3117,,
16279166774,1753.80142,17683853982,1765473499,17683850860,-3122,,
16279217827,1753.85247,17683905036,1765524549,17683901909,-3127,,
16279268418,1753.90307,17683955631,1765575150,17683952510,-3121,,
16279319458,1753.95411,17684006673,1765626176,17684003536,-3137,,
16279369564,1754.00421,17684056781,1765676278,17684053639,-3142,,
16279420229,1754.05488,17684107449,1765726942,17684104302,-3147,,
16279470749,1754.10540,17684157970,1765777458,17684154818,-3152,,
16279521676,1754.15632,17684208900,1765828382,17684205743,-3157,,
16279572299,1754.20695,17684259526,1765879002,17684256363,-3163,,
16279622860,1754.25751,17684310088,1765929561,17684306921,-3167,,
16279673008,1754.30766,17684360239,1765979706,17684357066,-3173,,
16279724056,1754.35870,17684411290,1766030752,17684408112,-3178,,
16279774658,1754.40931,17684461894,1766081352,17684458712,-3182,,
16279825228,1754.45988,17684512467,1766131918,17684509279,-3188,,
16279875858,1754.51051,17684563099,1766182546,17684559906,-3193,,
16279926453,1754.56110,17684613696,1766233137,17684610498,-3198,,
16279977456,1754.61210,17684664702,1766284138,17684661499,-3203,,
16280028048,1754.66270,17684715296,1766334727,17684712088,-3208,,
16280078574,1754.71322,17684765824,1766385250,17684762611,-3213,,
16280129122,1754.76377,17684816375,1766435797,17684813157,-3218,,
16280180192,1754.81484,17684867447,1766486863,17684864224,-3223,,
16280231241,1754.86589,17684918498,1766537909,17684915270,-3228,,
16280282289,1754.91694,17684969549,1766588955,17684966315,-3234,,
16280333342,1754.96799,17685020604,1766640005,17685017366,-3238,,
16280384358,1755.01901,17685071622,1766691018,17685068378,-3244,,
16280435439,1755.07009,17685122706,1766742096,17685119457,-3249,,
16280486486,1755.12113,17685173755,1766793141,17685170501,-3254,,
16280537537,1755.17218,17685224809,1766844190,17685221550,-3259,,
16280588125,1755.22277,17685275399,1766894774,17685272134,-3265,,
16280638255,1755.27290,17685325541,1766944912,17685322272,-3269,,
16280688790,1755.32344,17685376068,1766995434,17685372794,-3274,,
16280738921,1755.37357,17685426202,1767045563,17685422923,-3279,,
16280789483,1755.42413,17685476766,1767096121,17685473492,-3274,,
16280840376,1755.47502,17685527661,1767147012,17685524372,-3289,,
16280890925,1755.52557,17685578212,1767197558,17685574918,-3294,,
16280941517,1755.57616,17685628806,1767248147,17685625507,-3299,,
16280992529,1755.62718,17685679821,1767299156,17685676516,-3305,,
16281042665,1755.67731,17685729960,1767349300,17685726660,-3300,,
16281093215,1755.72786,17685780512,1767399837,17685777198,-3314,,
16281144257,1755.77890,17685831557,1767450877,17685828237,-3320,,
16281194373,1755.82902,17685881675,1767500990,17685878351,-3324,,
16281244969,1755.87962,17685932273,1767551583,17685928943,-3330,,
16281295566,1755.93021,17685982873,1767602177,17685979538,-3335,,
16281346589,1755.98124,17686033898,1767653197,17686030558,-3340,,
16281397145,1756.03179,17686084457,1767703751,17686081112,-3345,,
16281447707,1756.08236,17686135020,1767754310,17686131670,-3350,,
16281498330,1756.13298,17686185646,1767804930,17686182290,-3356,,
16281548900,1756.18355,17686236218,1767855498,17686232858,-3360,,
16281599076,1756.23372,17686286396,1767905671,17686283031,-3365,,
16281649754,1756.28440,17686337077,1767956346,17686333707,-3370,,
16281700840,1756.33549,17686388166,1768007430,17686384790,-3376,,
16281751449,1756.38610,17686438777,1768058046,17686435407,-3370,,
16281802509,1756.43716,17686489839,1768109094,17686486454,-3385,,
16281853599,1756.48825,17686540932,1768160180,17686537541,-3391,,
16281904671,1756.53932,17686592005,1768211250,17686588611,-3394,,
16281955232,1756.58988,17686642569,1768261808,17686639168,-3401,,
16282005780,1756.64043,17686693120,1768312354,17686689714,-3406,,
16282056827,1756.69148,17686744169,1768363398,17686740758,-3411,,
16282107384,1756.74203,17686794728,1768413952,17686791313,-3415,,
16282158428,1756.79308,17686845775,1768464993,17686842354,-3421,,
16282209475,1756.84412,17686896823,1768516037,17686893397,-3426,,
16282260027,1756.89468,17686947378,1768566587,17686943947,-3431,,
16282311078,1756.94573,17686998432,1768617635,17686994995,-3437,,
16282362127,1756.99678,17687049482,1768668681,17687046041,-3441,,
16282412674,1757.04732,17687100033,1768719225,17687096586,-3447,,
16282463191,1757.09784,17687150552,1768769740,17687147101,-3451,,
16282513753,1757.14840,17687201127,1768820310,17687197671,-3456,,
16282564823,1757.19947,17687252189,1768871366,17687248726,-3463,,
16282615664,1757.25031,17687303032,1768922205,17687299566,-3466,,
16282665874,1757.30052,17687353245,1768972412,17687349773,-3472,,
16282716486,1757.35113,17687403858,1769023021,17687400381,-3477,,
16282767070,1757.40172,17687454445,1769073602,17687450963,-3482,,
16282817703,1757.45235,17687505081,1769124234,17687501594,-3487,,
16282867880,1757.50253,17687555260,1769174407,17687551767,-3493,,
16282918892,1757.55354,17687606274,1769225416,17687602777,-3497,,
16282969902,1757.60455,17687657287,1769276424,17687653785,-3502,,
16283020495,1757.65514,17687707884,1769327019,17687704379,-3505,,
16283071087,1757.70574,17687758476,1769377603,17687754964,-3512,,
16283122025,1757.75667,17687809428,1769428551,17687805912,-3516,,
16283173116,1757.80776,17687860510,1769479627,17687856988,-3522,,
16283223628,1757.85828,17687911025,1769530136,17687907497,-3528,,
16283274711,1757.90936,17687962110,1769581216,17687958577,-3533,,
16283325280,1757.95993,17688012680,1769631795,17688009155,-3525,,
16283376315,1758.01096,17688063719,1769682815,17688060175,-3544,,
16283426850,1758.06150,17688114256,1769733347,17688110708,-3548,,
16283477403,1758.11205,17688164811,1769783897,17688161258,-3553,,
16283527464,1758.16211,17688214874,1769833956,17688211316,-3558,,
16283578557,1758.21321,17688265970,1769885046,17688262407,-3563,,
16283629640,1758.26429,17688317055,1769936126,17688313487,-3568,,
16283680667,1758.31532,17688368084,1769987150,17688364511,-3573,,
16283730778,1758.36543,17688418198,1770037259,17688414620,-3578,,
16283780879,1758.41553,17688468300,1770087357,17688464717,-3583,,
16283831077,1758.46573,17688518502,1770137553,17688514924,-3578,,
16283882146,1758.51679,17688569573,1770188619,17688565980,-3593,,
16283932713,1758.56736,17688620143,1770239183,17688616544,-3599,,
16283983309,1758.61796,17688670741,1770289777,17688667137,-3604,,
16284033913,1758.66856,17688721346,1770340378,17688717738,-3608,,
16284084098,1758.71875,17688771535,1770390560,17688767921,-3614,,
16284134691,1758.76934,17688822140,1770441161,17688818521,-3619,,
16284185389,1758.82004,17688872829,1770491846,17688869206,-3623,,
16284235811,1758.87046,17688923255,1770542265,17688919626,-3629,,
16284286862,1758.92151,17688974307,1770593313,17688970673,-3634,,
16284337910,1758.97256,17689025358,1770644358,17689021719,-3639,,
16284388459,1759.02311,17689075909,1770694905,17689072265,-3644,,
16284438988,1759.07364,17689126452,1770745442,17689122803,-3649,,
16284490049,1759.12470,17689177504,1770796489,17689173850,-3654,,
16284540647,1759.17530,17689228104,1770847096,17689224456,-3648,,
16284591714,1759.22636,17689279174,1770898149,17689275510,-3664,,
16284642659,1759.27731,17689330122,1770949091,17689326452,-3670,,
16284693276,1759.32792,17689380741,1770999706,17689377066,-3675,,
16284744155,1759.37880,17689431622,1771050583,17689427943,-3679,,
16284794720,1759.42937,17689482189,1771101144,17689478504,-3685,,
16284845556,1759.48020,17689533028,1771151978,17689529338,-3690,,
16284895998,1759.53065,17689583471,1771202417,17689579788,-3683,,
16284946565,1759.58121,17689634041,1771252981,17689630341,-3700,,
16284996625,1759.63127,17689684115,1771303050,17689680410,-3705,,
16285047175,1759.68182,17689734656,1771353586,17689730947,-3709,,
16285097793,1759.73244,17689785276,1771404201,17689781561,-3715,,
16285148330,1759.78298,17689835815,1771454735,17689832096,-3719,,
16285198760,1759.83341,17689886247,1771505162,17689882522,-3725,,
16285249194,1759.88384,17689936685,1771555594,17689932955,-3730,,
16285299777,1759.93442,17689987270,1771606174,17689983534,-3736,,
16285350366,1759.98501,17690037860,1771656760,17690034120,-3740,,
16285401426,1760.03607,17690088924,1771707819,17690085179,-3745,,
16285452270,1760.08692,17690139770,1771758659,17690136019,-3751,,
16285502818,1760.13747,17690190321,1771809205,17690186565,-3756,,
16285552960,1760.18761,17690240465,1771859344,17690236704,-3761,,
16285604047,1760.23870,17690291554,1771910428,17690287789,-3765,,
16285654646,1760.28929,17690342155,1771961024,17690338384,-3771,,
16285705241,1760.33989,17690392753,1772011617,17690388977,-3776,,
16285755882,1760.39053,17690443395,1772062255,17690439615,-3780,,
16285806391,1760.44104,17690493907,1772112761,17690490121,-3786,,
16285857019,1760.49167,17690544537,1772163386,17690540746,-3791,,
16285907646,1760.54229,17690595167,1772214011,17690591371,-3796,,
16285958724,1760.59337,17690646248,1772265087,17690642447,-3801,,
16286009793,1760.64444,17690697318,1772316152,17690693513,-3805,,
16286060708,1760.69536,17690748235,1772367064,17690744424,-3811,,
16286111208,1760.74586,17690798739,1772417562,17690794923,-3816,,
16286161384,1760.79603,17690848917,1772467735,17690845095,-3822,,
16286211903,1760.84655,17690899439,1772518251,17690895612,-3827,,
16286262524,1760.89717,17690950062,1772568870,17690946230,-3832,,
16286312706,1760.94735,17691000246,1772619050,17690996410,-3836,,
16286363303,1760.99795,17691050845,1772669643,17691047003,-3842,,
16286413739,1761.04839,17691101283,1772720076,17691097436,-3847,,
16286463919,1761.09857,17691151465,1772770254,17691147614,-3851,,
16286514965,1761.14961,17691202515,1772821297,17691198658,-3857,,
16286565545,1761.20019,17691253096,1772871874,17691249234,-3862,,
16286616586,1761.25123,17691304140,1772922914,17691300274,-3866,,
16286667658,1761.30231,17691355215,1772973982,17691351343,-3872,,
16286718548,1761.35320,17691406107,1773024869,17691402230,-3877,,
16286769147,1761.40379,17691456719,1773075477,17691452837,-3882,,
16286820264,1761.45491,17691507828,1773126580,17691503940,-3888,,
16286870684,1761.50533,17691558249,1773176997,17691554367,-3882,,
16286921250,1761.55590,17691608818,1773227560,17691604921,-3897,,
16286971794,1761.60644,17691659375,1773278113,17691655473,-3902,,
16287022383,1761.65703,17691709956,1773328688,17691706048,-3908,,
16287073147,1761.70780,17691760723,1773379450,17691756810,-3913,,
16287124170,1761.75882,17691811748,1773430470,17691807830,-3918,,
16287175237,1761.80988,17691862817,1773481534,17691858895,-3922,,
16287225856,1761.86050,17691913439,1773532150,17691909521,-3918,,
16287276441,1761.91109,17691964026,1773582732,17691960093,-3933,,
16287326890,1761.96154,17692014476,1773633179,17692010539,-3937,,
16287377924,1762.01257,17692065514,1773684211,17692061571,-3943,,
16287428572,1762.06322,17692116163,1773734855,17692112215,-3948,,
16287479088,1762.11374,17692166682,1773785369,17692162729,-3953,,
16287530171,1762.16482,17692217767,1773836449,17692213809,-3958,,
16287580747,1762.21539,17692268345,1773887022,17692264382,-3963,,
16287631651,1762.26630,17692319253,1773937934,17692315294,-3959,,
16287681772,1762.31642,17692369376,1773988043,17692365403,-3973,,
16287732401,1762.36705,17692420007,1774038668,17692416029,-3978,,
16287782997,1762.41764,17692470606,1774089262,17692466622,-3984,,
16287834073,1762.46872,17692521684,1774140335,17692517695,-3989,,
16287884479,1762.51913,17692572092,1774190738,17692568099,-3993,,
16287935093,1762.56974,17692622708,1774241348,17692618709,-3999,,
16287985729,1762.62038,17692673346,1774291982,17692669342,-4004,,
16288036333,1762.67098,17692723953,1774342584,17692719945,-4008,,
16288086952,1762.72160,17692774575,1774393201,17692770561,-4014,,
16288137156,1762.77180,17692824781,1774443402,17692820762,-4019,,
16288187674,1762.82232,17692875300,1774493916,17692871276,-4024,,
16288238704,1762.87335,17692926334,1774544944,17692922305,-4029,,
16288289621,1762.92427,17692977252,1774595858,17692973229,-4023,,
16288339852,1762.97450,17693027486,1774646086,17693023447,-4039,,
16288390828,1763.02548,17693078464,1774697060,17693074421,-4043,,
16288441876,1763.07652,17693129515,1774748105,17693125466,-4049,,
16288492911,1763.12756,17693180553,1774799137,17693176498,-4055,,
16288543949,1763.17860,17693231592,1774850172,17693227532,-4060,,
16288594988,1763.22964,17693282633,1774901209,17693278569,-4064,,
16288645587,1763.28023,17693333236,1774951806,17693329166,-4070,,
16288696134,1763.33078,17693383785,1775002349,17693379710,-4075,,
16288746709,1763.38136,17693434362,1775052922,17693430293,-4069,,
16288797491,1763.43214,17693485147,1775103702,17693481062,-4085,,
16288847679,1763.48233,17693535337,1775153886,17693531247,-4090,,
16288898293,1763.53294,17693585953,1775204497,17693581858,-4095,,
16288948875,1763.58352,17693636538,1775255077,17693632437,-4101,,
16288999506,1763.63415,17693687171,1775305705,17693683066,-4105,,
16289050515,1763.68516,17693738183,1775356712,17693734072,-4111,,
16289101565,1763.73621,17693789246,1775407771,17693785132,-4114,,
16289152133,1763.78678,17693839805,1775458325,17693835685,-4120,,
16289203182,1763.83783,17693890856,1775509370,17693886730,-4126,,
16289254207,1763.88885,17693941884,1775560393,17693937753,-4131,,
16289304759,1763.93941,17693992438,1775610953,17693988313,-4125,,
16289355827,1763.99048,17694043509,1775662007,17694039367,-4142,,
16289406847,1764.04149,17694094531,1775713024,17694090385,-4146,,
16289457890,1764.09254,17694145576,1775764065,17694141425,-4151,,
16289508452,1764.14310,17694196141,1775814624,17694191984,-4157,,
16289559077,1764.19373,17694246768,1775865246,17694242607,-4161,,
16289609593,1764.24424,17694297287,1775915759,17694293120,-4167,,
16289660579,1764.29523,17694348274,1775966743,17694344104,-4170,,
16289711205,1764.34585,17694398903,1776017366,17694394727,-4176,,
16289761827,1764.39648,17694449527,1776067985,17694445345,-4182,,
16289812844,1764.44749,17694500547,1776119012,17694496372,-4175,,
16289863429,1764.49808,17694551134,1776169583,17694546943,-4191,,
16289913577,1764.54823,17694601285,1776219727,17694597088,-4197,,
16289964626,1764.59927,17694652336,1776270774,17694648134,-4202,,
16290015238,1764.64989,17694702950,1776321383,17694698744,-4206,,
16290065976,1764.70062,17694753691,1776372118,17694749479,-4212,,
16290117081,1764.75173,17694804797,1776423220,17694800580,-4217,,
16290167667,1764.80231,17694855386,1776473804,17694851165,-4221,,
16290218257,1764.85290,17694905978,1776524391,17694901751,-4227,,
16290268782,1764.90343,17694956506,1776574913,17694952274,-4232,,
16290319433,1764.95408,17695007159,1776625561,17695002921,-4238,,
16290369975,1765.00462,17695057704,1776676101,17695053462,-4242,,
16290420079,1765.05473,17695107810,1776726213,17695103573,-4237,,
16290470551,1765.10520,17695158284,1776776671,17695154031,-4253,,
16290521186,1765.15583,17695208922,1776827304,17695204664,-4258,,
16290572228,1765.20688,17695259966,1776878355,17695255715,-4251,,
16290623290,1765.25794,17695311030,1776929402,17695306762,-4268,,
16290674246,1765.30889,17695361988,1776980355,17695357726,-4262,,
16290724858,1765.35951,17695412602,1777030965,17695408325,-4277,,
16290775413,1765.41006,17695463160,1777081516,17695458877,-4283,,
16290825544,1765.46019,17695513293,1777131645,17695509005,-4288,,
16290876163,1765.51081,17695563915,1777182263,17695559623,-4292,,
16290926271,1765.56092,17695614025,1777232367,17695609727,-4298,,
16290976787,1765.61144,17695664544,1777282880,17695660241,-4303,,
16291027306,1765.66195,17695715065,1777333398,17695710758,-4307,,
16291078353,1765.71300,17695766115,1777384452,17695761812,-4303,,
16291129409,1765.76406,17695817173,1777435494,17695812855,-4318,,
16291180467,1765.81512,17695868234,1777486549,17695863910,-4324,,
16291230995,1765.86564,17695918764,1777537076,17695914436,-4328,,
16291282078,1765.91673,17695969849,1777588155,17695965516,-4333,,
16291332658,1765.96731,17696020432,1777638743,17696016104,-4328,,
16291383730,1766.01838,17696071506,1777689802,17696067162,-4344,,
16291434799,1766.06945,17696122577,1777740868,17696118229,-4348,,
16291485315,1766.11996,17696173096,1777791381,17696168742,-4354,,
16291535898,1766.17055,17696223681,1777841961,17696219322,-4359,,
16291586945,1766.22159,17696274730,1777893006,17696270366,-4364,,
16291637547,1766.27220,17696325335,1777943605,17696320966,-4369,,
16291688603,1766.32325,17696376392,1777994658,17696372018,-4374,,
16291738724,1766.37337,17696426517,1778044788,17696422149,-4368,,
16291789807,1766.42446,17696477602,1778095857,17696473218,-4384,,
16291839944,1766.47459,17696527741,1778145991,17696523352,-4389,,
16291891027,1766.52568,17696578826,1778197071,17696574431,-4395,,
16291941186,1766.57583,17696628987,1778247228,17696624588,-4399,,
16291991760,1766.62641,17696679564,1778297800,17696675160,-4404,,
16292042309,1766.67696,17696730115,1778348345,17696725705,-4410,,
16292093314,1766.72796,17696781123,1778399349,17696776709,-4414,,
16292143905,1766.77855,17696831716,1778449936,17696827297,-4419,,
16292194454,1766.82910,17696882268,1778500482,17696877843,-4425,,
16292245503,1766.88015,17696933319,1778551528,17696928888,-4431,,
16292296552,1766.93120,17696984369,1778602575,17696979935,-4434,,
16292347600,1766.98225,17697035420,1778653620,17697030980,-4440,,
16292398649,1767.03330,17697086472,1778704666,17697082027,-4445,,
16292449697,1767.08434,17697137523,1778755711,17697133072,-4451,,
16292500722,1767.13537,17697188550,1778806734,17697184094,-4456,,
16292551296,1767.18594,17697239125,1778857305,17697234665,-4460,,
16292602345,1767.23699,17697290177,1778908351,17697285711,-4466,,
16292653348,1767.28800,17697341182,1778959352,17697336712,-4470,,
16292703531,1767.33818,17697391378,1779009543,17697386903,-4475,,
16292754601,1767.38925,17697442440,1779060599,17697437960,-4480,,
16292805649,1767.44030,17697493490,1779111644,17697489004,-4486,,
16292856695,1767.49134,17697544539,1779162689,17697540049,-4490,,
16292907747,1767.54239,17697595594,1779213738,17697591098,-4496,,
16292958794,1767.59344,17697646642,1779264781,17697642141,-4501,,
16293009799,1767.64445,17697697651,1779315784,17697693144,-4507,,
16293060388,1767.69504,17697748242,1779366371,17697743731,-4511,,
16293111440,1767.74609,17697799296,1779417419,17697794779,-4517,,
16293162488,1767.79714,17697850347,1779468465,17697845825,-4522,,
16293213520,1767.84817,17697901380,1779519494,17697896854,-4526,,
16293264555,1767.89920,17697952417,1779570526,17697947887,-4530,,
16293315120,1767.94977,17698002986,1779621088,17697998449,-4537,,
16293365299,1767.99995,17698053166,1779671264,17698048624,-4542,,
16293415915,1768.05056,17698103785,1779721878,17698099239,-4546,,
16293466524,1768.10117,17698154397,1779772485,17698149845,-4552,,
16293517038,1768.15169,17698204912,1779822995,17698200355,-4557,,
16293567809,1768.20246,17698255687,1779873764,17698251125,-4562,,
16293618434,1768.25308,17698306314,1779924387,17698301747,-4567,,
16293669038,1768.30369,17698356919,1779974986,17698352347,-4572,,
16293719545,1768.35419,17698407430,1780025492,17698402863,-4567,,
16293770628,1768.40528,17698458515,1780076572,17698453933,-4582,,
16293820726,1768.45537,17698508615,1780126667,17698504037,-4578,,
16293871832,1768.50648,17698559724,1780177771,17698555131,-4593,,
16293922921,1768.55757,17698610815,1780228858,17698606218,-4597,,
16293973472,1768.60812,17698661367,1780279405,17698656765,-4602,,
16294024513,1768.65916,17698712411,1780330443,17698707804,-4607,,
16294075062,1768.70971,17698762962,1780380990,17698758350,-4612,,
16294125655,1768.76030,17698813557,1780431580,17698808940,-4617,,
16294176704,1768.81135,17698864610,1780482627,17698859987,-4623,,
16294227770,1768.86242,17698915678,1780533689,17698911050,-4628,,
16294278801,1768.91345,17698966711,1780584718,17698962078,-4633,,
16294329352,1768.96400,17699017265,1780635267,17699012627,-4638,,
16294380399,1769.01505,17699068314,1780686310,17699063670,-4644,,
16294431415,1769.06606,17699119332,1780737323,17699114683,-4649,,
16294481999,1769.11665,17699169919,1780787905,17699165266,-4653,,
16294532580,1769.16723,17699220501,1780838483,17699215843,-4658,,
16294583177,1769.21782,17699271102,1780889077,17699266437,-4665,,
16294633827,1769.26848,17699321754,1780939726,17699317086,-4668,,
16294684179,1769.31883,17699372107,1780990074,17699367434,-4673,,
16294734317,1769.36896,17699422248,1781040209,17699417569,-4679,,
16294784475,1769.41912,17699472409,1781090365,17699467726,-4683,,
16294834823,1769.46947,17699522769,1781140720,17699518081,-4688,,
16294885409,1769.52006,17699573347,1781191293,17699568653,-4694,,
16294936515,1769.57116,17699624456,1781242397,17699619757,-4699,,
16294987136,1769.62178,17699675079,1781293015,17699670375,-4704,,
16295037689,1769.67234,17699725635,1781343565,17699720926,-4709,,
16295088775,1769.72342,17699776723,1781394648,17699772009,-4714,,
16295139823,1769.77447,17699827774,1781445695,17699823055,-4719,,
16295190352,1769.82500,17699878316,1781496232,17699873592,-4724,,
16295241418,1769.87607,17699929373,1781547284,17699924649,-4724,,
16295292445,1769.92709,17699980403,1781598308,17699975668,-4735,,
16295343540,1769.97819,17700031500,1781649400,17700026761,-4739,,
16295394149,1770.02880,17700082110,1781700006,17700077366,-4744,,
16295444881,1770.07953,17700132846,1781750735,17700128096,-4750,,
16295495562,1770.13021,17700183528,1781801414,17700178774,-4754,,
16295546066,1770.18071,17700234036,1781851916,17700229276,-4760,,
16295597115,1770.23176,17700285087,1781902962,17700280322,-4765,,
16295647749,1770.28240,17700335723,1781953592,17700330952,-4771,,
16295698789,1770.33344,17700386766,1782004630,17700381991,-4775,,
16295748952,1770.38360,17700436930,1782054790,17700432150,-4780,,
16295799997,1770.43465,17700487978,1782105832,17700483193,-4785,,
16295850606,1770.48525,17700538589,1782156439,17700533799,-4790,,
16295901651,1770.53630,17700589637,1782207481,17700584842,-4795,,
16295952315,1770.58696,17700640303,1782258143,17700635503,-4800,,
16296002756,1770.63740,17700690750,1782308584,17700685945,-4805,,
16296053244,1770.68789,17700741237,1782359067,17700736427,-4810,,
16296103403,1770.73805,17700791398,1782409222,17700786583,-4815,,
16296154372,1770.78902,17700842370,1782460188,17700837548,-4822,,
16296204994,1770.83964,17700892994,1782510808,17700888169,-4825,,
16296256024,1770.89067,17700944027,1782561846,17700939206,-4821,,
16296306592,1770.94124,17700994597,1782612400,17700989761,-4836,,
16296357219,1770.99187,17701045226,1782663024,17701040384,-4842,,
16296407382,1771.04203,17701095391,1782713185,17701090545,-4846,,
16296458342,1771.09299,17701146354,1782764142,17701141502,-4852,,
16296508950,1771.14360,17701196963,1782814747,17701192107,-4856,,
16296559999,1771.19465,17701248016,1782865794,17701243155,-4861,,
16296611060,1771.24571,17701299090,1782916864,17701294224,-4866,,
16296662128,1771.29678,17701350149,1782967917,17701345278,-4871,,
16296713178,1771.34783,17701401201,1783018964,17701396325,-4876,,
16296763765,1771.39841,17701451790,1783069549,17701446909,-4881,,
16296814316,1771.44896,17701502345,1783120108,17701497469,-4876,,
16296865269,1771.49992,17701553300,1783171047,17701548408,-4892,,
16296915408,1771.55006,17701603441,1783221185,17701598545,-4896,,
16296966021,1771.60067,17701654057,1783271794,17701649154,-4903,,
16297016597,1771.65125,17701704635,1783322368,17701699728,-4907,,
16297067644,1771.70229,17701755684,1783373411,17701750772,-4912,,
16297118691,1771.75334,17701806734,1783424456,17701801817,-4917,,
16297169718,1771.80437,17701857763,1783475481,17701852841,-4922,,
16297220793,1771.85544,17701908839,1783526552,17701903912,-4927,,
16297271842,1771.90649,17701959892,1783577598,17701954959,-4933,,
16297322849,1771.95750,17702010900,1783628603,17702005963,-4937,,
16297373439,1772.00809,17702061493,1783679190,17702056551,-4942,,
16297423966,1772.05861,17702112034,1783729725,17702107086,-4948,,
16297475008,1772.10966,17702163067,1783780755,17702158115,-4952,,
16297526034,1772.16068,17702214095,1783831777,17702209137,-4958,,
16297576079,1772.21073,17702264143,1783881820,17702259180,-4963,,
16297626175,1772.26082,17702314241,1783931914,17702309274,-4967,,
16297677224,1772.31187,17702365293,1783982959,17702360320,-4973,,
16297727818,1772.36247,17702415888,1784033550,17702410911,-4977,,
16297778454,1772.41310,17702466526,1784084182,17702461543,-4983,,
16297828984,1772.46363,17702517059,1784134711,17702512071,-4988,,
16297879165,1772.51381,17702567242,1784184888,17702562249,-4993,,
16297929749,1772.56440,17702617829,1784235470,17702612831,-4998,,
16297980363,1772.61501,17702668445,1784286082,17702663442,-5003,,
16298031398,1772.66605,17702719483,1784337115,17702714475,-5008,,
16298081992,1772.71664,17702770078,1784387716,17702765076,-5002,,
16298132626,1772.76727,17702820715,1784438335,17702815696,-5019,,
16298183255,1772.81790,17702871347,1784488963,17702866324,-5023,,
16298233553,1772.86820,17702921648,1784539258,17702916619,-5029,,
16298284377,1772.91902,17702972473,1784590079,17702967439,-5034,,
16298335423,1772.97007,17703023522,1784641123,17703018484,-5038,,
16298385553,1773.02020,17703073655,1784691250,17703068611,-5044,,
16298435730,1773.07038,17703123834,1784741425,17703118785,-5049,,
16298486323,1773.12097,17703174429,1784792015,17703169375,-5054,,
16298536927,1773.17158,17703225035,1784842616,17703219976,-5059,,
16298587522,1773.22217,17703275632,1784893208,17703270568,-5064,,
16298638091,1773.27274,17703326204,1784943774,17703321135,-5069,,
16298688723,1773.32337,17703376839,1784994405,17703371775,-5064,,
16298739164,1773.37381,17703427282,1785044842,17703422202,-5080,,
16298789633,1773.42428,17703477753,1785095309,17703472669,-5084,,
16298840701,1773.47535,17703528824,1785146374,17703523735,-5089,,
16298891765,1773.52641,17703579889,1785197435,17703574795,-5094,,
16298942272,1773.57692,17703630399,1785247939,17703625299,-5100,,
16298992395,1773.62704,17703680525,1785298059,17703675420,-5105,,
16299042509,1773.67716,17703730641,1785348171,17703725532,-5109,,
16299093112,1773.72776,17703781245,1785398781,17703776141,-5104,,
16299143702,1773.77835,17703831838,1785449358,17703826718,-5120,,
16299194286,1773.82893,17703882425,1785499952,17703877312,-5113,,
16299244915,1773.87956,17703933057,1785550566,17703927927,-5130,,
16299295523,1773.93017,17703983667,1785601171,17703978531,-5136,,
16299346523,1773.98117,17704034669,1785652168,17704029528,-5141,,
16299397602,1774.03225,17704085751,1785703245,17704080606,-5145,,
16299448606,1774.08325,17704136756,1785754246,17704131606,-5150,,
16299498699,1774.13335,17704186852,1785804336,17704181696,-5156,,
16299549215,1774.18386,17704237371,1785854851,17704232211,-5160,,
16299599260,1774.23391,17704287417,1785904892,17704282252,-5165,,
16299649814,1774.28446,17704337973,1785955443,17704332803,-5170,,
16299700393,1774.33504,17704388555,1786006020,17704383380,-5175,,
16299751467,1774.38612,17704439632,1786057091,17704434451,-5181,,
16299802485,1774.43713,17704490651,1786108116,17704485477,-5174,,
16299853537,1774.48818,17704541707,1786159155,17704536516,-5191,,
16299904144,1774.53879,17704592316,1786209761,17704587121,-5195,,
16299955176,1774.58982,17704643351,1786260790,17704638150,-5201,,
16300005723,1774.64037,17704693899,1786311343,17704688703,-5196,,
16300056273,1774.69092,17704744452,1786361881,17704739242,-5210,,
16300106373,1774.74102,17704794554,1786411978,17704789339,-5215,,
16300156932,1774.79158,17704845116,1786462534,17704839894,-5222,,
16300207987,1774.84263,17704896173,1786513586,17704890946,-5227,,
16300259005,1774.89365,17704947193,1786564602,17704941962,-5231,,
16300309112,1774.94376,17704997303,1786614707,17704992067,-5236,,
16300360120,1774.99477,17705048313,1786665712,17705043072,-5241,,
16300410709,1775.04536,17705098905,1786716298,17705093659,-5246,,
16300461758,1775.09641,17705149956,1786767344,17705144704,-5252,,
16300512808,1775.14746,17705201009,1786818391,17705195752,-5257,,
16300563838,1775.19849,17705252041,1786869418,17705246779,-5262,,
16300614885,1775.24953,17705303090,1786920463,17705297833,-5257,,
16300665408,1775.30006,17705353615,1786970983,17705348343,-5272,,
16300715483,1775.35013,17705403693,1787021056,17705398416,-5277,,
16300766069,1775.40072,17705454280,1787071639,17705448999,-5281,,
16300817067,1775.45171,17705505282,1787122634,17705499994,-5288,,
16300867655,1775.50230,17705555872,1787173219,17705550580,-5292,,
16300918243,1775.55289,17705606462,1787223804,17705601165,-5297,,
16300968847,1775.60350,17705657068,1787274406,17705651766,-5302,,
16301019424,1775.65407,17705707648,1787324981,17705702341,-5307,,
16301070479,1775.70513,17705758705,1787376032,17705753393,-5312,,
16301120598,1775.75525,17705808838,1787426161,17705803521,-5317,,
16301171184,1775.80583,17705859415,1787476732,17705854093,-5322,,
16301221790,1775.85644,17705910023,1787527336,17705904696,-5327,,
16301272380,1775.90703,17705960615,1787577922,17705955282,-5333,,
16301323374,1775.95802,17706011612,1787628914,17706006275,-5337,,
16301374451,1776.00910,17706062691,1787679988,17706057349,-5342,,
16301425033,1776.05968,17706113275,1787730567,17706107928,-5347,,
16301475657,1776.11030,17706163902,1787781190,17706158550,-5352,,
16301526684,1776.16133,17706214931,1787832213,17706209574,-5357,,
16301577198,1776.21185,17706265448,1787882724,17706260085,-5363,,
16301627782,1776.26243,17706316034,1787933305,17706310666,-5368,,
16301678382,1776.31303,17706366637,1787983903,17706361264,-5373,,
16301728940,1776.36359,17706417197,1788034458,17706411818,-5379,,
16301779162,1776.41381,17706467420,1788084677,17706462037,-5383,,
16301829885,1776.46453,17706518146,1788135398,17706512758,-5388,,
16301880522,1776.51517,17706568786,1788186032,17706563393,-5393,,
16301931406,1776.56605,17706619671,1788236913,17706614273,-5398,,
16301982002,1776.61665,17706670270,1788287506,17706664866,-5404,,
16302033097,1776.66774,17706721368,1788338599,17706715960,-5408,,
16302083593,1776.71824,17706771867,1788389092,17706766453,-5414,,
16302134642,1776.76929,17706822917,1788440148,17706817508,-5409,,
16302185680,1776.82033,17706873957,1788491174,17706868534,-5423,,
16302236191,1776.87084,17706924472,1788541682,17706919043,-5429,,
16302286455,1776.92110,17706974737,1788591943,17706969313,-5424,,
16302337490,1776.97214,17707025775,1788642975,17707020336,-5439,,
16302388296,1777.02294,17707076584,1788693779,17707071140,-5444,,
16302438926,1777.07357,17707127216,1788744406,17707121767,-5449,,
16302489875,1777.12452,17707178167,1788795353,17707172713,-5454,,
16302540468,1777.17512,17707228763,1788845943,17707223304,-5459,,
16302591357,1777.22600,17707279654,1788896830,17707274190,-5464,,
16302642402,1777.27705,17707330702,1788947871,17707325231,-5471,,
16302693450,1777.32810,17707381752,1788998916,17707376277,-5475,,
16302744044,1777.37869,17707432347,1789049508,17707426868,-5479,,
16302794620,1777.42927,17707482926,1789100081,17707477441,-5485,,
16302844965,1777.47961,17707533273,1789150423,17707527783,-5490,,
16302895295,1777.52994,17707583605,1789200751,17707578111,-5494,,
16302946345,1777.58099,17707634659,1789251798,17707629170,-5489,,
16302997000,1777.63165,17707685316,1789302450,17707679811,-5505,,
16303048070,1777.68272,17707736387,1789353517,17707730877,-5510,,
16303098576,1777.73322,17707786897,1789404021,17707781382,-5515,,
16303149651,1777.78430,17707837974,1789455093,17707832454,-5520,,
16303199749,1777.83440,17707888074,1789505188,17707882548,-5526,,
16303250823,1777.88547,17707939151,1789556261,17707933621,-5530,,
16303301433,1777.93608,17707989762,1789606867,17707984228,-5534,,
16303352437,1777.98708,17708040769,1789657868,17708035228,-5541,,
16303403021,1778.03767,17708091355,1789708449,17708085809,-5546,,
16303453647,1778.08830,17708141984,1789759073,17708136433,-5551,,
16303503766,1778.13841,17708192106,1789809189,17708186549,-5557,,
16303554796,1778.18944,17708243138,1789860216,17708237577,-5561,,
16303604847,1778.23950,17708293191,1789910266,17708287626,-5565,,
16303655432,1778.29008,17708343779,1789960848,17708338208,-5571,,
16303706417,1778.34107,17708394765,1790011829,17708389189,-5576,,
16303757015,1778.39166,17708445366,1790062425,17708439785,-5581,,
16303808031,1778.44268,17708496385,1790113438,17708490799,-5586,,
16303858473,1778.49312,17708546828,1790163877,17708541238,-5590,,
16303909095,1778.54374,17708597452,1790214496,17708591856,-5596,,
16303959672,1778.59432,17708648032,1790265071,17708642431,-5601,,
16304010692,1778.64534,17708699055,1790316088,17708693449,-5606,,
16304060823,1778.69547,17708749188,1790366217,17708743577,-5611,,
16304111788,1778.74644,17708800156,1790417180,17708794540,-5616,,
16304161876,1778.79652,17708850246,1790467265,17708844625,-5621,,
16304212487,1778.84713,17708900860,1790517872,17708895232,-5628,,
16304262660,1778.89731,17708951035,1790568042,17708945403,-5632,,
16304313708,1778.94836,17709002085,1790619088,17708996449,-5636,,
16304364248,1778.99890,17709052628,1790669625,17709046986,-5642,,
16304415111,1779.04976,17709103492,1790720485,17709097845,-5647,,
16304465718,1779.10037,17709154102,1790771091,17709148451,-5651,,
16304515912,1779.15056,17709204299,1790821281,17709198642,-5657,,
16304566508,1779.20116,17709254897,1790871874,17709249235,-5662,,
16304616599,1779.25125,17709304989,1790921963,17709299323,-5666,,
16304666702,1779.30135,17709355096,1790972063,17709349424,-5672,,
16304717309,1779.35196,17709405705,1791022678,17709400038,-5667,,
16304767901,1779.40255,17709456299,1791073256,17709450617,-5682,,
16304818949,1779.45360,17709507349,1791124302,17709501662,-5687,,
16304869498,1779.50415,17709557901,1791174848,17709552209,-5692,,
16304920506,1779.55515,17709608911,1791225853,17709603213,-5698,,
16304970694,1779.60534,17709659102,1791276039,17709653399,-5703,,
16305021283,1779.65593,17709709693,1791326626,17709703986,-5707,,
16305071878,1779.70653,17709760290,1791377218,17709754578,-5712,,
16305122830,1779.75748,17709811256,1791428178,17709805538,-5718,,
16305173799,1779.80845,17709862216,1791479133,17709856494,-5722,,
16305224406,1779.85905,17709912826,1791529737,17709907098,-5728,,
16305275005,1779.90965,17709963427,1791580333,17709957693,-5734,,
16305325167,1779.95981,17710013591,1791630493,17710007854,-5737,,
16305375780,1780.01043,17710064207,1791681104,17710058464,-5743,,
16305426376,1780.06102,17710114804,1791731696,17710109056,-5748,,
16305477424,1780.11207,17710165854,1791782741,17710160101,-5753,,
16305528477,1780.16313,17710216910,1791833792,17710211152,-5758,,
16305579514,1780.21416,17710267950,1791884826,17710262187,-5763,,
16305629594,1780.26424,17710318031,1791934903,17710312263,-5768,,
16305680367,1780.31501,17710368808,1791985674,17710363034,-5774,,
16305730936,1780.36558,17710419379,1792036241,17710413601,-5778,,
16305781504,1780.41615,17710469949,1792086805,17710464166,-5783,,
16305832578,1780.46723,17710521025,1792137876,17710515236,-5789,,
16305883095,1780.51774,17710571545,1792188391,17710565752,-5793,,
16305933278,1780.56793,17710621731,1792238571,17710615932,-5799,,
16305983402,1780.61805,17710671857,1792288692,17710666053,-5804,,
16306033548,1780.66820,17710722004,1792338836,17710716196,-5808,,
16306084437,1780.71908,17710772897,1792389723,17710767083,-5814,,
16306135417,1780.77006,17710823890,1792440710,17710818071,-5819,,
16306186500,1780.82115,17710874964,1792491780,17710869140,-5824,,
16306237549,1780.87220,17710926015,1792542825,17710920186,-5829,,
16306288568,1780.92322,17710977047,1792593853,17710971214,-5833,,
16306339146,1780.97379,17711027617,1792644417,17711021778,-5839,,
16306390194,1781.02484,17711078668,1792695463,17711072824,-5844,,
16306441243,1781.07589,17711129719,1792746509,17711123870,-5849,,
16306491795,1781.12644,17711180274,1792797059,17711174419,-5855,,
16306542845,1781.17749,17711231326,1792848105,17711225466,-5860,,
16306593893,1781.22854,17711282375,1792899151,17711276512,-5863,,
16306644916,1781.27956,17711333401,1792950171,17711327531,-5870,,
16306695987,1781.33064,17711384475,1793001239,17711378600,-5875,,
16306747035,1781.38168,17711435525,1793052286,17711429646,-5879,,
16306798045,1781.43269,17711486538,1793103292,17711480653,-5885,,
16306848685,1781.48333,17711537180,1793153929,17711531289,-5891,,
16306899741,1781.53439,17711588237,1793204982,17711582342,-5895,,
16306950298,1781.58495,17711638798,1793255537,17711632898,-5900,,
16307001342,1781.63599,17711689844,1793306578,17711683938,-5906,,
16307051458,1781.68611,17711739963,1793356692,17711734052,-5911,,
16307102298,1781.73695,17711790804,1793407529,17711784890,-5914,,
16307152424,1781.78707,17711840932,1793457652,17711835012,-5920,,
16307203026,1781.83767,17711891538,1793508251,17711885612,-5926,,
16307253907,1781.88855,17711942420,1793559129,17711936489,-5931,,
16307304421,1781.93907,17711992948,1793609653,17711987013,-5935,,
16307354718,1781.98937,17712043237,1793659935,17712037296,-5941,,
16307404892,1782.03954,17712093423,1793710117,17712087478,-5945,,
16307455525,1782.09017,17712144048,1793760738,17712138098,-5950,,
16307506049,1782.14070,17712194575,1793811258,17712188619,-5956,,
16307556489,1782.19114,17712245016,1793861695,17712239056,-5960,,
16307607074,1782.24172,17712295604,1793912278,17712289639,-5965,,
16307657658,1782.29231,17712346191,1793962859,17712340219,-5972,,
16307708270,1782.34292,17712396805,1794013468,17712390828,-5977,,
16307758782,1782.39343,17712447319,1794063977,17712441337,-5982,,
16307809659,1782.44431,17712498198,1794114852,17712492212,-5986,,
16307860247,1782.49490,17712548789,1794165437,17712542798,-5991,,
16307910393,1782.54504,17712598937,1794215580,17712592941,-5996,,
16307961443,1782.59609,17712649989,1794266628,17712643988,-6001,,
16308012491,1782.64714,17712701040,1794317673,17712695034,-6006,,
16308063372,1782.69802,17712751924,1794368551,17712745912,-6012,,
16308114391,1782.74904,17712802945,1794419567,17712796928,-6017,,
16308165005,1782.79965,17712853561,1794470179,17712847540,-6021,,
16308215586,1782.85023,17712904144,1794520757,17712898117,-6027,,
16308266602,1782.90125,17712955163,1794571770,17712949131,-6032,,
16308317261,1782.95191,17713005824,1794622428,17712999788,-6036,,
16308367883,1783.00253,17713056449,1794673046,17713050407,-6042,,
16308418574,1783.05322,17713107142,1794723735,17713101095,-6047,,
16308469160,1783.10381,17713157730,1794774317,17713151677,-6053,,
16308520053,1783.15470,17713208626,1794825208,17713202568,-6058,,
16308571078,1783.20573,17713259653,1794876230,17713253591,-6062,,
16308621767,1783.25642,17713310344,1794926916,17713304277,-6067,,
16308672339,1783.30699,17713360930,1794977498,17713354858,-6072,,
16308723367,1783.35802,17713411949,1795028511,17713405871,-6078,,
16308774428,1783.40908,17713463013,1795079569,17713456930,-6083,,
16308825458,1783.46011,17713514045,1795130597,17713507957,-6088,,
16308876526,1783.51117,17713565114,1795181662,17713559022,-6092,,
16308927596,1783.56224,17713616188,1795232729,17713610090,-6098,,
16308978660,1783.61331,17713667254,1795283790,17713661151,-6103,,
16309029661,1783.66431,17713718258,1795334788,17713712149,-6109,,
16309080192,1783.71484,17713768791,1795385318,17713762678,-6113,,
16309131237,1783.76589,17713819837,1795436359,17713813719,-6118,,
16309181863,1783.81651,17713870466,1795486982,17713864343,-6123,,
16309232482,1783.86713,17713921088,1795537599,17713914960,-6128,,
16309283445,1783.91809,17713972053,1795588559,17713965920,-6133,,
16309333996,1783.96864,17714022606,1795639107,17714016467,-6139,,
16309384640,1784.01929,17714073253,1795689749,17714067109,-6144,,
16309434780,1784.06943,17714123395,1795739886,17714117247,-6148,,
16309485382,1784.12003,17714174000,1795790486,17714167846,-6154,,
16309535994,1784.17064,17714224625,1795841106,17714218467,-6158,,
16309586617,1784.22126,17714275239,1795891715,17714269075,-6164,,
16309637671,1784.27232,17714326296,1795942767,17714320127,-6169,,
16309688717,1784.32336,17714377343,1795993809,17714371169,-6174,,
16309739279,1784.37393,17714427909,1796044368,17714421729,-6180,,
16309789871,1784.42452,17714478503,1796094959,17714472319,-6184,,
16309840492,1784.47514,17714529126,1796145577,17714522937,-6189,,
16309890648,1784.52530,17714579285,1796195729,17714573100,-6185,,
16309941718,1784.57637,17714630357,1796246798,17714624158,-6199,,
16309992815,1784.62746,17714681456,1796297891,17714675252,-6204,,
16310043424,1784.67807,17714732068,1796348498,17714725858,-6210,,
16310093974,1784.72862,17714782620,1796399045,17714776406,-6214,,
16310144495,1784.77914,17714833153,1796449575,17714826935,-6218,,
16310195534,1784.83018,17714884185,1796500599,17714877960,-6225,,
16310246116,1784.88076,17714934769,1796551178,17714928539,-6230,,
16310296225,1784.93087,17714984880,1796601286,17714978646,-6234,,
16310346378,1784.98103,17715035035,1796651435,17715028796,-6239,,
16310396461,1785.03111,17715085121,1796701515,17715078876,-6245,,
16310446916,1785.08156,17715135578,1796751968,17715129329,-6249,,
16310497471,1785.13212,17715186136,1796802521,17715179881,-6255,,
16310548513,1785.18316,17715237180,1796853560,17715230920,-6260,,
16310599568,1785.23422,17715288242,1796904616,17715281976,-6266,,
16310650379,1785.28503,17715339051,1796955420,17715332781,-6270,,
16310701428,1785.33608,17715390101,1797006466,17715383827,-6274,,
16310752448,1785.38710,17715441125,1797057484,17715434844,-6281,,
16310803034,1785.43768,17715491713,1797108067,17715485428,-6285,,
16310853608,1785.48826,17715542288,1797158638,17715535998,-6290,,
16310904530,1785.53918,17715593225,1797209569,17715586930,-6295,,
16310955140,1785.58979,17715643838,1797260177,17715637537,-6301,,
16311005752,1785.64040,17715694440,1797310774,17715688135,-6305,,
16311055908,1785.69056,17715744599,1797360927,17715738288,-6311,,
16311106408,1785.74106,17715795101,1797411424,17715788785,-6316,,
16311157179,1785.79183,17715845873,1797462193,17715839553,-6320,,
16311207827,1785.84247,17715896524,1797512838,17715890198,-6326,,
16311258869,1785.89352,17715947568,1797563877,17715941237,-6331,,
16311309454,1785.94410,17715998157,1797614459,17715991820,-6337,,
16311359651,1785.99430,17716048356,1797664654,17716042015,-6341,,
16311410190,1786.04484,17716098897,1797715191,17716092551,-6346,,
16311461090,1786.09574,17716149800,1797766087,17716143448,-6352,,
16311511640,1786.14629,17716200351,1797816635,17716193995,-6356,,
16311562251,1786.19690,17716250964,1797867243,17716244603,-6361,,
16311612816,1786.24746,17716301533,1797917805,17716295166,-6367,,
16311663356,1786.29800,17716352075,1797968343,17716345704,-6371,,
16311713939,1786.34859,17716402660,1798018923,17716396283,-6377,,
16311764499,1786.39915,17716453233,1798069491,17716446851,-6382,,
16311815059,1786.44971,17716503785,1798120048,17716497409,-6376,,
16311866113,1786.50076,17716554840,1798171089,17716548449,-6391,,
16311916656,1786.55130,17716605387,1798221629,17716598990,-6397,,
16311967180,1786.60183,17716655912,1798272150,17716649511,-6401,,
16312018229,1786.65288,17716706965,1798323198,17716700558,-6407,,
16312069264,1786.70391,17716758002,1798374229,17716751589,-6413,,
16312119852,1786.75450,17716808592,1798424815,17716802175,-6417,,
16312170408,1786.80506,17716859151,1798475368,17716852728,-6423,,
16312221470,1786.85612,17716910215,1798526428,17716903789,-6426,,
16312271579,1786.90623,17716960326,1798576533,17716953894,-6432,,
16312322140,1786.95679,17717010890,1798627091,17717004452,-6438,,
16312372718,1787.00737,17717061470,1798677668,17717055028,-6442,,
16312422817,1787.05747,17717111571,1798727763,17717105124,-6447,,
16312473374,1787.10802,17717162131,1798778329,17717155689,-6442,,
16312523921,1787.15857,17717212680,1798828862,17717206223,-6457,,
16312574483,1787.20913,17717263244,1798879432,17717256793,-6451,,
16312625541,1787.26019,17717314305,1798930476,17717307837,-6468,,
16312676590,1787.31124,17717365355,1798981522,17717358882,-6473,,
16312727638,1787.36229,17717416406,1799032568,17717409928,-6478,,
16312778694,1787.41334,17717467465,1799083622,17717460982,-6483,,
16312829250,1787.46390,17717518022,1799134174,17717511534,-6488,,
16312880332,1787.51498,17717569108,1799185253,17717562614,-6494,,
16312931380,1787.56603,17717620158,1799236299,17717613660,-6498,,
16312982428,1787.61708,17717671208,1799287344,17717664705,-6503,,
16313033456,1787.66810,17717722239,1799338369,17717715730,-6509,,
16313084518,1787.71917,17717773304,1799389430,17717766791,-6513,,
16313135074,1787.76972,17717823860,1799439982,17717817343,-6517,,
16313185665,1787.82031,17717874455,1799490570,17717867931,-6524,,
16313236286,1787.87093,17717925078,1799541189,17717918549,-6529,,
16313286835,1787.92148,17717975629,1799591735,17717969096,-6533,,
16313337880,1787.97253,17718026677,1799642777,17718020138,-6539,,
16313388897,1788.02355,17718077695,1799693803,17718071164,-6531,,
16313439481,1788.07413,17718128282,1799744373,17718121733,-6549,,
16313490474,1788.12512,17718179278,1799795364,17718172724,-6554,,
16313541073,1788.17572,17718229879,1799845959,17718223320,-6559,,
16313591791,1788.22644,17718280600,1799896675,17718274035,-6565,,
16313642794,1788.27744,17718331605,1799947676,17718325036,-6569,,
16313692855,1788.32750,17718381668,1799997733,17718375094,-6574,,
16313742972,1788.37762,17718431787,1800047847,17718425207,-6580,,
16313793381,1788.42803,17718482199,1800098254,17718475614,-6585,,
16313843778,1788.47843,17718532598,1800148648,17718526009,-6589,,
16313894803,1788.52945,17718583625,1800199670,17718577040,-6585,,
16313945871,1788.58052,17718634696,1800250735,17718628096,-6600,,
16313996939,1788.63159,17718685767,1800301801,17718679162,-6605,,
16314047963,1788.68261,17718736793,1800352822,17718730183,-6610,,
16314098888,1788.73354,17718787720,1800403745,17718781105,-6615,,
16314149890,1788.78454,17718838725,1800454744,17718832105,-6620,,
16314200433,1788.83508,17718889280,1800505295,17718882656,-6624,,
16314251045,1788.88569,17718939884,1800555894,17718933254,-6630,,
16314301619,1788.93627,17718990460,1800606481,17718983841,-6619,,
16314352530,1788.98718,17719041374,1800657373,17719034734,-6640,,
16314403007,1789.03766,17719091852,1800707857,17719085217,-6635,,
16314454076,1789.08872,17719142924,1800758913,17719136273,-6651,,
16314504664,1789.13931,17719193515,1800809499,17719186859,-6656,,
16314555231,1789.18988,17719244084,1800860064,17719237424,-6660,,
16314606270,1789.24092,17719295125,1800911099,17719288459,-6666,,
16314656828,1789.29148,17719345686,1800961654,17719339015,-6671,,
16314707362,1789.34201,17719396222,1801012186,17719389546,-6676,,
16314758427,1789.39307,17719447290,1801063248,17719440609,-6681,,
16314809043,1789.44369,17719497919,1801113873,17719491233,-6686,,
16314860116,1789.49476,17719548984,1801164933,17719542293,-6691,,
16314910694,1789.54534,17719599577,1801215520,17719592881,-6696,,
16314961384,1789.59603,17719650255,1801266194,17719643554,-6701,,
16315011972,1789.64662,17719700846,1801316779,17719694139,-6707,,
16315062968,1789.69762,17719751845,1801367774,17719745134,-6711,,
16315114076,1789.74872,17719802954,1801418878,17719796239,-6715,,
16315164638,1789.79929,17719853519,1801469437,17719846797,-6722,,
16315215643,1789.85029,17719904527,1801520439,17719897800,-6727,,
16315266691,1789.90134,17719955577,1801571485,17719948845,-6732,,
16315317216,1789.95186,17720006105,1801622008,17719999368,-6737,,
16315367759,1790.00241,17720056650,1801672548,17720049908,-6742,,
16315418836,1790.05348,17720107730,1801723623,17720100984,-6746,,
16315469444,1790.10409,17720158340,1801774227,17720151588,-6752,,
16315520468,1790.15512,17720209366,1801825249,17720202609,-6757,,
16315571424,1790.20607,17720260325,1801876202,17720253562,-6763,,
16315622015,1790.25666,17720310917,1801926790,17720304150,-6767,,
16315673052,1790.30770,17720361957,1801977824,17720355184,-6773,,
16315723596,1790.35824,17720412504,1802028365,17720405726,-6778,,
16315774627,1790.40927,17720463537,1802079395,17720456755,-6782,,
16315824713,1790.45936,17720513625,1802129477,17720506838,-6787,,
16315875253,1790.50990,17720564168,1802180015,17720557375,-6793,,
16315925836,1790.56048,17720614752,1802230595,17720607955,-6797,,
16315975927,1790.61057,17720664846,1802280683,17720658043,-6803,,
16316026423,1790.66107,17720715356,1802331188,17720708548,-6808,,
16316076956,1790.71160,17720765880,1802381706,17720759067,-6813,,
16316127041,1790.76169,17720815968,1802431789,17720809150,-6818,,
16316178065,1790.81271,17720866994,1802482811,17720860171,-6823,,
16316228621,1790.86327,17720917552,1802533363,17720910724,-6828,,
16316279304,1790.91395,17720968239,1802584046,17720961406,-6833,,
16316329903,1790.96455,17721018839,1802634640,17721012000,-6839,,
16316380464,1791.01511,17721069402,1802685198,17721062559,-6843,,
16316430980,1791.06563,17721119921,1802735711,17721113072,-6849,,
16316481511,1791.11616,17721170454,1802786241,17721163601,-6853,,
16316532070,1791.16672,17721221015,1802836797,17721214157,-6858,,
16316582900,1791.21755,17721271848,1802887623,17721264984,-6864,,
16316633199,1791.26785,17721322148,1802937920,17721315280,-6868,,
16316683815,1791.31846,17721372767,1802988533,17721365894,-6873,,
16316734856,1791.36950,17721423811,1803039571,17721416931,-6880,,
16316785459,1791.42011,17721474416,1803090172,17721467533,-6883,,
16316836489,1791.47114,17721525449,1803141199,17721518560,-6889,,
16316886551,1791.52120,17721575512,1803191258,17721568619,-6893,,
16316936696,1791.57134,17721625660,1803241401,17721618761,-6899,,
16316987095,1791.62174,17721676062,1803291798,17721669158,-6904,,
16317038105,1791.67275,17721727073,1803342804,17721720164,-6909,,
16317088421,1791.72307,17721777392,1803393117,17721770478,-6914,,
16317138534,1791.77318,17721827508,1803443229,17721820589,-6919,,
16317189092,1791.82374,17721878068,1803493784,17721871144,-6924,,
16317239232,1791.87388,17721928209,1803543920,17721921281,-6928,,
16317290305,1791.92495,17721979286,1803594991,17721972352,-6934,,
16317340854,1791.97550,17722029836,1803645550,17722022910,-6926,,
16317391112,1792.02576,17722080097,1803695793,17722073153,-6944,,
16317441724,1792.07637,17722130712,1803746402,17722123762,-6950,,
16317492377,1792.12703,17722181367,1803797052,17722174413,-6954,,
16317542902,1792.17755,17722231905,1803847586,17722224946,-6959,,
16317593470,1792.22812,17722282464,1803898139,17722275499,-6965,,
16317644068,1792.27872,17722333065,1803948736,17722326096,-6969,,
16317694624,1792.32927,17722383623,1803999288,17722376649,-6974,,
16317745169,1792.37982,17722434170,1804049830,17722427190,-6980,,
16317795737,1792.43038,17722484741,1804100396,17722477756,-6985,,
16317846311,1792.48096,17722535318,1804150967,17722528328,-6990,,
16317896883,1792.53153,17722585892,1804201536,17722578897,-6995,,
16317947111,1792.58176,17722636122,1804251761,17722629122,-7000,,
16317998057,1792.63270,17722687071,1804302705,17722680066,-7005,,
16318048803,1792.68345,17722737819,1804353448,17722730808,-7011,,
16318099820,1792.73447,17722788838,1804404463,17722781823,-7015,,
16318150060,1792.78471,17722839081,1804454700,17722832061,-7020,,
16318201050,1792.83570,17722890073,1804505687,17722883048,-7025,,
16318252132,1792.88678,17722941157,1804556766,17722934127,-7030,,
16318303061,1792.93771,17722992089,1804607692,17722985052,-7037,,
16318353621,1792.98827,17723042650,1804658250,17723035620,-7030,,
16318404155,1793.03880,17723093197,1804708792,17723086152,-7045,,
16318454841,1793.08949,17723143876,1804759475,17723136835,-7041,,
16318505499,1793.14015,17723194536,1804810120,17723187480,-7056,,
16318555858,1793.19051,17723244898,1804860476,17723237837,-7061,,
16318606470,1793.24112,17723295512,1804911085,17723288445,-7067,,
16318657111,1793.29176,17723346155,1804961723,17723339084,-7071,,
16318707371,1793.34202,17723396418,1805011981,17723389341,-7077,,
16318757637,1793.39228,17723446686,1805062244,17723439605,-7081,,
16318808359,1793.44301,17723497410,1805112963,17723490324,-7086,,
16318858942,1793.49359,17723547995,1805163544,17723540904,-7091,,
16318909543,1793.54419,17723598599,1805214142,17723591503,-7096,,
16318960116,1793.59476,17723649174,1805264722,17723642083,-7091,,
16319010562,1793.64521,17723699623,1805315156,17723692516,-7107,,
16319060796,1793.69544,17723749859,1805365387,17723742747,-7112,,
16319111844,1793.74649,17723800909,1805416433,17723793793,-7116,,
16319161961,1793.79661,17723851029,1805466547,17723843907,-7122,,
16319212549,1793.84720,17723901619,1805517132,17723894493,-7126,,
16319263476,1793.89812,17723952547,1805568056,17723945416,-7131,,
16319314001,1793.94865,17724003076,1805618578,17723995939,-7137,,
16319364076,1793.99872,17724053153,1805668651,17724046012,-7141,,
16319415045,1794.04969,17724104124,1805719617,17724096978,-7146,,
16319465675,1794.10032,17724154757,1805770245,17724147605,-7152,,
16319516685,1794.15133,17724205768,1805821251,17724198611,-7157,,
16319567258,1794.20191,17724256345,1805871822,17724249183,-7162,,
16319617871,1794.25252,17724306959,1805922432,17724299793,-7166,,
16319668884,1794.30353,17724357975,1805973442,17724350803,-7172,,
16319719919,1794.35457,17724409013,1806024476,17724401836,-7177,,
16319770518,1794.40517,17724459613,1806075071,17724452432,-7181,,
16319821041,1794.45569,17724510139,1806125591,17724502963,-7176,,
16319872113,1794.50676,17724561213,1806176660,17724554021,-7192,,
16319923137,1794.55778,17724612239,1806227682,17724605042,-7197,,
16319974200,1794.60885,17724663305,1806278743,17724656103,-7202,,
16320025220,1794.65987,17724714328,1806329759,17724707120,-7208,,
16320075316,1794.70996,17724764426,1806379854,17724757214,-7212,,
16320125363,1794.76001,17724814475,1806429897,17724807258,-7217,,
16320175925,1794.81057,17724865039,1806480456,17724857816,-7223,,
16320226486,1794.86113,17724915603,1806531014,17724908375,-7228,,
16320277532,1794.91218,17724966652,1806582058,17724959419,-7233,,
16320328101,1794.96275,17725017223,1806632624,17725009985,-7238,,
16320379140,1795.01379,17725068263,1806683660,17725061021,-7242,,
16320429675,1795.06432,17725118802,1806734193,17725111554,-7248,,
16320480264,1795.11491,17725169393,1806784780,17725162140,-7253,,
16320530908,1795.16556,17725220038,1806835420,17725212780,-7258,,
16320581927,1795.21657,17725271061,1806886437,17725263797,-7264,,
16320632515,1795.26716,17725321662,1806937033,17725314394,-7268,,
16320683259,1795.31791,17725372397,1806987764,17725365125,-7272,,
16320733820,1795.36847,17725422960,1807038321,17725415681,-7279,,
16320784828,1795.41948,17725473970,1807089327,17725466687,-7283,,
16320835432,1795.47008,17725524578,1807139929,17725517289,-7289,,
16320886097,1795.52075,17725575245,1807190591,17725567951,-7294,,
16320936691,1795.57134,17725625843,1807241184,17725618544,-7299,,
16320987515,1795.62216,17725676668,1807292003,17725669363,-7305,,
16321038541,1795.67319,17725727696,1807343027,17725720387,-7309,,
16321088641,1795.72329,17725777798,1807393124,17725770484,-7314,,
16321139235,1795.77388,17725828395,1807443715,17725821076,-7319,,
16321189702,1795.82435,17725878864,1807494180,17725871540,-7324,,
16321240558,1795.87521,17725929722,1807545032,17725922393,-7329,,
16321290629,1795.92528,17725979796,1807595100,17725972460,-7336,,
16321341251,1795.97590,17726030420,1807645720,17726023081,-7339,,
16321392292,1796.02694,17726081462,1807696758,17726074118,-7344,,
16321442911,1796.07756,17726132085,1807747374,17726124735,-7350,,
16321493509,1796.12816,17726182685,1807797970,17726175331,-7354,,
16321543719,1796.17837,17726232897,1807848177,17726225538,-7359,,
16321594245,1796.22889,17726283437,1807898712,17726276072,-7365,,
16321645267,1796.27992,17726334450,1807949720,17726327081,-7369,,
16321695826,1796.33047,17726385012,1808000276,17726377637,-7375,,
16321745875,1796.38052,17726435063,1808050322,17726427683,-7380,,
16321796424,1796.43107,17726485625,1808100879,17726478240,-7385,,
16321847506,1796.48215,17726536699,1808151949,17726529309,-7390,,
16321898553,1796.53320,17726587748,1808202993,17726580353,-7395,,
16321949571,1796.58422,17726638768,1808254007,17726631368,-7400,,
16322000653,1796.63530,17726689853,1808305087,17726682448,-7405,,
16322051651,1796.68630,17726740852,1808356082,17726733442,-7410,,
16322101760,1796.73641,17726790963,1808406188,17726783548,-7415,,
16322152782,1796.78743,17726841989,1808457208,17726834568,-7421,,
16322202995,1796.83764,17726892203,1808507418,17726884778,-7425,,
16322253208,1796.88786,17726942418,1808557628,17726934988,-7430,,
16322303802,1796.93845,17726993016,1808608220,17726985580,-7436,,
16322353909,1796.98856,17727043125,1808658324,17727035685,-7440,,
16322404961,1797.03961,17727094189,1808709384,17727086744,-7445,,
16322455578,1797.09023,17727144798,1808759998,17727137359,-7439,,
16322506130,1797.14078,17727195362,1808810546,17727187907,-7455,,
16322556779,1797.19143,17727246004,1808861183,17727238544,-7460,,
16322607828,1797.24248,17727297056,1808912230,17727289590,-7466,,
16322658450,1797.29310,17727347680,1808962848,17727340209,-7471,,
16322709315,1797.34396,17727398548,1809013711,17727391072,-7476,,
16322760184,1797.39483,17727449419,1809064578,17727441938,-7481,,
16322810747,1797.44539,17727499984,1809115137,17727492498,-7486,,
16322861795,1797.49644,17727551034,1809166182,17727543542,-7492,,
16322912375,1797.54702,17727601617,1809216760,17727594121,-7496,,
16322962946,1797.59759,17727652190,1809267328,17727644689,-7501,,
16323013711,1797.64836,17727702958,1809318091,17727695451,-7507,,
16323064317,1797.69897,17727753566,1809368694,17727746054,-7512,,
16323114872,1797.74952,17727804123,1809419247,17727796607,-7516,,
16323165477,1797.80012,17727854731,1809469859,17727847220,-7511,,
16323216511,1797.85116,17727905766,1809520879,17727898240,-7526,,
16323267157,1797.90180,17727956416,1809571535,17727948895,-7521,,
16323317701,1797.95235,17728006972,1809622075,17727999435,-7537,,
16323368464,1798.00311,17728057727,1809672824,17728050185,-7542,,
16323419482,1798.05413,17728108747,1809723840,17728101200,-7547,,
16323470062,1798.10471,17728159330,1809774417,17728151778,-7552,,
16323521109,1798.15576,17728210379,1809825462,17728202822,-7557,,
16323572128,1798.20678,17728261401,1809876477,17728253838,-7563,,
16323623207,1798.25786,17728312482,1809927554,17728304915,-7567,,
16323673737,1798.30839,17728363014,1809978081,17728355452,-7562,,
16323724773,1798.35942,17728414053,1810029115,17728406475,-7578,,
16323775354,1798.41000,17728464636,1810079693,17728457054,-7582,,
16323826384,1798.46103,17728515669,1810130731,17728508091,-7578,,
16323877452,1798.51210,17728566739,1810181785,17728559146,-7593,,
16323928492,1798.56314,17728617791,1810232833,17728610193,-7598,,
16323979082,1798.61373,17728668374,1810283410,17728660771,-7603,,
16324029672,1798.66432,17728718966,1810333997,17728711357,-7609,,
16324080258,1798.71491,17728769554,1810384581,17728761941,-7613,,
16324130363,1798.76501,17728819662,1810434683,17728812044,-7618,,
16324180870,1798.81552,17728870171,1810485187,17728862548,-7623,,
16324231462,1798.86611,17728920765,1810535776,17728913137,-7628,,
16324282092,1798.91674,17728971398,1810586404,17728963764,-7634,,
16324332554,1798.96720,17729021861,1810636863,17729014235,-7626,,
16324382718,1799.01737,17729072028,1810687024,17729064384,-7644,,
16324433174,1799.06782,17729122487,1810737477,17729114837,-7650,,
16324483302,1799.11795,17729172617,1810787603,17729164964,-7653,,
16324534057,1799.16871,17729223373,1810838355,17729215715,-7658,,
16324584618,1799.21927,17729273938,1810888913,17729266274,-7664,,
16324635165,1799.26981,17729324486,1810939458,17729316818,-7668,,
16324686013,1799.32066,17729375348,1810990313,17729367673,-7675,,
16324736908,1799.37156,17729426235,1811041195,17729418556,-7679,,
16324787029,1799.42168,17729476357,1811091313,17729468673,-7684,,
16324837653,1799.47230,17729526985,1811141935,17729519307,-7678,,
16324887783,1799.52243,17729577128,1811192073,17729569434,-7694,,
16324938444,1799.57309,17729627780,1811242720,17729620081,-7699,,
16324989280,1799.62393,17729678618,1811293554,17729670914,-7704,,
16325039403,1799.67405,17729728744,1811343674,17729721035,-7709,,
16325090038,1799.72469,17729779380,1811394305,17729771666,-7714,,
16325140605,1799.77525,17729829951,1811444871,17729822231,-7720,,
16325191647,1799.82630,17729880994,1811495910,17729873280,-7714,,
16325242702,1799.87735,17729932052,1811546962,17729924323,-7729,,
16325293254,1799.92790,17729982607,1811597522,17729974882,-7725,,
16325344328,1799.97898,17730033682,1811648583,17730025943,-7739,,
